,LOAD_TIME,FFP_DATE,LAST_TO_END,FLIGHT_COUNT,avg_discount,SEG_KM_SUM,LAST_TO_END,P1Y_Flight_Count,L1Y_Flight_Count
0,2014/03/31,2006/11/02,1,210,0.961639043,580717,1,103,107
1,2014/03/31,2007/02/19,7,140,1.25231444,293678,7,68,72
2,2014/03/31,2007/02/01,11,135,1.254675516,283712,11,65,70
3,2014/03/31,2008/08/22,97,23,1.090869565,281336,97,13,10
4,2014/03/31,2009/04/10,5,152,0.970657895,309928,5,71,81
5,2014/03/31,2008/02/10,79,92,0.967692483,294585,79,50,42
6,2014/03/31,2006/03/22,1,101,0.965346535,287042,1,50,51
7,2014/03/31,2010/04/09,3,73,0.962070222,287230,3,30,43
8,2014/03/31,2011/06/07,6,56,0.828478237,321489,6,33,23
9,2014/03/31,2010/07/05,15,64,0.7080101529999999,375074,15,39,25
10,2014/03/31,2010/11/18,22,43,0.988658044,262013,22,20,23
11,2014/03/31,2004/11/13,6,145,0.95253487,271438,6,57,88
12,2014/03/31,2006/11/23,67,29,0.799126984,321529,67,14,15
13,2014/03/31,2006/10/25,3,118,1.398381742,179514,3,52,66
14,2014/03/31,2010/02/01,2,50,0.921984841,270067,2,25,25
15,2014/03/31,2008/03/28,65,22,1.026084586,234721,65,11,11
16,2014/03/31,2010/07/15,7,101,1.3865249,172231,7,46,55
17,2014/03/31,2010/11/10,45,40,0.8378442429999999,284160,45,15,25
18,2014/03/31,2006/04/06,2,64,1.401596264,169358,2,32,32
19,2014/03/31,2011/08/29,24,38,0.70828541,332896,24,20,18
20,2014/03/31,2008/07/30,4,106,1.369404116,167113,4,44,62
21,2014/03/31,2011/06/07,6,23,1.061630924,214590,6,8,15
22,2014/03/31,2005/04/10,23,94,0.741803833,305250,23,43,51
23,2014/03/31,2010/04/13,74,20,1.004904443,222380,74,13,7
24,2014/03/31,2010/02/14,17,44,0.7873084440000001,281837,17,17,27
25,2014/03/31,2010/10/14,17,62,0.902990019,243674,17,20,42
26,2014/03/31,2007/02/01,3,213,1.146354614,187917,3,118,95
27,2014/03/31,2005/01/15,11,74,1.4333644280000002,148685,11,40,34
28,2014/03/31,2006/01/07,18,101,1.33816985,159129,18,49,52
29,2014/03/31,2008/06/16,11,87,1.424714581,149254,11,42,45
30,2014/03/31,2006/04/11,2,53,1.469224298,144076,2,27,26
31,2014/03/31,2004/11/25,8,95,1.414895104,149053,8,66,29
32,2014/03/31,2005/04/11,16,131,0.944884271,220948,16,58,73
33,2014/03/31,2006/03/20,3,95,1.3986401940000002,148227,3,56,39
34,2014/03/31,2006/12/01,3,47,0.725685618,285144,3,22,25
35,2014/03/31,2009/10/13,108,25,0.937899941,220389,108,12,13
36,2014/03/31,2005/02/13,34,24,1.087220053,189813,34,18,6
37,2014/03/31,2006/03/30,125,54,1.462104927,141012,125,32,22
38,2014/03/31,2007/05/08,1,166,0.890172305,229303,1,68,98
39,2014/03/31,2009/02/27,34,81,1.4291794430000002,140819,34,41,40
40,2014/03/31,2006/04/25,2,98,1.458541443,137876,2,51,47
41,2014/03/31,2011/01/18,3,35,0.998554546,201141,3,20,15
42,2014/03/31,2007/01/04,3,95,1.3969850069999998,140803,3,44,51
43,2014/03/31,2010/05/04,13,46,0.764737193,256766,13,26,20
44,2014/03/31,2004/12/04,38,54,1.20853437,160825,38,25,29
45,2014/03/31,2010/12/11,22,21,1.029507529,185493,22,11,10
46,2014/03/31,2012/07/13,1,110,1.015978367,187588,1,37,73
47,2014/03/31,2006/07/16,7,134,1.356053179,140356,7,78,56
48,2014/03/31,2005/01/26,2,107,1.3989924230000002,135811,2,56,51
49,2014/03/31,2010/07/15,304,70,0.863479447,219282,304,61,9
50,2014/03/31,2008/05/21,1,189,0.802633323,235687,1,78,111
51,2014/03/31,2012/01/08,4,87,1.4251770069999998,132283,4,38,49
52,2014/03/31,2006/11/18,11,29,0.8888699859999999,211369,11,10,19
53,2014/03/31,2007/12/10,1,48,1.408197795,130135,1,17,31
54,2014/03/31,2007/07/06,1,68,1.349375212,135374,1,27,41
55,2014/03/31,2004/12/03,4,111,0.828452854,216560,4,51,60
56,2014/03/31,2007/11/26,22,69,1.3549435669999998,131660,22,31,38
57,2014/03/31,2008/02/02,4,126,0.867522349,204371,4,63,63
58,2014/03/31,2004/12/28,15,55,1.146000598,153868,15,25,30
59,2014/03/31,2005/01/26,21,76,0.819187329,214921,21,30,46
60,2014/03/31,2005/02/17,15,68,1.380410335,127335,15,32,36
61,2014/03/31,2004/11/19,1,77,1.288018381,136121,1,29,48
62,2014/03/31,2010/06/09,6,84,0.938031056,186821,6,33,51
63,2014/03/31,2011/05/14,14,96,0.848239546,204612,14,54,42
64,2014/03/31,2010/05/28,8,30,1.057257212,164001,8,9,21
65,2014/03/31,2005/08/13,19,85,1.4261062619999998,121097,19,47,38
66,2014/03/31,2007/11/15,88,32,0.944650121,182563,88,19,13
67,2014/03/31,2010/07/10,19,34,1.013669976,170121,19,22,12
68,2014/03/31,2010/10/30,1,197,0.620507614,275800,1,117,80
69,2014/03/31,2008/12/14,7,30,0.928504294,184194,7,15,15
70,2014/03/31,2012/08/15,62,18,0.8118710790000001,209911,62,6,12
71,2014/03/31,2009/10/19,19,64,1.236256939,137636,19,22,42
72,2014/03/31,2011/12/21,4,149,0.774487057,219108,4,68,81
73,2014/03/31,2007/11/18,13,61,1.183962818,143186,13,23,38
74,2014/03/31,2010/10/13,36,36,0.8061770690000001,209839,36,15,21
75,2014/03/31,2010/08/14,22,22,0.992454374,170406,22,6,16
76,2014/03/31,2013/03/15,29,23,0.995539285,169224,29,4,19
77,2014/03/31,2011/06/09,18,16,1.019520072,163191,18,6,10
78,2014/03/31,2010/10/26,8,102,1.179368992,140220,8,41,61
79,2014/03/31,2005/10/21,6,81,1.034587737,159255,6,43,38
80,2014/03/31,2012/06/29,6,30,0.782406571,208687,6,7,23
81,2014/03/31,2006/07/13,12,127,0.956332827,170611,12,53,74
82,2014/03/31,2008/09/19,2,56,1.394863786,116728,2,22,34
83,2014/03/31,2012/04/25,1,79,0.777341772,208797,1,34,45
84,2014/03/31,2005/02/17,9,97,1.036667137,155881,9,42,55
85,2014/03/31,2004/11/18,2,158,0.784701427,205159,2,77,81
86,2014/03/31,2006/05/08,7,64,1.3912993059999998,115300,7,31,33
87,2014/03/31,2010/07/03,13,51,1.165835855,137500,13,26,25
88,2014/03/31,2007/06/28,144,29,1.0178590440000002,157056,144,17,12
89,2014/03/31,2007/10/05,1,69,1.3874902919999998,114077,1,34,35
90,2014/03/31,2008/06/13,15,88,1.281481989,122619,15,27,61
91,2014/03/31,2011/01/31,15,42,0.966069448,162453,15,4,38
92,2014/03/31,2007/01/26,10,129,1.429138536,109813,10,67,62
93,2014/03/31,2006/11/28,14,67,1.265322199,123464,14,32,35
94,2014/03/31,2010/04/13,53,12,1.059166667,146784,53,1,11
95,2014/03/31,2004/11/26,4,100,0.952273652,162250,4,44,56
96,2014/03/31,2005/09/23,11,69,1.297050351,118726,11,35,34
97,2014/03/31,2011/04/14,34,17,1.226505277,125349,34,7,10
98,2014/03/31,2004/11/11,9,12,1.046666667,146784,9,7,5
99,2014/03/31,2012/04/27,4,54,1.053910364,144562,4,34,20
100,2014/03/31,2008/07/28,21,79,1.228445376,123985,21,39,40
101,2014/03/31,2008/09/08,5,87,1.4454897780000002,105119,5,43,44
102,2014/03/31,2012/04/28,17,53,1.046215562,144682,17,30,23
103,2014/03/31,2007/01/03,17,92,1.118316089,134823,17,46,46
104,2014/03/31,2010/05/26,11,48,1.001144569,150537,11,23,25
105,2014/03/31,2005/10/22,3,90,1.390945611,108184,3,46,44
106,2014/03/31,2009/01/18,9,56,1.435274261,104663,9,29,27
107,2014/03/31,2005/04/05,4,146,0.7832398290000001,191328,4,74,72
108,2014/03/31,2011/09/14,15,35,0.894261083,167150,15,20,15
109,2014/03/31,2011/10/09,63,33,0.85318887,174046,63,23,10
110,2014/03/31,2005/08/26,7,142,0.835532119,177357,7,59,83
111,2014/03/31,2010/11/17,44,31,0.723434195,204438,44,11,20
112,2014/03/31,2006/11/28,29,53,1.434114409,102999,29,29,24
113,2014/03/31,2007/05/31,14,21,0.925114251,159605,14,10,11
114,2014/03/31,2012/06/07,27,16,0.75375,195712,27,6,10
115,2014/03/31,2004/11/25,3,85,0.946174922,155704,3,37,48
116,2014/03/31,2004/11/24,22,71,1.225504039,119961,22,33,38
117,2014/03/31,2008/08/23,2,130,0.873661907,167593,2,50,80
118,2014/03/31,2010/05/07,4,89,0.978068228,149557,4,37,52
119,2014/03/31,2005/07/29,11,83,1.411593411,103087,11,30,53
120,2014/03/31,2004/12/02,2,99,0.8969661870000001,162215,2,44,55
121,2014/03/31,2005/03/16,27,40,0.731685018,198627,27,18,22
122,2014/03/31,2008/05/30,11,52,1.458000784,99524,11,25,27
123,2014/03/31,2005/12/29,10,65,1.210876087,119794,10,26,39
124,2014/03/31,2005/04/23,3,34,0.951756044,151642,3,15,19
125,2014/03/31,2006/08/14,6,83,0.960765569,149993,6,32,51
126,2014/03/31,2011/11/14,24,65,1.318943707,109089,24,27,38
127,2014/03/31,2012/12/20,23,18,0.982511386,146238,23,3,15
128,2014/03/31,2007/06/08,4,66,1.39722054,102689,4,29,37
129,2014/03/31,2006/04/17,2,52,1.3569867919999998,105167,2,21,31
130,2014/03/31,2011/03/15,38,27,0.780547269,182561,38,16,11
131,2014/03/31,2004/11/30,1,193,0.6756097790000001,209912,1,104,89
132,2014/03/31,2012/06/26,6,65,0.764,184730,6,0,65
133,2014/03/31,2012/04/11,59,14,0.97367319,144708,59,9,5
134,2014/03/31,2009/10/19,11,24,0.658633893,213058,11,9,15
135,2014/03/31,2010/10/09,17,89,0.787337009,177556,17,39,50
136,2014/03/31,2008/06/20,8,57,1.42497258,98104,8,23,34
137,2014/03/31,2009/11/13,12,101,0.996902945,140188,12,52,49
138,2014/03/31,2013/03/03,16,19,0.897522308,155552,16,2,17
139,2014/03/31,2006/06/29,24,95,0.988949912,140931,24,62,33
140,2014/03/31,2008/04/01,7,85,1.423453171,97855,7,43,42
141,2014/03/31,2004/11/24,22,108,0.8176859540000001,169746,22,59,49
142,2014/03/31,2004/11/26,4,64,1.426656247,97250,4,28,36
143,2014/03/31,2005/04/02,3,113,0.6743815809999999,204853,3,47,66
144,2014/03/31,2009/08/27,1,31,1.438600025,95766,1,14,17
145,2014/03/31,2005/11/16,5,79,1.065611103,129119,5,35,44
146,2014/03/31,2012/05/02,17,109,0.843554751,163010,17,55,54
147,2014/03/31,2009/03/29,18,19,0.681331859,201613,18,11,8
148,2014/03/31,2009/06/04,25,120,0.7902875509999999,172352,25,55,65
149,2014/03/31,2006/04/15,1,45,1.154155854,116917,1,19,26
150,2014/03/31,2007/05/08,135,19,0.988910129,136374,135,14,5
151,2014/03/31,2010/05/27,184,22,0.993493225,135717,184,14,8
152,2014/03/31,2009/12/27,15,80,1.277942503,105118,15,39,41
153,2014/03/31,2006/12/25,6,82,1.255920537,106666,6,34,48
154,2014/03/31,2010/08/08,12,90,0.744693267,179472,12,38,52
155,2014/03/31,2010/08/06,157,17,0.931991388,143287,157,11,6
156,2014/03/31,2006/09/15,9,39,1.374724556,97116,9,27,12
157,2014/03/31,2008/05/05,11,102,1.295748779,102961,11,43,59
158,2014/03/31,2004/11/24,11,90,0.8431856670000001,158149,11,50,40
159,2014/03/31,2005/01/22,7,125,0.75433474,176585,7,55,70
160,2014/03/31,2007/02/07,23,77,1.414713624,94142,23,33,44
161,2014/03/31,2004/12/07,6,79,0.843179595,157844,6,53,26
162,2014/03/31,2006/11/09,13,116,0.802227557,165365,13,49,67
163,2014/03/31,2011/01/19,15,58,1.448642081,91515,15,30,28
164,2014/03/31,2006/07/23,8,109,0.914492693,144321,8,48,61
165,2014/03/31,2006/07/10,9,180,0.720028487,182540,9,90,90
166,2014/03/31,2010/01/13,1,103,0.602317149,218087,1,42,61
167,2014/03/31,2005/01/19,8,107,0.841613512,155834,8,52,55
168,2014/03/31,2011/03/30,121,14,1.040394289,125796,121,9,5
169,2014/03/31,2010/02/12,2,149,0.836742487,155588,2,78,71
170,2014/03/31,2011/09/13,49,76,1.380177417,94185,49,45,31
171,2014/03/31,2007/02/10,3,55,1.369523774,94577,3,31,24
172,2014/03/31,2011/09/21,4,80,1.407186108,92022,4,38,42
173,2014/03/31,2005/01/23,16,40,0.926317142,139742,16,16,24
174,2014/03/31,2006/01/15,7,142,0.702883928,183472,7,73,69
175,2014/03/31,2013/03/16,23,14,1.016463224,126850,23,0,14
176,2014/03/31,2011/02/25,30,24,1.026238631,125340,30,4,20
177,2014/03/31,2011/05/12,18,13,1.014545871,126495,18,4,9
178,2014/03/31,2006/12/06,2,85,0.843447435,151736,2,31,54
179,2014/03/31,2005/03/02,3,68,1.085817147,117537,3,31,37
180,2014/03/31,2005/03/31,8,116,0.786706177,161730,8,63,53
181,2014/03/31,2012/04/09,2,123,1.419099832,89350,2,56,67
182,2014/03/31,2007/04/04,17,47,1.389867279,91018,17,14,33
183,2014/03/31,2010/08/08,95,14,1.022610665,123662,95,7,7
184,2014/03/31,2006/06/20,107,49,1.394936204,90602,107,34,15
185,2014/03/31,2005/05/27,2,86,0.799002655,157799,2,35,51
186,2014/03/31,2008/02/18,11,60,1.182681834,106278,11,39,21
187,2014/03/31,2005/07/24,4,110,0.7509068409999999,166843,4,59,51
188,2014/03/31,2010/08/10,179,15,0.681333333,183480,179,11,4
189,2014/03/31,2005/03/20,2,67,1.046676247,119347,2,36,31
190,2014/03/31,2010/02/13,1,51,1.259950118,99034,1,13,38
191,2014/03/31,2010/05/17,69,74,1.289827497,96520,69,41,33
192,2014/03/31,2010/09/18,27,12,1.023333333,121632,27,7,5
193,2014/03/31,2009/11/01,6,59,1.461263576,85171,6,30,29
194,2014/03/31,2009/08/27,18,120,0.701123814,176951,18,48,72
195,2014/03/31,2008/09/02,3,60,1.40060309,88428,3,19,41
196,2014/03/31,2006/06/05,1,57,1.366744227,90553,1,9,48
197,2014/03/31,2011/12/18,57,43,0.631640227,195034,57,21,22
198,2014/03/31,2008/04/20,2,113,0.81511929,151060,2,59,54
199,2014/03/31,2005/05/01,23,42,0.743348652,165589,23,22,20
200,2014/03/31,2005/04/27,16,58,1.299097235,94554,16,31,27
201,2014/03/31,2005/10/12,30,16,0.66544855,184227,30,5,11
202,2014/03/31,2004/11/23,18,122,0.68017726,180074,18,56,66
203,2014/03/31,2005/05/29,6,72,1.343311285,91164,6,26,46
204,2014/03/31,2009/11/13,10,113,1.008554047,121394,10,59,54
205,2014/03/31,2005/08/02,2,77,0.7772353470000001,157206,2,35,42
206,2014/03/31,2008/12/13,10,57,1.332451177,91658,10,31,26
207,2014/03/31,2012/01/04,13,16,1.057235119,115401,13,7,9
208,2014/03/31,2009/05/08,9,77,0.803643702,151637,9,30,47
209,2014/03/31,2005/01/20,3,88,1.039534044,117157,3,42,46
210,2014/03/31,2007/05/27,51,13,0.884236795,137604,51,9,4
211,2014/03/31,2005/05/20,3,124,1.070194781,113615,3,64,60
212,2014/03/31,2005/11/17,31,69,0.823818121,147549,31,36,33
213,2014/03/31,2008/02/26,1,66,1.406350341,86430,1,42,24
214,2014/03/31,2010/12/01,102,26,0.6793056709999999,178921,102,19,7
215,2014/03/31,2009/08/01,4,59,1.273062688,94946,4,26,33
216,2014/03/31,2007/06/04,1,125,0.6379945770000001,189177,1,52,73
217,2014/03/31,2009/03/14,11,97,0.701652637,171544,11,56,41
218,2014/03/31,2006/01/25,3,57,0.832500467,144505,3,28,29
219,2014/03/31,2011/01/04,5,64,0.457967364,262290,5,4,60
220,2014/03/31,2004/12/24,114,49,1.3509114430000002,88903,114,35,14
221,2014/03/31,2007/09/17,2,58,1.423312271,84353,2,27,31
222,2014/03/31,2005/04/06,5,136,0.82433441,145540,5,49,87
223,2014/03/31,2010/12/17,4,68,0.8048453440000001,148879,4,32,36
224,2014/03/31,2008/02/11,4,71,0.664729007,180226,4,20,51
225,2014/03/31,2006/11/01,16,116,0.916310894,130636,16,63,53
226,2014/03/31,2007/05/28,1,110,0.6930268190000001,172640,1,30,80
227,2014/03/31,2008/07/21,12,105,0.823284201,145253,12,51,54
228,2014/03/31,2009/03/03,21,52,1.433468257,83356,21,29,23
229,2014/03/31,2005/06/16,3,106,0.714441235,167199,3,51,55
230,2014/03/31,2005/04/17,178,11,1.065035317,112128,178,5,6
231,2014/03/31,2010/04/28,13,59,1.283990608,92635,13,35,24
232,2014/03/31,2007/11/29,18,59,0.817583423,145433,18,26,33
233,2014/03/31,2006/01/16,26,83,1.254728561,94441,26,36,47
234,2014/03/31,2012/05/08,317,10,0.966,122320,317,8,2
235,2014/03/31,2008/08/31,1,116,0.8661216490000001,136228,1,61,55
236,2014/03/31,2005/04/19,2,95,0.849043083,138873,2,61,34
237,2014/03/31,2011/08/20,6,79,0.7788971640000001,151183,6,26,53
238,2014/03/31,2006/03/28,7,76,1.367977249,86061,7,44,32
239,2014/03/31,2007/07/14,1,100,1.282347182,91727,1,40,60
240,2014/03/31,2004/11/20,1,107,0.7108682190000001,165304,1,48,59
241,2014/03/31,2006/02/02,290,25,1.074683178,109336,290,20,5
242,2014/03/31,2008/06/01,13,114,0.774562836,151625,13,55,59
243,2014/03/31,2010/03/10,9,57,1.3949203140000002,84080,9,21,36
244,2014/03/31,2007/01/09,22,76,0.98076627,119514,22,33,43
245,2014/03/31,2012/10/17,99,11,1.05,111496,99,5,6
246,2014/03/31,2006/04/11,30,43,1.240551283,94144,30,18,25
247,2014/03/31,2011/02/22,22,20,0.7845195429999999,148827,22,8,12
248,2014/03/31,2007/06/17,32,53,1.373478,85000,32,19,34
249,2014/03/31,2005/09/09,4,56,1.403768453,82981,4,28,28
250,2014/03/31,2011/09/28,2,84,0.827823318,140535,2,42,42
251,2014/03/31,2008/03/15,6,111,0.819703519,141864,6,37,74
252,2014/03/31,2011/05/30,18,109,0.921339098,126167,18,53,56
253,2014/03/31,2006/03/02,5,60,1.175007596,98083,5,34,26
254,2014/03/31,2010/07/25,3,61,0.713012031,161499,3,24,37
255,2014/03/31,2008/08/28,9,43,1.231469603,93447,9,14,29
256,2014/03/31,2006/12/07,5,149,0.724336929,157683,5,67,82
257,2014/03/31,2010/10/20,4,43,1.020765158,111807,4,9,34
258,2014/03/31,2010/04/25,83,56,0.995827664,114358,83,34,22
259,2014/03/31,2005/11/15,3,94,1.040933738,109142,3,43,51
260,2014/03/31,2005/08/30,13,84,0.811427392,139338,13,45,39
261,2014/03/31,2012/07/20,9,16,1.051401627,107047,9,2,14
262,2014/03/31,2006/01/24,17,128,0.856878118,131315,17,61,67
263,2014/03/31,2006/10/26,2,124,0.8600265340000001,130776,2,62,62
264,2014/03/31,2011/01/28,4,111,0.8591966129999999,130622,4,50,61
265,2014/03/31,2009/07/09,1,77,0.832180765,134838,1,31,46
266,2014/03/31,2006/04/02,22,42,1.4360421369999998,77936,22,24,18
267,2014/03/31,2009/11/02,1,124,0.695089955,160524,1,48,76
268,2014/03/31,2011/07/25,6,19,1.156085303,96503,6,10,9
269,2014/03/31,2010/08/28,45,53,0.828407972,134627,45,32,21
270,2014/03/31,2011/06/01,1,61,1.337276713,83245,1,26,35
271,2014/03/31,2009/12/12,1,17,1.056396083,105377,1,5,12
272,2014/03/31,2011/08/28,4,48,0.934725209,119036,4,17,31
273,2014/03/31,2006/10/13,22,26,1.178456641,94249,22,8,18
274,2014/03/31,2006/03/11,31,43,1.3955870869999998,79426,31,20,23
275,2014/03/31,2009/08/07,61,87,0.962306964,115134,61,40,47
276,2014/03/31,2010/05/22,1,114,0.889901525,124499,1,47,67
277,2014/03/31,2010/02/19,20,54,1.462917873,75651,20,28,26
278,2014/03/31,2009/12/09,20,68,0.676618926,163454,20,42,26
279,2014/03/31,2007/09/28,6,112,0.82046172,134757,6,67,45
280,2014/03/31,2008/10/12,13,73,0.6731207379999999,163958,13,42,31
281,2014/03/31,2007/06/12,38,49,1.368281891,80641,38,20,29
282,2014/03/31,2012/08/22,2,40,0.868515165,127004,2,15,25
283,2014/03/31,2005/03/16,5,82,0.81353969,135413,5,32,50
284,2014/03/31,2009/01/17,1,154,0.8481413309999999,129582,1,74,80
285,2014/03/31,2005/11/17,13,58,0.7557019559999999,145294,13,29,29
286,2014/03/31,2008/08/12,2,52,1.120337764,97731,2,29,23
287,2014/03/31,2010/11/10,8,43,1.388142957,78765,8,14,29
288,2014/03/31,2009/02/09,4,105,0.7888733920000001,138593,4,48,57
289,2014/03/31,2006/01/10,4,97,0.93836632,116461,4,48,49
290,2014/03/31,2010/06/09,112,17,0.896000164,121870,112,12,5
291,2014/03/31,2010/02/26,59,32,1.416159832,77106,59,15,17
292,2014/03/31,2010/05/31,5,37,0.914270784,119320,5,14,23
293,2014/03/31,2006/03/31,5,86,0.682643911,159612,5,48,38
294,2014/03/31,2012/03/17,13,62,0.778110575,139995,13,28,34
295,2014/03/31,2010/12/16,11,67,0.856602875,127081,11,27,40
296,2014/03/31,2006/06/29,8,84,0.837625235,129836,8,53,31
297,2014/03/31,2009/01/15,8,117,0.8163014759999999,132853,8,60,57
298,2014/03/31,2009/06/10,2,122,0.837572715,129272,2,55,67
299,2014/03/31,2006/05/04,24,87,0.82610529,131029,24,42,45
300,2014/03/31,2009/01/20,2,73,1.434756209,75413,2,38,35
301,2014/03/31,2005/09/09,8,97,0.949395993,113939,8,53,44
302,2014/03/31,2010/02/23,5,93,0.7180637,150612,5,36,57
303,2014/03/31,2010/02/23,8,83,0.8017396990000001,134621,8,39,44
304,2014/03/31,2010/09/15,11,105,0.7375951740000001,145865,11,41,64
305,2014/03/31,2007/12/28,56,27,0.654476682,164336,56,13,14
306,2014/03/31,2005/12/21,31,24,0.968107765,110964,31,10,14
307,2014/03/31,2006/04/06,2,137,0.874927107,122439,2,55,82
308,2014/03/31,2012/09/02,22,57,1.187537496,90144,22,18,39
309,2014/03/31,2009/12/05,7,50,1.201031476,89115,7,30,20
310,2014/03/31,2011/05/27,8,45,0.765013009,139898,8,23,22
311,2014/03/31,2011/10/17,1,109,0.877036239,122024,1,50,59
312,2014/03/31,2009/12/15,18,46,1.32374168,80830,18,23,23
313,2014/03/31,2008/07/22,17,77,0.763144213,139876,17,29,48
314,2014/03/31,2006/10/01,5,60,0.689844509,154736,5,28,32
315,2014/03/31,2012/06/12,6,66,0.705022823,151383,6,18,48
316,2014/03/31,2007/04/03,4,77,0.74088551,144030,4,30,47
317,2014/03/31,2006/03/04,16,77,1.325833583,80208,16,41,36
318,2014/03/31,2010/10/21,13,28,1.3789923219999998,77108,13,10,18
319,2014/03/31,2011/05/08,113,34,0.739229694,143761,113,16,18
320,2014/03/31,2007/06/11,9,62,0.751386294,141413,9,29,33
321,2014/03/31,2010/04/30,34,53,1.440717609,73717,34,21,32
322,2014/03/31,2011/09/18,4,37,1.4590118369999998,72741,4,17,20
323,2014/03/31,2007/02/10,65,94,0.839762709,126174,65,57,37
324,2014/03/31,2007/06/21,10,48,1.4236073969999998,74411,10,14,34
325,2014/03/31,2010/07/28,5,52,1.430674841,73647,5,26,26
326,2014/03/31,2011/05/11,1,52,0.776371777,135689,1,25,27
327,2014/03/31,2005/11/02,33,59,0.827179729,127314,33,35,24
328,2014/03/31,2008/02/26,9,72,0.705943112,149171,9,34,38
329,2014/03/31,2008/05/19,13,47,1.37078264,76753,13,25,22
330,2014/03/31,2004/11/23,9,107,0.619739087,169750,9,77,30
331,2014/03/31,2011/07/11,23,96,0.7718554670000001,136246,23,54,42
332,2014/03/31,2012/04/18,5,132,0.694012613,151273,5,68,64
333,2014/03/31,2011/01/19,2,168,0.8006591590000001,130985,2,76,92
334,2014/03/31,2011/12/05,17,49,0.837061811,125237,17,26,23
335,2014/03/31,2004/12/02,136,12,1.00799115,103960,136,7,5
336,2014/03/31,2006/12/06,13,36,0.954319431,109695,13,21,15
337,2014/03/31,2006/04/23,77,21,0.7606666670000001,137610,77,9,12
338,2014/03/31,2009/01/17,24,60,0.760252081,137654,24,37,23
339,2014/03/31,2004/11/26,33,84,0.8915401,117382,33,43,41
340,2014/03/31,2006/04/03,7,59,1.075326325,97219,7,19,40
341,2014/03/31,2006/04/16,1,118,0.746258043,139566,1,51,67
342,2014/03/31,2008/08/20,27,49,1.327684941,78417,27,32,17
343,2014/03/31,2012/08/28,4,74,0.91433425,113789,4,26,48
344,2014/03/31,2011/12/10,7,64,0.7440065220000001,139827,7,34,30
345,2014/03/31,2007/08/08,19,47,1.461826465,71121,19,26,21
346,2014/03/31,2006/11/08,1,46,1.462023883,71012,1,21,25
347,2014/03/31,2007/05/29,7,115,0.8967864,115562,7,55,60
348,2014/03/31,2010/10/02,13,28,1.434513512,72232,13,6,22
349,2014/03/31,2010/06/25,351,12,1.029644795,100421,351,11,1
350,2014/03/31,2006/07/23,8,65,1.107523948,93221,8,50,15
351,2014/03/31,2009/12/12,66,24,0.562442563,183418,66,16,8
352,2014/03/31,2008/08/08,4,50,0.7601155829999999,135574,4,14,36
353,2014/03/31,2007/04/25,5,98,0.728867305,141053,5,42,56
354,2014/03/31,2005/09/04,1,46,1.3989986090000002,73338,1,13,33
355,2014/03/31,2009/06/17,17,61,0.899280547,114031,17,28,33
356,2014/03/31,2011/11/10,84,28,1.238878525,82659,84,16,12
357,2014/03/31,2012/01/16,68,28,1.3861765419999998,73852,68,12,16
358,2014/03/31,2012/10/12,15,17,0.978310605,104641,15,5,12
359,2014/03/31,2006/05/18,1,51,1.416135816,72274,1,24,27
360,2014/03/31,2008/02/24,16,85,0.974864579,104969,16,48,37
361,2014/03/31,2006/01/25,2,128,0.69244581,147767,2,47,81
362,2014/03/31,2012/09/08,14,23,0.6506196479999999,157186,14,7,16
363,2014/03/31,2008/02/14,2,78,0.84343724,121231,2,43,35
364,2014/03/31,2009/01/05,1,67,0.754458243,135439,1,32,35
365,2014/03/31,2005/08/11,1,96,0.775295546,131739,1,39,57
366,2014/03/31,2011/04/03,20,118,0.7100688479999999,143796,20,71,47
367,2014/03/31,2012/07/15,48,86,0.792415925,128754,48,35,51
368,2014/03/31,2012/02/15,5,36,0.82250645,124032,5,17,19
369,2014/03/31,2009/07/01,83,10,1.025894957,99312,83,8,2
370,2014/03/31,2006/09/18,1,34,1.443316261,70486,1,12,22
371,2014/03/31,2006/07/21,2,23,1.357742091,74910,2,9,14
372,2014/03/31,2007/02/01,5,76,0.7315326879999999,138952,5,30,46
373,2014/03/31,2009/12/26,19,45,0.696498655,145724,19,7,38
374,2014/03/31,2005/08/15,18,111,0.697522309,145458,18,54,57
375,2014/03/31,2006/04/14,25,47,1.230913428,82382,25,24,23
376,2014/03/31,2006/01/30,1,84,1.337146213,75766,1,37,47
377,2014/03/31,2005/03/27,1,134,0.8674246959999999,116627,1,65,69
378,2014/03/31,2006/03/27,3,46,0.7711733270000001,130782,3,23,23
379,2014/03/31,2004/11/01,6,96,0.746628299,135009,6,43,53
380,2014/03/31,2011/01/03,94,16,0.936013465,107690,94,12,4
381,2014/03/31,2005/06/22,11,83,0.7554607959999999,133367,11,36,47
382,2014/03/31,2005/09/03,3,93,0.91579564,109943,3,54,39
383,2014/03/31,2011/07/01,6,13,0.632307692,159016,6,4,9
384,2014/03/31,2012/10/13,2,36,0.886428351,113253,2,7,29
385,2014/03/31,2006/04/28,11,73,0.810458452,123568,11,40,33
386,2014/03/31,2012/01/14,1,98,1.303309449,76759,1,28,70
387,2014/03/31,2006/05/05,3,116,0.7104835279999999,140571,3,54,62
388,2014/03/31,2005/04/26,17,61,1.230116011,81113,17,35,26
389,2014/03/31,2010/07/19,13,85,1.401901923,70965,13,39,46
390,2014/03/31,2007/05/16,10,48,1.453157218,68459,10,21,27
391,2014/03/31,2007/10/17,6,104,0.7217528940000001,137698,6,50,54
392,2014/03/31,2006/05/19,12,57,1.179321043,84129,12,29,28
393,2014/03/31,2006/04/13,9,43,0.757415506,130985,9,12,31
394,2014/03/31,2011/02/25,12,101,0.841051069,117880,12,57,44
395,2014/03/31,2007/10/30,2,69,0.7021256840000001,141164,2,31,38
396,2014/03/31,2007/10/31,5,71,1.413737887,70069,5,37,34
397,2014/03/31,2009/01/06,5,124,0.837548052,118049,5,63,61
398,2014/03/31,2007/11/16,18,86,1.10819519,89195,18,27,59
399,2014/03/31,2007/06/22,12,82,0.8186665390000001,120536,12,38,44
400,2014/03/31,2011/03/07,1,122,0.7144708040000001,137879,1,56,66
401,2014/03/31,2012/06/02,20,18,0.718332944,136876,20,8,10
402,2014/03/31,2005/02/08,22,39,1.387449853,70792,22,28,11
403,2014/03/31,2010/07/01,4,83,0.870657357,112709,4,34,49
404,2014/03/31,2007/06/06,1,81,0.982403492,99888,1,37,44
405,2014/03/31,2008/09/23,34,66,0.8786453000000002,111545,34,36,30
406,2014/03/31,2005/03/16,41,46,1.365195471,71622,41,28,18
407,2014/03/31,2007/08/31,3,75,0.745084105,131146,3,43,32
408,2014/03/31,2005/01/28,79,69,0.7741921070000001,126180,79,51,18
409,2014/03/31,2009/09/03,10,45,1.432941764,68136,10,20,25
410,2014/03/31,2007/07/03,4,36,1.460493648,66829,4,17,19
411,2014/03/31,2004/12/02,1,106,0.7464892759999999,130691,1,41,65
412,2014/03/31,2010/06/14,19,64,1.464381643,66612,19,43,21
413,2014/03/31,2011/09/01,6,61,0.7340983609999999,132797,6,30,31
414,2014/03/31,2012/08/26,1,67,0.788739195,123556,1,20,47
415,2014/03/31,2006/04/19,30,52,0.778333174,125190,30,28,24
416,2014/03/31,2011/03/21,13,21,0.704172358,138363,13,8,13
417,2014/03/31,2011/09/18,9,100,0.8364075999999999,116315,9,44,56
418,2014/03/31,2008/03/21,1,119,0.971327249,100147,1,56,63
419,2014/03/31,2005/02/26,20,79,1.305487564,74503,20,35,44
420,2014/03/31,2009/08/27,4,101,0.822947613,118160,4,44,57
421,2014/03/31,2005/09/09,5,116,0.750052132,129478,5,52,64
422,2014/03/31,2011/04/09,85,42,1.303695272,74368,85,30,12
423,2014/03/31,2005/04/09,3,82,0.7679306220000001,126149,3,47,35
424,2014/03/31,2005/10/07,11,96,0.72174598,134194,11,48,48
425,2014/03/31,2008/08/28,11,79,0.779597965,124218,11,22,57
426,2014/03/31,2006/03/17,4,133,0.675632052,143216,4,53,80
427,2014/03/31,2009/02/22,15,73,0.7170868140000001,134897,15,39,34
428,2014/03/31,2006/03/28,1,58,0.7904340040000001,122349,1,30,28
429,2014/03/31,2008/09/23,135,19,0.7423071720000001,130168,135,12,7
430,2014/03/31,2013/01/20,1,62,1.265360941,76356,1,7,55
431,2014/03/31,2007/11/17,5,46,1.425841856,67761,5,28,18
432,2014/03/31,2011/06/02,16,38,1.450518407,66550,16,21,17
433,2014/03/31,2010/07/21,23,65,0.858959758,112320,23,30,35
434,2014/03/31,2012/12/07,13,15,0.968166892,99645,13,1,14
435,2014/03/31,2010/05/27,2,93,0.754275019,127824,2,53,40
436,2014/03/31,2008/10/20,6,13,0.6511630820000001,147883,6,6,7
437,2014/03/31,2007/12/03,4,60,0.811934708,118514,4,19,41
438,2014/03/31,2010/09/25,2,93,0.82114127,117159,2,42,51
439,2014/03/31,2011/11/25,15,83,0.712543548,134851,15,33,50
440,2014/03/31,2012/06/23,16,44,0.8862730190000001,108388,16,15,29
441,2014/03/31,2005/09/08,8,62,0.855358305,112125,8,30,32
442,2014/03/31,2010/11/10,2,89,1.221743017,78410,2,31,58
443,2014/03/31,2005/02/28,2,78,0.789605839,121245,2,34,44
444,2014/03/31,2007/04/17,26,39,1.3639718,70142,26,13,26
445,2014/03/31,2009/09/13,14,101,0.929938153,102834,14,42,59
446,2014/03/31,2010/01/02,17,44,1.452790676,65769,17,23,21
447,2014/03/31,2009/08/26,32,31,1.375394871,69453,32,15,16
448,2014/03/31,2009/07/15,7,75,0.781846052,122158,7,44,31
449,2014/03/31,2007/06/12,18,93,0.894763601,106705,18,37,56
450,2014/03/31,2010/04/01,20,54,1.33526505,71496,20,33,21
451,2014/03/31,2005/09/20,18,73,1.242032954,76834,18,60,13
452,2014/03/31,2005/04/06,2,70,0.969874916,98334,2,31,39
453,2014/03/31,2008/03/13,14,36,0.926531747,102876,14,12,24
454,2014/03/31,2008/01/10,5,45,1.401278409,67936,5,21,24
455,2014/03/31,2008/10/16,14,97,1.432786199,66431,14,48,49
456,2014/03/31,2009/10/20,10,107,0.715139321,132823,10,45,62
457,2014/03/31,2008/03/03,8,123,0.8507229209999999,111589,8,49,74
458,2014/03/31,2011/08/06,29,38,1.408719882,67361,29,16,22
459,2014/03/31,2007/04/19,13,98,0.7335678609999999,129338,13,42,56
460,2014/03/31,2007/08/07,7,33,1.4518301319999998,65345,7,15,18
461,2014/03/31,2008/11/08,6,39,1.393603751,68043,6,21,18
462,2014/03/31,2010/09/20,8,72,1.286411022,73670,8,25,47
463,2014/03/31,2010/10/14,6,83,0.7490311209999999,126476,6,37,46
464,2014/03/31,2005/03/05,4,66,0.7776507109999999,121756,4,37,29
465,2014/03/31,2008/03/27,37,46,0.78231049,120983,37,22,24
466,2014/03/31,2004/11/12,9,65,0.923260068,102504,9,31,34
467,2014/03/31,2007/05/10,5,99,0.763360156,123899,5,41,58
468,2014/03/31,2009/03/08,4,54,1.463962112,64453,4,32,22
469,2014/03/31,2007/03/12,16,65,0.8783021870000001,107397,16,30,35
470,2014/03/31,2006/05/24,243,27,0.941445133,100143,243,19,8
471,2014/03/31,2009/02/01,21,36,1.302530408,72186,21,22,14
472,2014/03/31,2011/08/19,20,61,1.306106868,71752,20,24,37
473,2014/03/31,2006/11/10,32,49,1.425973949,65717,32,28,21
474,2014/03/31,2008/06/16,3,46,1.314534381,71260,3,8,38
475,2014/03/31,2008/03/01,6,103,0.7469010540000001,125149,6,54,49
476,2014/03/31,2007/06/17,73,52,1.228696235,76072,73,29,23
477,2014/03/31,2012/09/15,9,36,1.35804096,68799,9,8,28
478,2014/03/31,2009/07/20,12,37,1.4023350369999998,66530,12,17,20
479,2014/03/31,2005/11/02,14,100,1.4373,64900,14,38,62
480,2014/03/31,2007/09/17,7,51,1.06409081,87589,7,28,23
481,2014/03/31,2006/12/25,12,69,0.742781227,125139,12,35,34
482,2014/03/31,2012/06/26,8,82,0.8508076309999999,109233,8,41,41
483,2014/03/31,2012/10/20,17,13,0.971737343,95577,17,2,11
484,2014/03/31,2011/02/25,25,65,1.246913025,74458,25,33,32
485,2014/03/31,2012/04/18,5,45,1.247410235,74389,5,22,23
486,2014/03/31,2007/02/26,2,118,0.67473221,137477,2,59,59
487,2014/03/31,2008/05/07,11,75,0.7257207240000001,127816,11,33,42
488,2014/03/31,2011/05/20,1,56,0.789488352,117444,1,20,36
489,2014/03/31,2007/03/12,6,73,0.720501275,128233,6,29,44
490,2014/03/31,2010/10/17,17,66,1.1168940040000002,82682,17,44,22
491,2014/03/31,2011/07/02,6,21,0.660121097,139888,6,8,13
492,2014/03/31,2008/07/21,4,78,0.8077245190000001,114244,4,37,41
493,2014/03/31,2008/06/01,2,90,0.753979567,122350,2,46,44
494,2014/03/31,2004/11/04,8,80,0.766244247,120362,8,48,32
495,2014/03/31,2012/02/22,85,20,0.761441087,121103,85,11,9
496,2014/03/31,2005/01/04,31,80,0.781219907,117968,31,43,37
497,2014/03/31,2005/01/18,34,95,0.87833354,104659,34,65,30
498,2014/03/31,2006/10/25,2,99,0.7805520440000001,117708,2,43,56
499,2014/03/31,2007/03/14,17,90,0.716619964,128188,17,42,48
500,2014/03/31,2007/07/01,1,33,1.447113927,63453,1,20,13
501,2014/03/31,2005/06/01,12,73,0.8304361440000001,110537,12,48,25
502,2014/03/31,2006/05/23,18,127,0.7372848190000001,124500,18,62,65
503,2014/03/31,2011/07/03,158,83,0.8003160690000001,114627,158,75,8
504,2014/03/31,2011/12/25,8,27,1.010241814,90731,8,12,15
505,2014/03/31,2010/03/25,1,97,0.614937825,149015,1,39,58
506,2014/03/31,2006/06/01,7,77,0.875997495,104572,7,31,46
507,2014/03/31,2009/12/20,65,19,1.053728357,86805,65,8,11
508,2014/03/31,2007/01/14,41,13,0.72670131,125853,41,6,7
509,2014/03/31,2005/03/17,1,139,0.703798197,129859,1,61,78
510,2014/03/31,2005/07/08,6,86,0.803908618,113677,6,41,45
511,2014/03/31,2005/05/23,2,82,0.7376269109999999,123788,2,43,39
512,2014/03/31,2006/06/05,31,41,0.9943289,91797,31,11,30
513,2014/03/31,2009/11/11,2,72,0.7550119120000001,120888,2,40,32
514,2014/03/31,2005/03/19,11,82,0.782969391,116502,11,39,43
515,2014/03/31,2012/03/24,4,83,1.36549308,66764,4,27,56
516,2014/03/31,2005/12/22,14,92,0.8751388179999999,103985,14,52,40
517,2014/03/31,2006/06/12,25,49,0.920499534,98732,25,33,16
518,2014/03/31,2004/11/11,10,74,0.719323851,126274,10,38,36
519,2014/03/31,2010/06/14,4,78,0.854748717,106195,4,38,40
520,2014/03/31,2007/09/24,9,49,0.858548997,105720,9,23,26
521,2014/03/31,2009/09/08,29,44,1.311839518,69154,29,12,32
522,2014/03/31,2007/03/01,13,26,0.8757814209999999,103395,13,13,13
523,2014/03/31,2004/11/11,2,85,0.729566125,124022,2,40,45
524,2014/03/31,2010/11/09,5,49,1.454720362,62116,5,21,28
525,2014/03/31,2005/08/28,5,69,0.854199991,105755,5,24,45
526,2014/03/31,2012/11/11,8,53,0.7872666340000001,114734,8,7,46
527,2014/03/31,2008/10/09,67,11,0.6709090910000001,134552,67,5,6
528,2014/03/31,2006/03/30,10,55,0.76517731,117957,10,30,25
529,2014/03/31,2004/12/22,14,39,1.4274219519999998,63230,14,18,21
530,2014/03/31,2008/11/06,34,18,0.725114241,124386,34,9,9
531,2014/03/31,2009/04/18,22,63,0.656078433,137264,22,41,22
532,2014/03/31,2010/01/02,181,23,0.529890073,169931,181,16,7
533,2014/03/31,2011/07/10,13,55,0.8668173370000001,103869,13,27,28
534,2014/03/31,2012/04/01,24,36,0.7999573090000001,112436,24,22,14
535,2014/03/31,2006/03/23,8,43,1.299686515,69158,8,29,14
536,2014/03/31,2010/03/01,2,59,1.142706025,78595,2,40,19
537,2014/03/31,2012/04/01,4,69,0.913754872,98267,4,28,41
538,2014/03/31,2011/09/13,27,77,0.600361671,149556,27,39,38
539,2014/03/31,2008/09/20,21,75,0.793122565,113205,21,29,46
540,2014/03/31,2005/09/23,14,89,0.911670561,98446,14,36,53
541,2014/03/31,2011/04/28,1,51,1.251371344,71594,1,24,27
542,2014/03/31,2007/07/01,65,15,1.053199256,84976,65,8,7
543,2014/03/31,2006/05/09,10,51,0.7337164890000001,121900,10,24,27
544,2014/03/31,2005/05/29,13,63,1.062971704,84110,13,39,24
545,2014/03/31,2005/07/19,3,67,0.77813186,114895,3,33,34
546,2014/03/31,2005/06/12,58,35,0.869739722,102698,58,11,24
547,2014/03/31,2009/07/31,3,31,0.789749247,112940,3,17,14
548,2014/03/31,2011/12/01,4,63,0.677294726,131617,4,31,32
549,2014/03/31,2007/05/08,1,95,0.7918911740000001,112565,1,36,59
550,2014/03/31,2005/12/18,13,97,0.7958487240000001,111809,13,56,41
551,2014/03/31,2007/01/24,9,67,0.712584784,124788,9,36,31
552,2014/03/31,2005/12/25,2,101,0.742826118,119673,2,51,50
553,2014/03/31,2010/03/07,21,60,0.6731966779999999,131743,21,23,37
554,2014/03/31,2011/01/10,38,12,0.7283333329999999,121632,38,6,6
555,2014/03/31,2010/08/19,3,48,1.4044699580000002,63061,3,35,13
556,2014/03/31,2011/04/20,3,52,1.427972616,62006,3,23,29
557,2014/03/31,2009/09/05,9,11,1.09967805,80261,9,8,3
558,2014/03/31,2006/03/06,2,92,0.8101632240000001,108930,2,43,49
559,2014/03/31,2006/03/28,1,67,0.754195707,116848,1,36,31
560,2014/03/31,2006/11/23,6,47,1.280616269,68720,6,15,32
561,2014/03/31,2006/07/31,46,109,0.61047623,144111,46,52,57
562,2014/03/31,2006/04/15,12,82,0.6466828720000001,135759,12,43,39
563,2014/03/31,2006/06/05,21,68,0.819026757,107075,21,33,35
564,2014/03/31,2012/02/20,16,79,0.775295725,113061,16,29,50
565,2014/03/31,2012/04/28,11,74,0.734588563,119277,11,40,34
566,2014/03/31,2006/05/26,113,31,1.463755474,59830,113,17,14
567,2014/03/31,2012/05/26,8,34,1.001857522,87326,8,16,18
568,2014/03/31,2007/01/15,3,74,0.690051909,126760,3,40,34
569,2014/03/31,2012/07/27,7,7,1.021428571,85624,7,2,5
570,2014/03/31,2009/03/17,93,36,0.739067177,118329,93,20,16
571,2014/03/31,2012/07/11,9,43,1.224596738,71368,9,12,31
572,2014/03/31,2009/12/31,36,106,0.678582369,128750,36,59,47
573,2014/03/31,2008/09/02,3,89,0.82264602,106167,3,27,62
574,2014/03/31,2010/03/27,104,62,0.972563954,89752,104,32,30
575,2014/03/31,2009/10/24,11,36,1.380619144,63184,11,17,19
576,2014/03/31,2012/04/27,12,51,0.73627451,118422,12,21,30
577,2014/03/31,2006/02/13,5,69,0.731558088,119146,5,20,49
578,2014/03/31,2005/01/11,1,84,0.962312287,90564,1,42,42
579,2014/03/31,2005/12/13,5,68,0.794431222,109665,5,33,35
580,2014/03/31,2007/04/02,3,20,0.7694140690000001,113068,3,6,14
581,2014/03/31,2011/01/13,89,27,0.8167115290000001,106399,89,20,7
582,2014/03/31,2007/10/30,2,64,0.757229554,114718,2,38,26
583,2014/03/31,2005/04/16,7,113,0.589203374,147384,7,53,60
584,2014/03/31,2007/10/19,2,40,1.4430294769999998,60149,2,15,25
585,2014/03/31,2006/01/19,2,80,0.624723523,138420,2,38,42
586,2014/03/31,2008/08/06,41,53,0.76250826,113194,41,28,25
587,2014/03/31,2009/09/01,1,109,0.700098478,123276,1,57,52
588,2014/03/31,2010/07/18,4,70,0.764457525,112890,4,38,32
589,2014/03/31,2009/11/18,9,35,1.37325484,62808,9,24,11
590,2014/03/31,2011/12/13,29,34,1.307116221,65969,29,15,19
591,2014/03/31,2009/01/14,27,88,0.782405619,110192,27,50,38
592,2014/03/31,2009/10/21,10,101,0.821220119,104916,10,53,48
593,2014/03/31,2007/02/01,15,44,0.697107982,123585,15,24,20
594,2014/03/31,2007/06/01,1,57,0.6901963609999999,124821,1,26,31
595,2014/03/31,2010/08/18,11,43,1.225645051,70258,11,14,29
596,2014/03/31,2010/11/28,4,57,0.846069291,101773,4,23,34
597,2014/03/31,2007/10/25,11,82,0.705870234,121881,11,49,33
598,2014/03/31,2009/09/18,23,69,0.903869993,94964,23,64,5
599,2014/03/31,2010/02/20,44,63,0.833366699,102801,44,33,30
600,2014/03/31,2012/04/24,230,12,1.013213001,84488,230,9,3
601,2014/03/31,2010/10/17,17,69,0.8593490309999999,99590,17,31,38
602,2014/03/31,2007/07/17,4,88,0.922312153,92775,4,40,48
603,2014/03/31,2012/03/03,3,59,0.6414616679999999,133334,3,30,29
604,2014/03/31,2006/04/11,10,40,0.640861525,133403,10,16,24
605,2014/03/31,2008/12/21,86,13,0.752468392,113580,86,6,7
606,2014/03/31,2005/05/05,11,68,0.7120725809999999,119701,11,30,38
607,2014/03/31,2010/11/29,3,69,0.7104411509999999,119959,3,30,39
608,2014/03/31,2012/05/20,4,38,1.335886053,63749,4,8,30
609,2014/03/31,2006/03/09,18,97,0.8904420470000001,95578,18,53,44
610,2014/03/31,2005/03/31,34,13,0.8791565459999999,96745,34,6,7
611,2014/03/31,2010/12/13,3,84,0.680674344,124877,3,19,65
612,2014/03/31,2008/03/25,79,33,1.400179804,60566,79,12,21
613,2014/03/31,2007/09/24,25,61,0.652295875,129994,25,20,41
614,2014/03/31,2007/06/17,17,87,0.740124516,114443,17,39,48
615,2014/03/31,2008/10/13,13,17,0.80243475,105518,13,8,9
616,2014/03/31,2006/01/15,3,62,0.810345085,104351,3,36,26
617,2014/03/31,2007/11/06,2,79,0.8209831340000001,102926,2,41,38
618,2014/03/31,2008/03/31,85,58,0.896582367,94188,85,28,30
619,2014/03/31,2007/12/10,48,26,0.666378424,126699,48,15,11
620,2014/03/31,2011/08/22,2,82,0.7009850000000001,120396,2,45,37
621,2014/03/31,2006/10/16,7,94,0.761320588,110837,7,45,49
622,2014/03/31,2012/05/12,15,43,0.947841903,88958,15,12,31
623,2014/03/31,2005/04/29,9,49,1.019422095,82626,9,25,24
624,2014/03/31,2007/08/12,11,32,0.967861715,87009,11,20,12
625,2014/03/31,2011/04/01,4,82,0.706153885,119037,4,36,46
626,2014/03/31,2010/08/06,22,62,0.824876139,101808,22,33,29
627,2014/03/31,2012/05/11,18,67,0.877645872,95683,18,34,33
628,2014/03/31,2009/07/14,30,81,0.807743897,103927,30,34,47
629,2014/03/31,2005/07/07,7,86,0.7913474970000001,105952,7,52,34
630,2014/03/31,2007/04/02,102,6,1.141666667,73392,102,1,5
631,2014/03/31,2010/10/06,69,9,0.917777778,91224,69,4,5
632,2014/03/31,2009/09/10,4,63,0.81701218,102466,4,29,34
633,2014/03/31,2004/11/17,66,38,0.672776465,124410,66,19,19
634,2014/03/31,2010/07/01,2,40,1.311356405,63801,2,15,25
635,2014/03/31,2005/10/20,9,73,0.695825062,120191,9,29,44
636,2014/03/31,2007/02/21,15,71,0.78021629,107032,15,39,32
637,2014/03/31,2009/10/17,1,74,0.967311788,86299,1,32,42
638,2014/03/31,2012/04/20,103,45,0.995006913,83894,103,25,20
639,2014/03/31,2008/05/27,1,127,0.635267428,131400,1,28,99
640,2014/03/31,2007/10/26,4,86,0.641211101,130146,4,42,44
641,2014/03/31,2009/08/31,29,58,0.728744669,114424,29,29,29
642,2014/03/31,2011/05/18,3,69,0.82410712,101139,3,29,40
643,2014/03/31,2006/06/28,43,38,1.056982345,78846,43,22,16
644,2014/03/31,2008/09/06,19,78,0.723989122,115093,19,21,57
645,2014/03/31,2005/12/30,68,16,0.862176721,96627,68,8,8
646,2014/03/31,2007/04/01,163,37,1.428155295,58302,163,24,13
647,2014/03/31,2007/07/09,5,76,0.7130119770000001,116724,5,32,44
648,2014/03/31,2009/01/12,2,44,1.230681203,67601,2,25,19
649,2014/03/31,2005/03/11,3,99,0.951464844,87395,3,41,58
650,2014/03/31,2012/01/13,14,51,1.3578358430000002,61100,14,29,22
651,2014/03/31,2008/09/09,5,66,0.722954875,114482,5,18,48
652,2014/03/31,2006/07/11,5,77,0.879383317,94084,5,40,37
653,2014/03/31,2007/06/28,2,106,0.78942673,104750,2,50,56
654,2014/03/31,2012/05/19,1,94,0.632198528,130742,1,35,59
655,2014/03/31,2011/05/27,27,89,0.7526219559999999,109773,27,36,53
656,2014/03/31,2012/05/25,37,11,0.8100533809999999,101908,37,6,5
657,2014/03/31,2008/01/11,17,19,0.7193145329999999,114608,17,3,16
658,2014/03/31,2011/04/22,7,57,0.941829369,87522,7,17,40
659,2014/03/31,2011/04/05,18,65,0.747842479,110131,18,25,40
660,2014/03/31,2012/06/01,76,25,1.413954787,58213,76,13,12
661,2014/03/31,2005/10/30,26,51,1.418412885,57992,26,23,28
662,2014/03/31,2012/03/01,19,54,1.057823619,77707,19,26,28
663,2014/03/31,2008/09/18,46,13,0.691331701,118818,46,7,6
664,2014/03/31,2012/03/22,7,72,1.25802427,65267,7,30,42
665,2014/03/31,2008/09/21,2,93,0.693748774,118300,2,42,51
666,2014/03/31,2010/05/19,27,31,1.35912265,60318,27,16,15
667,2014/03/31,2006/12/06,4,78,0.8228736720000001,99566,4,36,42
668,2014/03/31,2008/05/20,4,96,0.661020551,123933,4,18,78
669,2014/03/31,2008/08/20,20,58,0.81945874,99952,20,37,21
670,2014/03/31,2012/06/06,8,85,0.710912445,115207,8,42,43
671,2014/03/31,2006/05/30,5,65,0.883145532,92722,5,22,43
672,2014/03/31,2005/02/01,4,85,0.65577155,124859,4,44,41
673,2014/03/31,2010/12/28,88,14,1.035521272,79047,88,5,9
674,2014/03/31,2011/09/08,2,60,0.6915089729999999,118246,2,37,23
675,2014/03/31,2006/11/07,8,39,1.350910398,60512,8,18,21
676,2014/03/31,2011/04/05,61,36,1.086663476,75213,61,22,14
677,2014/03/31,2005/04/10,46,17,0.745799622,109583,46,13,4
678,2014/03/31,2009/10/31,21,104,0.875784758,93309,21,58,46
679,2014/03/31,2006/04/19,15,50,0.6526988229999999,125199,15,25,25
680,2014/03/31,2008/03/23,12,41,0.7536585370000001,108363,12,23,18
681,2014/03/31,2012/08/17,195,20,1.052316793,77590,195,12,8
682,2014/03/31,2007/09/09,7,68,0.948622421,86064,7,25,43
683,2014/03/31,2007/04/01,2,99,0.77280422,105598,2,52,47
684,2014/03/31,2010/11/27,12,98,0.6753600940000001,120774,12,43,55
685,2014/03/31,2004/12/01,8,89,0.764573373,106510,8,41,48
686,2014/03/31,2008/09/05,71,35,0.7683779620000001,105725,71,12,23
687,2014/03/31,2007/01/08,6,78,0.767752423,105745,6,41,37
688,2014/03/31,2010/03/15,4,75,0.677779021,119758,4,32,43
689,2014/03/31,2006/04/20,15,56,1.402678633,57828,15,31,25
690,2014/03/31,2012/01/03,2,29,0.99101884,81848,2,11,18
691,2014/03/31,2011/12/03,45,55,0.8062292409999999,100558,45,25,30
692,2014/03/31,2006/11/15,18,26,1.156431302,70104,18,1,25
693,2014/03/31,2007/05/07,5,66,0.856638865,94599,5,29,37
694,2014/03/31,2006/03/27,5,67,0.7188581829999999,112610,5,30,37
695,2014/03/31,2010/07/23,17,65,0.81700528,99061,17,27,38
696,2014/03/31,2010/07/27,9,76,0.981291089,82442,9,41,35
697,2014/03/31,2007/05/18,4,38,1.370945673,58995,4,27,11
698,2014/03/31,2011/03/15,17,51,0.7100000879999999,113913,17,27,24
699,2014/03/31,2006/05/14,3,71,0.738039452,109398,3,14,57
700,2014/03/31,2012/08/25,9,67,1.248345512,64594,9,29,38
701,2014/03/31,2004/11/20,25,61,0.746502852,108008,25,48,13
702,2014/03/31,2008/07/12,3,44,1.4340239069999998,56219,3,14,30
703,2014/03/31,2009/09/20,1,120,0.797076083,101087,1,52,68
704,2014/03/31,2010/10/09,1,101,0.853658074,94342,1,47,54
705,2014/03/31,2010/07/24,8,34,1.375456688,58541,8,16,18
706,2014/03/31,2006/09/19,9,70,0.689642615,116485,9,35,35
707,2014/03/31,2009/05/16,28,34,0.883529412,90814,28,15,19
708,2014/03/31,2012/05/25,35,31,0.8012903229999999,100130,35,17,14
709,2014/03/31,2012/02/10,62,44,0.7843010090000001,102276,62,20,24
710,2014/03/31,2010/06/07,27,43,1.322550717,60630,27,5,38
711,2014/03/31,2010/01/11,34,62,0.762393469,104969,34,31,31
712,2014/03/31,2008/04/27,26,35,1.386811155,57698,26,21,14
713,2014/03/31,2007/12/17,4,51,0.8615744790000001,92818,4,26,25
714,2014/03/31,2012/03/20,3,59,0.6739168940000001,118571,3,23,36
715,2014/03/31,2011/09/27,6,54,1.238703118,64470,6,24,30
716,2014/03/31,2012/01/13,23,55,0.942580466,84601,23,17,38
717,2014/03/31,2011/12/07,69,34,0.938940654,84892,69,20,14
718,2014/03/31,2009/02/18,2,58,0.7446574109999999,107038,2,25,33
719,2014/03/31,2006/11/17,3,83,0.8329750690000001,95665,3,52,31
720,2014/03/31,2006/01/04,3,39,1.238633431,64329,3,16,23
721,2014/03/31,2005/04/20,18,65,0.7799595659999999,102141,18,18,47
722,2014/03/31,2008/09/15,10,44,0.953680726,83527,10,15,29
723,2014/03/31,2006/11/06,1,64,0.639421062,124573,1,42,22
724,2014/03/31,2012/02/28,67,50,1.237046489,64381,67,23,27
725,2014/03/31,2011/05/20,83,27,1.42926697,55673,83,14,13
726,2014/03/31,2005/02/01,9,40,1.030612192,77198,9,21,19
727,2014/03/31,2005/07/27,2,72,0.7381336490000001,107745,2,38,34
728,2014/03/31,2007/06/18,41,47,1.391171839,57158,41,36,11
729,2014/03/31,2005/12/07,1,70,0.709738017,112030,1,29,41
730,2014/03/31,2011/01/30,113,51,0.739495067,107440,113,31,20
731,2014/03/31,2006/05/25,1,52,0.8075949640000001,98327,1,35,17
732,2014/03/31,2012/06/26,2,57,0.798412817,99434,2,27,30
733,2014/03/31,2005/09/04,2,56,0.908338086,87321,2,22,34
734,2014/03/31,2009/12/13,13,32,1.3146624,60308,13,15,17
735,2014/03/31,2006/01/30,1,65,0.8411298070000001,94255,1,29,36
736,2014/03/31,2009/11/07,30,16,0.623378315,127164,30,7,9
737,2014/03/31,2010/05/26,8,81,0.7176489559999999,110402,8,38,43
738,2014/03/31,2008/03/23,101,44,0.7555097409999999,104867,101,23,21
739,2014/03/31,2011/01/25,11,96,0.7372859509999999,107452,11,33,63
740,2014/03/31,2013/01/27,75,37,1.025352668,77098,75,8,29
741,2014/03/31,2011/03/01,10,63,0.729203429,108377,10,32,31
742,2014/03/31,2009/11/22,21,81,0.677642764,116556,21,38,43
743,2014/03/31,2009/12/21,13,82,0.617297044,127934,13,44,38
744,2014/03/31,2007/03/16,2,38,1.269493087,62200,2,16,22
745,2014/03/31,2006/02/12,38,25,1.238245644,63767,38,14,11
746,2014/03/31,2009/04/03,70,50,1.338983448,58964,70,40,10
747,2014/03/31,2009/03/30,6,66,0.825197125,95599,6,21,45
748,2014/03/31,2008/08/01,2,75,0.820139033,96092,2,34,41
749,2014/03/31,2011/04/01,12,70,0.661306893,119084,12,22,48
750,2014/03/31,2008/03/13,3,93,1.163014573,67658,3,34,59
751,2014/03/31,2007/07/15,2,97,0.8019518090000001,98027,2,46,51
752,2014/03/31,2010/10/01,20,72,0.780282142,100623,20,37,35
753,2014/03/31,2010/03/15,5,65,0.746562628,105089,5,39,26
754,2014/03/31,2005/09/20,60,45,1.3739172240000002,57094,60,29,16
755,2014/03/31,2008/05/28,10,27,1.4536389930000002,53927,10,11,16
756,2014/03/31,2009/03/01,2,81,0.789152044,99333,2,31,50
757,2014/03/31,2011/02/17,8,74,0.633542051,123708,8,30,44
758,2014/03/31,2005/09/09,2,81,0.8128448140000001,96407,2,34,47
759,2014/03/31,2012/06/15,63,43,0.9000129809999999,87048,63,21,22
760,2014/03/31,2010/09/07,62,13,1.054007025,74307,62,8,5
761,2014/03/31,2010/01/08,2,68,0.8934457029999999,87657,2,37,31
762,2014/03/31,2011/06/29,3,51,0.742125613,105499,3,27,24
763,2014/03/31,2009/07/30,36,65,0.8242233059999999,94928,36,34,31
764,2014/03/31,2007/06/12,12,61,0.816480465,95828,12,24,37
765,2014/03/31,2005/09/01,3,34,1.441951251,54155,3,15,19
766,2014/03/31,2005/09/12,1,106,1.059797165,73656,1,54,52
767,2014/03/31,2009/12/22,10,68,0.664639116,117406,10,35,33
768,2014/03/31,2011/03/03,5,69,1.315850461,59262,5,33,36
769,2014/03/31,2012/04/06,9,31,1.418710546,54938,9,6,25
770,2014/03/31,2010/03/23,4,85,0.6286328210000001,123956,4,45,40
771,2014/03/31,2004/11/10,9,85,0.6731533820000001,115698,9,35,50
772,2014/03/31,2012/06/26,21,44,0.6342576120000001,122665,21,21,23
773,2014/03/31,2005/03/12,2,82,0.917503332,84793,2,41,41
774,2014/03/31,2012/05/17,20,78,0.837629526,92800,20,35,43
775,2014/03/31,2010/05/31,288,35,0.7928544470000001,98033,288,30,5
776,2014/03/31,2010/11/17,23,64,0.6863847059999999,113219,23,39,25
777,2014/03/31,2010/04/20,3,49,0.727940377,106738,3,18,31
778,2014/03/31,2012/01/28,143,9,0.705555556,110088,143,4,5
779,2014/03/31,2006/04/11,105,44,0.603258718,128750,105,22,22
780,2014/03/31,2007/10/16,3,86,0.647968909,119842,3,44,42
781,2014/03/31,2006/05/12,7,45,0.765687133,101385,7,22,23
782,2014/03/31,2006/05/23,30,78,0.6849814259999999,113329,30,30,48
783,2014/03/31,2011/05/05,14,59,0.71581593,108263,14,31,28
784,2014/03/31,2007/08/25,1,98,0.7815750340000001,99128,1,24,74
785,2014/03/31,2011/12/21,12,87,0.739837298,104670,12,41,46
786,2014/03/31,2006/07/19,39,25,0.654261755,118355,39,19,6
787,2014/03/31,2011/01/22,23,48,0.879216392,88016,23,17,31
788,2014/03/31,2011/10/23,13,53,1.304834683,59280,13,19,34
789,2014/03/31,2004/11/25,10,31,0.934580215,82721,10,19,12
790,2014/03/31,2006/12/22,12,61,0.7541312809999999,102513,12,38,23
791,2014/03/31,2010/05/07,2,54,0.885256908,87327,2,36,18
792,2014/03/31,2007/09/05,2,68,0.928783415,83233,2,33,35
793,2014/03/31,2010/03/22,5,80,0.6987418040000001,110571,5,29,51
794,2014/03/31,2007/06/09,2,70,0.8396392690000001,91869,2,18,52
795,2014/03/31,2010/08/14,2,61,1.081109008,71334,2,23,38
796,2014/03/31,2005/11/24,9,59,0.8011154640000001,96238,9,33,26
797,2014/03/31,2012/02/16,3,71,0.713502263,108053,3,26,45
798,2014/03/31,2012/10/03,67,9,1.026311241,75093,67,2,7
799,2014/03/31,2010/04/06,33,43,1.218127915,63261,33,24,19
800,2014/03/31,2007/02/16,12,65,0.942705034,81718,12,27,38
801,2014/03/31,2006/02/15,1,118,0.677334828,113715,1,42,76
802,2014/03/31,2010/08/20,27,31,1.348767483,57054,27,12,19
803,2014/03/31,2011/02/06,34,13,0.623107079,123460,34,4,9
804,2014/03/31,2006/08/14,11,105,0.7646203429999999,100538,11,52,53
805,2014/03/31,2006/07/20,108,54,0.7849829979999999,97929,108,36,18
806,2014/03/31,2009/08/07,4,39,1.441390547,53274,4,19,20
807,2014/03/31,2008/09/19,2,67,0.918858199,83561,2,18,49
808,2014/03/31,2006/04/02,24,43,0.81727746,93927,24,21,22
809,2014/03/31,2008/01/12,3,78,0.8383759009999999,91540,3,33,45
810,2014/03/31,2005/05/28,1,77,0.640188153,119849,1,41,36
811,2014/03/31,2009/12/08,2,33,1.270434862,60387,2,0,33
812,2014/03/31,2007/03/08,25,67,0.71315326,107438,25,27,40
813,2014/03/31,2008/10/30,1,34,1.462471215,52371,1,15,19
814,2014/03/31,2010/01/31,82,40,0.7356240209999999,104027,82,17,23
815,2014/03/31,2010/02/28,34,47,1.329559135,57546,34,22,25
816,2014/03/31,2006/07/26,14,49,0.778446009,98276,14,16,33
817,2014/03/31,2005/09/09,3,39,0.71552526,106909,3,19,20
818,2014/03/31,2010/02/07,8,47,0.747021277,102319,8,23,24
819,2014/03/31,2008/10/25,4,72,0.785089206,97247,4,20,52
820,2014/03/31,2008/04/06,113,30,1.382804856,55190,113,20,10
821,2014/03/31,2010/10/17,123,21,1.4073332719999998,54220,123,15,6
822,2014/03/31,2008/04/23,1,62,0.862353147,88473,1,30,32
823,2014/03/31,2010/11/19,3,31,0.801548679,95165,3,8,23
824,2014/03/31,2011/03/27,5,85,0.6599335510000001,115578,5,31,54
825,2014/03/31,2010/05/25,376,18,1.077664372,70739,376,18,0
826,2014/03/31,2006/03/28,22,41,1.3586755069999998,56029,22,19,22
827,2014/03/31,2010/03/31,71,12,0.6764841659999999,112511,71,5,7
828,2014/03/31,2007/10/10,10,88,0.7644740859999999,99522,10,35,53
829,2014/03/31,2009/11/13,4,43,0.734484473,103564,4,19,24
830,2014/03/31,2011/01/21,2,53,0.904737825,84028,2,4,49
831,2014/03/31,2011/08/02,20,56,1.167142221,65103,20,38,18
832,2014/03/31,2005/07/13,32,80,0.664970058,114222,32,38,42
833,2014/03/31,2008/01/27,24,42,1.431651895,53030,24,22,20
834,2014/03/31,2011/12/14,1,79,0.7339671,103403,1,25,54
835,2014/03/31,2012/03/30,96,30,0.888219942,85368,96,19,11
836,2014/03/31,2005/02/01,12,30,1.355861619,55918,12,19,11
837,2014/03/31,2007/02/20,23,38,0.757393112,100035,23,18,20
838,2014/03/31,2008/09/16,25,49,0.755588065,100244,25,15,34
839,2014/03/31,2012/05/19,1,122,0.83108397,91128,1,52,70
840,2014/03/31,2005/04/19,7,60,0.762068552,99311,7,28,32
841,2014/03/31,2007/05/02,2,86,0.7873670509999999,96033,2,41,45
842,2014/03/31,2009/01/20,39,6,1.03,73392,39,2,4
843,2014/03/31,2012/03/30,235,6,1.03,73392,235,5,1
844,2014/03/31,2005/03/23,24,59,0.7158654040000001,105575,24,28,31
845,2014/03/31,2008/04/18,3,68,0.885546077,85336,3,32,36
846,2014/03/31,2006/03/20,1,62,0.863288072,87492,1,30,32
847,2014/03/31,2010/07/11,72,38,1.30967272,57596,72,19,19
848,2014/03/31,2009/10/08,6,104,0.757270716,99462,6,42,62
849,2014/03/31,2011/03/26,21,45,0.662631116,113659,21,17,28
850,2014/03/31,2006/08/08,1,59,0.721700494,104352,1,33,26
851,2014/03/31,2010/02/03,11,57,0.7899742890000001,95289,11,27,30
852,2014/03/31,2007/03/28,36,58,0.729874305,103107,36,36,22
853,2014/03/31,2006/01/13,11,78,0.685185398,109710,11,31,47
854,2014/03/31,2013/03/03,11,38,1.351954277,55596,11,1,37
855,2014/03/31,2010/06/01,8,31,1.3507072,55642,8,21,10
856,2014/03/31,2012/05/11,24,91,0.655811606,114600,24,51,40
857,2014/03/31,2012/07/14,1,82,0.631932339,118887,1,28,54
858,2014/03/31,2008/11/17,109,34,1.132759349,66320,109,25,9
859,2014/03/31,2004/12/08,3,54,0.766080091,98038,3,25,29
860,2014/03/31,2007/07/03,38,51,0.933638602,80432,38,33,18
861,2014/03/31,2006/03/20,4,62,0.817490664,91853,4,41,21
862,2014/03/31,2009/03/16,11,101,0.871194513,86102,11,43,58
863,2014/03/31,2012/01/06,3,98,0.82935577,90418,3,60,38
864,2014/03/31,2011/11/26,2,67,0.751497414,99772,2,37,30
865,2014/03/31,2007/10/05,1,58,0.911499088,82250,1,20,38
866,2014/03/31,2005/09/09,10,45,1.028986397,72849,10,15,30
867,2014/03/31,2008/07/09,1,45,0.960536115,77987,1,12,33
868,2014/03/31,2009/12/11,15,55,0.8932666509999999,83780,15,23,32
869,2014/03/31,2007/04/04,31,38,0.659311165,113467,31,17,21
870,2014/03/31,2010/07/15,5,53,0.878743334,85130,5,30,23
871,2014/03/31,2010/12/31,56,39,1.311457343,57001,56,12,27
872,2014/03/31,2005/11/10,9,51,0.810541273,92227,9,23,28
873,2014/03/31,2012/10/23,9,11,0.912206573,81937,9,7,4
874,2014/03/31,2006/03/28,60,31,1.431188333,52216,60,11,20
875,2014/03/31,2012/06/14,7,51,0.795260889,93929,7,29,22
876,2014/03/31,2007/04/15,7,67,0.78088584,95559,7,37,30
877,2014/03/31,2006/03/16,75,65,0.780413325,95518,75,44,21
878,2014/03/31,2011/08/25,14,22,1.361512333,54730,14,0,22
879,2014/03/31,2008/12/20,1,64,0.733608939,101534,1,31,33
880,2014/03/31,2006/07/17,15,70,0.635178874,117261,15,35,35
881,2014/03/31,2006/10/17,14,73,0.7606702759999999,97885,14,42,31
882,2014/03/31,2010/04/03,25,55,0.8169428190000001,91097,25,23,32
883,2014/03/31,2009/08/24,30,59,0.8379436490000001,88730,30,35,24
884,2014/03/31,2009/08/09,6,63,0.88377199,84128,6,27,36
885,2014/03/31,2005/05/18,6,113,0.681333761,109075,6,54,59
886,2014/03/31,2006/08/08,3,72,1.224716518,60674,3,33,39
887,2014/03/31,2006/02/23,4,122,0.844693244,87871,4,52,70
888,2014/03/31,2006/10/30,3,79,0.7569282629999999,98039,3,30,49
889,2014/03/31,2012/05/17,19,78,0.91528402,81033,19,39,39
890,2014/03/31,2007/05/16,15,45,0.7628747490000001,97205,15,17,28
891,2014/03/31,2011/11/08,2,78,0.7349542579999999,100891,2,30,48
892,2014/03/31,2011/10/11,42,75,0.950140982,78024,42,42,33
893,2014/03/31,2006/03/24,1,72,0.715944549,103478,1,28,44
894,2014/03/31,2006/11/24,180,45,0.925069436,80074,180,38,7
895,2014/03/31,2007/05/31,107,47,0.7023584140000001,105448,107,26,21
896,2014/03/31,2010/02/16,2,61,1.288559697,57474,2,41,20
897,2014/03/31,2011/12/22,88,10,0.665374696,111277,88,5,5
898,2014/03/31,2006/06/26,14,32,0.928148418,79748,14,16,16
899,2014/03/31,2008/03/28,1,57,0.7992955420000001,92596,1,25,32
900,2014/03/31,2010/03/18,85,58,1.441034872,51359,85,34,24
901,2014/03/31,2006/05/25,20,34,0.7469786979999999,99007,20,15,19
902,2014/03/31,2007/09/20,28,45,0.6786184940000001,108968,28,16,29
903,2014/03/31,2006/07/27,15,66,0.743689072,99380,15,44,22
904,2014/03/31,2008/07/16,11,52,1.3461425809999998,54902,11,25,27
905,2014/03/31,2005/03/23,4,103,0.5845876489999999,126385,4,55,48
906,2014/03/31,2005/09/01,61,61,0.8973846209999999,82229,61,38,23
907,2014/03/31,2012/11/10,2,32,1.071943718,68796,2,1,31
908,2014/03/31,2012/06/13,3,92,0.907426648,81252,3,28,64
909,2014/03/31,2009/04/07,6,58,0.777775797,94789,6,31,27
910,2014/03/31,2005/07/05,1,80,0.73022133,100890,1,32,48
911,2014/03/31,2005/12/08,8,46,0.8951384459999999,82198,8,28,18
912,2014/03/31,2011/05/29,14,85,0.762113878,96524,14,35,50
913,2014/03/31,2012/10/27,53,15,0.8357346640000001,87979,53,7,8
914,2014/03/31,2009/01/03,26,55,1.38513677,53082,26,29,26
915,2014/03/31,2005/02/14,9,70,0.8107778240000001,90676,9,15,55
916,2014/03/31,2010/01/15,4,84,0.828726975,88600,4,44,40
917,2014/03/31,2005/12/24,5,85,0.7733566540000001,94910,5,43,42
918,2014/03/31,2009/02/06,8,51,0.710294095,103334,8,27,24
919,2014/03/31,2006/11/15,5,66,0.842461652,87096,5,34,32
920,2014/03/31,2011/08/28,30,13,0.965910007,75939,30,6,7
921,2014/03/31,2010/02/20,6,85,0.8405888420000001,87222,6,41,44
922,2014/03/31,2005/04/01,11,83,0.866116497,84586,11,35,48
923,2014/03/31,2006/06/14,6,89,0.952323571,76929,6,49,40
924,2014/03/31,2010/07/22,4,85,0.829060102,88084,4,41,44
925,2014/03/31,2007/11/01,20,53,0.724125295,100834,20,21,32
926,2014/03/31,2011/10/09,1,92,0.7794460940000001,93608,1,48,44
927,2014/03/31,2009/07/15,15,54,0.991353507,73594,15,19,35
928,2014/03/31,2011/01/13,6,78,0.7846618470000001,92961,6,42,36
929,2014/03/31,2006/04/22,5,45,0.77380288,94176,5,27,18
930,2014/03/31,2009/11/15,21,57,0.752291723,96770,21,20,37
931,2014/03/31,2010/04/04,18,44,0.770116925,94505,18,21,23
932,2014/03/31,2007/02/12,1,78,0.744750123,97688,1,41,37
933,2014/03/31,2010/10/08,13,69,0.595677639,122130,13,40,29
934,2014/03/31,2010/05/28,13,91,0.770311126,94399,13,42,49
935,2014/03/31,2011/12/11,4,56,0.7335225009999999,99083,4,19,37
936,2014/03/31,2008/06/12,4,44,1.048949208,69243,4,21,23
937,2014/03/31,2007/04/27,7,72,0.784232377,92591,7,53,19
938,2014/03/31,2012/07/04,287,49,0.894173991,81119,287,36,13
939,2014/03/31,2012/04/25,1,37,0.67363915,107668,1,21,16
940,2014/03/31,2012/11/03,4,88,0.7709061909999999,94053,4,26,62
941,2014/03/31,2007/05/08,9,84,0.715400813,101344,9,28,56
942,2014/03/31,2009/06/28,12,58,0.751877658,96418,12,36,22
943,2014/03/31,2005/12/28,4,60,0.676071828,107228,4,22,38
944,2014/03/31,2012/06/27,3,9,0.794444444,91224,3,4,5
945,2014/03/31,2012/08/24,151,11,0.7609997059999999,95158,151,6,5
946,2014/03/31,2006/03/25,10,33,0.76655558,94251,10,14,19
947,2014/03/31,2005/09/19,46,72,0.666644027,108362,46,39,33
948,2014/03/31,2006/03/07,29,38,1.2653776840000002,57045,29,19,19
949,2014/03/31,2012/08/01,130,27,0.997066121,72382,130,20,7
950,2014/03/31,2010/11/15,8,35,1.008923608,71526,8,19,16
951,2014/03/31,2005/08/11,5,84,0.760778361,94699,5,40,44
952,2014/03/31,2012/04/11,31,27,0.8632206640000001,83430,31,17,10
953,2014/03/31,2010/09/14,87,55,0.789220204,91229,87,35,20
954,2014/03/31,2006/07/11,2,25,1.181765256,60909,2,9,16
955,2014/03/31,2006/02/01,76,24,0.685569377,104992,76,13,11
956,2014/03/31,2011/11/15,404,48,0.65625,109680,404,48,0
957,2014/03/31,2010/03/08,7,65,0.838990253,85774,7,31,34
958,2014/03/31,2007/01/25,5,67,0.666477923,107942,5,19,48
959,2014/03/31,2008/03/31,44,37,0.744337447,96596,44,19,18
960,2014/03/31,2011/01/30,5,68,1.464808986,49054,5,39,29
961,2014/03/31,2011/06/14,15,75,0.756962955,94885,15,32,43
962,2014/03/31,2006/08/25,10,78,0.749861982,95712,10,43,35
963,2014/03/31,2008/09/12,18,29,0.766206897,93670,18,17,12
964,2014/03/31,2009/10/22,4,61,0.78226347,91722,4,27,34
965,2014/03/31,2011/03/09,1,110,0.761354286,94212,1,44,66
966,2014/03/31,2007/04/27,67,26,1.4205865569999998,50464,67,13,13
967,2014/03/31,2005/04/22,7,62,0.867230581,82613,7,37,25
968,2014/03/31,2005/05/10,29,61,0.7364044040000001,97269,29,30,31
969,2014/03/31,2006/10/20,9,62,0.695298834,103017,9,23,39
970,2014/03/31,2006/04/03,37,53,0.768521162,93161,37,20,33
971,2014/03/31,2007/11/18,9,28,1.470489719,48681,9,19,9
972,2014/03/31,2006/06/18,7,67,0.678681764,105406,7,25,42
973,2014/03/31,2006/11/03,18,79,0.902894036,79187,18,25,54
974,2014/03/31,2004/11/01,4,26,0.956791465,74707,4,13,13
975,2014/03/31,2006/09/29,20,60,0.893743995,79936,20,28,32
976,2014/03/31,2008/03/27,25,47,0.839405903,85104,25,16,31
977,2014/03/31,2010/09/15,22,47,0.767970626,93009,22,19,28
978,2014/03/31,2005/05/06,6,47,1.027577651,69445,6,20,27
979,2014/03/31,2009/02/01,5,52,1.410842497,50564,5,26,26
980,2014/03/31,2012/09/08,19,12,0.8210383090000001,86872,19,4,8
981,2014/03/31,2007/06/09,12,47,1.275212587,55930,12,23,24
982,2014/03/31,2011/09/14,14,64,0.7506681470000001,95009,14,32,32
983,2014/03/31,2005/03/31,14,50,0.7760869570000001,91885,14,30,20
984,2014/03/31,2012/06/20,86,11,0.892701511,79822,86,4,7
985,2014/03/31,2008/07/06,8,49,0.7450367609999999,95617,8,17,32
986,2014/03/31,2007/10/21,7,43,0.929799128,76616,7,26,17
987,2014/03/31,2006/11/29,8,59,0.7578648570000001,93989,8,19,40
988,2014/03/31,2007/03/16,3,89,0.728606997,97760,3,31,58
989,2014/03/31,2005/02/08,39,50,1.070130276,66551,39,35,15
990,2014/03/31,2008/11/20,2,60,1.19527963,59525,2,20,40
991,2014/03/31,2011/05/15,12,50,0.820040344,86754,12,19,31
992,2014/03/31,2010/04/15,4,60,0.694059575,102459,4,17,43
993,2014/03/31,2008/04/12,6,67,0.7487699440000001,94955,6,32,35
994,2014/03/31,2009/12/22,5,40,1.264161391,56236,5,16,24
995,2014/03/31,2008/05/27,2,46,1.38430046,51348,2,22,24
996,2014/03/31,2011/07/31,4,82,0.847254187,83895,4,55,27
997,2014/03/31,2006/05/31,34,56,0.7756107459999999,91642,34,24,32
998,2014/03/31,2010/05/23,27,9,0.645555556,110088,27,7,2
999,2014/03/31,2007/08/24,148,28,1.457490254,48738,148,23,5
1000,2014/03/31,2010/03/06,30,65,0.6734283759999999,105426,30,24,41
1001,2014/03/31,2012/11/28,14,39,1.241211236,57173,14,11,28
1002,2014/03/31,2009/01/26,5,63,0.7843940159999999,90448,5,18,45
1003,2014/03/31,2009/10/13,72,17,1.166852837,60715,72,9,8
1004,2014/03/31,2010/04/24,27,8,0.942246505,75179,27,1,7
1005,2014/03/31,2005/05/26,3,84,0.640647015,110523,3,34,50
1006,2014/03/31,2007/11/27,18,37,0.7828232940000001,90444,18,16,21
1007,2014/03/31,2007/09/13,29,80,0.7060982179999999,100267,29,50,30
1008,2014/03/31,2006/10/18,3,45,0.8610738490000001,82181,3,21,24
1009,2014/03/31,2012/02/23,14,93,0.84441154,83778,14,58,35
1010,2014/03/31,2008/03/27,21,44,1.369228759,51657,21,20,24
1011,2014/03/31,2006/11/29,2,69,0.8358346059999999,84501,2,26,43
1012,2014/03/31,2009/07/06,20,82,0.725362843,97301,20,44,38
1013,2014/03/31,2007/03/01,1,78,0.7927240740000001,88944,1,23,55
1014,2014/03/31,2009/09/17,3,69,0.712019397,98985,3,36,33
1015,2014/03/31,2006/08/21,19,84,0.765469565,92064,19,49,35
1016,2014/03/31,2007/10/15,1,64,0.676593058,104064,1,30,34
1017,2014/03/31,2011/09/28,10,11,0.630909091,111496,10,6,5
1018,2014/03/31,2008/12/07,2,87,0.707182388,99343,2,21,66
1019,2014/03/31,2010/05/28,9,36,0.677307911,103715,9,17,19
1020,2014/03/31,2008/01/15,31,58,0.7480802990000001,93874,31,26,32
1021,2014/03/31,2010/01/16,4,45,0.786511917,89241,4,17,28
1022,2014/03/31,2011/04/05,3,78,0.84868599,82663,3,41,37
1023,2014/03/31,2011/04/23,58,51,0.996027411,70410,58,27,24
1024,2014/03/31,2008/04/26,6,81,0.74244971,94452,6,33,48
1025,2014/03/31,2008/01/22,1,67,0.807476938,86831,1,34,33
1026,2014/03/31,2006/06/01,12,83,0.751684992,93223,12,39,44
1027,2014/03/31,2006/10/26,48,38,0.88335611,79321,48,15,23
1028,2014/03/31,2010/08/20,4,47,0.886655909,79014,4,28,19
1029,2014/03/31,2006/01/31,74,75,0.738562797,94837,74,39,36
1030,2014/03/31,2012/01/21,7,50,0.7679431320000001,91158,7,15,35
1031,2014/03/31,2009/07/31,5,43,0.726250389,96346,5,23,20
1032,2014/03/31,2005/11/07,2,103,0.709802487,98576,2,32,71
1033,2014/03/31,2006/06/13,16,53,1.196730703,58456,16,22,31
1034,2014/03/31,2008/03/04,13,59,0.65477251,106818,13,30,29
1035,2014/03/31,2010/11/28,220,40,0.831087778,84144,220,25,15
1036,2014/03/31,2010/12/31,5,92,0.776382171,90054,5,34,58
1037,2014/03/31,2009/01/22,85,23,0.718099175,97363,85,14,9
1038,2014/03/31,2011/02/04,18,74,0.925861603,75406,18,46,28
1039,2014/03/31,2011/07/29,117,31,1.439048326,48504,117,14,17
1040,2014/03/31,2007/08/09,5,66,0.6636847220000001,104974,5,27,39
1041,2014/03/31,2008/02/17,1,114,0.651210811,106887,1,63,51
1042,2014/03/31,2011/09/28,44,8,0.71,97856,44,4,4
1043,2014/03/31,2007/07/01,7,74,0.793000365,87556,7,38,36
1044,2014/03/31,2010/04/27,12,74,0.723339585,95970,12,29,45
1045,2014/03/31,2008/10/27,48,45,0.74342941,93363,48,26,19
1046,2014/03/31,2007/09/12,38,19,1.029754457,67361,38,16,3
1047,2014/03/31,2009/12/01,22,51,1.395562442,49694,22,36,15
1048,2014/03/31,2005/06/29,87,9,1.066327925,64966,87,5,4
1049,2014/03/31,2011/10/05,11,53,0.976189208,70959,11,25,28
1050,2014/03/31,2011/03/08,10,63,0.770572087,89864,10,28,35
1051,2014/03/31,2006/05/24,32,27,1.388584408,49859,32,11,16
1052,2014/03/31,2009/07/17,9,39,0.684744247,101074,9,14,25
1053,2014/03/31,2004/11/30,2,82,0.704230722,98222,2,40,42
1054,2014/03/31,2007/09/18,40,52,0.6938930190000001,99663,40,24,28
1055,2014/03/31,2009/01/15,4,60,0.72390922,95528,4,35,25
1056,2014/03/31,2012/03/31,21,15,0.677207167,102029,21,7,8
1057,2014/03/31,2007/05/29,119,64,0.796799954,86680,119,43,21
1058,2014/03/31,2005/11/10,4,128,0.561786827,122933,4,57,71
1059,2014/03/31,2010/11/17,17,21,1.179136865,58554,17,2,19
1060,2014/03/31,2006/05/21,81,49,0.929462599,74209,81,33,16
1061,2014/03/31,2012/07/13,6,68,0.7215020240000001,95591,6,11,57
1062,2014/03/31,2006/03/15,14,52,0.771647904,89362,14,27,25
1063,2014/03/31,2005/04/12,2,66,0.756303449,91139,2,27,39
1064,2014/03/31,2008/03/05,25,43,1.208202145,56979,25,25,18
1065,2014/03/31,2011/03/17,18,79,0.671539069,102497,18,33,46
1066,2014/03/31,2006/09/01,7,88,0.7228046090000001,95204,7,34,54
1067,2014/03/31,2006/06/09,7,62,0.817781462,84141,7,30,32
1068,2014/03/31,2006/04/05,4,76,0.646832085,106316,4,36,40
1069,2014/03/31,2009/06/18,9,61,0.734644483,93582,9,24,37
1070,2014/03/31,2005/09/07,69,63,0.63222306,108742,69,38,25
1071,2014/03/31,2006/12/27,13,99,0.770776846,89194,13,44,55
1072,2014/03/31,2007/03/23,6,59,0.710553034,96721,6,22,37
1073,2014/03/31,2006/03/28,3,35,0.8123133020000001,84602,3,10,25
1074,2014/03/31,2007/11/01,25,93,0.73240629,93800,25,55,38
1075,2014/03/31,2011/01/26,6,55,0.7908684490000001,86833,6,25,30
1076,2014/03/31,2012/02/25,24,50,0.791493983,86748,24,23,27
1077,2014/03/31,2012/04/25,16,83,0.575621269,119272,16,37,46
1078,2014/03/31,2010/10/01,4,54,0.7857932759999999,87334,4,21,33
1079,2014/03/31,2007/07/13,28,67,0.686488346,99876,28,23,44
1080,2014/03/31,2011/02/27,92,44,0.8720875990000001,78334,92,24,20
1081,2014/03/31,2012/01/09,1,71,0.8177744379999999,83498,1,27,44
1082,2014/03/31,2009/09/28,77,8,0.6975,97856,77,4,4
1083,2014/03/31,2005/04/05,8,67,0.6357259439999999,107343,8,28,39
1084,2014/03/31,2008/01/08,14,66,0.714466492,95500,14,30,36
1085,2014/03/31,2012/01/28,5,37,1.3865882230000002,49165,5,18,19
1086,2014/03/31,2007/08/28,2,45,1.050657223,64879,2,13,32
1087,2014/03/31,2008/04/10,2,88,0.825079034,82559,2,38,50
1088,2014/03/31,2008/06/14,7,74,0.77524067,87838,7,40,34
1089,2014/03/31,2006/12/27,97,55,0.814324997,83607,97,41,14
1090,2014/03/31,2006/09/29,2,63,0.7542840999999999,90250,2,15,48
1091,2014/03/31,2009/01/20,1,96,0.638373879,106628,1,31,65
1092,2014/03/31,2012/04/20,9,63,0.82876639,82060,9,27,36
1093,2014/03/31,2007/09/03,4,66,0.7864642140000001,86473,4,27,39
1094,2014/03/31,2007/04/30,25,65,0.7314930940000001,92968,25,28,37
1095,2014/03/31,2013/02/01,175,9,0.760529166,89386,175,3,6
1096,2014/03/31,2007/02/22,28,24,1.166275543,58285,28,12,12
1097,2014/03/31,2005/11/14,18,38,1.443096193,47103,18,20,18
1098,2014/03/31,2012/04/05,11,75,0.6472666220000001,104980,11,21,54
1099,2014/03/31,2008/11/23,3,42,0.819982012,82833,3,21,21
1100,2014/03/31,2005/11/21,18,48,0.890162362,76188,18,22,26
1101,2014/03/31,2010/08/08,3,84,0.8483582390000001,79768,3,48,36
1102,2014/03/31,2006/03/23,9,48,0.655015683,103296,9,21,27
1103,2014/03/31,2006/04/10,1,38,0.751680518,90002,1,7,31
1104,2014/03/31,2009/06/25,14,41,0.870894754,77675,14,18,23
1105,2014/03/31,2009/11/13,20,59,0.8352330640000001,80922,20,24,35
1106,2014/03/31,2012/06/29,64,15,0.920963128,73334,64,6,9
1107,2014/03/31,2005/09/10,15,50,0.751963299,89808,15,30,20
1108,2014/03/31,2007/01/14,7,98,0.7206628409999999,93582,7,55,43
1109,2014/03/31,2009/09/22,9,70,0.932417455,72324,9,15,55
1110,2014/03/31,2008/04/10,15,53,0.8900197990000001,75761,15,31,22
1111,2014/03/31,2008/07/09,112,23,1.416268936,47595,112,7,16
1112,2014/03/31,2011/06/26,4,60,0.762685873,88340,4,30,30
1113,2014/03/31,2009/09/05,36,34,0.797343238,84475,36,11,23
1114,2014/03/31,2011/11/06,16,46,0.690650512,97431,16,17,29
1115,2014/03/31,2007/03/14,3,66,0.695424233,96751,3,31,35
1116,2014/03/31,2005/08/05,22,64,0.7517455390000001,89491,22,21,43
1117,2014/03/31,2006/12/23,6,58,1.349008201,49869,6,29,29
1118,2014/03/31,2008/12/11,12,97,0.582283647,115517,12,55,42
1119,2014/03/31,2011/07/26,61,50,0.8066655070000001,83383,61,18,32
1120,2014/03/31,2011/12/09,4,73,0.62728915,107221,4,33,40
1121,2014/03/31,2006/06/05,2,63,0.665195416,101041,2,28,35
1122,2014/03/31,2008/08/31,2,55,0.663082359,101325,2,20,35
1123,2014/03/31,2012/03/31,13,83,0.664267955,101114,13,35,48
1124,2014/03/31,2011/05/26,5,37,0.8366723970000001,80277,5,16,21
1125,2014/03/31,2012/07/14,11,54,1.134827161,59159,11,22,32
1126,2014/03/31,2010/05/27,94,56,0.91625,73248,94,30,26
1127,2014/03/31,2007/10/15,5,54,0.830013488,80811,5,26,28
1128,2014/03/31,2009/11/21,5,77,0.7099307690000001,94466,5,33,44
1129,2014/03/31,2005/05/17,263,17,0.741289723,90438,263,11,6
1130,2014/03/31,2009/06/23,3,61,0.676810666,99005,3,35,26
1131,2014/03/31,2012/04/21,27,24,0.8923636359999999,75020,27,11,13
1132,2014/03/31,2006/07/30,68,25,0.862744191,77593,68,12,13
1133,2014/03/31,2005/01/01,2,75,0.7291747679999999,91756,2,26,49
1134,2014/03/31,2010/10/25,3,62,0.7639901790000001,87570,3,32,30
1135,2014/03/31,2007/02/14,6,8,0.825,81088,6,4,4
1136,2014/03/31,2011/12/22,27,47,0.61626093,108535,27,19,28
1137,2014/03/31,2011/12/16,5,77,1.310647431,51017,5,26,51
1138,2014/03/31,2007/02/07,16,93,0.847757067,78812,16,38,55
1139,2014/03/31,2011/03/11,2,45,1.247749239,53533,2,22,23
1140,2014/03/31,2009/01/02,16,84,0.721065869,92563,16,41,43
1141,2014/03/31,2007/05/16,6,42,0.892427995,74786,6,27,15
1142,2014/03/31,2006/06/09,4,31,1.236860909,53936,4,12,19
1143,2014/03/31,2005/03/28,1,62,0.7623050459999999,87482,1,24,38
1144,2014/03/31,2007/08/20,3,27,1.431428295,46587,3,13,14
1145,2014/03/31,2010/08/11,1,95,0.818104182,81511,1,59,36
1146,2014/03/31,2005/02/01,2,65,0.7564273640000001,88117,2,32,33
1147,2014/03/31,2010/11/22,3,60,0.7367836609999999,90460,3,22,38
1148,2014/03/31,2011/08/13,21,33,0.800237669,83267,21,17,16
1149,2014/03/31,2010/09/09,437,31,0.60440544,110216,437,31,0
1150,2014/03/31,2007/06/30,18,54,0.752916615,88445,18,23,31
1151,2014/03/31,2006/04/13,5,42,0.695375825,95736,5,21,21
1152,2014/03/31,2006/12/26,6,69,0.891297365,74659,6,47,22
1153,2014/03/31,2009/08/10,7,62,0.7595434879999999,87599,7,30,32
1154,2014/03/31,2007/07/19,16,57,0.6873007259999999,96789,16,32,25
1155,2014/03/31,2012/10/25,5,68,0.74069863,89790,5,22,46
1156,2014/03/31,2012/10/30,1,128,0.6740434270000001,98649,1,52,76
1157,2014/03/31,2008/04/14,7,76,0.7711289990000001,86218,7,25,51
1158,2014/03/31,2012/05/02,6,67,0.642522193,103410,6,23,44
1159,2014/03/31,2006/04/26,14,56,0.7590530390000001,87501,14,34,22
1160,2014/03/31,2009/09/10,52,63,0.7634627409999999,86986,52,33,30
1161,2014/03/31,2007/08/14,9,56,0.678767262,97831,9,27,29
1162,2014/03/31,2005/03/17,1,76,0.7028135090000001,94455,1,25,51
1163,2014/03/31,2009/06/01,22,31,0.804163718,82520,22,18,13
1164,2014/03/31,2007/06/01,6,70,0.746303211,88915,6,32,38
1165,2014/03/31,2011/05/06,66,40,0.741461247,89451,66,24,16
1166,2014/03/31,2010/09/07,7,86,0.815594824,81293,7,45,41
1167,2014/03/31,2012/01/14,30,8,0.6775,97856,30,4,4
1168,2014/03/31,2009/10/18,2,38,0.884175169,74979,2,13,25
1169,2014/03/31,2006/07/29,10,75,0.8032435509999999,82533,10,37,38
1170,2014/03/31,2011/08/29,32,28,1.128214286,58744,32,18,10
1171,2014/03/31,2011/11/11,3,58,0.715125553,92630,3,19,39
1172,2014/03/31,2010/05/01,6,56,0.703703373,94125,6,20,36
1173,2014/03/31,2012/01/24,7,66,0.632428741,104688,7,34,32
1174,2014/03/31,2009/07/13,3,60,0.774692023,85396,3,30,30
1175,2014/03/31,2007/03/31,3,108,0.8595644259999999,76956,3,62,46
1176,2014/03/31,2004/11/06,28,10,0.594440819,111243,28,6,4
1177,2014/03/31,2012/06/28,50,21,0.7695947059999999,85913,50,12,9
1178,2014/03/31,2010/05/04,31,17,0.985147442,67111,31,8,9
1179,2014/03/31,2011/01/04,4,71,0.844210977,78274,4,22,49
1180,2014/03/31,2009/12/26,1,83,0.6719452859999999,98330,1,25,58
1181,2014/03/31,2007/08/15,60,42,0.684900773,96446,60,21,21
1182,2014/03/31,2010/05/24,25,62,0.7436010040000001,88828,25,28,34
1183,2014/03/31,2012/09/17,23,32,0.556829741,118596,23,8,24
1184,2014/03/31,2008/02/04,2,59,0.803856089,82148,2,38,21
1185,2014/03/31,2006/01/17,6,45,0.874336472,75513,6,12,33
1186,2014/03/31,2005/09/20,2,62,1.00370367,65751,2,30,32
1187,2014/03/31,2009/04/13,51,61,0.68244726,96606,51,31,30
1188,2014/03/31,2005/11/27,2,60,0.69633966,94677,2,18,42
1189,2014/03/31,2007/07/16,107,25,0.664036304,99217,107,10,15
1190,2014/03/31,2010/11/29,1,103,0.6964352109999999,94561,1,48,55
1191,2014/03/31,2006/05/12,34,64,0.818625942,80426,34,34,30
1192,2014/03/31,2011/11/23,8,66,0.822299043,79955,8,28,38
1193,2014/03/31,2009/07/23,17,53,1.193531729,55075,17,19,34
1194,2014/03/31,2010/08/13,144,71,0.802114353,81869,144,35,36
1195,2014/03/31,2007/06/18,6,43,1.237156745,53080,6,18,25
1196,2014/03/31,2009/08/14,10,71,0.77772471,84420,10,36,35
1197,2014/03/31,2012/09/21,9,48,0.836235471,78464,9,16,32
1198,2014/03/31,2011/08/12,9,60,0.798367322,82184,9,34,26
1199,2014/03/31,2012/02/15,2,34,0.775308023,84604,2,11,23
1200,2014/03/31,2012/06/02,3,49,0.835948457,78459,3,19,30
1201,2014/03/31,2011/01/06,2,43,0.6997169440000001,93727,2,15,28
1202,2014/03/31,2006/10/07,35,57,0.726836612,90166,35,30,27
1203,2014/03/31,2005/02/02,4,81,0.718119985,91228,4,30,51
1204,2014/03/31,2005/02/02,17,66,0.7447026590000001,87963,17,38,28
1205,2014/03/31,2007/08/13,9,33,0.7748500309999999,84484,9,12,21
1206,2014/03/31,2007/05/01,20,55,0.635123674,103053,20,32,23
1207,2014/03/31,2006/03/13,107,10,0.7347814859999999,89033,107,5,5
1208,2014/03/31,2007/12/12,67,10,0.6489639229999999,100784,67,3,7
1209,2014/03/31,2011/12/12,30,34,0.7438075140000001,87913,30,18,16
1210,2014/03/31,2005/05/21,7,39,0.804813608,81039,7,19,20
1211,2014/03/31,2006/06/20,10,50,0.6773808040000001,96270,10,25,25
1212,2014/03/31,2011/06/27,3,60,0.6712497159999999,96998,3,21,39
1213,2014/03/31,2007/07/25,2,116,0.782612517,83165,2,57,59
1214,2014/03/31,2010/09/28,217,32,1.400029255,46488,217,28,4
1215,2014/03/31,2010/06/11,1,74,0.652215703,99702,1,31,43
1216,2014/03/31,2011/02/23,6,13,0.844045975,77042,6,6,7
1217,2014/03/31,2008/11/12,60,28,1.3555404480000002,47951,60,4,24
1218,2014/03/31,2011/09/19,14,50,0.6834599570000001,95085,14,25,25
1219,2014/03/31,2007/10/12,16,71,0.7112315440000001,91365,16,38,33
1220,2014/03/31,2010/11/10,49,51,0.748592215,86803,49,29,22
1221,2014/03/31,2005/01/15,12,63,0.713542692,91024,12,23,40
1222,2014/03/31,2008/10/11,63,40,1.227439421,52906,63,16,24
1223,2014/03/31,2006/03/07,2,64,0.7288708770000001,89078,2,37,27
1224,2014/03/31,2005/10/23,2,34,1.35951645,47751,2,21,13
1225,2014/03/31,2007/04/26,11,45,0.8032229609999999,80817,11,15,30
1226,2014/03/31,2008/05/29,39,11,0.724004216,89648,39,8,3
1227,2014/03/31,2008/03/07,2,39,0.7726835459999999,83889,2,18,21
1228,2014/03/31,2004/11/30,1,101,0.7897719209999999,82033,1,42,59
1229,2014/03/31,2006/11/02,71,10,0.655965331,98764,71,4,6
1230,2014/03/31,2006/06/02,2,45,0.7120016490000001,90950,2,30,15
1231,2014/03/31,2008/10/30,35,46,0.735062056,88065,35,24,22
1232,2014/03/31,2006/01/11,3,82,0.7409887820000001,87360,3,36,46
1233,2014/03/31,2008/10/01,265,11,0.716932695,90291,265,6,5
1234,2014/03/31,2005/06/01,15,61,0.654428514,98900,15,29,32
1235,2014/03/31,2007/07/04,6,30,0.772333333,83790,6,12,18
1236,2014/03/31,2008/12/18,1,97,0.6935350859999999,93299,1,40,57
1237,2014/03/31,2005/08/25,4,88,0.740870083,87325,4,44,44
1238,2014/03/31,2011/07/30,19,18,0.6838852459999999,94550,19,8,10
1239,2014/03/31,2007/07/19,65,43,0.652629385,99065,65,21,22
1240,2014/03/31,2011/03/03,1,81,0.763417239,84659,1,31,50
1241,2014/03/31,2011/03/02,28,25,0.765015931,84429,28,7,18
1242,2014/03/31,2005/07/18,6,13,0.65643674,98379,6,7,6
1243,2014/03/31,2007/11/14,42,71,0.842243326,76605,42,39,32
1244,2014/03/31,2006/10/25,9,91,0.774857888,83244,9,40,51
1245,2014/03/31,2008/08/02,1,76,0.870106206,74101,1,13,63
1246,2014/03/31,2009/09/21,11,48,0.68701783,93831,11,11,37
1247,2014/03/31,2011/01/09,6,9,0.585555556,110088,6,4,5
1248,2014/03/31,2012/07/03,3,59,0.655315017,98344,3,23,36
1249,2014/03/31,2006/04/16,57,28,0.795878735,80963,57,17,11
1250,2014/03/31,2012/09/26,23,26,1.28795738,50024,23,0,26
1251,2014/03/31,2006/09/05,289,18,0.684170092,94161,289,12,6
1252,2014/03/31,2008/11/09,57,23,1.363048817,47238,57,16,7
1253,2014/03/31,2012/02/14,15,89,0.6664313510000001,96608,15,45,44
1254,2014/03/31,2012/05/14,1,43,0.69179658,93049,1,16,27
1255,2014/03/31,2012/11/17,224,7,1.026835338,62686,224,5,2
1256,2014/03/31,2010/12/01,68,25,1.433750836,44870,68,12,13
1257,2014/03/31,2012/07/11,14,59,0.742177442,86620,14,21,38
1258,2014/03/31,2006/06/07,5,53,0.741590338,86686,5,36,17
1259,2014/03/31,2007/02/04,12,56,0.794874297,80865,12,29,27
1260,2014/03/31,2005/01/28,90,35,1.149063249,55938,90,24,11
1261,2014/03/31,2006/10/12,12,51,1.207902929,53198,12,24,27
1262,2014/03/31,2006/10/11,5,51,0.75665261,84896,5,36,15
1263,2014/03/31,2005/07/22,255,5,1.05,61160,255,3,2
1264,2014/03/31,2006/09/14,13,39,1.299550976,49396,13,14,25
1265,2014/03/31,2006/05/19,65,15,0.972289971,65979,65,5,10
1266,2014/03/31,2006/08/16,11,63,0.7538277940000001,85096,11,24,39
1267,2014/03/31,2005/06/19,5,52,1.135377599,56462,5,25,27
1268,2014/03/31,2007/10/11,4,73,0.81388666,78754,4,37,36
1269,2014/03/31,2011/09/03,4,26,1.337733378,47873,4,10,16
1270,2014/03/31,2006/07/31,11,57,0.7940450859999999,80646,11,22,35
1271,2014/03/31,2005/04/22,2,77,0.710465253,90123,2,35,42
1272,2014/03/31,2007/09/07,6,71,0.764650707,83712,6,30,41
1273,2014/03/31,2005/10/07,2,95,0.862945346,74066,2,37,58
1274,2014/03/31,2012/07/25,5,40,0.916007655,69761,5,18,22
1275,2014/03/31,2005/05/04,2,28,0.69680407,91701,2,13,15
1276,2014/03/31,2006/02/26,5,73,0.668030362,95647,5,31,42
1277,2014/03/31,2005/12/03,131,43,0.743074883,85974,131,28,15
1278,2014/03/31,2010/02/13,8,25,1.2176,52450,8,19,6
1279,2014/03/31,2006/01/26,47,63,0.791293957,80675,47,33,30
1280,2014/03/31,2011/05/21,4,49,0.845687295,75477,4,18,31
1281,2014/03/31,2006/09/23,22,46,0.714593877,89271,22,18,28
1282,2014/03/31,2012/09/12,314,10,0.634799745,100472,314,8,2
1283,2014/03/31,2011/07/18,2,59,0.791726947,80541,2,30,29
1284,2014/03/31,2012/06/20,38,9,0.698888889,91224,38,5,4
1285,2014/03/31,2005/10/27,2,81,0.847747732,75182,2,35,46
1286,2014/03/31,2012/11/18,87,7,0.7442857140000001,85624,87,1,6
1287,2014/03/31,2011/06/11,2,75,1.056982731,60283,2,29,46
1288,2014/03/31,2011/05/20,4,107,0.801270927,79501,4,57,50
1289,2014/03/31,2012/04/22,1,73,0.7936877659999999,80241,1,35,38
1290,2014/03/31,2008/05/16,4,65,0.658601864,96693,4,31,34
1291,2014/03/31,2007/03/22,3,76,0.886963733,71746,3,26,50
1292,2014/03/31,2010/11/23,32,64,0.682162356,93264,32,21,43
1293,2014/03/31,2007/06/15,24,34,0.669690526,95000,24,21,13
1294,2014/03/31,2012/12/15,32,67,0.714236622,89045,32,17,50
1295,2014/03/31,2005/02/07,57,39,1.1158591409999998,56993,57,21,18
1296,2014/03/31,2005/05/06,44,28,1.447174086,43915,44,12,16
1297,2014/03/31,2007/12/16,24,71,0.721764104,88022,24,33,38
1298,2014/03/31,2010/11/25,28,12,0.741325632,85695,28,8,4
1299,2014/03/31,2008/10/13,6,54,0.789281267,80475,6,6,48
1300,2014/03/31,2009/11/06,13,50,1.339272022,47419,13,27,23
1301,2014/03/31,2008/03/19,18,63,0.701515115,90508,18,31,32
1302,2014/03/31,2010/10/31,16,47,0.663811052,95635,16,21,26
1303,2014/03/31,2006/06/07,7,52,0.7158285679999999,88665,7,22,30
1304,2014/03/31,2012/05/30,4,30,1.442555629,43997,4,2,28
1305,2014/03/31,2007/08/02,26,50,0.7968496820000001,79538,26,29,21
1306,2014/03/31,2009/12/01,7,67,0.546489866,115950,7,36,31
1307,2014/03/31,2011/02/25,33,51,0.798170595,79381,33,30,21
1308,2014/03/31,2007/05/31,70,75,0.816596247,77582,70,40,35
1309,2014/03/31,2006/12/11,10,61,0.641866669,98657,10,23,38
1310,2014/03/31,2009/12/10,123,6,1.017113992,62259,123,0,6
1311,2014/03/31,2006/07/02,5,72,0.701083628,90317,5,31,41
1312,2014/03/31,2009/01/24,14,77,0.72837993,86916,14,33,44
1313,2014/03/31,2010/06/09,74,19,1.256990983,50352,74,7,12
1314,2014/03/31,2006/01/15,4,46,0.779039657,81221,4,23,23
1315,2014/03/31,2007/08/28,1,49,0.8236952270000001,76772,1,20,29
1316,2014/03/31,2011/09/26,5,93,0.8000583609999999,78991,5,55,38
1317,2014/03/31,2007/10/01,45,29,0.67474611,93643,45,13,16
1318,2014/03/31,2008/09/13,15,49,0.677956972,93195,15,21,28
1319,2014/03/31,2012/09/22,11,62,0.75303485,83902,11,21,41
1320,2014/03/31,2007/02/12,8,36,0.817882551,77225,8,17,19
1321,2014/03/31,2010/09/07,13,78,0.785563626,80399,13,40,38
1322,2014/03/31,2010/10/09,90,20,0.709340599,89005,90,9,11
1323,2014/03/31,2011/12/13,33,36,1.187838997,53142,33,22,14
1324,2014/03/31,2006/07/01,41,11,0.7455329279999999,84655,41,3,8
1325,2014/03/31,2006/03/13,8,54,0.819158575,77036,8,18,36
1326,2014/03/31,2007/04/27,28,33,1.4618181819999998,43164,28,19,14
1327,2014/03/31,2006/08/05,31,35,1.372635266,45965,31,14,21
1328,2014/03/31,2006/09/03,104,44,0.915871241,68873,104,42,2
1329,2014/03/31,2008/01/08,5,48,0.782426848,80586,5,20,28
1330,2014/03/31,2011/05/31,345,9,0.937580192,67245,345,8,1
1331,2014/03/31,2009/07/19,1,49,0.832198082,75716,1,20,29
1332,2014/03/31,2008/05/15,9,55,0.711070945,88604,9,33,22
1333,2014/03/31,2013/01/12,5,19,1.297306219,48560,5,5,14
1334,2014/03/31,2011/06/11,86,5,1.03,61160,86,2,3
1335,2014/03/31,2011/04/20,1,82,0.724723993,86882,1,28,54
1336,2014/03/31,2007/07/31,22,40,0.634788005,99177,22,18,22
1337,2014/03/31,2006/06/20,4,81,0.734077525,85753,4,30,51
1338,2014/03/31,2005/06/30,3,61,0.634378944,99202,3,32,29
1339,2014/03/31,2006/05/16,5,54,0.710252297,88586,5,17,37
1340,2014/03/31,2008/03/10,100,7,0.7342857140000001,85624,100,3,4
1341,2014/03/31,2008/06/22,31,40,0.889793009,70631,31,21,19
1342,2014/03/31,2009/11/10,12,62,0.770479116,81546,12,27,35
1343,2014/03/31,2007/07/02,17,48,1.286855884,48815,17,33,15
1344,2014/03/31,2011/05/20,18,52,0.8582962820000001,73187,18,28,24
1345,2014/03/31,2005/04/09,2,42,1.110958274,56487,2,21,21
1346,2014/03/31,2009/04/10,20,42,0.776964157,80686,20,23,19
1347,2014/03/31,2006/07/03,11,69,0.699150052,89629,11,38,31
1348,2014/03/31,2010/12/14,130,26,1.428440995,43810,130,22,4
1349,2014/03/31,2010/05/17,2,71,0.816414747,76572,2,15,56
1350,2014/03/31,2004/12/14,15,58,0.6580753229999999,94925,15,26,32
1351,2014/03/31,2009/10/16,230,13,0.7798879590000001,79971,230,10,3
1352,2014/03/31,2005/09/09,5,42,1.021400632,61051,5,21,21
1353,2014/03/31,2010/12/20,23,37,0.824821977,75552,23,6,31
1354,2014/03/31,2009/02/17,10,82,0.6853246270000001,90889,10,46,36
1355,2014/03/31,2008/07/23,9,75,0.620769346,100319,9,42,33
1356,2014/03/31,2010/12/31,144,31,1.455932164,42750,144,20,11
1357,2014/03/31,2005/03/20,6,49,0.652557664,95380,6,30,19
1358,2014/03/31,2007/06/06,11,76,0.750763458,82886,11,47,29
1359,2014/03/31,2008/06/07,39,41,0.7525508059999999,82668,39,16,25
1360,2014/03/31,2012/07/28,11,70,0.7767253159999999,80023,11,23,47
1361,2014/03/31,2009/06/23,21,70,0.74161054,83798,21,35,35
1362,2014/03/31,2007/05/23,36,50,0.839648207,73964,36,29,21
1363,2014/03/31,2009/09/22,10,59,0.8765782529999999,70841,10,41,18
1364,2014/03/31,2007/07/28,2,41,1.433718588,43296,2,15,26
1365,2014/03/31,2005/08/11,2,80,0.983662863,63090,2,44,36
1366,2014/03/31,2012/09/29,26,44,0.751008887,82596,26,11,33
1367,2014/03/31,2010/01/17,77,34,0.7944558009999999,78078,77,22,12
1368,2014/03/31,2004/12/31,27,35,0.8373972340000001,74052,27,27,8
1369,2014/03/31,2006/04/29,9,60,0.842998503,73500,9,28,32
1370,2014/03/31,2009/12/20,11,54,0.7773350809999999,79706,11,31,23
1371,2014/03/31,2011/03/24,6,46,0.705171165,87839,6,17,29
1372,2014/03/31,2007/09/22,37,51,1.188997963,52044,37,28,23
1373,2014/03/31,2005/08/02,10,65,0.784764846,78842,10,35,30
1374,2014/03/31,2004/12/03,35,60,0.592701939,104351,35,35,25
1375,2014/03/31,2010/12/31,78,49,1.089030304,56791,78,28,21
1376,2014/03/31,2007/10/09,20,65,0.778212056,79460,20,31,34
1377,2014/03/31,2007/02/06,20,53,0.7429943640000001,83213,20,27,26
1378,2014/03/31,2008/04/03,3,62,0.765801273,80734,3,24,38
1379,2014/03/31,2012/08/17,24,50,0.55817343,110765,24,18,32
1380,2014/03/31,2012/12/11,214,47,0.607049628,101838,214,9,38
1381,2014/03/31,2004/11/11,66,37,0.987120791,62604,66,25,12
1382,2014/03/31,2010/01/07,33,49,0.715697788,86330,33,34,15
1383,2014/03/31,2006/05/17,16,40,0.763638443,80889,16,6,34
1384,2014/03/31,2011/06/20,7,47,0.7639381190000001,80833,7,25,22
1385,2014/03/31,2012/09/01,1,51,0.7577202759999999,81466,1,15,36
1386,2014/03/31,2011/04/01,2,63,0.678944235,90863,2,34,29
1387,2014/03/31,2010/10/02,5,58,0.734023251,84039,5,23,35
1388,2014/03/31,2008/04/24,3,57,0.7429861459999999,83010,3,23,34
1389,2014/03/31,2010/08/30,25,79,0.6837351709999999,90194,25,35,44
1390,2014/03/31,2006/02/23,5,64,0.754111215,81662,5,28,36
1391,2014/03/31,2006/11/01,24,42,1.3550815269999998,45445,24,15,27
1392,2014/03/31,2009/08/01,7,71,0.7760737109999999,79337,7,20,51
1393,2014/03/31,2006/11/07,21,34,0.670704084,91793,21,16,18
1394,2014/03/31,2011/06/29,6,58,0.935059924,65833,6,27,31
1395,2014/03/31,2009/01/26,12,75,0.817348709,75269,12,45,30
1396,2014/03/31,2005/07/06,1,35,1.136308789,54134,1,13,22
1397,2014/03/31,2012/05/11,1,28,0.771087319,79765,1,10,18
1398,2014/03/31,2007/02/16,3,49,0.690976788,89006,3,21,28
1399,2014/03/31,2006/02/25,2,10,0.73567936,83564,2,6,4
1400,2014/03/31,2011/01/20,32,58,0.676096501,90921,32,31,27
1401,2014/03/31,2005/06/15,17,34,0.5974340260000001,102881,17,9,25
1402,2014/03/31,2011/10/13,10,32,1.46025874,42050,10,16,16
1403,2014/03/31,2009/03/30,57,14,0.70785314,86722,57,6,8
1404,2014/03/31,2007/09/07,11,87,0.852811931,71979,11,37,50
1405,2014/03/31,2009/10/18,12,54,0.8527599579999999,71954,12,30,24
1406,2014/03/31,2007/09/26,67,20,0.73654354,83302,67,10,10
1407,2014/03/31,2005/10/02,5,34,0.7281499770000001,84253,5,16,18
1408,2014/03/31,2012/09/25,120,30,1.316232906,46508,120,17,13
1409,2014/03/31,2007/06/21,26,36,1.277978826,47888,26,24,12
1410,2014/03/31,2011/03/19,8,46,0.717079276,85335,8,27,19
1411,2014/03/31,2011/09/09,220,53,1.346975602,45414,220,44,9
1412,2014/03/31,2013/01/13,8,15,0.628571517,97250,8,4,11
1413,2014/03/31,2010/08/06,6,95,0.803118801,76026,6,36,59
1414,2014/03/31,2006/03/24,49,52,0.813926148,75015,49,37,15
1415,2014/03/31,2008/04/05,6,64,0.645575291,94526,6,30,34
1416,2014/03/31,2011/09/19,5,38,0.7174053909999999,85034,5,16,22
1417,2014/03/31,2004/12/02,461,51,0.908231721,67167,461,51,0
1418,2014/03/31,2011/08/21,8,48,0.776952312,78489,8,22,26
1419,2014/03/31,2009/01/13,16,65,0.824283416,73962,16,30,35
1420,2014/03/31,2010/03/22,93,23,1.45569101,41859,93,14,9
1421,2014/03/31,2006/11/05,5,55,0.8373704829999999,72751,5,33,22
1422,2014/03/31,2007/10/19,7,58,0.943011116,64594,7,25,33
1423,2014/03/31,2011/04/22,15,31,0.8053593440000001,75610,15,14,17
1424,2014/03/31,2012/02/06,10,78,0.751913932,80959,10,36,42
1425,2014/03/31,2006/04/13,3,54,0.906626843,67130,3,20,34
1426,2014/03/31,2006/05/20,12,58,0.947089664,64240,12,21,37
1427,2014/03/31,2010/05/24,18,37,0.7161925840000001,84950,18,18,19
1428,2014/03/31,2011/06/13,3,43,0.766335668,79376,3,19,24
1429,2014/03/31,2006/01/28,3,57,0.6947636509999999,87540,3,30,27
1430,2014/03/31,2009/08/27,2,62,0.667879817,91011,2,0,62
1431,2014/03/31,2005/12/20,23,59,0.716748865,84795,23,29,30
1432,2014/03/31,2007/10/26,88,10,0.586999807,103500,88,4,6
1433,2014/03/31,2007/01/26,22,36,0.8833333329999999,68760,22,0,36
1434,2014/03/31,2009/02/12,32,58,0.810649463,74908,32,24,34
1435,2014/03/31,2006/06/16,5,45,0.770872165,78758,5,22,23
1436,2014/03/31,2011/12/19,8,81,0.8208944970000001,73941,8,34,47
1437,2014/03/31,2006/04/22,11,60,0.6882506290000001,88186,11,36,24
1438,2014/03/31,2011/01/17,3,62,0.835425306,72630,3,37,25
1439,2014/03/31,2005/06/05,24,26,1.353867369,44816,24,12,14
1440,2014/03/31,2012/05/31,19,28,1.4296336,42440,19,8,20
1441,2014/03/31,2005/10/03,7,56,0.6985944609999999,86835,7,12,44
1442,2014/03/31,2006/01/12,11,75,0.765996564,79162,11,22,53
1443,2014/03/31,2012/09/20,86,7,1.03,58856,86,3,4
1444,2014/03/31,2011/01/30,62,74,0.795091028,76240,62,41,33
1445,2014/03/31,2006/04/28,7,45,0.831767281,72869,7,26,19
1446,2014/03/31,2007/08/08,11,47,0.742864272,81560,11,17,30
1447,2014/03/31,2011/05/23,4,53,0.8563897490000001,70743,4,33,20
1448,2014/03/31,2013/03/09,23,8,0.6982588240000001,86723,23,2,6
1449,2014/03/31,2010/01/03,2,67,0.827588903,73170,2,24,43
1450,2014/03/31,2006/09/12,5,77,0.6821544740000001,88662,5,38,39
1451,2014/03/31,2004/12/15,1,68,0.733065548,82504,1,26,42
1452,2014/03/31,2011/04/24,15,57,0.904841119,66811,15,33,24
1453,2014/03/31,2008/04/25,4,40,1.1763480309999998,51323,4,14,26
1454,2014/03/31,2011/08/10,40,45,0.718592062,83981,40,21,24
1455,2014/03/31,2006/06/13,16,62,0.7610923740000001,79286,16,29,33
1456,2014/03/31,2010/06/03,13,57,0.848845753,71068,13,37,20
1457,2014/03/31,2010/11/10,34,57,0.682957351,88302,34,27,30
1458,2014/03/31,2007/02/18,10,77,0.638324741,94463,10,50,27
1459,2014/03/31,2006/03/30,2,28,0.8288306529999999,72750,2,4,24
1460,2014/03/31,2006/06/02,12,40,0.7255,83080,12,23,17
1461,2014/03/31,2010/08/31,356,7,0.964329669,62499,356,6,1
1462,2014/03/31,2005/04/05,5,61,0.70780913,85126,5,34,27
1463,2014/03/31,2006/06/08,7,50,0.843246266,71439,7,20,30
1464,2014/03/31,2007/06/05,3,41,0.813431276,74057,3,20,21
1465,2014/03/31,2009/07/16,53,28,1.318700298,45672,53,21,7
1466,2014/03/31,2012/12/06,1,41,0.752799695,79948,1,9,32
1467,2014/03/31,2011/07/09,1,57,0.735845138,81750,1,22,35
1468,2014/03/31,2005/09/09,6,40,1.3677514730000002,43971,6,16,24
1469,2014/03/31,2004/12/17,102,50,0.940822029,63915,102,23,27
1470,2014/03/31,2008/02/25,121,11,0.847978647,70903,121,7,4
1471,2014/03/31,2012/11/08,34,11,0.8037045359999999,74784,34,4,7
1472,2014/03/31,2011/02/19,10,45,0.797246285,75360,10,25,20
1473,2014/03/31,2006/04/16,50,32,0.650243543,92386,50,16,16
1474,2014/03/31,2007/12/13,12,55,0.6570854070000001,91409,12,23,32
1475,2014/03/31,2008/03/14,37,62,0.7565587009999999,79377,37,29,33
1476,2014/03/31,2010/06/22,36,38,1.103523099,54418,36,15,23
1477,2014/03/31,2004/11/01,34,33,1.4394261330000002,41717,34,16,17
1478,2014/03/31,2007/05/24,5,44,0.775820541,77388,5,20,24
1479,2014/03/31,2012/04/01,12,75,0.796333055,75387,12,21,54
1480,2014/03/31,2011/04/18,5,80,1.28204356,46786,5,45,35
1481,2014/03/31,2012/01/12,14,31,0.7122166409999999,84213,14,16,15
1482,2014/03/31,2008/04/05,22,55,0.630205895,95097,22,24,31
1483,2014/03/31,2011/08/26,9,54,0.8496850709999999,70492,9,26,28
1484,2014/03/31,2007/07/31,188,15,0.763890008,78406,188,7,8
1485,2014/03/31,2006/03/03,6,69,0.741118979,80779,6,39,30
1486,2014/03/31,2009/12/21,41,18,0.786949543,76005,41,7,11
1487,2014/03/31,2012/01/15,53,10,0.67362121,88788,53,4,6
1488,2014/03/31,2011/09/04,6,62,0.62216469,96120,6,34,28
1489,2014/03/31,2012/06/20,4,48,0.6605712420000001,90522,4,18,30
1490,2014/03/31,2009/08/18,69,9,0.799971357,74714,69,5,4
1491,2014/03/31,2004/11/19,41,63,0.705565817,84674,41,38,25
1492,2014/03/31,2011/07/08,417,11,0.8136363640000001,73370,417,11,0
1493,2014/03/31,2005/04/01,21,61,0.661176809,90278,21,21,40
1494,2014/03/31,2012/04/09,21,55,0.782083399,76308,21,19,36
1495,2014/03/31,2012/08/11,3,29,0.77862069,76647,3,12,17
1496,2014/03/31,2006/11/29,4,46,0.7840008409999999,76109,4,17,29
1497,2014/03/31,2012/02/09,8,21,0.8158812670000001,73122,8,9,12
1498,2014/03/31,2010/03/23,6,61,0.6402187810000001,93107,6,20,41
1499,2014/03/31,2007/09/07,46,30,0.562647556,105909,46,12,18
1500,2014/03/31,2006/09/09,58,43,0.753221316,79095,58,28,15
1501,2014/03/31,2011/03/04,193,7,0.695714286,85624,193,3,4
1502,2014/03/31,2006/04/03,4,81,0.722041608,82484,4,34,47
1503,2014/03/31,2005/11/04,42,31,1.202572115,49504,42,13,18
1504,2014/03/31,2009/04/15,16,56,0.749712487,79405,16,35,21
1505,2014/03/31,2007/06/17,20,44,1.425675443,41743,20,19,25
1506,2014/03/31,2008/01/14,5,30,1.396327945,42562,5,2,28
1507,2014/03/31,2006/12/12,2,65,0.813006213,73072,2,29,36
1508,2014/03/31,2011/03/09,57,10,0.781935522,75964,57,7,3
1509,2014/03/31,2011/12/04,18,59,0.700848186,84722,18,28,31
1510,2014/03/31,2008/01/17,103,35,1.390304003,42697,103,27,8
1511,2014/03/31,2004/11/05,7,42,0.903884675,65658,7,22,20
1512,2014/03/31,2009/09/28,15,60,0.72681964,81648,15,33,27
1513,2014/03/31,2007/07/18,201,47,0.654768847,90546,201,31,16
1514,2014/03/31,2007/07/21,3,81,0.757902455,78220,3,28,53
1515,2014/03/31,2006/04/01,4,62,0.861806234,68784,4,38,24
1516,2014/03/31,2009/06/26,4,45,0.757046909,78301,4,24,21
1517,2014/03/31,2012/01/06,46,42,0.97947718,60518,46,22,20
1518,2014/03/31,2006/12/31,62,42,0.694923947,85269,62,22,20
1519,2014/03/31,2012/09/22,199,7,1.103162482,53692,199,2,5
1520,2014/03/31,2007/02/08,25,49,0.8127250770000001,72864,25,30,19
1521,2014/03/31,2010/03/20,2,64,0.581049186,101898,2,29,35
1522,2014/03/31,2011/07/25,7,29,1.437351185,41192,7,13,16
1523,2014/03/31,2008/04/23,8,27,1.290050145,45867,8,4,23
1524,2014/03/31,2006/03/01,26,33,0.8227040109999999,71908,26,14,19
1525,2014/03/31,2007/06/20,17,60,0.7107645340000001,83201,17,28,32
1526,2014/03/31,2006/10/20,5,71,0.797750121,74124,5,42,29
1527,2014/03/31,2006/11/29,3,45,0.7247199000000001,81578,3,14,31
1528,2014/03/31,2011/06/29,14,40,0.918675888,64345,14,21,19
1529,2014/03/31,2009/03/09,11,48,0.755420703,78250,11,19,29
1530,2014/03/31,2009/06/27,13,68,0.78270324,75428,13,35,33
1531,2014/03/31,2006/04/11,1,91,0.809087268,72913,1,24,67
1532,2014/03/31,2005/06/16,279,30,0.8859158229999999,66574,279,24,6
1533,2014/03/31,2011/12/22,4,55,0.815335316,72305,4,24,31
1534,2014/03/31,2006/04/16,33,61,0.72922268,80829,33,26,35
1535,2014/03/31,2006/01/22,68,31,1.12996375,52138,68,15,16
1536,2014/03/31,2006/04/27,2,85,0.7656638929999999,76910,2,29,56
1537,2014/03/31,2006/07/01,22,76,0.7351777620000001,80079,22,35,41
1538,2014/03/31,2011/09/01,4,65,0.7356728509999999,79988,4,29,36
1539,2014/03/31,2007/11/22,2,68,0.733140507,80245,2,33,35
1540,2014/03/31,2012/01/16,19,109,0.705422615,83362,19,53,56
1541,2014/03/31,2006/04/25,15,90,0.921863543,63771,15,33,57
1542,2014/03/31,2006/12/22,9,41,0.701363897,83804,9,16,25
1543,2014/03/31,2011/10/05,146,67,0.67426218,87169,146,53,14
1544,2014/03/31,2008/04/09,25,57,0.8114199259999999,72377,25,33,24
1545,2014/03/31,2011/01/14,266,7,0.685714286,85624,266,5,2
1546,2014/03/31,2009/08/27,9,32,1.266520342,46358,9,16,16
1547,2014/03/31,2012/01/04,62,47,0.670796435,87515,62,29,18
1548,2014/03/31,2007/07/19,38,33,1.161700178,50530,38,22,11
1549,2014/03/31,2010/08/12,26,49,0.7488319529999999,78353,26,26,23
1550,2014/03/31,2012/08/04,2,67,0.60650106,96735,2,19,48
1551,2014/03/31,2012/07/08,10,54,0.746956605,78534,10,21,33
1552,2014/03/31,2009/01/06,11,16,0.720098386,81414,11,4,12
1553,2014/03/31,2011/08/15,22,51,0.7369657270000001,79538,22,0,51
1554,2014/03/31,2013/03/24,31,17,0.616385003,95007,31,1,16
1555,2014/03/31,2007/06/17,41,82,0.8413657529999999,69588,41,47,35
1556,2014/03/31,2009/09/29,18,39,0.847488528,69083,18,22,17
1557,2014/03/31,2012/04/14,23,41,0.856000731,68390,23,38,3
1558,2014/03/31,2012/03/25,7,56,0.631503441,92694,7,30,26
1559,2014/03/31,2010/07/26,10,24,0.5980096460000001,97867,10,6,18
1560,2014/03/31,2006/07/27,5,37,1.39931441,41818,5,20,17
1561,2014/03/31,2008/01/12,14,39,0.703076923,83226,14,24,15
1562,2014/03/31,2011/11/20,38,65,0.654886518,89309,38,33,32
1563,2014/03/31,2009/11/04,16,27,1.257314572,46514,16,9,18
1564,2014/03/31,2008/09/06,18,64,0.73549656,79497,18,32,32
1565,2014/03/31,2012/12/03,6,29,0.850526308,68743,6,4,25
1566,2014/03/31,2009/07/03,9,34,0.684334083,85416,9,15,19
1567,2014/03/31,2007/08/16,68,46,0.799320392,73101,68,24,22
1568,2014/03/31,2011/09/18,16,38,1.066140706,54795,16,20,18
1569,2014/03/31,2006/10/22,20,43,0.777458963,75115,20,23,20
1570,2014/03/31,2011/09/29,6,52,0.84672592,68969,6,24,28
1571,2014/03/31,2007/07/15,18,57,0.77384858,75446,18,31,26
1572,2014/03/31,2006/08/01,16,47,0.884623079,65982,16,34,13
1573,2014/03/31,2007/09/14,26,21,1.29325585,45128,26,12,9
1574,2014/03/31,2010/05/07,14,47,0.916174522,63694,14,25,22
1575,2014/03/31,2007/06/29,15,45,0.781728347,74632,15,22,23
1576,2014/03/31,2007/07/06,1,35,0.914372012,63799,1,19,16
1577,2014/03/31,2010/05/24,6,80,0.792120532,73557,6,33,47
1578,2014/03/31,2007/12/30,18,18,0.7207040809999999,80843,18,8,10
1579,2014/03/31,2008/12/06,38,20,1.092643137,53323,38,12,8
1580,2014/03/31,2008/06/16,30,56,0.781062934,74586,30,28,28
1581,2014/03/31,2005/09/26,4,49,0.792537449,73499,4,23,26
1582,2014/03/31,2009/10/24,17,68,0.765782596,76061,17,37,31
1583,2014/03/31,2009/11/19,77,6,0.793333333,73392,77,4,2
1584,2014/03/31,2009/08/16,2,54,0.455938643,127679,2,24,30
1585,2014/03/31,2010/11/29,40,21,0.858095238,67830,40,8,13
1586,2014/03/31,2006/12/26,4,49,0.908325581,64070,4,0,49
1587,2014/03/31,2006/06/01,2,68,0.668273676,87081,2,21,47
1588,2014/03/31,2005/02/03,13,70,0.6820233090000001,85202,13,18,52
1589,2014/03/31,2008/01/28,20,36,0.816660666,71104,20,20,16
1590,2014/03/31,2010/04/15,11,25,1.33482149,43499,11,0,25
1591,2014/03/31,2005/06/22,13,64,0.8517359520000001,68124,13,26,38
1592,2014/03/31,2005/03/23,1,51,0.829807172,69907,1,27,24
1593,2014/03/31,2009/06/24,26,53,0.691750662,83854,26,19,34
1594,2014/03/31,2010/01/17,1,37,0.746388928,77711,1,11,26
1595,2014/03/31,2008/10/22,38,33,1.382889239,41928,38,13,20
1596,2014/03/31,2007/02/01,6,22,1.239995509,46757,6,14,8
1597,2014/03/31,2012/05/02,30,41,0.719569433,80545,30,19,22
1598,2014/03/31,2012/04/16,5,66,0.629454002,92015,5,21,45
1599,2014/03/31,2010/07/27,1,90,0.616375817,93966,1,38,52
1600,2014/03/31,2006/06/30,5,63,0.8170829159999999,70879,5,24,39
1601,2014/03/31,2007/05/10,23,35,1.035714465,55902,23,15,20
1602,2014/03/31,2007/06/25,3,35,0.679067812,85251,3,14,21
1603,2014/03/31,2008/08/05,70,17,1.246928896,46397,70,9,8
1604,2014/03/31,2004/12/29,68,41,0.829597085,69717,68,27,14
1605,2014/03/31,2009/01/30,6,64,0.792919598,72921,6,30,34
1606,2014/03/31,2011/11/01,8,54,0.905549064,63845,8,21,33
1607,2014/03/31,2012/04/28,7,50,0.6893688720000001,83834,7,22,28
1608,2014/03/31,2008/01/09,12,47,0.910236936,63477,12,25,22
1609,2014/03/31,2008/04/01,121,12,0.768661248,75167,121,2,10
1610,2014/03/31,2006/10/10,1,55,0.678248304,85186,1,23,32
1611,2014/03/31,2008/02/09,59,26,1.489189977,38789,59,21,5
1612,2014/03/31,2013/03/28,12,14,0.560795287,102944,12,1,13
1613,2014/03/31,2006/02/15,50,21,1.332436401,43318,50,11,10
1614,2014/03/31,2012/01/25,1,76,0.7892203870000001,73126,1,37,39
1615,2014/03/31,2005/06/19,5,29,1.40125003,41143,5,17,12
1616,2014/03/31,2007/04/17,23,32,0.685331899,84122,23,19,13
1617,2014/03/31,2007/11/14,43,54,0.775025209,74377,43,27,27
1618,2014/03/31,2008/03/09,12,32,1.033650432,55766,12,15,17
1619,2014/03/31,2008/08/15,3,72,0.8958609809999999,64322,3,33,39
1620,2014/03/31,2010/07/08,44,37,0.751621995,76634,44,18,19
1621,2014/03/31,2010/04/25,7,31,0.702903226,81933,7,15,16
1622,2014/03/31,2009/04/01,4,31,0.782758532,73550,4,13,18
1623,2014/03/31,2005/01/10,25,55,0.7808144109999999,73722,25,15,40
1624,2014/03/31,2008/03/09,11,40,0.7030596109999999,81847,11,19,21
1625,2014/03/31,2007/07/13,57,34,1.263444269,45522,57,11,23
1626,2014/03/31,2010/12/27,77,5,0.94,61160,77,0,5
1627,2014/03/31,2010/01/19,132,18,0.5413759260000001,106154,132,11,7
1628,2014/03/31,2010/04/27,11,60,0.6685619829999999,85903,11,31,29
1629,2014/03/31,2006/05/15,1,81,0.789687105,72708,1,31,50
1630,2014/03/31,2011/02/20,19,63,0.789229257,72722,19,30,33
1631,2014/03/31,2010/05/08,5,53,0.7688294640000001,74641,5,20,33
1632,2014/03/31,2008/10/22,4,50,0.8351948640000001,68689,4,23,27
1633,2014/03/31,2007/07/07,12,32,1.413034834,40592,12,9,23
1634,2014/03/31,2007/03/08,3,59,0.818839029,70019,3,25,34
1635,2014/03/31,2005/02/03,2,38,1.066208436,53772,2,19,19
1636,2014/03/31,2005/10/12,3,76,0.780757266,73422,3,30,46
1637,2014/03/31,2006/04/03,5,98,0.7507427790000001,76335,5,33,65
1638,2014/03/31,2006/10/10,14,41,0.7251879370000001,79016,14,24,17
1639,2014/03/31,2008/03/28,22,37,0.928196103,61733,22,25,12
1640,2014/03/31,2010/05/28,21,44,1.3188620359999998,43446,21,18,26
1641,2014/03/31,2012/05/22,7,27,0.754722131,75917,7,15,12
1642,2014/03/31,2008/02/06,8,62,0.744064886,76996,8,44,18
1643,2014/03/31,2007/07/17,48,46,0.879509078,65102,48,16,30
1644,2014/03/31,2011/11/18,7,55,0.690070392,82964,7,26,29
1645,2014/03/31,2006/07/10,261,8,0.653613956,87591,261,6,2
1646,2014/03/31,2010/03/15,4,63,0.827563155,69155,4,22,41
1647,2014/03/31,2012/05/09,7,57,0.64904609,88153,7,25,32
1648,2014/03/31,2006/08/18,2,40,0.857412992,66718,2,22,18
1649,2014/03/31,2007/07/11,78,24,0.7431023720000001,76925,78,13,11
1650,2014/03/31,2008/09/14,8,57,0.7432098509999999,76907,8,22,35
1651,2014/03/31,2008/07/29,83,34,0.7996450709999999,71479,83,11,23
1652,2014/03/31,2010/12/13,14,69,0.7888588459999999,72453,14,21,48
1653,2014/03/31,2006/06/01,13,63,0.68333764,83598,13,24,39
1654,2014/03/31,2012/07/21,101,44,0.6989859009999999,81708,101,10,34
1655,2014/03/31,2011/09/25,5,49,0.629715288,90688,5,23,26
1656,2014/03/31,2012/04/13,20,59,0.7218104000000001,79093,20,25,34
1657,2014/03/31,2009/11/26,20,29,0.744482759,76647,20,19,10
1658,2014/03/31,2009/01/18,7,63,0.7853258909999999,72647,7,27,36
1659,2014/03/31,2011/04/24,8,55,0.753726208,75656,8,22,33
1660,2014/03/31,2007/08/03,28,41,0.8447689340000001,67470,28,16,25
1661,2014/03/31,2008/02/27,15,62,0.620526385,91815,15,34,28
1662,2014/03/31,2009/11/04,10,71,0.839344559,67878,10,38,33
1663,2014/03/31,2005/07/05,74,59,0.765892499,74381,74,28,31
1664,2014/03/31,2008/03/06,2,95,0.744784633,76451,2,48,47
1665,2014/03/31,2005/03/24,4,47,0.87572589,65003,4,28,19
1666,2014/03/31,2008/11/20,26,20,1.405455668,40490,26,11,9
1667,2014/03/31,2012/01/06,3,71,0.741266105,76763,3,35,36
1668,2014/03/31,2007/10/17,147,10,0.744669809,76380,147,8,2
1669,2014/03/31,2008/08/02,6,89,0.676331985,84070,6,30,59
1670,2014/03/31,2011/12/28,13,45,0.822271805,68998,13,19,26
1671,2014/03/31,2005/08/07,9,41,0.90209948,62887,9,17,24
1672,2014/03/31,2004/11/17,17,69,0.615404159,92179,17,25,44
1673,2014/03/31,2011/06/01,24,68,0.8177601720000001,69358,24,18,50
1674,2014/03/31,2006/04/25,12,45,0.7622874390000001,74402,12,26,19
1675,2014/03/31,2005/01/28,78,24,1.427256713,39737,78,9,15
1676,2014/03/31,2009/08/06,11,56,0.666922235,85000,11,22,34
1677,2014/03/31,2006/04/13,20,57,0.679352175,83433,20,19,38
1678,2014/03/31,2012/07/09,5,48,0.75562074,74967,5,14,34
1679,2014/03/31,2012/06/02,23,32,1.173499337,48252,23,14,18
1680,2014/03/31,2007/09/08,3,51,0.733756545,77156,3,17,34
1681,2014/03/31,2008/03/30,57,25,1.289499613,43886,57,11,14
1682,2014/03/31,2005/01/29,4,39,0.899042217,62937,4,11,28
1683,2014/03/31,2005/10/24,23,35,0.609367723,92839,23,15,20
1684,2014/03/31,2010/10/19,1,96,0.6964122420000001,81229,1,34,62
1685,2014/03/31,2005/07/14,21,46,0.7012313590000001,80667,21,33,13
1686,2014/03/31,2010/04/09,3,73,0.760014926,74367,3,23,50
1687,2014/03/31,2011/03/01,18,72,0.827066485,68331,18,32,40
1688,2014/03/31,2009/01/02,146,58,0.8799842729999999,64221,146,39,19
1689,2014/03/31,2005/03/10,20,44,0.658901819,85760,20,16,28
1690,2014/03/31,2004/11/25,1,45,0.6533965620000001,86458,1,27,18
1691,2014/03/31,2008/05/01,19,66,0.68432585,82541,19,15,51
1692,2014/03/31,2006/08/20,36,42,0.7081476090000001,79751,36,17,25
1693,2014/03/31,2010/05/11,16,59,0.703297965,80298,16,36,23
1694,2014/03/31,2010/10/08,33,51,0.694876512,81263,33,26,25
1695,2014/03/31,2008/10/09,14,39,0.85130128,66327,14,17,22
1696,2014/03/31,2005/11/09,12,31,1.4606835530000002,38651,12,21,10
1697,2014/03/31,2006/11/01,6,60,0.670326922,84179,6,27,33
1698,2014/03/31,2009/08/10,187,45,0.809556576,69685,187,27,18
1699,2014/03/31,2010/08/18,9,62,0.8836951040000001,63825,9,26,36
1700,2014/03/31,2013/02/05,29,44,0.822996438,68508,29,6,38
1701,2014/03/31,2006/01/18,6,64,0.861653518,65406,6,27,37
1702,2014/03/31,2009/09/16,1,53,0.74474178,75672,1,24,29
1703,2014/03/31,2010/02/06,15,59,0.750699837,75046,15,19,40
1704,2014/03/31,2008/06/28,2,44,0.635538005,88633,2,16,28
1705,2014/03/31,2007/01/17,9,63,0.6864893759999999,82031,9,38,25
1706,2014/03/31,2011/06/27,55,28,0.715280646,78729,55,20,8
1707,2014/03/31,2009/03/10,2,55,0.806595233,69808,2,25,30
1708,2014/03/31,2010/07/28,8,43,0.751682244,74894,8,21,22
1709,2014/03/31,2006/09/22,1,97,0.6804539909999999,82733,1,45,52
1710,2014/03/31,2005/11/30,27,16,0.913205432,61636,27,4,12
1711,2014/03/31,2010/02/13,21,65,0.561892348,100156,21,31,34
1712,2014/03/31,2012/04/01,163,6,0.7666666670000001,73392,163,3,3
1713,2014/03/31,2010/10/18,4,74,0.7804754970000001,72093,4,24,50
1714,2014/03/31,2009/09/19,1,44,0.916820974,61371,1,26,18
1715,2014/03/31,2009/01/28,12,18,1.204624545,46690,12,3,15
1716,2014/03/31,2010/11/24,12,61,0.789186732,71268,12,10,51
1717,2014/03/31,2007/06/15,18,61,0.674546305,83349,18,39,22
1718,2014/03/31,2007/03/25,3,48,1.086691474,51733,3,26,22
1719,2014/03/31,2009/09/07,27,39,0.91878564,61168,27,17,22
1720,2014/03/31,2009/10/30,109,29,0.834418311,67347,109,15,14
1721,2014/03/31,2010/04/19,32,40,0.78941964,71180,32,28,12
1722,2014/03/31,2011/04/01,6,69,0.786237092,71466,6,22,47
1723,2014/03/31,2006/12/21,68,56,0.7158533570000001,78490,68,35,21
1724,2014/03/31,2011/06/02,8,47,0.736197903,76300,8,15,32
1725,2014/03/31,2012/08/09,65,46,0.588578374,95433,65,14,32
1726,2014/03/31,2010/04/01,14,56,0.8460531109999999,66389,14,25,31
1727,2014/03/31,2006/06/28,1,31,0.745776785,75246,1,9,22
1728,2014/03/31,2006/08/01,5,15,0.696142575,80603,5,5,10
1729,2014/03/31,2007/09/22,2,51,0.7908898659999999,70932,2,28,23
1730,2014/03/31,2009/03/01,7,70,0.936210085,59909,7,45,25
1731,2014/03/31,2008/03/17,48,72,0.745592995,75203,48,40,32
1732,2014/03/31,2007/03/17,11,36,0.6974686440000001,80368,11,18,18
1733,2014/03/31,2011/01/13,1,63,0.810884583,69106,1,34,29
1734,2014/03/31,2008/06/20,5,85,0.900294406,62227,5,34,51
1735,2014/03/31,2007/05/09,1,72,0.7048075640000001,79481,1,35,37
1736,2014/03/31,2012/05/01,288,30,0.7046278220000001,79478,288,29,1
1737,2014/03/31,2012/10/15,4,76,0.526315789,106400,4,9,67
1738,2014/03/31,2007/04/16,354,21,1.4171977830000002,39508,354,17,4
1739,2014/03/31,2005/06/02,2,59,0.6969155779999999,80323,2,9,50
1740,2014/03/31,2006/09/06,3,56,0.7312887509999999,76547,3,20,36
1741,2014/03/31,2011/11/17,8,50,0.691065881,80994,8,14,36
1742,2014/03/31,2012/09/19,1,50,0.673498189,83103,1,10,40
1743,2014/03/31,2005/02/03,11,69,0.73099919,76532,11,28,41
1744,2014/03/31,2011/10/22,413,54,0.7060800909999999,79160,413,54,0
1745,2014/03/31,2011/12/31,19,58,0.891100783,62719,19,25,33
1746,2014/03/31,2006/07/14,1,51,0.7586946720000001,73629,1,18,33
1747,2014/03/31,2011/10/01,9,61,0.808590805,69082,9,30,31
1748,2014/03/31,2006/10/04,13,50,1.000959697,55778,13,27,23
1749,2014/03/31,2010/05/19,34,47,0.765313366,72918,34,19,28
1750,2014/03/31,2011/11/15,405,8,0.6502144320000001,85808,405,8,0
1751,2014/03/31,2007/09/11,9,72,0.6914398140000001,80691,9,41,31
1752,2014/03/31,2012/01/02,4,70,0.654763812,85144,4,26,44
1753,2014/03/31,2010/09/20,5,64,0.77303722,72112,5,29,35
1754,2014/03/31,2006/03/29,4,49,0.610603192,91281,4,21,28
1755,2014/03/31,2011/05/14,22,34,1.107902722,50289,22,13,21
1756,2014/03/31,2012/02/19,25,38,0.8721916690000001,63860,25,9,29
1757,2014/03/31,2006/09/16,24,21,0.710221633,78418,24,13,8
1758,2014/03/31,2012/11/14,17,64,0.6437068420000001,86513,17,15,49
1759,2014/03/31,2006/06/22,1,77,0.75117501,74127,1,33,44
1760,2014/03/31,2009/09/24,2,104,0.658278039,84578,2,60,44
1761,2014/03/31,2007/09/22,6,44,0.696777175,79843,6,18,26
1762,2014/03/31,2010/12/07,67,83,0.7932300999999999,70100,67,42,41
1763,2014/03/31,2009/08/07,91,6,0.890073638,62468,91,2,4
1764,2014/03/31,2007/06/10,16,81,0.733546437,75769,16,39,42
1765,2014/03/31,2012/06/20,27,38,0.921759447,60286,27,15,23
1766,2014/03/31,2008/08/09,23,71,0.588499682,94420,23,28,43
1767,2014/03/31,2005/06/20,26,33,0.8662906140000001,64140,26,15,18
1768,2014/03/31,2007/06/11,33,54,0.801744144,69289,33,27,27
1769,2014/03/31,2012/12/28,59,9,0.995776395,55777,59,2,7
1770,2014/03/31,2006/11/13,1,43,0.7789986809999999,71266,1,13,30
1771,2014/03/31,2010/11/07,49,47,0.860040125,64549,49,26,21
1772,2014/03/31,2010/09/11,25,28,1.462118738,37966,25,15,13
1773,2014/03/31,2011/03/19,17,42,0.774258973,71691,17,17,25
1774,2014/03/31,2008/11/10,9,58,0.7847278,70720,9,18,40
1775,2014/03/31,2005/08/27,97,29,1.369818325,40512,97,2,27
1776,2014/03/31,2010/05/17,10,52,0.79788701,69546,10,27,25
1777,2014/03/31,2007/03/05,2,63,0.68665899,80760,2,32,31
1778,2014/03/31,2005/11/12,7,78,0.8683429140000001,63841,7,47,31
1779,2014/03/31,2009/08/06,2,174,0.8046627279999999,68891,2,86,88
1780,2014/03/31,2012/02/06,10,67,0.755922506,73322,10,30,37
1781,2014/03/31,2010/02/18,15,53,0.782651358,70809,15,29,24
1782,2014/03/31,2008/06/06,5,71,0.763069772,72608,5,29,42
1783,2014/03/31,2008/10/18,2,41,0.76296529,72573,2,27,14
1784,2014/03/31,2006/03/05,6,52,0.84519101,65494,6,25,27
1785,2014/03/31,2006/04/07,76,36,0.920092086,60161,76,24,12
1786,2014/03/31,2011/11/10,18,50,0.669776269,82644,18,22,28
1787,2014/03/31,2010/02/25,58,39,0.922404515,59983,58,13,26
1788,2014/03/31,2006/10/11,56,21,1.3836584630000002,39984,56,11,10
1789,2014/03/31,2006/05/10,12,47,0.656885256,84222,12,26,21
1790,2014/03/31,2007/03/06,16,20,1.282584796,43133,16,7,13
1791,2014/03/31,2005/08/22,33,51,0.71721018,77134,33,19,32
1792,2014/03/31,2007/03/01,1,53,0.80343253,68853,1,27,26
1793,2014/03/31,2012/10/09,1,49,0.6809546259999999,81236,1,12,37
1794,2014/03/31,2005/10/18,37,50,0.647232636,85464,37,16,34
1795,2014/03/31,2008/01/16,7,32,1.433378189,38568,7,18,14
1796,2014/03/31,2004/11/25,39,30,0.6901676840000001,80091,39,14,16
1797,2014/03/31,2007/06/20,66,32,1.392156512,39703,66,17,15
1798,2014/03/31,2012/11/21,22,61,0.632155683,87434,22,10,51
1799,2014/03/31,2012/03/07,9,46,0.773761061,71424,9,11,35
1800,2014/03/31,2007/11/22,3,72,0.720287692,76714,3,24,48
1801,2014/03/31,2008/01/23,8,28,1.393130141,39634,8,23,5
1802,2014/03/31,2006/06/21,3,30,0.6699134720000001,82401,3,15,15
1803,2014/03/31,2012/03/25,5,39,1.09740768,50287,5,19,20
1804,2014/03/31,2008/01/07,16,27,1.326618262,41594,16,15,12
1805,2014/03/31,2006/05/01,114,24,1.387523137,39764,114,13,11
1806,2014/03/31,2011/03/29,93,7,0.644285714,85624,93,3,4
1807,2014/03/31,2010/03/18,5,30,0.6749196190000001,81736,5,16,14
1808,2014/03/31,2007/05/15,6,46,0.860966287,64070,6,23,23
1809,2014/03/31,2013/03/18,9,12,0.7894326979999999,69857,9,0,12
1810,2014/03/31,2008/01/18,2,36,1.431433133,38524,2,20,16
1811,2014/03/31,2011/06/08,5,49,0.602134012,91574,5,27,22
1812,2014/03/31,2012/03/19,16,66,0.740179108,74480,16,33,33
1813,2014/03/31,2009/12/02,11,64,0.52925853,104131,11,33,31
1814,2014/03/31,2009/01/31,6,42,0.767894568,71762,6,20,22
1815,2014/03/31,2006/03/17,5,62,0.882587295,62432,5,32,30
1816,2014/03/31,2006/04/07,59,31,0.8215737340000001,67038,59,16,15
1817,2014/03/31,2006/05/21,14,53,0.668129095,82420,14,25,28
1818,2014/03/31,2012/04/06,9,47,0.969595237,56774,9,18,29
1819,2014/03/31,2006/03/02,36,28,1.187985195,46337,36,17,11
1820,2014/03/31,2010/01/20,70,35,0.8939330609999999,61578,70,17,18
1821,2014/03/31,2010/01/31,24,68,0.719430812,76495,24,33,35
1822,2014/03/31,2012/08/02,5,52,0.7068114320000001,77850,5,21,31
1823,2014/03/31,2009/04/24,2,95,0.881219028,62435,2,35,60
1824,2014/03/31,2011/11/10,12,55,0.8902412409999999,61764,12,17,38
1825,2014/03/31,2007/10/11,18,66,0.7853382090000001,70001,18,28,38
1826,2014/03/31,2005/12/04,38,85,0.70946456,77413,38,47,38
1827,2014/03/31,2011/02/15,22,63,0.805492023,68137,22,41,22
1828,2014/03/31,2008/04/18,6,60,0.605253641,90640,6,31,29
1829,2014/03/31,2010/10/16,146,12,0.647776046,84678,146,6,6
1830,2014/03/31,2008/03/13,4,53,0.775084089,70758,4,28,25
1831,2014/03/31,2007/10/03,90,29,1.259702597,43510,90,14,15
1832,2014/03/31,2009/11/17,6,22,1.4296281119999998,38318,6,14,8
1833,2014/03/31,2006/11/01,2,72,0.763005823,71784,2,37,35
1834,2014/03/31,2008/08/05,31,34,1.165268501,46983,31,21,13
1835,2014/03/31,2008/07/13,1,76,0.825049832,66323,1,32,44
1836,2014/03/31,2007/01/11,11,68,0.650000713,84174,11,37,31
1837,2014/03/31,2008/11/27,38,47,0.7097193970000001,77084,38,20,27
1838,2014/03/31,2005/12/06,18,55,0.7860591690000001,69597,18,27,28
1839,2014/03/31,2012/06/22,81,6,0.745,73392,81,4,2
1840,2014/03/31,2011/07/21,10,46,0.887718318,61573,10,25,21
1841,2014/03/31,2006/05/12,65,39,0.7555741290000001,72327,65,13,26
1842,2014/03/31,2007/04/05,60,43,0.909902756,60055,60,22,21
1843,2014/03/31,2008/01/09,1,24,0.834027209,65492,1,11,13
1844,2014/03/31,2004/12/03,34,53,0.908051939,60147,34,31,22
1845,2014/03/31,2006/11/14,67,43,0.853737827,63973,67,26,17
1846,2014/03/31,2009/05/30,4,62,0.748585825,72933,4,33,29
1847,2014/03/31,2012/01/01,280,6,1.01873068,53572,280,4,2
1848,2014/03/31,2009/09/25,10,114,0.659096267,82801,10,49,65
1849,2014/03/31,2011/05/24,14,61,0.847582907,64379,14,25,36
1850,2014/03/31,2007/02/27,12,52,0.841186428,64867,12,15,37
1851,2014/03/31,2009/09/14,18,44,0.7912877209999999,68928,18,6,38
1852,2014/03/31,2006/03/15,25,54,0.712893598,76493,25,24,30
1853,2014/03/31,2011/07/05,85,12,0.717172452,76027,85,9,3
1854,2014/03/31,2005/11/25,154,25,0.837251478,65115,154,17,8
1855,2014/03/31,2012/05/25,27,29,0.676881744,80529,27,17,12
1856,2014/03/31,2011/10/04,143,31,0.7623522090000001,71469,143,18,13
1857,2014/03/31,2012/01/12,6,43,0.723608336,75284,6,17,26
1858,2014/03/31,2009/07/16,16,52,0.7358636479999999,74029,16,24,28
1859,2014/03/31,2007/01/01,95,23,1.3597593730000002,40062,95,14,9
1860,2014/03/31,2005/08/17,15,59,0.887042682,61407,15,31,28
1861,2014/03/31,2009/01/22,24,56,0.8110976520000001,67116,24,24,32
1862,2014/03/31,2006/01/19,2,43,0.991978607,54877,2,21,22
1863,2014/03/31,2005/02/24,4,27,0.7949893379999999,68470,4,12,15
1864,2014/03/31,2007/05/28,7,69,0.720937467,75480,7,29,40
1865,2014/03/31,2010/11/04,2,77,0.954623243,56973,2,37,40
1866,2014/03/31,2010/06/07,25,45,0.6787525590000001,80124,25,31,14
1867,2014/03/31,2006/10/05,1,63,0.788672461,68917,1,32,31
1868,2014/03/31,2005/01/27,151,24,0.94360082,57573,151,18,6
1869,2014/03/31,2007/10/21,8,38,0.691248759,78590,8,19,19
1870,2014/03/31,2007/02/18,15,54,0.686011189,79184,15,32,22
1871,2014/03/31,2005/09/07,1,85,0.688358603,78884,1,41,44
1872,2014/03/31,2012/07/01,13,22,0.74724304,72667,13,9,13
1873,2014/03/31,2008/08/23,21,24,0.75735059,71665,21,13,11
1874,2014/03/31,2011/12/21,13,49,0.689859543,78672,13,19,30
1875,2014/03/31,2010/12/19,102,25,0.7638668129999999,71043,102,17,8
1876,2014/03/31,2006/10/06,21,45,0.8271630640000001,65606,21,27,18
1877,2014/03/31,2011/05/02,141,24,0.589396079,92065,141,16,8
1878,2014/03/31,2005/05/02,8,24,1.315569295,41244,8,8,16
1879,2014/03/31,2011/10/21,6,8,0.943893568,57464,6,4,4
1880,2014/03/31,2011/03/27,2,43,0.778118265,69691,2,21,22
1881,2014/03/31,2006/06/13,2,63,0.703105622,77086,2,35,28
1882,2014/03/31,2007/09/07,2,101,0.771874733,70218,2,40,61
1883,2014/03/31,2012/01/10,214,9,0.963410541,56255,214,4,5
1884,2014/03/31,2011/03/21,9,48,0.7921053790000001,68401,9,24,24
1885,2014/03/31,2009/09/06,3,47,0.6795917909999999,79714,3,16,31
1886,2014/03/31,2007/07/26,209,24,1.38845239,39015,209,20,4
1887,2014/03/31,2006/05/26,8,47,0.651815085,83087,8,14,33
1888,2014/03/31,2008/03/02,78,18,0.8026457029999999,67449,78,9,9
1889,2014/03/31,2005/10/01,6,57,0.807451712,67045,6,24,33
1890,2014/03/31,2006/11/15,4,49,0.7588668959999999,71335,4,14,35
1891,2014/03/31,2009/11/19,14,48,0.828175793,65327,14,19,29
1892,2014/03/31,2007/08/05,26,36,1.213644929,44577,26,23,13
1893,2014/03/31,2006/05/09,15,35,0.751002611,72002,15,19,16
1894,2014/03/31,2005/07/27,17,45,0.88209039,61290,17,26,19
1895,2014/03/31,2005/11/27,2,48,0.873503329,61884,2,25,23
1896,2014/03/31,2012/12/07,8,47,0.8313004820000001,64999,8,12,35
1897,2014/03/31,2006/03/02,12,53,0.962406477,56136,12,26,27
1898,2014/03/31,2006/05/24,2,50,0.765735307,70542,2,18,32
1899,2014/03/31,2005/04/17,11,50,1.343804121,40188,11,35,15
1900,2014/03/31,2006/10/08,18,36,0.7036102679999999,76745,18,11,25
1901,2014/03/31,2006/08/15,33,55,0.839766382,64293,33,34,21
1902,2014/03/31,2008/03/30,61,88,0.843317815,64009,61,60,28
1903,2014/03/31,2004/12/24,3,25,0.753411178,71638,3,7,18
1904,2014/03/31,2006/09/09,14,50,0.810333358,66595,14,22,28
1905,2014/03/31,2012/07/12,63,45,0.642080755,84032,63,13,32
1906,2014/03/31,2005/05/12,217,88,0.916207119,58884,217,50,38
1907,2014/03/31,2012/07/20,72,27,0.755925926,71361,72,9,18
1908,2014/03/31,2010/01/19,3,36,0.784099895,68792,3,7,29
1909,2014/03/31,2008/02/08,110,24,1.3443943740000002,40099,110,12,12
1910,2014/03/31,2005/01/08,151,31,0.893380583,60318,151,18,13
1911,2014/03/31,2006/03/06,19,39,0.954449702,56424,19,24,15
1912,2014/03/31,2006/06/19,4,49,0.762378363,70620,4,14,35
1913,2014/03/31,2008/05/28,39,55,0.809717115,66458,39,30,25
1914,2014/03/31,2005/03/28,39,23,1.357985564,39624,39,10,13
1915,2014/03/31,2009/08/03,8,65,0.5659443670000001,95016,8,41,24
1916,2014/03/31,2006/01/19,7,57,0.607900707,88425,7,24,33
1917,2014/03/31,2006/10/27,1,36,0.734755382,73155,1,21,15
1918,2014/03/31,2007/11/16,34,37,0.702855947,76465,34,7,30
1919,2014/03/31,2010/11/03,18,62,0.694175763,77411,18,31,31
1920,2014/03/31,2007/10/25,2,53,0.68290022,78663,2,31,22
1921,2014/03/31,2012/05/29,3,53,0.6725996940000001,79844,3,27,26
1922,2014/03/31,2006/03/31,6,51,0.84746394,63366,6,20,31
1923,2014/03/31,2011/01/27,50,33,0.841622821,63784,50,17,16
1924,2014/03/31,2012/12/12,7,40,0.7939857379999999,67591,7,15,25
1925,2014/03/31,2012/02/14,31,37,1.3904574790000002,38581,31,8,29
1926,2014/03/31,2010/04/17,31,28,1.441935328,37203,31,10,18
1927,2014/03/31,2010/10/26,1,69,0.635778747,84347,1,33,36
1928,2014/03/31,2008/10/03,74,28,0.716789507,74758,74,18,10
1929,2014/03/31,2009/11/02,13,56,0.762727415,70246,13,25,31
1930,2014/03/31,2012/01/26,2,45,0.857958778,62443,2,10,35
1931,2014/03/31,2006/02/24,2,71,0.889184815,60244,2,25,46
1932,2014/03/31,2011/05/31,6,45,0.724737975,73867,6,25,20
1933,2014/03/31,2010/05/09,7,29,0.7218597090000001,74146,7,13,16
1934,2014/03/31,2007/10/30,24,80,0.911581735,58714,24,40,40
1935,2014/03/31,2007/02/16,5,30,1.371430256,39021,5,13,17
1936,2014/03/31,2010/06/04,6,50,0.668378817,80065,6,17,33
1937,2014/03/31,2006/06/08,35,43,0.906853714,58987,35,12,31
1938,2014/03/31,2010/12/09,17,9,1.049346687,50971,17,1,8
1939,2014/03/31,2012/01/25,10,53,0.757081523,70643,10,21,32
1940,2014/03/31,2012/08/14,68,44,0.8181297740000001,65329,68,18,26
1941,2014/03/31,2006/12/05,34,34,0.848396908,62997,34,24,10
1942,2014/03/31,2008/01/20,34,50,0.848128502,63003,34,25,25
1943,2014/03/31,2005/03/12,13,66,1.272723613,41981,13,24,42
1944,2014/03/31,2010/01/10,5,56,0.656791063,81326,5,10,46
1945,2014/03/31,2012/05/19,37,26,0.812536266,65695,37,14,12
1946,2014/03/31,2007/12/09,7,78,0.7459395440000001,71556,7,47,31
1947,2014/03/31,2010/07/02,11,27,0.747777778,71361,11,15,12
1948,2014/03/31,2006/03/26,49,34,0.742669701,71847,49,27,7
1949,2014/03/31,2012/11/28,2,19,1.368311149,38991,2,6,13
1950,2014/03/31,2007/03/05,6,48,0.914743489,58282,6,16,32
1951,2014/03/31,2004/12/21,11,45,1.378929246,38655,11,20,25
1952,2014/03/31,2005/02/09,4,75,0.637296725,83606,4,42,33
1953,2014/03/31,2012/10/26,18,31,0.6722451070000001,79239,18,2,29
1954,2014/03/31,2010/09/23,31,53,0.721889408,73785,31,30,23
1955,2014/03/31,2007/10/11,3,21,1.453219548,36648,3,10,11
1956,2014/03/31,2007/08/16,47,19,0.908637628,58589,47,10,9
1957,2014/03/31,2007/04/29,8,28,0.636567257,83627,8,16,12
1958,2014/03/31,2008/07/17,20,52,0.690345883,77107,20,25,27
1959,2014/03/31,2011/10/12,83,49,0.734195222,72492,83,31,18
1960,2014/03/31,2008/07/15,108,56,0.672366087,79156,108,26,30
1961,2014/03/31,2008/05/28,62,47,0.7159164179999999,74322,62,25,22
1962,2014/03/31,2006/01/05,19,70,0.837163874,63555,19,27,43
1963,2014/03/31,2011/07/31,10,45,0.6511346379999999,81656,10,10,35
1964,2014/03/31,2005/10/08,1,38,1.318885057,40307,1,20,18
1965,2014/03/31,2007/04/23,13,55,0.819298148,64857,13,30,25
1966,2014/03/31,2009/04/24,2,68,0.773164275,68714,2,29,39
1967,2014/03/31,2006/06/30,2,40,0.92916639,57173,2,9,31
1968,2014/03/31,2008/03/12,34,51,0.7188818790000001,73865,34,21,30
1969,2014/03/31,2010/10/17,7,48,0.7481792820000001,70972,7,16,32
1970,2014/03/31,2008/05/15,90,6,0.723333333,73392,90,2,4
1971,2014/03/31,2007/06/28,22,35,1.336175841,39729,22,19,16
1972,2014/03/31,2010/12/18,2,42,0.699951868,75833,2,15,27
1973,2014/03/31,2010/01/08,244,26,0.778251195,68178,244,19,7
1974,2014/03/31,2007/08/15,11,44,0.914250116,58029,11,23,21
1975,2014/03/31,2010/03/28,97,40,0.912895403,58099,97,17,23
1976,2014/03/31,2005/09/09,4,80,0.8720413029999999,60819,4,34,46
1977,2014/03/31,2009/01/23,2,61,0.560379117,94641,2,32,29
1978,2014/03/31,2012/01/13,60,31,1.382930715,38349,60,14,17
1979,2014/03/31,2007/05/26,22,36,0.77778575,68154,22,16,20
1980,2014/03/31,2011/09/03,1,56,0.818160925,64788,1,24,32
1981,2014/03/31,2007/06/25,153,15,0.68137689,77784,153,10,5
1982,2014/03/31,2010/06/23,19,82,0.716978125,73921,19,42,40
1983,2014/03/31,2012/04/18,44,20,0.902687165,58705,44,13,7
1984,2014/03/31,2010/06/30,21,56,0.675712445,78399,21,15,41
1985,2014/03/31,2005/05/24,1,25,1.406549307,37662,1,9,16
1986,2014/03/31,2009/06/17,15,49,0.782873803,67656,15,32,17
1987,2014/03/31,2010/11/20,27,49,0.707764519,74834,27,21,28
1988,2014/03/31,2009/04/22,82,43,0.983912203,53829,82,26,17
1989,2014/03/31,2011/03/28,5,62,0.800625699,66150,5,26,36
1990,2014/03/31,2012/03/14,194,19,0.8707730779999999,60783,194,14,5
1991,2014/03/31,2008/04/24,17,45,0.744562453,71078,17,25,20
1992,2014/03/31,2008/09/23,130,43,0.8218548440000001,64372,130,23,20
1993,2014/03/31,2007/03/29,314,29,1.452817752,36412,314,23,6
1994,2014/03/31,2012/06/12,4,63,0.652203891,81102,4,31,32
1995,2014/03/31,2009/03/14,13,46,0.99180976,53322,13,16,30
1996,2014/03/31,2008/10/23,4,48,0.68187255,77552,4,18,30
1997,2014/03/31,2005/11/07,55,35,0.915299841,57764,55,16,19
1998,2014/03/31,2005/06/18,12,42,0.737411458,71689,12,19,23
1999,2014/03/31,2011/06/11,46,20,0.818,64600,46,13,7
2000,2014/03/31,2008/04/30,59,55,0.8928179340000001,59171,59,36,19
2001,2014/03/31,2011/03/17,59,29,0.859254217,61479,59,9,20
2002,2014/03/31,2010/01/20,5,42,0.7060913240000001,74767,5,10,32
2003,2014/03/31,2011/04/25,13,28,0.8167194729999999,64639,13,12,16
2004,2014/03/31,2007/10/30,151,46,0.7800974279999999,67640,151,29,17
2005,2014/03/31,2006/10/31,30,49,0.802753678,65723,30,37,12
2006,2014/03/31,2005/09/13,13,57,0.714524987,73819,13,31,26
2007,2014/03/31,2009/03/20,1,82,0.89987375,58614,1,37,45
2008,2014/03/31,2010/08/21,88,29,0.6796229429999999,77601,88,19,10
2009,2014/03/31,2005/04/05,32,52,0.747067285,70566,32,19,33
2010,2014/03/31,2007/03/01,32,29,1.468002396,35893,32,14,15
2011,2014/03/31,2008/03/19,23,35,0.971369805,54234,23,17,18
2012,2014/03/31,2012/08/07,20,52,0.762866391,69052,20,25,27
2013,2014/03/31,2007/08/01,32,67,0.641917414,82048,32,39,28
2014,2014/03/31,2006/01/09,283,19,0.7758892159999999,67880,283,16,3
2015,2014/03/31,2007/01/11,64,36,0.817238259,64434,64,16,20
2016,2014/03/31,2006/10/16,11,36,0.819461058,64237,11,14,22
2017,2014/03/31,2010/12/02,21,49,0.753950723,69810,21,25,24
2018,2014/03/31,2008/08/15,1,22,1.323486723,39768,1,10,12
2019,2014/03/31,2007/06/26,2,54,0.761393458,69123,2,23,31
2020,2014/03/31,2012/03/09,94,19,1.210662188,43462,94,11,8
2021,2014/03/31,2005/02/12,5,48,0.72545531,72522,5,28,20
2022,2014/03/31,2010/02/24,24,63,0.748315087,70241,24,26,37
2023,2014/03/31,2011/04/10,23,44,0.7479286740000001,70269,23,19,25
2024,2014/03/31,2010/10/15,70,34,0.8449199359999999,62200,70,16,18
2025,2014/03/31,2011/09/05,67,32,1.186242043,44298,67,17,15
2026,2014/03/31,2005/07/20,293,13,1.005550006,52254,293,10,3
2027,2014/03/31,2004/11/25,44,41,0.753241244,69751,44,18,23
2028,2014/03/31,2008/04/19,31,56,0.786896278,66736,31,32,24
2029,2014/03/31,2006/03/01,13,45,0.638975445,82182,13,20,25
2030,2014/03/31,2005/06/09,2,51,0.671176441,78236,2,23,28
2031,2014/03/31,2009/12/24,2,47,0.842580096,62300,2,22,25
2032,2014/03/31,2012/11/04,9,48,1.093051455,48023,9,14,34
2033,2014/03/31,2008/04/23,3,72,0.75271387,69727,3,22,50
2034,2014/03/31,2010/07/06,34,57,0.6787286370000001,77295,34,31,26
2035,2014/03/31,2007/06/27,20,26,1.385577213,37863,20,10,16
2036,2014/03/31,2009/01/19,86,27,1.348791073,38894,86,15,12
2037,2014/03/31,2006/04/17,27,41,0.8368193859999999,62686,27,19,22
2038,2014/03/31,2006/03/29,8,72,0.906908446,57835,8,38,34
2039,2014/03/31,2006/04/01,12,68,0.817871803,64120,12,40,28
2040,2014/03/31,2004/12/04,11,74,0.8345716009999999,62827,11,33,41
2041,2014/03/31,2007/07/15,1,49,0.6937529109999999,75576,1,22,27
2042,2014/03/31,2006/10/23,39,46,0.870313595,60237,39,16,30
2043,2014/03/31,2005/04/28,3,44,0.743063837,70539,3,16,28
2044,2014/03/31,2007/05/29,26,54,0.954376013,54913,26,26,28
2045,2014/03/31,2007/01/09,4,46,0.806643365,64946,4,25,21
2046,2014/03/31,2007/02/13,2,54,0.735079646,71253,2,31,23
2047,2014/03/31,2004/11/11,3,58,0.783947912,66810,3,33,25
2048,2014/03/31,2011/08/20,16,42,0.750047872,69770,16,21,21
2049,2014/03/31,2009/03/30,39,39,0.858228124,60958,39,16,23
2050,2014/03/31,2007/03/05,3,16,1.106824396,47254,3,10,6
2051,2014/03/31,2011/09/30,1,55,0.80317141,65113,1,40,15
2052,2014/03/31,2006/11/30,37,37,0.972195808,53716,37,22,15
2053,2014/03/31,2006/10/16,4,51,0.8018683390000001,65122,4,25,26
2054,2014/03/31,2011/06/24,3,63,0.719675218,72541,3,22,41
2055,2014/03/31,2006/12/27,12,69,0.7664703979999999,68104,12,26,43
2056,2014/03/31,2011/10/12,3,46,0.660163275,79069,3,14,32
2057,2014/03/31,2005/10/31,40,70,0.698464854,74716,40,36,34
2058,2014/03/31,2008/09/21,5,34,0.786851503,66311,5,14,20
2059,2014/03/31,2008/09/01,19,27,0.7792551240000001,66897,19,15,12
2060,2014/03/31,2010/07/07,5,22,0.932533944,55901,5,7,15
2061,2014/03/31,2010/06/20,32,64,0.648725078,80350,32,32,32
2062,2014/03/31,2007/03/07,11,77,0.723545579,72039,11,39,38
2063,2014/03/31,2010/05/09,38,45,0.7222562229999999,72156,38,25,20
2064,2014/03/31,2012/03/13,156,24,1.209802679,43077,156,11,13
2065,2014/03/31,2011/08/19,31,67,0.777202726,67051,31,37,30
2066,2014/03/31,2011/12/26,96,34,0.611359866,85229,96,16,18
2067,2014/03/31,2007/11/11,32,52,0.7621654840000001,68345,32,29,23
2068,2014/03/31,2010/08/19,11,71,0.60493508,86106,11,32,39
2069,2014/03/31,2008/01/22,5,34,1.080389322,48212,5,21,13
2070,2014/03/31,2008/11/11,12,28,0.657000795,79281,12,12,16
2071,2014/03/31,2012/06/18,1,21,0.8094870759999999,64337,1,5,16
2072,2014/03/31,2005/07/23,4,24,0.8094311470000001,64340,4,12,12
2073,2014/03/31,2007/08/01,10,58,0.670858733,77626,10,14,44
2074,2014/03/31,2008/01/07,18,73,0.6673156729999999,78027,18,33,40
2075,2014/03/31,2007/02/22,12,44,0.887773647,58643,12,22,22
2076,2014/03/31,2010/08/16,32,40,0.760788115,68353,32,29,11
2077,2014/03/31,2011/11/06,4,84,0.763973225,68048,4,31,53
2078,2014/03/31,2009/02/09,102,31,0.517901029,100373,102,15,16
2079,2014/03/31,2011/12/06,20,56,0.7581415229999999,68540,20,19,37
2080,2014/03/31,2011/03/06,63,46,0.6495670929999999,79994,63,34,12
2081,2014/03/31,2006/10/09,13,45,1.2000067,43281,13,22,23
2082,2014/03/31,2005/01/11,18,42,0.937671488,55383,18,18,24
2083,2014/03/31,2012/12/26,87,5,1.019951469,50895,87,2,3
2084,2014/03/31,2005/09/23,25,41,0.654149336,79338,25,21,20
2085,2014/03/31,2011/04/17,11,75,0.8106862779999999,64012,11,35,40
2086,2014/03/31,2006/03/01,8,55,0.656156434,79075,8,28,27
2087,2014/03/31,2010/11/21,2,38,0.7125466579999999,72817,2,27,11
2088,2014/03/31,2011/03/07,1,58,0.681298295,76146,1,32,26
2089,2014/03/31,2009/09/12,1,64,0.668124509,77633,1,20,44
2090,2014/03/31,2010/09/20,35,50,0.590458406,87826,35,27,23
2091,2014/03/31,2008/05/10,66,39,0.729428338,71091,66,26,13
2092,2014/03/31,2013/03/12,2,65,0.69095287,75026,2,0,65
2093,2014/03/31,2008/05/12,118,69,0.570273169,90823,118,36,33
2094,2014/03/31,2006/12/26,18,62,0.7271142070000001,71204,18,36,26
2095,2014/03/31,2005/11/04,13,46,0.66311371,78058,13,25,21
2096,2014/03/31,2005/11/03,16,40,1.062421107,48705,16,16,24
2097,2014/03/31,2010/02/13,121,10,0.927492197,55746,121,5,5
2098,2014/03/31,2004/11/01,24,36,0.779253945,66349,24,19,17
2099,2014/03/31,2009/04/07,23,41,1.117744998,46235,23,38,3
2100,2014/03/31,2008/06/12,7,44,0.7202844279999999,71723,7,16,28
2101,2014/03/31,2010/09/23,1,34,0.912387983,56621,1,22,12
2102,2014/03/31,2004/12/30,7,32,0.694945145,74287,7,12,20
2103,2014/03/31,2011/08/29,13,56,0.684551314,75409,13,17,39
2104,2014/03/31,2011/07/11,20,41,0.7863225970000001,65636,20,21,20
2105,2014/03/31,2011/06/01,40,39,0.8646027540000001,59686,40,19,20
2106,2014/03/31,2009/01/03,10,53,0.695000202,74249,10,23,30
2107,2014/03/31,2007/11/29,27,66,0.7582707940000001,68037,27,22,44
2108,2014/03/31,2012/06/12,62,26,1.370714305,37631,62,5,21
2109,2014/03/31,2009/01/09,62,39,0.783891236,65794,62,20,19
2110,2014/03/31,2005/12/14,7,76,0.816826807,63132,7,23,53
2111,2014/03/31,2008/05/19,13,45,0.667262208,77263,13,26,19
2112,2014/03/31,2006/12/03,93,37,0.982461263,52469,93,14,23
2113,2014/03/31,2011/04/14,7,72,0.704958083,73121,7,26,46
2114,2014/03/31,2006/08/24,31,53,0.690445874,74640,31,26,27
2115,2014/03/31,2011/03/20,41,39,0.800816602,64352,41,24,15
2116,2014/03/31,2008/11/20,107,35,1.118377463,46076,107,24,11
2117,2014/03/31,2007/03/14,3,76,0.682545411,75477,3,28,48
2118,2014/03/31,2010/08/27,31,40,0.809896025,63573,31,21,19
2119,2014/03/31,2012/09/12,1,58,0.5984795470000001,86027,1,16,42
2120,2014/03/31,2011/04/14,1,42,0.7738453909999999,66529,1,12,30
2121,2014/03/31,2012/11/02,49,33,0.738067083,69734,49,10,23
2122,2014/03/31,2007/03/06,9,59,0.7359304940000001,69893,9,32,27
2123,2014/03/31,2008/10/17,111,26,1.296921254,39659,111,11,15
2124,2014/03/31,2010/01/19,9,42,0.7265254059999999,70791,9,22,20
2125,2014/03/31,2011/01/19,14,33,0.74590177,68920,14,16,17
2126,2014/03/31,2007/08/08,1,70,0.8228040790000001,62459,1,34,36
2127,2014/03/31,2011/04/01,3,44,0.786177362,65358,3,14,30
2128,2014/03/31,2004/11/28,9,60,0.525715616,97713,9,39,21
2129,2014/03/31,2009/06/20,63,36,0.8457190179999999,60680,63,17,19
2130,2014/03/31,2012/10/19,5,60,0.6858344140000001,74825,5,18,42
2131,2014/03/31,2012/01/01,2,43,0.740439407,69298,2,21,22
2132,2014/03/31,2005/03/27,69,61,0.717274049,71531,69,39,22
2133,2014/03/31,2009/11/10,6,54,0.845511462,60679,6,26,28
2134,2014/03/31,2010/10/06,16,20,0.8338073640000001,61515,16,7,13
2135,2014/03/31,2011/05/11,9,80,0.755703256,67870,9,43,37
2136,2014/03/31,2012/04/25,170,8,0.980220226,52310,170,6,2
2137,2014/03/31,2009/07/13,11,66,0.861908373,59480,11,20,46
2138,2014/03/31,2007/10/12,86,5,1.015233256,50481,86,3,2
2139,2014/03/31,2011/07/19,39,15,0.741636774,69081,39,3,12
2140,2014/03/31,2012/03/15,4,45,0.460557709,111205,4,22,23
2141,2014/03/31,2009/11/16,32,24,1.251077754,40937,32,13,11
2142,2014/03/31,2005/09/28,126,37,0.8684074829999999,58957,126,17,20
2143,2014/03/31,2011/10/27,151,41,0.743698915,68831,151,24,17
2144,2014/03/31,2012/04/16,158,6,0.992950489,51544,158,2,4
2145,2014/03/31,2012/12/07,5,23,1.432148434,35733,5,5,18
2146,2014/03/31,2009/01/01,40,32,0.782574344,65372,40,20,12
2147,2014/03/31,2008/03/05,30,5,0.92993238,55013,30,2,3
2148,2014/03/31,2009/08/16,319,72,0.562365059,90966,319,64,8
2149,2014/03/31,2007/10/14,18,75,0.77504826,65997,18,34,41
2150,2014/03/31,2011/08/01,35,26,0.946324994,54038,35,11,15
2151,2014/03/31,2009/10/21,67,4,1.045,48928,67,0,4
2152,2014/03/31,2009/10/21,39,39,0.7079183179999999,72182,39,20,19
2153,2014/03/31,2005/04/17,136,39,0.90452725,56478,136,35,4
2154,2014/03/31,2010/05/18,3,30,0.614307618,83155,3,15,15
2155,2014/03/31,2007/04/09,16,21,1.176802202,43408,16,9,12
2156,2014/03/31,2012/05/23,21,73,0.832736343,61341,21,18,55
2157,2014/03/31,2007/06/20,36,36,0.930500383,54878,36,24,12
2158,2014/03/31,2008/01/17,8,41,0.7116057090000001,71744,8,18,23
2159,2014/03/31,2010/12/04,2,54,0.8185618929999999,62325,2,14,40
2160,2014/03/31,2008/06/25,14,72,0.8679024679999999,58750,14,39,33
2161,2014/03/31,2010/10/24,13,25,0.958813441,53179,13,10,15
2162,2014/03/31,2012/08/22,19,48,0.671169351,75931,19,12,36
2163,2014/03/31,2010/01/12,3,31,1.033152399,49318,3,12,19
2164,2014/03/31,2011/07/10,31,28,0.644642857,79016,31,17,11
2165,2014/03/31,2005/12/30,3,70,0.71046989,71655,3,34,36
2166,2014/03/31,2006/04/12,13,36,0.7310109859999999,69635,13,27,9
2167,2014/03/31,2012/09/21,138,20,1.306759012,38948,138,7,13
2168,2014/03/31,2012/04/02,20,42,0.625529935,81359,20,10,32
2169,2014/03/31,2004/11/13,2,47,0.804304228,63275,2,26,21
2170,2014/03/31,2006/06/09,258,4,1.04,48928,258,2,2
2171,2014/03/31,2008/10/24,27,78,0.824487527,61691,27,34,44
2172,2014/03/31,2004/12/20,131,16,0.6882352540000001,73903,131,11,5
2173,2014/03/31,2006/04/18,63,27,0.703860742,72240,63,11,16
2174,2014/03/31,2005/07/03,19,53,0.80251401,63349,19,27,26
2175,2014/03/31,2008/03/08,15,52,0.666775184,76209,15,25,27
2176,2014/03/31,2010/10/22,40,21,1.049754525,48396,40,10,11
2177,2014/03/31,2005/07/02,66,54,0.735568592,69039,66,34,20
2178,2014/03/31,2007/07/22,6,31,0.788709677,64387,6,19,12
2179,2014/03/31,2006/11/20,18,27,0.6832123390000001,74301,18,11,16
2180,2014/03/31,2005/08/09,15,44,0.7025769609999999,72244,15,20,24
2181,2014/03/31,2008/05/24,6,49,0.694149571,73116,6,24,25
2182,2014/03/31,2011/01/14,17,54,0.7764672579999999,65360,17,19,35
2183,2014/03/31,2005/09/15,17,38,0.7150509420000001,70963,17,26,12
2184,2014/03/31,2012/10/30,13,31,0.778791372,65140,13,9,22
2185,2014/03/31,2004/11/08,27,30,0.905490781,56023,27,14,16
2186,2014/03/31,2005/01/21,40,19,0.7943036840000001,63836,40,3,16
2187,2014/03/31,2012/03/27,43,36,1.460571527,34714,43,24,12
2188,2014/03/31,2007/07/26,16,28,1.098501473,46152,16,17,11
2189,2014/03/31,2012/01/24,4,69,0.7228426579999999,70121,4,27,42
2190,2014/03/31,2009/09/25,16,63,0.681498218,74355,16,27,36
2191,2014/03/31,2012/08/19,9,60,0.651002327,77799,9,12,48
2192,2014/03/31,2012/03/29,31,61,0.824465553,61428,31,25,36
2193,2014/03/31,2012/03/16,9,31,1.371955839,36910,9,12,19
2194,2014/03/31,2008/08/23,12,52,0.7147355559999999,70809,12,16,36
2195,2014/03/31,2010/05/05,7,34,1.215350022,41626,7,14,20
2196,2014/03/31,2008/01/08,1,27,0.984149445,51390,1,9,18
2197,2014/03/31,2008/04/13,7,42,0.702774055,71920,7,18,24
2198,2014/03/31,2011/06/14,6,50,0.690326978,73216,6,21,29
2199,2014/03/31,2012/03/28,6,40,0.896432487,56367,6,11,29
2200,2014/03/31,2007/03/21,146,19,0.8309826659999999,60804,146,11,8
2201,2014/03/31,2006/11/27,17,31,0.816110725,61901,17,10,21
2202,2014/03/31,2012/05/25,7,18,1.404529425,35956,7,10,8
2203,2014/03/31,2006/07/23,14,49,0.731013129,69083,14,20,29
2204,2014/03/31,2006/05/19,5,23,1.332791987,37887,5,6,17
2205,2014/03/31,2007/11/24,4,70,0.71282439,70833,4,32,38
2206,2014/03/31,2012/04/15,94,10,0.541591677,93191,94,7,3
2207,2014/03/31,2005/12/06,17,46,0.864927077,58349,17,29,17
2208,2014/03/31,2004/11/06,2,60,0.839483852,60099,2,35,25
2209,2014/03/31,2011/04/26,134,29,0.7917790440000001,63714,134,17,12
2210,2014/03/31,2012/03/15,33,39,0.743163426,67841,33,20,19
2211,2014/03/31,2009/04/02,6,56,0.731220008,68934,6,29,27
2212,2014/03/31,2012/06/30,4,62,0.68649037,73418,4,17,45
2213,2014/03/31,2012/04/21,18,24,0.6636279,75942,18,14,10
2214,2014/03/31,2008/01/27,34,48,0.851339449,59196,34,30,18
2215,2014/03/31,2011/12/04,202,6,0.686666667,73392,202,4,2
2216,2014/03/31,2012/01/27,403,4,1.03,48928,403,4,0
2217,2014/03/31,2005/10/08,30,24,1.309841183,38472,30,12,12
2218,2014/03/31,2009/04/30,8,59,0.646664656,77920,8,28,31
2219,2014/03/31,2010/11/19,3,73,0.843651067,59725,3,44,29
2220,2014/03/31,2007/08/03,6,27,0.63883175,78853,6,10,17
2221,2014/03/31,2011/03/19,26,52,1.136604711,44279,26,30,22
2222,2014/03/31,2006/08/11,13,30,0.956941174,52579,13,14,16
2223,2014/03/31,2006/08/16,59,8,0.662752076,75870,59,0,8
2224,2014/03/31,2007/10/26,59,48,0.7590225820000001,66246,59,20,28
2225,2014/03/31,2007/04/11,96,39,0.718097456,69980,96,21,18
2226,2014/03/31,2007/07/26,19,46,0.817299242,61442,19,30,16
2227,2014/03/31,2005/11/07,34,57,0.7032378029999999,71391,34,40,17
2228,2014/03/31,2008/12/20,5,63,0.664296683,75542,5,31,32
2229,2014/03/31,2009/08/04,10,13,1.111672798,45122,10,3,10
2230,2014/03/31,2011/11/14,69,80,0.7897170840000001,63517,69,37,43
2231,2014/03/31,2005/04/11,11,48,1.253854154,40001,11,14,34
2232,2014/03/31,2006/06/25,34,38,0.7808756170000001,64229,34,28,10
2233,2014/03/31,2007/04/22,28,55,0.843655664,59442,28,35,20
2234,2014/03/31,2009/01/27,32,48,0.68475141,73233,32,31,17
2235,2014/03/31,2009/06/25,34,47,0.703431963,71277,34,29,18
2236,2014/03/31,2009/01/06,69,14,0.7398881079999999,67744,69,9,5
2237,2014/03/31,2011/05/27,8,40,0.726904413,68953,8,16,24
2238,2014/03/31,2006/07/08,66,42,0.69738811,71856,66,14,28
2239,2014/03/31,2010/09/03,5,55,0.717866661,69792,5,19,36
2240,2014/03/31,2008/07/28,8,39,0.7648081090000001,65506,8,18,21
2241,2014/03/31,2009/03/02,34,60,0.714509328,70108,34,36,24
2242,2014/03/31,2007/03/19,1,37,0.723418118,69234,1,8,29
2243,2014/03/31,2009/03/26,33,45,0.7609555440000001,65795,33,29,16
2244,2014/03/31,2012/04/20,291,18,0.8611111109999999,58140,291,16,2
2245,2014/03/31,2007/06/17,2,45,0.98647162,50740,2,12,33
2246,2014/03/31,2011/10/26,18,33,0.7613023640000001,65742,18,16,17
2247,2014/03/31,2012/06/10,30,31,0.7496791009999999,66750,30,16,15
2248,2014/03/31,2007/01/05,26,25,0.8095486690000001,61795,26,10,15
2249,2014/03/31,2005/04/19,11,80,0.722001472,69279,11,45,35
2250,2014/03/31,2005/05/31,2,50,0.751283542,66558,2,23,27
2251,2014/03/31,2010/03/23,16,56,0.79376262,62996,16,30,26
2252,2014/03/31,2004/12/19,7,33,1.038886788,48122,7,21,12
2253,2014/03/31,2009/10/16,11,48,0.700609047,71341,11,25,23
2254,2014/03/31,2008/04/04,12,62,0.6777604209999999,73746,12,26,36
2255,2014/03/31,2011/03/06,55,26,0.634111774,78820,55,13,13
2256,2014/03/31,2010/05/19,17,53,0.767083231,65144,17,39,14
2257,2014/03/31,2006/08/26,1,20,1.329684306,37568,1,8,12
2258,2014/03/31,2007/05/11,30,34,1.252192492,39877,30,16,18
2259,2014/03/31,2010/09/11,5,42,0.656594802,76022,5,28,14
2260,2014/03/31,2008/01/04,5,55,0.783405795,63712,5,30,25
2261,2014/03/31,2012/02/15,49,41,0.646040264,77240,49,25,16
2262,2014/03/31,2006/05/08,39,46,0.623314013,80054,39,23,23
2263,2014/03/31,2008/05/14,12,55,0.574586069,86826,12,27,28
2264,2014/03/31,2005/11/06,60,23,1.171318588,42591,60,7,16
2265,2014/03/31,2009/02/13,43,41,0.781289272,63850,43,11,30
2266,2014/03/31,2008/07/19,16,52,0.73737235,67646,16,7,45
2267,2014/03/31,2011/08/10,42,38,0.817397004,61022,42,25,13
2268,2014/03/31,2011/04/01,126,19,0.980998761,50833,126,8,11
2269,2014/03/31,2006/03/28,75,46,0.76707385,64983,75,21,25
2270,2014/03/31,2012/06/26,8,63,0.6690377670000001,74483,8,18,45
2271,2014/03/31,2007/12/27,130,12,0.661214217,75349,130,4,8
2272,2014/03/31,2004/12/03,20,53,0.7616076340000001,65388,20,31,22
2273,2014/03/31,2007/08/12,13,39,0.841060348,59207,13,18,21
2274,2014/03/31,2005/03/21,2,42,0.757844999,65703,2,21,21
2275,2014/03/31,2007/01/26,7,6,0.678333333,73392,7,2,4
2276,2014/03/31,2007/07/29,12,20,1.34056892,37123,12,9,11
2277,2014/03/31,2009/10/07,19,44,0.7456051659999999,66742,19,14,30
2278,2014/03/31,2012/02/17,63,7,0.7710477840000001,64498,63,2,5
2279,2014/03/31,2005/03/25,76,21,0.738517055,67339,76,13,8
2280,2014/03/31,2006/09/18,6,56,0.796528438,62433,6,31,25
2281,2014/03/31,2007/05/29,4,35,0.761810647,65275,4,18,17
2282,2014/03/31,2006/12/04,8,30,1.064747263,46669,8,16,14
2283,2014/03/31,2011/10/29,84,20,0.77832422,63827,84,10,10
2284,2014/03/31,2011/02/26,34,6,0.676666667,73392,34,1,5
2285,2014/03/31,2005/10/07,114,45,0.775392616,64032,114,31,14
2286,2014/03/31,2005/08/13,1,38,1.064775028,46628,1,16,22
2287,2014/03/31,2009/09/30,11,35,0.860810764,57674,11,14,21
2288,2014/03/31,2009/01/07,83,42,0.889423528,55805,83,34,8
2289,2014/03/31,2011/04/24,4,74,0.6953326890000001,71373,4,41,33
2290,2014/03/31,2009/04/08,5,50,0.7043608159999999,70457,5,26,24
2291,2014/03/31,2011/07/16,36,37,0.606722787,81789,36,20,17
2292,2014/03/31,2011/09/20,75,42,0.721880965,68736,75,25,17
2293,2014/03/31,2009/10/13,43,39,0.664070401,74715,43,22,17
2294,2014/03/31,2007/05/15,5,44,0.7088151090000001,69998,5,19,25
2295,2014/03/31,2006/05/31,4,52,0.66677376,74390,4,26,26
2296,2014/03/31,2011/09/10,24,50,0.697566465,71090,24,16,34
2297,2014/03/31,2010/04/28,39,30,0.790226678,62688,39,16,14
2298,2014/03/31,2008/06/06,18,60,0.77486719,63926,18,34,26
2299,2014/03/31,2005/11/12,3,40,0.7237085529999999,68431,3,12,28
2300,2014/03/31,2010/10/20,35,48,0.673834048,73455,35,25,23
2301,2014/03/31,2005/10/28,31,42,0.715156833,69182,31,19,23
2302,2014/03/31,2008/11/04,4,30,0.711618745,69523,4,13,17
2303,2014/03/31,2006/12/26,59,24,0.7304166670000001,67728,59,14,10
2304,2014/03/31,2007/07/21,15,53,0.625088305,79101,15,23,30
2305,2014/03/31,2005/11/11,30,33,0.953053772,51867,30,16,17
2306,2014/03/31,2005/04/13,18,57,0.7237105909999999,68291,18,36,21
2307,2014/03/31,2007/12/02,8,46,0.630668955,78361,8,18,28
2308,2014/03/31,2009/09/13,83,38,0.759309259,65075,83,11,27
2309,2014/03/31,2006/11/03,10,41,0.7231698000000001,68304,10,20,21
2310,2014/03/31,2006/06/27,84,50,0.683592001,72255,84,23,27
2311,2014/03/31,2010/03/07,15,55,0.7142149109999999,69145,15,18,37
2312,2014/03/31,2006/10/11,2,72,0.682124579,72372,2,27,45
2313,2014/03/31,2007/06/27,73,30,1.25737471,39249,73,23,7
2314,2014/03/31,2006/02/04,29,51,1.006655583,49022,29,32,19
2315,2014/03/31,2012/01/12,37,37,0.823821045,59892,37,10,27
2316,2014/03/31,2011/10/08,14,22,0.696795893,70806,14,10,12
2317,2014/03/31,2009/01/17,19,39,0.765195595,64470,19,11,28
2318,2014/03/31,2011/05/23,22,27,0.752822587,65525,22,15,12
2319,2014/03/31,2008/09/17,33,38,0.971334725,50782,33,21,17
2320,2014/03/31,2007/08/02,14,46,0.96044402,51349,14,22,24
2321,2014/03/31,2007/12/17,8,64,0.696282596,70829,8,31,33
2322,2014/03/31,2013/02/04,4,52,0.655099568,75275,4,4,48
2323,2014/03/31,2011/06/08,19,62,0.776200681,63464,19,21,41
2324,2014/03/31,2010/09/20,147,39,0.698672388,70495,147,19,20
2325,2014/03/31,2008/10/16,33,53,0.7651404559999999,64362,33,24,29
2326,2014/03/31,2008/11/08,20,25,0.698,70550,20,13,12
2327,2014/03/31,2009/10/21,32,40,0.758355673,64908,32,21,19
2328,2014/03/31,2011/02/28,9,31,0.812386305,60579,9,1,30
2329,2014/03/31,2012/06/12,18,46,0.72254471,68106,18,27,19
2330,2014/03/31,2009/04/22,23,49,1.088652051,45202,23,23,26
2331,2014/03/31,2006/12/11,37,35,1.146472973,42920,37,21,14
2332,2014/03/31,2005/04/07,7,43,0.74954391,65623,7,23,20
2333,2014/03/31,2011/10/26,24,57,0.795606252,61806,24,22,35
2334,2014/03/31,2011/09/05,13,69,0.841010809,58468,13,33,36
2335,2014/03/31,2008/02/17,10,43,0.686400927,71624,10,17,26
2336,2014/03/31,2012/01/20,5,49,0.7289043270000001,67438,5,15,34
2337,2014/03/31,2012/06/26,39,46,0.768844517,63904,39,33,13
2338,2014/03/31,2011/04/28,37,54,0.640941589,76647,37,17,37
2339,2014/03/31,2011/09/26,87,42,0.646998867,75918,87,34,8
2340,2014/03/31,2010/11/28,33,30,0.8764319620000001,56042,33,16,14
2341,2014/03/31,2008/01/02,23,26,1.447624971,33928,23,12,14
2342,2014/03/31,2007/04/01,5,99,0.623999085,78698,5,49,50
2343,2014/03/31,2007/04/28,20,47,0.621666751,78992,20,19,28
2344,2014/03/31,2007/09/03,11,62,0.756509262,64886,11,37,25
2345,2014/03/31,2012/04/11,41,45,0.670862142,73155,41,20,25
2346,2014/03/31,2009/10/04,67,64,0.654643553,74962,67,40,24
2347,2014/03/31,2005/12/08,2,38,0.7856434440000001,62453,2,21,17
2348,2014/03/31,2010/03/02,5,73,0.8328990359999999,58892,5,25,48
2349,2014/03/31,2005/07/07,5,39,0.8075612209999999,60723,5,17,22
2350,2014/03/31,2010/12/24,44,18,0.89048489,55064,44,10,8
2351,2014/03/31,2012/07/13,2,22,0.806351107,60802,2,11,11
2352,2014/03/31,2010/02/08,2,39,0.91837072,53361,2,10,29
2353,2014/03/31,2005/09/29,12,54,0.78806627,62170,12,24,30
2354,2014/03/31,2011/04/07,14,35,0.731721007,66955,14,13,22
2355,2014/03/31,2011/10/23,37,50,1.255212412,39028,37,18,32
2356,2014/03/31,2006/09/20,6,39,0.849802717,57633,6,14,25
2357,2014/03/31,2005/11/30,2,32,0.7286829459999999,67203,2,13,19
2358,2014/03/31,2007/08/11,23,59,0.8406733390000001,58247,23,29,30
2359,2014/03/31,2008/09/04,14,26,1.316133473,37191,14,11,15
2360,2014/03/31,2012/02/18,9,59,0.7606894409999999,64342,9,24,35
2361,2014/03/31,2008/10/14,33,40,0.7168020559999999,68272,33,18,22
2362,2014/03/31,2008/06/27,12,23,1.4786925119999998,33094,12,14,9
2363,2014/03/31,2007/05/18,12,36,0.615612843,79482,12,19,17
2364,2014/03/31,2011/12/11,6,32,0.706966329,69200,6,12,20
2365,2014/03/31,2005/10/31,30,52,0.8265007520000001,59187,30,28,24
2366,2014/03/31,2012/11/25,55,22,0.779879443,62709,55,6,16
2367,2014/03/31,2012/01/09,37,20,0.82367273,59370,37,13,7
2368,2014/03/31,2010/09/29,27,32,1.486519426,32894,27,30,2
2369,2014/03/31,2007/11/25,70,46,0.7884798590000001,62014,70,30,16
2370,2014/03/31,2011/07/02,31,14,0.711088285,68732,31,4,10
2371,2014/03/31,2010/03/24,9,79,0.733657259,66610,9,40,39
2372,2014/03/31,2006/11/03,23,44,0.981059005,49792,23,22,22
2373,2014/03/31,2011/12/13,35,20,1.4695505009999998,33237,35,11,9
2374,2014/03/31,2011/04/19,11,53,0.866189767,56385,11,21,32
2375,2014/03/31,2007/08/23,40,59,0.896388517,54479,40,24,35
2376,2014/03/31,2008/08/09,3,51,0.711479722,68621,3,24,27
2377,2014/03/31,2008/07/29,21,87,0.7848756990000001,62188,21,30,57
2378,2014/03/31,2009/10/17,34,41,0.8084868559999999,60371,34,22,19
2379,2014/03/31,2007/12/10,5,35,1.077432507,45301,5,15,20
2380,2014/03/31,2012/01/20,2,73,0.848445078,57527,2,30,43
2381,2014/03/31,2006/05/01,2,28,0.654286232,74569,2,14,14
2382,2014/03/31,2008/11/22,59,31,1.333376442,36574,59,20,11
2383,2014/03/31,2011/09/16,13,20,0.934647512,52172,13,9,11
2384,2014/03/31,2005/05/27,98,42,0.69542251,70093,98,17,25
2385,2014/03/31,2009/10/14,12,38,0.722693922,67437,12,18,20
2386,2014/03/31,2011/01/06,152,8,0.897809385,54277,152,5,3
2387,2014/03/31,2011/11/10,199,5,0.950485463,51250,199,4,1
2388,2014/03/31,2010/01/07,7,54,1.022643557,47629,7,28,26
2389,2014/03/31,2009/09/04,33,66,0.60671202,80259,33,37,29
2390,2014/03/31,2005/11/18,24,35,0.8059700059999999,60412,24,20,15
2391,2014/03/31,2004/12/29,14,67,0.7403320809999999,65767,14,29,38
2392,2014/03/31,2008/10/27,125,6,0.663333333,73392,125,2,4
2393,2014/03/31,2004/12/18,56,6,0.663333333,73392,56,0,6
2394,2014/03/31,2006/06/24,45,46,0.724942967,67154,45,20,26
2395,2014/03/31,2011/12/10,9,57,0.746886431,65176,9,34,23
2396,2014/03/31,2010/11/23,58,41,1.461069981,33309,58,21,20
2397,2014/03/31,2013/03/25,367,4,1.135799645,42844,367,4,0
2398,2014/03/31,2009/01/05,6,48,0.74256127,65530,6,24,24
2399,2014/03/31,2010/04/15,3,71,0.75745636,64219,3,37,34
2400,2014/03/31,2008/05/23,6,38,0.904904748,53752,6,19,19
2401,2014/03/31,2013/03/01,17,14,1.014575285,47938,17,1,13
2402,2014/03/31,2009/10/14,9,36,0.684074783,71086,9,16,20
2403,2014/03/31,2009/10/20,105,24,0.7990079370000001,60853,105,11,13
2404,2014/03/31,2012/01/02,105,10,0.735854615,66059,105,5,5
2405,2014/03/31,2005/01/06,39,61,0.969567863,50123,39,43,18
2406,2014/03/31,2006/03/21,25,38,0.682880348,71165,25,20,18
2407,2014/03/31,2011/02/01,14,38,0.72410817,67098,14,25,13
2408,2014/03/31,2011/12/26,138,45,1.279919374,37953,138,32,13
2409,2014/03/31,2008/01/16,8,52,0.8472555690000001,57327,8,20,32
2410,2014/03/31,2005/07/26,21,50,0.830540591,58473,21,20,30
2411,2014/03/31,2005/07/31,135,49,0.971115645,49989,135,34,15
2412,2014/03/31,2010/04/16,75,25,0.677349443,71634,75,17,8
2413,2014/03/31,2007/02/05,194,22,1.457156374,33292,194,16,6
2414,2014/03/31,2006/11/01,14,37,0.748072603,64818,14,21,16
2415,2014/03/31,2008/03/05,8,60,0.685775413,70672,8,25,35
2416,2014/03/31,2009/10/16,80,56,0.588995187,82284,80,43,13
2417,2014/03/31,2011/05/27,80,7,0.7747996420000001,62538,80,3,4
2418,2014/03/31,2010/10/21,3,48,1.193269468,40606,3,9,39
2419,2014/03/31,2010/01/30,80,59,0.968302618,50030,80,39,20
2420,2014/03/31,2012/03/15,118,55,0.726079878,66702,118,33,22
2421,2014/03/31,2006/05/22,15,44,0.948618751,51048,15,19,25
2422,2014/03/31,2008/08/07,2,48,0.6969027609999999,69478,2,25,23
2423,2014/03/31,2011/03/29,24,42,0.887377112,54562,24,17,25
2424,2014/03/31,2010/04/26,21,56,0.713490627,67856,21,29,27
2425,2014/03/31,2011/01/28,12,33,0.7410467890000001,65314,12,14,19
2426,2014/03/31,2007/09/18,3,56,0.7448542220000001,64962,3,23,33
2427,2014/03/31,2012/09/22,3,23,0.8133471729999999,59489,3,5,18
2428,2014/03/31,2006/01/09,24,65,0.754613669,64116,24,42,23
2429,2014/03/31,2009/01/26,5,50,0.790610681,61194,5,24,26
2430,2014/03/31,2012/12/13,24,7,0.681428571,70952,24,3,4
2431,2014/03/31,2006/04/16,11,26,0.7902649820000001,61174,11,13,13
2432,2014/03/31,2006/07/20,15,45,0.754137651,64104,15,16,29
2433,2014/03/31,2011/01/04,18,49,0.703001265,68761,18,27,22
2434,2014/03/31,2007/09/12,2,45,0.947583279,51003,2,12,33
2435,2014/03/31,2008/09/04,16,69,0.7775044259999999,62134,16,12,57
2436,2014/03/31,2012/05/11,19,19,0.811631885,59514,19,7,12
2437,2014/03/31,2012/02/20,15,45,0.670756176,72007,15,16,29
2438,2014/03/31,2010/04/23,88,34,1.318610436,36623,88,25,9
2439,2014/03/31,2010/05/25,4,65,0.816271553,59156,4,32,33
2440,2014/03/31,2009/07/01,1,40,0.8978898329999999,53773,1,30,10
2441,2014/03/31,2007/08/27,109,32,0.7504944029999999,64320,109,13,19
2442,2014/03/31,2008/07/03,3,43,0.692856487,69652,3,15,28
2443,2014/03/31,2005/11/10,14,28,1.217062073,39647,14,12,16
2444,2014/03/31,2009/02/13,60,48,0.637128161,75725,60,29,19
2445,2014/03/31,2009/12/06,178,9,0.8441565459999999,57146,178,4,5
2446,2014/03/31,2007/08/29,141,36,0.819984355,58805,141,22,14
2447,2014/03/31,2012/02/11,26,55,0.7353266740000001,65570,26,33,22
2448,2014/03/31,2005/12/27,4,67,0.7135484059999999,67543,4,30,37
2449,2014/03/31,2011/04/06,8,19,0.514123659,93742,8,12,7
2450,2014/03/31,2008/02/07,22,31,1.447885153,33279,22,15,16
2451,2014/03/31,2009/01/03,204,12,0.955632909,50418,204,6,6
2452,2014/03/31,2007/07/18,4,67,0.8903366970000001,54114,4,32,35
2453,2014/03/31,2012/08/03,9,45,0.7259558209999999,66367,9,26,19
2454,2014/03/31,2008/03/04,33,17,0.955150289,50436,33,9,8
2455,2014/03/31,2005/04/06,28,47,0.779862231,61770,28,27,20
2456,2014/03/31,2013/02/11,11,9,0.72832983,66125,11,3,6
2457,2014/03/31,2008/08/09,17,52,0.7162865559999999,67226,17,32,20
2458,2014/03/31,2006/11/07,16,29,1.0995670240000002,43790,16,15,14
2459,2014/03/31,2006/02/14,12,40,1.020103849,47184,12,22,18
2460,2014/03/31,2004/12/04,4,53,0.612289891,78602,4,30,23
2461,2014/03/31,2008/01/07,6,29,0.698824401,68816,6,14,15
2462,2014/03/31,2007/07/13,21,26,0.7360867640000001,65327,21,10,16
2463,2014/03/31,2012/08/14,46,39,0.74243658,64767,46,13,26
2464,2014/03/31,2011/08/27,14,40,0.7384751959999999,65110,14,23,17
2465,2014/03/31,2012/02/08,10,66,0.427987679,112328,10,10,56
2466,2014/03/31,2012/12/30,122,49,0.792634713,60629,122,17,32
2467,2014/03/31,2005/12/01,4,59,0.7732966309999999,62121,4,28,31
2468,2014/03/31,2006/11/27,56,51,0.948414006,50637,56,21,30
2469,2014/03/31,2008/03/03,1,39,0.641605878,74850,1,13,26
2470,2014/03/31,2012/04/16,47,36,0.532407947,90193,47,20,16
2471,2014/03/31,2010/11/11,83,22,0.8167127740000001,58776,83,8,14
2472,2014/03/31,2012/07/08,16,23,0.789565217,60789,16,9,14
2473,2014/03/31,2012/07/11,22,57,0.6485211879999999,73958,22,15,42
2474,2014/03/31,2011/08/13,11,30,0.7812733140000001,61336,11,14,16
2475,2014/03/31,2011/02/07,112,20,0.775476121,61770,112,12,8
2476,2014/03/31,2006/09/21,244,9,0.8367280990000001,57245,244,7,2
2477,2014/03/31,2006/06/01,58,49,0.797296951,60047,58,21,28
2478,2014/03/31,2004/12/01,12,62,0.7218044309999999,66309,12,28,34
2479,2014/03/31,2008/08/23,41,34,0.724151749,66083,41,17,17
2480,2014/03/31,2005/04/03,12,35,0.728040683,65727,12,10,25
2481,2014/03/31,2008/02/01,32,33,0.802731513,59608,32,19,14
2482,2014/03/31,2012/07/08,12,73,0.723123658,66134,12,28,45
2483,2014/03/31,2008/07/29,35,7,0.702750937,68035,35,3,4
2484,2014/03/31,2011/11/13,13,36,0.7055571959999999,67741,13,16,20
2485,2014/03/31,2011/02/18,4,59,0.713847475,66953,4,19,40
2486,2014/03/31,2010/11/14,26,34,0.7895856529999999,60529,26,21,13
2487,2014/03/31,2012/04/15,28,21,1.435951136,33276,28,14,7
2488,2014/03/31,2012/08/23,1,39,0.799607538,59751,1,21,18
2489,2014/03/31,2009/07/02,20,29,0.7572113490000001,63052,20,17,12
2490,2014/03/31,2009/10/14,345,40,0.773243589,61731,345,36,4
2491,2014/03/31,2006/07/18,12,62,1.190853336,40078,12,26,36
2492,2014/03/31,2011/09/13,8,47,0.711044845,67120,8,27,20
2493,2014/03/31,2006/05/15,29,40,0.8365228290000001,57032,29,18,22
2494,2014/03/31,2005/04/15,184,5,0.78,61160,184,2,3
2495,2014/03/31,2005/09/17,43,32,0.7518853740000001,63441,43,18,14
2496,2014/03/31,2005/03/06,15,43,0.769031681,62025,15,22,21
2497,2014/03/31,2011/07/28,85,12,0.718209535,66385,85,4,8
2498,2014/03/31,2008/09/11,10,45,0.960496302,49627,10,19,26
2499,2014/03/31,2005/11/09,11,39,0.733006598,65017,11,19,20
2500,2014/03/31,2010/10/11,5,54,0.782877959,60873,5,10,44
2501,2014/03/31,2008/05/03,48,18,1.25841591,37864,48,8,10
2502,2014/03/31,2012/12/06,63,33,0.74588844,63876,63,8,25
2503,2014/03/31,2008/12/05,6,38,0.709327268,67159,6,11,27
2504,2014/03/31,2010/06/23,234,42,0.747260349,63749,234,38,4
2505,2014/03/31,2010/08/11,5,58,0.614588823,77497,5,25,33
2506,2014/03/31,2008/08/06,25,62,0.701904706,67853,25,25,37
2507,2014/03/31,2006/01/25,18,49,0.6711713970000001,70958,18,29,20
2508,2014/03/31,2007/09/04,13,44,0.766165975,62154,13,27,17
2509,2014/03/31,2012/03/24,32,35,0.748222701,63619,32,13,22
2510,2014/03/31,2010/03/20,1,67,0.7238763340000001,65758,1,26,41
2511,2014/03/31,2007/03/09,2,53,0.671400497,70882,2,18,35
2512,2014/03/31,2009/12/08,180,21,0.8857060959999999,53725,180,19,2
2513,2014/03/31,2010/06/13,76,31,0.746398388,63752,76,23,8
2514,2014/03/31,2005/08/26,10,23,0.995652174,47771,10,11,12
2515,2014/03/31,2011/04/07,66,42,0.668125219,71187,66,20,22
2516,2014/03/31,2008/04/19,108,8,1.042693623,45604,108,4,4
2517,2014/03/31,2013/01/15,11,32,1.18006106,40288,11,2,30
2518,2014/03/31,2010/11/09,14,76,0.917133266,51836,14,33,43
2519,2014/03/31,2011/03/08,6,58,0.677743177,70134,6,23,35
2520,2014/03/31,2011/12/13,10,46,0.61502421,77242,10,17,29
2521,2014/03/31,2012/02/15,342,8,0.776353295,61184,342,6,2
2522,2014/03/31,2012/03/30,28,14,0.824759928,57587,28,10,4
2523,2014/03/31,2007/04/06,7,30,0.882125932,53807,7,15,15
2524,2014/03/31,2011/03/15,1,54,0.843904157,56217,1,26,28
2525,2014/03/31,2009/10/26,9,50,0.7606669229999999,62361,9,27,23
2526,2014/03/31,2008/10/22,10,53,0.730108202,64971,10,18,35
2527,2014/03/31,2010/08/29,33,44,0.781914859,60652,33,21,23
2528,2014/03/31,2007/05/20,105,27,0.630254011,75233,105,23,4
2529,2014/03/31,2012/11/30,24,23,0.8299919459999999,57117,24,6,17
2530,2014/03/31,2012/10/15,1,44,0.7061735259999999,67114,1,12,32
2531,2014/03/31,2011/06/27,19,58,0.990887137,47828,19,45,13
2532,2014/03/31,2011/02/21,89,18,1.358156929,34882,89,10,8
2533,2014/03/31,2008/04/01,1,78,0.772970472,61263,1,43,35
2534,2014/03/31,2006/12/01,34,21,1.402942222,33750,34,10,11
2535,2014/03/31,2010/09/06,212,17,0.861764706,54910,212,9,8
2536,2014/03/31,2012/12/23,48,9,0.8084781120000001,58526,48,2,7
2537,2014/03/31,2011/09/16,39,51,0.7830077120000001,60428,39,20,31
2538,2014/03/31,2012/03/23,70,69,0.549837308,86052,70,46,23
2539,2014/03/31,2011/06/02,3,63,0.8098729929999999,58422,3,32,31
2540,2014/03/31,2004/12/07,7,65,0.7399654259999999,63920,7,35,30
2541,2014/03/31,2008/09/07,5,21,0.8381723940000001,56429,5,11,10
2542,2014/03/31,2007/06/25,4,39,0.819496448,57710,4,14,25
2543,2014/03/31,2008/05/31,68,37,0.720904795,65595,68,21,16
2544,2014/03/31,2006/07/14,2,48,0.729878373,64788,2,28,20
2545,2014/03/31,2005/12/30,42,31,0.90728234,52111,42,15,16
2546,2014/03/31,2004/12/15,184,48,0.87667699,53921,184,38,10
2547,2014/03/31,2007/06/08,33,29,1.14571993,41254,33,18,11
2548,2014/03/31,2007/12/12,221,26,0.8589872409999999,55018,221,15,11
2549,2014/03/31,2010/09/28,1,25,0.67432088,70076,1,10,15
2550,2014/03/31,2009/12/29,31,16,0.85214211,55450,31,5,11
2551,2014/03/31,2006/02/23,103,39,0.6964071159999999,67848,103,28,11
2552,2014/03/31,2008/06/05,6,42,1.318284869,35834,6,25,17
2553,2014/03/31,2012/11/21,17,43,0.672575855,70233,17,7,36
2554,2014/03/31,2007/01/24,15,28,1.270427426,37176,15,11,17
2555,2014/03/31,2007/08/13,13,34,0.7433406779999999,63535,13,14,20
2556,2014/03/31,2007/05/18,4,95,0.666308339,70857,4,44,51
2557,2014/03/31,2011/08/01,6,64,0.714856645,66025,6,27,37
2558,2014/03/31,2006/09/16,44,13,0.927162895,50904,44,7,6
2559,2014/03/31,2012/07/07,13,34,0.8563825420000001,55105,13,9,25
2560,2014/03/31,2008/10/23,29,58,0.6976323179999999,67640,29,28,30
2561,2014/03/31,2009/02/06,30,30,1.253037427,37647,30,18,12
2562,2014/03/31,2013/03/01,8,20,0.65420119,72101,8,3,17
2563,2014/03/31,2006/06/14,50,13,1.461983696,32263,50,6,7
2564,2014/03/31,2009/06/04,8,75,0.693026714,68054,8,48,27
2565,2014/03/31,2008/11/13,4,19,1.34355346,35101,4,5,14
2566,2014/03/31,2012/04/01,8,69,0.842095,56000,8,35,34
2567,2014/03/31,2007/06/21,8,43,0.833829355,56550,8,8,35
2568,2014/03/31,2012/05/19,31,14,0.686018157,68732,31,4,10
2569,2014/03/31,2008/01/08,27,19,1.4431086830000002,32673,27,8,11
2570,2014/03/31,2012/04/22,329,23,0.815447942,57820,329,21,2
2571,2014/03/31,2009/11/22,34,25,1.455732283,32385,34,13,12
2572,2014/03/31,2005/10/14,4,45,0.622993482,75631,4,24,21
2573,2014/03/31,2011/01/13,95,29,1.324360892,35573,95,18,11
2574,2014/03/31,2006/05/24,17,49,0.607343083,77541,17,25,24
2575,2014/03/31,2005/01/08,8,39,0.7035082690000001,66939,8,11,28
2576,2014/03/31,2010/12/31,11,26,0.746037078,63110,11,12,14
2577,2014/03/31,2005/04/15,12,37,0.805995617,58401,12,19,18
2578,2014/03/31,2007/03/02,27,67,0.8222866879999999,57240,27,47,20
2579,2014/03/31,2008/02/08,31,39,0.718047177,65541,31,17,22
2580,2014/03/31,2013/02/15,10,36,0.978387486,48074,10,4,32
2581,2014/03/31,2006/02/23,4,39,0.8288450959999999,56732,4,20,19
2582,2014/03/31,2008/03/20,14,46,0.706532866,66542,14,24,22
2583,2014/03/31,2010/01/05,7,51,0.7989782459999999,58840,7,27,24
2584,2014/03/31,2005/09/09,9,59,0.777837337,60407,9,38,21
2585,2014/03/31,2012/03/26,7,19,0.959844523,48946,7,8,11
2586,2014/03/31,2006/09/30,16,50,0.7328192809999999,64105,16,21,29
2587,2014/03/31,2009/07/06,3,38,0.822513657,57112,3,12,26
2588,2014/03/31,2012/05/11,4,28,1.280117198,36690,4,13,15
2589,2014/03/31,2007/04/30,8,22,0.667765171,70332,8,9,13
2590,2014/03/31,2007/05/14,11,30,0.6676612829999999,70342,11,15,15
2591,2014/03/31,2005/11/15,2,60,0.8857837940000001,53005,2,26,34
2592,2014/03/31,2012/02/09,4,20,0.7666473420000001,61235,4,11,9
2593,2014/03/31,2008/05/27,3,55,0.686492498,68382,3,25,30
2594,2014/03/31,2010/09/21,63,24,0.68645535,68365,63,14,10
2595,2014/03/31,2011/01/18,8,50,0.7194023209999999,65219,8,26,24
2596,2014/03/31,2007/10/24,22,33,1.246635839,37629,22,14,19
2597,2014/03/31,2008/05/16,25,39,0.786998792,59596,25,21,18
2598,2014/03/31,2011/03/03,4,57,0.73771812,63566,4,34,23
2599,2014/03/31,2011/05/20,86,21,1.4081760019999998,33295,86,15,6
2600,2014/03/31,2008/10/19,2,40,0.6330408479999999,74055,2,14,26
2601,2014/03/31,2007/06/15,178,8,0.615665992,76142,178,4,4
2602,2014/03/31,2007/10/14,10,46,0.691612632,67765,10,21,25
2603,2014/03/31,2005/07/09,39,62,0.861574176,54384,39,36,26
2604,2014/03/31,2005/03/29,4,49,0.750316214,62426,4,21,28
2605,2014/03/31,2007/03/09,18,56,0.63813853,73399,18,29,27
2606,2014/03/31,2005/04/27,6,45,0.656746694,71309,6,22,23
2607,2014/03/31,2008/11/01,191,44,0.625183623,74909,191,31,13
2608,2014/03/31,2010/07/21,97,20,0.8321757059999999,56253,97,5,15
2609,2014/03/31,2010/03/13,15,40,0.913425671,51225,15,17,23
2610,2014/03/31,2012/05/19,7,45,0.811587183,57643,7,34,11
2611,2014/03/31,2011/07/14,42,35,0.6817794420000001,68617,42,15,20
2612,2014/03/31,2005/12/01,4,38,0.77580413,60295,4,15,23
2613,2014/03/31,2011/09/14,5,13,1.327692308,35230,5,12,1
2614,2014/03/31,2007/05/21,9,68,0.765644295,61090,9,26,42
2615,2014/03/31,2007/05/24,28,37,0.666759636,70131,28,21,16
2616,2014/03/31,2011/05/31,5,40,0.8825977309999999,52977,5,25,15
2617,2014/03/31,2007/12/05,11,32,0.98308933,47554,11,12,20
2618,2014/03/31,2008/09/05,7,39,0.762239529,61312,7,16,23
2619,2014/03/31,2011/02/08,388,15,1.5,31155,388,15,0
2620,2014/03/31,2010/04/13,24,42,0.7782782859999999,60039,24,18,24
2621,2014/03/31,2008/03/24,2,44,0.730510656,63957,2,19,25
2622,2014/03/31,2013/03/21,24,10,0.698374843,66892,24,1,9
2623,2014/03/31,2009/08/18,15,36,0.788744532,59205,15,19,17
2624,2014/03/31,2004/11/22,10,29,1.108626478,42118,10,12,17
2625,2014/03/31,2006/05/28,17,28,0.78164404,59737,17,17,11
2626,2014/03/31,2006/05/26,6,52,0.7630109159999999,61194,6,30,22
2627,2014/03/31,2011/01/15,8,33,0.744676902,62659,8,18,15
2628,2014/03/31,2008/01/21,27,24,0.603654809,77279,27,15,9
2629,2014/03/31,2010/12/01,44,40,0.66035008,70641,44,25,15
2630,2014/03/31,2010/07/24,7,29,1.059304158,44033,7,13,16
2631,2014/03/31,2012/03/05,29,44,0.8393983840000001,55567,29,24,20
2632,2014/03/31,2006/11/15,15,22,0.939592836,49636,15,8,14
2633,2014/03/31,2012/11/20,4,50,0.604554128,77141,4,7,43
2634,2014/03/31,2013/03/01,7,24,0.735,63432,7,2,22
2635,2014/03/31,2011/08/26,19,35,1.428168617,32642,19,17,18
2636,2014/03/31,2010/02/05,25,37,0.912370286,51074,25,18,19
2637,2014/03/31,2009/02/12,164,23,0.7665217390000001,60789,164,15,8
2638,2014/03/31,2005/04/23,3,81,0.7638480590000001,60984,3,35,46
2639,2014/03/31,2007/02/19,18,23,1.366488207,34088,18,6,17
2640,2014/03/31,2009/02/23,64,24,0.93031064,50058,64,11,13
2641,2014/03/31,2011/01/14,220,9,0.701145262,66404,220,6,3
2642,2014/03/31,2009/04/21,20,40,0.872332071,53356,20,19,21
2643,2014/03/31,2013/01/17,1,47,0.742803876,62649,1,1,46
2644,2014/03/31,2007/05/30,2,49,0.725679812,64106,2,19,30
2645,2014/03/31,2008/08/06,9,47,0.609131471,76359,9,28,19
2646,2014/03/31,2009/02/17,13,37,0.755213974,61573,13,24,13
2647,2014/03/31,2007/03/13,32,10,0.7175753090000001,64800,32,0,10
2648,2014/03/31,2009/11/09,22,69,0.614127695,75696,22,21,48
2649,2014/03/31,2006/10/22,35,29,0.917573628,50660,35,23,6
2650,2014/03/31,2008/11/07,413,24,1.4903164780000002,31187,413,24,0
2651,2014/03/31,2006/10/22,13,67,0.7399490540000001,62811,13,30,37
2652,2014/03/31,2011/10/02,35,16,0.856861038,54209,35,6,10
2653,2014/03/31,2011/11/01,1,34,0.655183874,70891,1,15,19
2654,2014/03/31,2012/03/22,13,66,0.912695271,50878,13,27,39
2655,2014/03/31,2010/07/30,40,25,1.126618703,41212,40,12,13
2656,2014/03/31,2007/08/01,4,24,0.7110719259999999,65275,4,9,15
2657,2014/03/31,2011/09/01,22,23,0.7634782609999999,60789,22,10,13
2658,2014/03/31,2010/06/30,19,62,0.8543835040000001,54315,19,27,35
2659,2014/03/31,2011/04/14,14,36,0.70194505,66096,14,15,21
2660,2014/03/31,2005/11/01,2,77,0.77060596,60202,2,30,47
2661,2014/03/31,2010/06/27,241,6,0.903595013,51335,241,2,4
2662,2014/03/31,2012/09/27,40,36,0.7883763709999999,58825,40,14,22
2663,2014/03/31,2006/12/25,11,31,1.255328226,36941,11,8,23
2664,2014/03/31,2007/11/01,436,6,1.0197140340000002,45460,436,6,0
2665,2014/03/31,2005/06/18,2,29,0.657086281,70525,2,12,17
2666,2014/03/31,2006/01/06,4,46,0.7503197970000001,61758,4,24,22
2667,2014/03/31,2009/11/10,155,18,1.039563423,44574,155,10,8
2668,2014/03/31,2006/06/27,8,36,0.744928921,62184,8,20,16
2669,2014/03/31,2010/01/09,382,8,0.8295926920000001,55830,382,8,0
2670,2014/03/31,2011/06/20,1,65,0.811691437,57058,1,36,29
2671,2014/03/31,2011/06/29,4,53,0.85911678,53905,4,27,26
2672,2014/03/31,2011/01/27,12,46,0.6590417820000001,70245,12,26,20
2673,2014/03/31,2007/02/15,7,55,0.633246966,73099,7,28,27
2674,2014/03/31,2008/10/20,86,29,0.788664747,58693,86,17,12
2675,2014/03/31,2009/09/05,5,51,0.873529412,52989,5,23,28
2676,2014/03/31,2007/02/14,20,49,0.683388764,67712,20,34,15
2677,2014/03/31,2006/11/03,16,64,0.7520083890000001,61512,16,25,39
2678,2014/03/31,2013/01/30,11,49,0.794436044,58196,11,9,40
2679,2014/03/31,2009/03/17,8,32,0.695090212,66510,8,15,17
2680,2014/03/31,2009/01/31,5,22,0.573560794,80600,5,8,14
2681,2014/03/31,2012/05/16,74,75,0.7855454140000001,58836,74,57,18
2682,2014/03/31,2012/11/29,18,26,1.143504627,40418,18,8,18
2683,2014/03/31,2006/01/16,4,34,0.781142287,59162,4,14,20
2684,2014/03/31,2011/11/02,27,46,0.505251607,91452,27,25,21
2685,2014/03/31,2010/07/21,62,19,0.933420489,49490,62,5,14
2686,2014/03/31,2009/07/01,2,47,0.715870236,64517,2,21,26
2687,2014/03/31,2008/05/27,21,36,1.040605057,44376,21,17,19
2688,2014/03/31,2007/10/11,24,32,0.753479751,61263,24,14,18
2689,2014/03/31,2008/08/14,267,41,1.003256901,46010,267,36,5
2690,2014/03/31,2010/06/18,37,39,0.8462471109999999,54526,37,20,19
2691,2014/03/31,2013/01/26,4,71,0.7025183890000001,65665,4,9,62
2692,2014/03/31,2006/09/15,18,28,1.434148685,32162,18,12,16
2693,2014/03/31,2007/12/14,3,34,1.123679312,41043,3,7,27
2694,2014/03/31,2005/11/26,7,48,0.7733460790000001,59628,7,11,37
2695,2014/03/31,2007/10/06,112,19,1.419373903,32487,112,9,10
2696,2014/03/31,2009/02/10,3,22,0.753359311,61206,3,12,10
2697,2014/03/31,2009/10/18,26,54,0.8154913229999999,56531,26,31,23
2698,2014/03/31,2006/08/08,40,51,0.7054253220000001,65327,40,26,25
2699,2014/03/31,2006/06/23,65,18,0.804222598,57287,65,10,8
2700,2014/03/31,2012/09/05,15,29,0.87071149,52889,15,8,21
2701,2014/03/31,2007/07/10,6,35,0.745936918,61729,6,17,18
2702,2014/03/31,2004/12/01,76,40,0.740671428,62166,76,21,19
2703,2014/03/31,2005/11/04,22,36,0.7360569440000001,62553,22,11,25
2704,2014/03/31,2008/07/20,2,53,0.873115506,52733,2,22,31
2705,2014/03/31,2007/12/04,25,45,0.755442178,60937,25,20,25
2706,2014/03/31,2011/03/09,3,34,0.812530227,56655,3,20,14
2707,2014/03/31,2009/12/29,3,63,0.7743353909999999,59441,3,31,32
2708,2014/03/31,2006/01/25,6,68,0.588061796,78258,6,30,38
2709,2014/03/31,2007/08/06,28,48,0.662308047,69483,28,26,22
2710,2014/03/31,2011/04/20,185,29,1.3240801290000002,34744,185,22,7
2711,2014/03/31,2011/09/18,9,38,0.938369887,49015,9,26,12
2712,2014/03/31,2004/11/13,4,44,0.74014021,62121,4,14,30
2713,2014/03/31,2005/09/15,13,50,0.708793537,64859,13,24,26
2714,2014/03/31,2012/01/12,9,68,0.88782209,51779,9,15,53
2715,2014/03/31,2012/07/24,207,5,1.189666641,38637,207,3,2
2716,2014/03/31,2007/10/14,51,49,0.879918979,52209,51,35,14
2717,2014/03/31,2011/12/16,31,50,0.8195570179999999,56052,31,30,20
2718,2014/03/31,2011/05/25,39,45,0.987847388,46497,39,22,23
2719,2014/03/31,2006/12/27,89,68,0.758290102,60565,89,28,40
2720,2014/03/31,2005/07/10,21,34,0.830052963,55322,21,16,18
2721,2014/03/31,2006/06/25,4,24,1.086775774,42252,4,17,7
2722,2014/03/31,2010/12/16,11,61,0.813098068,56461,11,42,19
2723,2014/03/31,2012/08/14,6,61,0.776697821,59061,6,32,29
2724,2014/03/31,2009/01/02,3,44,0.717740815,63908,3,28,16
2725,2014/03/31,2011/02/01,1,43,0.687006021,66764,1,1,42
2726,2014/03/31,2011/02/24,23,41,0.73097561,62730,23,24,17
2727,2014/03/31,2007/11/01,5,56,0.715391612,64094,5,6,50
2728,2014/03/31,2007/11/07,2,61,0.778074632,58929,2,27,34
2729,2014/03/31,2010/08/18,106,19,0.975393225,46996,106,11,8
2730,2014/03/31,2008/04/05,40,34,0.824684981,55584,40,11,23
2731,2014/03/31,2005/03/06,71,45,0.716859936,63935,71,24,21
2732,2014/03/31,2009/09/16,14,67,0.7160442770000001,64006,14,30,37
2733,2014/03/31,2006/09/08,10,39,0.719844568,63629,10,22,17
2734,2014/03/31,2009/10/27,222,23,0.656626307,69707,222,10,13
2735,2014/03/31,2007/08/14,13,35,0.7763063509999999,58939,13,11,24
2736,2014/03/31,2005/06/10,58,48,0.630697886,72519,58,28,20
2737,2014/03/31,2005/09/10,25,47,0.600286176,76177,25,19,28
2738,2014/03/31,2007/06/28,72,28,0.8991294,50850,72,14,14
2739,2014/03/31,2005/07/08,5,45,0.6947223659999999,65806,5,18,27
2740,2014/03/31,2009/08/16,2,30,0.742580729,61564,2,13,17
2741,2014/03/31,2005/09/09,6,56,0.681457812,67080,6,20,36
2742,2014/03/31,2012/03/07,19,32,0.69743321,65541,19,14,18
2743,2014/03/31,2012/09/06,17,14,0.65992435,69266,17,0,14
2744,2014/03/31,2008/08/14,256,26,1.4206424130000002,32160,256,21,5
2745,2014/03/31,2012/06/24,25,42,0.717311595,63666,25,15,27
2746,2014/03/31,2009/03/06,33,37,0.7826380559999999,58346,33,15,22
2747,2014/03/31,2008/12/31,25,38,0.780300508,58501,25,22,16
2748,2014/03/31,2012/04/12,22,20,1.447878749,31505,22,7,13
2749,2014/03/31,2009/04/27,141,17,0.830588235,54910,141,8,9
2750,2014/03/31,2004/12/21,59,41,0.670298821,68034,59,25,16
2751,2014/03/31,2006/06/27,114,36,0.691085183,65952,114,22,14
2752,2014/03/31,2006/03/28,45,28,0.599965249,75968,45,14,14
2753,2014/03/31,2010/08/09,10,46,0.8468874270000001,53814,10,23,23
2754,2014/03/31,2005/04/02,20,47,0.864183877,52731,20,29,18
2755,2014/03/31,2006/04/13,49,46,0.8110139540000001,56186,49,31,15
2756,2014/03/31,2008/12/12,177,35,0.76871155,59265,177,22,13
2757,2014/03/31,2004/11/19,5,38,0.7443697709999999,61200,5,16,22
2758,2014/03/31,2010/03/02,17,59,0.7278382609999999,62570,17,31,28
2759,2014/03/31,2012/01/01,1,28,0.612005967,74408,1,10,18
2760,2014/03/31,2012/01/17,17,43,0.604975419,75260,17,21,22
2761,2014/03/31,2009/04/14,2,47,0.7686624009999999,59233,2,19,28
2762,2014/03/31,2009/09/29,104,20,0.8231042709999999,55298,104,10,10
2763,2014/03/31,2008/01/14,1,50,0.6071945129999999,74946,1,22,28
2764,2014/03/31,2006/03/23,8,36,0.601727593,75556,8,15,21
2765,2014/03/31,2008/04/12,192,8,0.834387755,54488,192,4,4
2766,2014/03/31,2006/06/01,51,35,0.6129072010000001,74171,51,21,14
2767,2014/03/31,2011/06/20,19,40,0.669969635,67841,19,20,20
2768,2014/03/31,2012/02/05,9,55,0.798042425,56948,9,8,47
2769,2014/03/31,2011/07/31,14,50,0.7152224359999999,63524,14,21,29
2770,2014/03/31,2005/08/19,1,38,0.932770077,48699,1,14,24
2771,2014/03/31,2008/07/10,9,32,0.669805905,67802,9,19,13
2772,2014/03/31,2012/08/17,9,48,0.586318725,77446,9,21,27
2773,2014/03/31,2011/09/17,34,39,0.8361327390000001,54302,34,22,17
2774,2014/03/31,2006/08/14,7,46,0.574883744,78964,7,15,31
2775,2014/03/31,2007/02/19,16,50,0.8718710740000001,52061,16,29,21
2776,2014/03/31,2005/12/03,115,26,1.271262008,35705,115,19,7
2777,2014/03/31,2010/11/18,65,21,1.218635033,37239,65,8,13
2778,2014/03/31,2007/10/11,13,52,0.796344541,56986,13,28,24
2779,2014/03/31,2013/03/11,4,53,0.7980229059999999,56841,4,2,51
2780,2014/03/31,2012/06/15,161,47,0.752108964,60295,161,30,17
2781,2014/03/31,2008/03/24,413,6,0.724888889,62550,413,6,0
2782,2014/03/31,2010/09/27,12,53,0.747226535,60675,12,27,26
2783,2014/03/31,2009/04/01,7,48,1.448363689,31296,7,21,27
2784,2014/03/31,2012/11/08,13,25,1.284100915,35297,13,7,18
2785,2014/03/31,2009/02/09,3,22,0.7662095720000001,59149,3,13,9
2786,2014/03/31,2011/01/18,32,58,0.6796839370000001,66664,32,32,26
2787,2014/03/31,2006/09/18,84,32,0.681207265,66514,84,17,15
2788,2014/03/31,2008/11/28,9,61,0.653228751,69355,9,21,40
2789,2014/03/31,2008/09/08,85,26,0.964484895,46971,85,18,8
2790,2014/03/31,2009/10/28,4,69,0.768996673,58904,4,29,40
2791,2014/03/31,2012/09/08,14,29,0.628702894,72045,14,2,27
2792,2014/03/31,2008/03/12,4,50,0.705503427,64200,4,21,29
2793,2014/03/31,2007/01/17,15,33,0.66026951,68569,15,12,21
2794,2014/03/31,2005/07/01,49,23,0.894726274,50598,49,17,6
2795,2014/03/31,2009/03/26,18,24,0.753484571,60082,18,7,17
2796,2014/03/31,2012/06/01,97,61,0.762873947,59340,97,32,29
2797,2014/03/31,2008/01/02,6,61,0.786321595,57563,6,32,29
2798,2014/03/31,2007/03/13,13,6,1.263212482,35829,13,4,2
2799,2014/03/31,2008/02/22,2,5,0.74,61160,2,1,4
2800,2014/03/31,2012/10/03,33,40,0.616131131,73453,33,13,27
2801,2014/03/31,2012/05/09,21,43,1.254020567,36077,21,23,20
2802,2014/03/31,2009/01/21,36,29,0.611150859,74023,36,14,15
2803,2014/03/31,2007/06/21,231,18,1.436934905,31477,231,17,1
2804,2014/03/31,2007/12/17,9,43,0.797227667,56732,9,24,19
2805,2014/03/31,2006/08/23,17,29,1.004147647,45040,17,16,13
2806,2014/03/31,2010/04/13,35,44,0.5274779860000001,85741,35,27,17
2807,2014/03/31,2005/12/06,31,18,1.357441993,33315,31,13,5
2808,2014/03/31,2005/12/01,110,17,1.447039775,31251,110,12,5
2809,2014/03/31,2007/11/28,10,57,0.6831943859999999,66188,10,30,27
2810,2014/03/31,2009/06/20,1,32,0.743889364,60776,1,19,13
2811,2014/03/31,2009/06/16,59,29,0.922505204,48998,59,20,9
2812,2014/03/31,2005/08/24,6,40,1.031286708,43825,6,17,23
2813,2014/03/31,2009/12/11,30,39,0.912545102,49499,30,17,22
2814,2014/03/31,2012/11/26,31,45,0.938984739,48096,31,16,29
2815,2014/03/31,2011/08/01,23,38,0.7147882109999999,63176,23,21,17
2816,2014/03/31,2011/07/10,61,53,0.7890642370000001,57226,61,28,25
2817,2014/03/31,2008/04/05,5,36,0.602841273,74896,5,13,23
2818,2014/03/31,2012/07/30,35,5,0.738,61160,35,3,2
2819,2014/03/31,2011/04/19,16,23,1.4292574180000002,31579,16,6,17
2820,2014/03/31,2012/05/25,2,43,0.63162932,71447,2,21,22
2821,2014/03/31,2010/06/21,20,47,0.854987115,52776,20,23,24
2822,2014/03/31,2006/10/06,18,22,1.397829657,32276,18,13,9
2823,2014/03/31,2006/02/20,47,23,0.7872116240000001,57295,47,12,11
2824,2014/03/31,2011/08/15,7,22,1.094539763,41207,7,8,14
2825,2014/03/31,2007/11/13,2,23,0.7837592329999999,57541,2,6,17
2826,2014/03/31,2006/10/26,27,43,0.7525493529999999,59925,27,17,26
2827,2014/03/31,2006/02/23,1,33,0.949605518,47480,1,15,18
2828,2014/03/31,2010/07/28,96,39,0.693632068,64974,96,18,21
2829,2014/03/31,2006/10/17,14,37,0.861950874,52274,14,17,20
2830,2014/03/31,2012/03/01,9,50,0.6675260789999999,67488,9,26,24
2831,2014/03/31,2012/05/15,23,41,0.76772828,58678,23,21,20
2832,2014/03/31,2005/10/14,40,24,1.22505673,36753,40,12,12
2833,2014/03/31,2012/11/09,6,90,0.847673928,53111,6,16,74
2834,2014/03/31,2007/10/18,12,55,0.689411819,65303,12,35,20
2835,2014/03/31,2010/08/02,1,43,0.755410777,59570,1,27,16
2836,2014/03/31,2007/06/02,50,18,0.7288205,61738,50,5,13
2837,2014/03/31,2012/10/18,4,68,0.745974103,60317,4,15,53
2838,2014/03/31,2007/06/04,10,46,0.722142112,62303,10,12,34
2839,2014/03/31,2012/04/09,22,45,0.7362912229999999,61101,22,13,32
2840,2014/03/31,2012/03/15,3,33,0.842067462,53423,3,18,15
2841,2014/03/31,2007/08/22,23,40,0.631924509,71161,23,15,25
2842,2014/03/31,2006/08/23,13,64,0.724909158,62031,13,25,39
2843,2014/03/31,2008/03/16,9,38,0.704748523,63803,9,16,22
2844,2014/03/31,2012/02/15,18,62,0.8736676,51456,18,41,21
2845,2014/03/31,2007/04/29,405,8,1.092948843,41128,405,8,0
2846,2014/03/31,2012/02/07,11,33,0.94217066,47709,11,12,21
2847,2014/03/31,2008/02/04,44,25,0.738973743,60823,44,14,11
2848,2014/03/31,2007/08/08,21,38,0.74451708,60362,21,25,13
2849,2014/03/31,2012/02/26,61,47,0.778620415,57713,61,27,20
2850,2014/03/31,2006/05/09,8,46,0.7178445999999999,62587,8,18,28
2851,2014/03/31,2006/03/29,5,32,0.791187918,56780,5,20,12
2852,2014/03/31,2007/11/06,8,52,0.630811111,71211,8,27,25
2853,2014/03/31,2009/08/18,132,38,0.86427656,51967,132,30,8
2854,2014/03/31,2010/02/26,221,16,1.396464131,32159,221,11,5
2855,2014/03/31,2011/12/17,304,13,0.661141915,67921,304,10,3
2856,2014/03/31,2011/03/26,23,31,0.739236632,60744,23,8,23
2857,2014/03/31,2005/08/20,34,36,0.745339132,60242,34,22,14
2858,2014/03/31,2004/11/25,31,37,0.72147797,62234,31,23,14
2859,2014/03/31,2009/08/16,156,8,1.006973333,44587,156,4,4
2860,2014/03/31,2009/04/22,152,46,0.717778666,62548,152,35,11
2861,2014/03/31,2007/04/24,2,31,0.73152649,61363,2,10,21
2862,2014/03/31,2005/02/12,1,50,0.720400918,62307,1,14,36
2863,2014/03/31,2008/05/17,5,44,0.793328441,56549,5,21,23
2864,2014/03/31,2010/07/23,14,33,0.957029973,46875,14,8,25
2865,2014/03/31,2005/09/24,38,46,0.85596283,52408,38,20,26
2866,2014/03/31,2013/03/14,2,38,0.693929605,64635,2,2,36
2867,2014/03/31,2011/01/13,4,33,1.3440319580000002,33356,4,19,14
2868,2014/03/31,2007/08/28,2,52,0.888476404,50453,2,32,20
2869,2014/03/31,2007/08/09,16,40,0.7535856959999999,59478,16,25,15
2870,2014/03/31,2005/04/21,11,57,0.607649277,73739,11,29,28
2871,2014/03/31,2012/06/17,3,63,0.73466741,60976,3,14,49
2872,2014/03/31,2005/03/31,47,28,0.96733306,46304,47,7,21
2873,2014/03/31,2004/11/30,10,47,0.701130212,63873,10,20,27
2874,2014/03/31,2010/10/22,15,79,0.790046576,56682,15,41,38
2875,2014/03/31,2009/03/23,46,5,0.732,61160,46,3,2
2876,2014/03/31,2011/06/26,96,22,0.79882693,56041,96,12,10
2877,2014/03/31,2008/03/29,106,25,1.208357222,37047,106,14,11
2878,2014/03/31,2007/08/21,64,34,1.450814183,30853,64,17,17
2879,2014/03/31,2010/02/27,5,68,0.987772972,45316,5,29,39
2880,2014/03/31,2011/04/14,5,44,0.732255014,61126,5,13,31
2881,2014/03/31,2010/11/30,33,16,0.946853576,47260,33,9,7
2882,2014/03/31,2011/09/12,15,36,0.6950779029999999,64375,15,23,13
2883,2014/03/31,2008/09/25,137,6,1.053174211,42483,137,1,5
2884,2014/03/31,2011/03/15,26,17,0.761781853,58731,26,9,8
2885,2014/03/31,2005/10/21,3,43,0.7436037040000001,60152,3,13,30
2886,2014/03/31,2009/04/06,157,30,0.662833706,67477,157,3,27
2887,2014/03/31,2011/05/07,4,41,0.712404543,62777,4,18,23
2888,2014/03/31,2005/05/07,8,51,0.616010498,72588,8,30,21
2889,2014/03/31,2012/02/06,49,16,0.865,51680,49,8,8
2890,2014/03/31,2011/04/29,5,49,0.6250469120000001,71517,5,20,29
2891,2014/03/31,2012/04/24,56,20,0.85467123,52301,56,18,2
2892,2014/03/31,2006/03/23,1,68,0.614011406,72770,1,31,37
2893,2014/03/31,2011/09/13,13,25,0.6560775329999999,68100,13,15,10
2894,2014/03/31,2006/02/03,63,23,1.244676457,35884,63,8,15
2895,2014/03/31,2011/01/21,11,5,0.73,61160,11,2,3
2896,2014/03/31,2010/03/27,21,23,0.761983234,58571,21,9,14
2897,2014/03/31,2008/03/02,7,48,0.935792056,47686,7,23,25
2898,2014/03/31,2010/05/28,100,16,1.453925544,30676,100,8,8
2899,2014/03/31,2009/11/27,36,26,0.791206003,56368,36,10,16
2900,2014/03/31,2010/11/27,17,58,0.66147691,67411,17,18,40
2901,2014/03/31,2005/07/09,1,61,0.654963182,68037,1,31,30
2902,2014/03/31,2006/12/12,32,22,0.8266609779999999,53905,32,11,11
2903,2014/03/31,2008/01/24,12,49,0.841020543,52962,12,31,18
2904,2014/03/31,2012/04/30,2,29,0.7623827540000001,58424,2,18,11
2905,2014/03/31,2009/09/08,14,39,0.7680952790000001,57977,14,19,20
2906,2014/03/31,2007/05/10,7,36,0.805424768,55289,7,20,16
2907,2014/03/31,2012/11/21,7,49,0.6667817620000001,66785,7,12,37
2908,2014/03/31,2005/03/09,1,47,0.684942844,64997,1,12,35
2909,2014/03/31,2005/04/21,2,72,0.687457067,64752,2,24,48
2910,2014/03/31,2005/03/18,11,51,0.747623767,59527,11,25,26
2911,2014/03/31,2005/12/04,8,53,0.690908399,64410,8,24,29
2912,2014/03/31,2008/12/05,7,43,0.747711054,59499,7,23,20
2913,2014/03/31,2007/02/20,15,36,0.850514208,52294,15,12,24
2914,2014/03/31,2007/11/29,13,45,0.682911587,65126,13,24,21
2915,2014/03/31,2007/08/15,10,49,0.6332087270000001,70221,10,23,26
2916,2014/03/31,2012/01/20,4,39,0.843880317,52689,4,24,15
2917,2014/03/31,2012/09/04,1,28,1.180680267,37647,1,2,26
2918,2014/03/31,2011/11/05,7,30,0.865899394,51329,7,13,17
2919,2014/03/31,2005/04/18,62,73,0.7219216270000001,61552,62,35,38
2920,2014/03/31,2010/02/17,2,40,0.688497551,64528,2,13,27
2921,2014/03/31,2005/10/21,13,25,1.451671133,30596,13,11,14
2922,2014/03/31,2008/07/04,1,48,0.71268634,62319,1,9,39
2923,2014/03/31,2004/11/16,18,34,0.7033892429999999,63138,18,18,16
2924,2014/03/31,2005/09/04,5,47,0.7359828959999999,60337,5,28,19
2925,2014/03/31,2008/06/03,259,4,0.9075,48928,259,1,3
2926,2014/03/31,2008/05/07,206,6,0.605,73392,206,4,2
2927,2014/03/31,2013/03/02,67,12,0.7328531340000001,60586,67,0,12
2928,2014/03/31,2012/04/12,19,48,0.563962389,78700,19,18,30
2929,2014/03/31,2012/05/16,64,21,1.072935971,41356,64,13,8
2930,2014/03/31,2012/03/30,16,70,0.7154213559999999,62014,16,23,47
2931,2014/03/31,2009/01/01,9,38,0.6990070909999999,63460,9,10,28
2932,2014/03/31,2012/08/15,3,40,0.710502893,62399,3,15,25
2933,2014/03/31,2007/06/04,57,24,0.752989295,58850,57,9,15
2934,2014/03/31,2010/04/02,4,34,0.7487709029999999,59141,4,12,22
2935,2014/03/31,2006/06/08,1,46,0.8432880079999999,52509,1,31,15
2936,2014/03/31,2008/06/01,42,16,1.4030970109999998,31553,42,7,9
2937,2014/03/31,2011/02/25,58,8,0.7171809990000001,61724,58,3,5
2938,2014/03/31,2006/05/17,285,31,0.939318095,47118,285,28,3
2939,2014/03/31,2009/07/27,68,24,0.677254323,65350,68,7,17
2940,2014/03/31,2008/11/09,13,40,0.7615235090000001,58083,13,18,22
2941,2014/03/31,2007/07/02,2,35,0.856107466,51663,2,18,17
2942,2014/03/31,2007/03/16,33,31,0.684574047,64608,33,19,12
2943,2014/03/31,2010/09/14,110,24,1.204280268,36722,110,17,7
2944,2014/03/31,2011/07/13,12,37,0.815316556,54240,12,13,24
2945,2014/03/31,2010/08/27,6,35,0.74887566,59048,6,4,31
2946,2014/03/31,2007/06/01,10,53,0.7302890320000001,60547,10,20,33
2947,2014/03/31,2005/11/18,1,69,0.72229716,61206,1,32,37
2948,2014/03/31,2006/08/04,81,37,0.720649442,61345,81,20,17
2949,2014/03/31,2006/04/28,190,18,1.444814524,30597,190,14,4
2950,2014/03/31,2008/01/16,49,35,0.8766307040000001,50423,49,21,14
2951,2014/03/31,2005/05/21,61,22,1.4593647440000002,30287,61,15,7
2952,2014/03/31,2009/02/14,419,38,0.797495218,55414,419,38,0
2953,2014/03/31,2012/09/26,114,5,0.722,61160,114,1,4
2954,2014/03/31,2005/09/10,178,37,0.738039855,59817,178,30,7
2955,2014/03/31,2008/03/09,67,40,0.884373147,49916,67,0,40
2956,2014/03/31,2006/05/28,153,49,0.852536125,51764,153,34,15
2957,2014/03/31,2006/03/22,2,60,0.81288238,54285,2,31,29
2958,2014/03/31,2010/02/21,13,84,0.76926728,57348,13,33,51
2959,2014/03/31,2011/11/06,49,44,0.68484801,64412,49,22,22
2960,2014/03/31,2009/05/16,33,63,0.5972848279999999,73848,33,35,28
2961,2014/03/31,2008/08/30,14,37,0.628804762,70145,14,12,25
2962,2014/03/31,2011/11/08,24,40,0.8630628459999999,51093,24,17,23
2963,2014/03/31,2012/04/28,153,68,0.68948147,63950,153,32,36
2964,2014/03/31,2011/09/15,159,59,0.852312049,51729,159,42,17
2965,2014/03/31,2012/02/14,13,24,0.705416667,62496,13,5,19
2966,2014/03/31,2011/06/07,68,7,0.732795545,60160,68,2,5
2967,2014/03/31,2008/04/26,6,45,0.627443105,70261,6,20,25
2968,2014/03/31,2012/03/26,29,51,0.767004472,57469,29,25,26
2969,2014/03/31,2005/12/01,1,42,0.539351657,81716,1,34,8
2970,2014/03/31,2010/11/05,24,33,0.7512614440000001,58655,24,15,18
2971,2014/03/31,2006/10/29,34,44,1.4529612530000002,30325,34,21,23
2972,2014/03/31,2008/10/24,86,20,0.667907386,65951,86,7,13
2973,2014/03/31,2008/09/03,60,48,0.631346702,69763,60,23,25
2974,2014/03/31,2012/09/05,3,25,1.4455960469999998,30459,3,12,13
2975,2014/03/31,2006/03/01,116,48,0.747379485,58893,116,19,29
2976,2014/03/31,2005/03/08,165,20,0.744709277,59094,165,11,9
2977,2014/03/31,2007/10/01,27,24,0.69375,63432,27,15,9
2978,2014/03/31,2012/05/18,18,35,0.6264016170000001,70251,18,15,20
2979,2014/03/31,2012/01/01,5,49,1.068535525,41182,5,20,29
2980,2014/03/31,2005/02/26,45,40,0.649244581,67777,45,18,22
2981,2014/03/31,2006/06/06,16,32,0.785453182,56004,16,15,17
2982,2014/03/31,2007/10/20,2,36,0.78658229,55900,2,7,29
2983,2014/03/31,2010/02/15,8,47,0.819092959,53658,8,20,27
2984,2014/03/31,2013/03/27,40,38,0.736985445,59634,40,2,36
2985,2014/03/31,2012/06/30,2,41,0.749917066,58601,2,12,29
2986,2014/03/31,2005/11/08,61,29,0.790481702,55553,61,20,9
2987,2014/03/31,2013/02/04,34,5,0.718,61160,34,1,4
2988,2014/03/31,2012/01/22,8,43,0.648530815,67711,8,17,26
2989,2014/03/31,2008/05/19,34,57,0.6587674029999999,66656,34,29,28
2990,2014/03/31,2011/01/20,93,27,0.70037037,62694,93,19,8
2991,2014/03/31,2009/01/07,1,61,0.681297831,64446,1,38,23
2992,2014/03/31,2005/11/19,7,34,0.764860254,57390,7,16,18
2993,2014/03/31,2005/04/20,16,31,0.8156527720000001,53809,16,20,11
2994,2014/03/31,2009/10/07,7,79,0.928292786,47270,7,38,41
2995,2014/03/31,2011/07/09,9,43,0.8102316690000001,54129,9,17,26
2996,2014/03/31,2008/08/15,10,27,0.715083082,61325,10,17,10
2997,2014/03/31,2011/08/09,48,6,0.793725426,55242,48,0,6
2998,2014/03/31,2011/06/26,12,31,0.925794398,47344,12,27,4
2999,2014/03/31,2005/11/20,11,36,0.667499124,65657,11,25,11
3000,2014/03/31,2008/05/25,106,25,0.766727932,57129,106,15,10
3001,2014/03/31,2009/11/16,19,58,0.8903573459999999,49196,19,34,24
3002,2014/03/31,2012/02/23,4,33,0.816042455,53657,4,17,16
3003,2014/03/31,2008/01/04,25,36,0.744190921,58820,25,17,19
3004,2014/03/31,2007/02/01,17,24,1.382805599,31651,17,14,10
3005,2014/03/31,2007/02/14,8,57,0.765416557,57171,8,19,38
3006,2014/03/31,2011/10/11,49,35,0.8216264529999999,53257,49,16,19
3007,2014/03/31,2012/01/07,8,20,0.799295098,54731,8,7,13
3008,2014/03/31,2012/12/26,1,51,0.825454065,52988,1,3,48
3009,2014/03/31,2006/05/22,30,40,0.698771151,62587,30,17,23
3010,2014/03/31,2011/12/15,11,80,0.807504478,54157,11,37,43
3011,2014/03/31,2010/07/09,110,41,0.7875094559999999,55522,110,22,19
3012,2014/03/31,2007/02/01,13,28,0.8592590990000001,50884,13,0,28
3013,2014/03/31,2007/12/28,162,25,1.456537744,30018,162,12,13
3014,2014/03/31,2007/03/14,21,47,0.6280176439999999,69599,21,22,25
3015,2014/03/31,2006/03/11,18,15,1.4792567769999998,29547,18,11,4
3016,2014/03/31,2012/10/19,22,41,0.761445502,57378,22,21,20
3017,2014/03/31,2007/06/04,86,18,0.8191413679999999,53329,86,8,10
3018,2014/03/31,2013/02/05,7,18,1.253288284,34851,7,1,17
3019,2014/03/31,2005/09/08,9,61,0.7451315340000001,58616,9,31,30
3020,2014/03/31,2005/11/26,26,54,1.01908183,42857,26,38,16
3021,2014/03/31,2006/05/30,25,46,0.965011269,45258,25,18,28
3022,2014/03/31,2009/03/12,109,43,0.920707961,47432,109,25,18
3023,2014/03/31,2004/11/08,30,55,0.75660955,57718,30,26,29
3024,2014/03/31,2010/12/02,105,26,0.6723700859999999,64947,105,15,11
3025,2014/03/31,2007/11/28,14,42,0.735478236,59364,14,18,24
3026,2014/03/31,2012/01/06,18,37,0.90702171,48135,18,21,16
3027,2014/03/31,2004/12/16,3,31,0.7510701999999999,58120,3,14,17
3028,2014/03/31,2011/11/15,21,46,0.8519798559999999,51231,21,27,19
3029,2014/03/31,2009/05/31,3,41,1.268779545,34397,3,20,21
3030,2014/03/31,2011/11/20,24,20,0.7452466999999999,58553,24,14,6
3031,2014/03/31,2009/09/15,71,28,1.373740869,31760,71,9,19
3032,2014/03/31,2011/10/24,25,43,0.82132057,53121,25,22,21
3033,2014/03/31,2010/11/01,19,36,0.712777778,61200,19,20,16
3034,2014/03/31,2006/11/06,18,54,0.7023426559999999,62109,18,24,30
3035,2014/03/31,2006/12/01,2,39,1.040744655,41912,2,18,21
3036,2014/03/31,2006/05/25,44,35,0.635242208,68660,44,23,12
3037,2014/03/31,2005/03/28,65,24,1.097152704,39750,65,17,7
3038,2014/03/31,2008/04/18,3,47,0.617153452,70654,3,24,23
3039,2014/03/31,2011/06/30,10,26,0.7080811640000001,61579,10,14,12
3040,2014/03/31,2013/03/12,3,21,1.237558255,35233,3,1,20
3041,2014/03/31,2012/02/12,6,47,0.675058927,64571,6,10,37
3042,2014/03/31,2011/12/22,2,53,0.819941293,53145,2,23,30
3043,2014/03/31,2012/07/12,13,21,1.301733987,33472,13,5,16
3044,2014/03/31,2009/12/01,11,22,0.709090909,61446,11,10,12
3045,2014/03/31,2006/07/12,21,49,0.77474711,56230,21,27,22
3046,2014/03/31,2009/10/26,2,36,0.67007677,64999,2,18,18
3047,2014/03/31,2005/06/19,5,40,0.6605321829999999,65936,5,17,23
3048,2014/03/31,2011/12/15,28,25,0.7777944509999999,55977,28,15,10
3049,2014/03/31,2010/05/13,8,22,0.8301378690000001,52441,8,8,14
3050,2014/03/31,2010/08/03,10,37,0.6435708689999999,67625,10,19,18
3051,2014/03/31,2005/04/07,4,46,0.6360995970000001,68416,4,21,25
3052,2014/03/31,2007/08/16,11,49,0.68179347,63826,11,24,25
3053,2014/03/31,2011/03/31,44,18,0.554306461,78496,44,13,5
3054,2014/03/31,2012/03/15,22,53,0.8083738090000001,53819,22,27,26
3055,2014/03/31,2012/12/21,2,24,1.413422899,30778,2,4,20
3056,2014/03/31,2009/12/03,16,40,0.822185072,52909,16,19,21
3057,2014/03/31,2008/12/15,4,31,0.848745217,51220,4,6,25
3058,2014/03/31,2011/04/11,1,52,0.631127775,68879,1,23,29
3059,2014/03/31,2012/09/30,2,55,0.7713251809999999,56347,2,19,36
3060,2014/03/31,2007/06/14,16,31,0.6941202679999999,62610,16,14,17
3061,2014/03/31,2008/08/30,19,36,1.320973311,32898,19,14,22
3062,2014/03/31,2012/06/18,66,44,0.800573182,54276,66,24,20
3063,2014/03/31,2004/12/23,11,27,1.235481614,35163,11,8,19
3064,2014/03/31,2006/05/25,23,25,0.6587827079999999,65925,23,11,14
3065,2014/03/31,2011/10/31,11,48,0.742260165,58509,11,28,20
3066,2014/03/31,2012/08/10,66,25,0.7100034359999999,61120,66,9,16
3067,2014/03/31,2006/06/20,3,40,0.824839703,52590,3,14,26
3068,2014/03/31,2006/07/02,11,32,0.76074076,57009,11,2,30
3069,2014/03/31,2010/08/26,7,36,0.740094723,58592,7,8,28
3070,2014/03/31,2006/05/26,18,31,0.739801065,58612,18,20,11
3071,2014/03/31,2012/04/12,32,48,0.803124085,53987,32,19,29
3072,2014/03/31,2005/12/17,13,41,0.721284897,60106,13,18,23
3073,2014/03/31,2013/01/10,2,23,0.591504157,73257,2,3,20
3074,2014/03/31,2010/07/08,78,30,0.929410352,46621,78,7,23
3075,2014/03/31,2006/07/30,87,22,0.7432003359999999,58297,87,9,13
3076,2014/03/31,2006/04/14,4,25,0.6157702039999999,70358,4,10,15
3077,2014/03/31,2011/08/15,18,39,0.6688669110000001,64761,18,23,16
3078,2014/03/31,2007/12/28,5,53,0.7041964909999999,61499,5,27,26
3079,2014/03/31,2006/06/22,19,67,0.746682472,57998,19,31,36
3080,2014/03/31,2011/10/20,286,5,0.708,61160,286,3,2
3081,2014/03/31,2005/08/11,5,38,0.613569556,70555,5,23,15
3082,2014/03/31,2008/01/13,39,25,0.662494221,65323,39,12,13
3083,2014/03/31,2005/11/24,7,47,0.8691553679999999,49785,7,22,25
3084,2014/03/31,2012/03/30,15,59,0.661964778,65356,15,25,34
3085,2014/03/31,2009/11/03,16,19,1.390726092,31098,16,12,7
3086,2014/03/31,2010/03/01,22,44,0.7407018540000001,58374,22,22,22
3087,2014/03/31,2011/08/04,6,48,0.550058401,78594,6,20,28
3088,2014/03/31,2012/05/16,129,23,0.724668097,59656,129,12,11
3089,2014/03/31,2009/07/09,21,33,0.756437673,57134,21,18,15
3090,2014/03/31,2009/12/01,9,46,0.645656462,66927,9,26,20
3091,2014/03/31,2009/10/21,3,44,0.7874213240000001,54877,3,25,19
3092,2014/03/31,2012/09/01,74,47,0.8609125329999999,50179,74,14,33
3093,2014/03/31,2009/08/03,26,35,0.6445252020000001,67018,26,19,16
3094,2014/03/31,2012/07/14,78,7,0.880189133,49066,78,5,2
3095,2014/03/31,2012/12/10,12,52,0.74728703,57778,12,18,34
3096,2014/03/31,2011/03/21,7,38,0.684188285,63064,7,14,24
3097,2014/03/31,2008/08/25,5,46,0.8194135640000001,52640,5,23,23
3098,2014/03/31,2008/07/25,124,28,0.908113641,47483,124,21,7
3099,2014/03/31,2010/02/04,4,49,0.824702822,52275,4,20,29
3100,2014/03/31,2007/06/11,3,36,0.908255383,47466,3,21,15
3101,2014/03/31,2012/05/30,3,56,0.577413897,74649,3,20,36
3102,2014/03/31,2009/09/11,104,27,1.445812425,29812,104,19,8
3103,2014/03/31,2012/06/19,95,11,1.120954016,38448,95,8,3
3104,2014/03/31,2008/07/19,126,16,1.337345602,32222,126,10,6
3105,2014/03/31,2012/05/22,18,48,0.767032026,56173,18,11,37
3106,2014/03/31,2005/01/21,27,39,0.6268643770000001,68720,27,20,19
3107,2014/03/31,2011/03/31,5,50,0.8951998170000001,48119,5,29,21
3108,2014/03/31,2012/11/16,35,34,1.314797167,32761,35,13,21
3109,2014/03/31,2010/02/05,74,55,0.718661917,59929,74,37,18
3110,2014/03/31,2010/07/01,9,27,0.582703152,73910,9,14,13
3111,2014/03/31,2012/03/31,95,37,0.7420547590000001,58036,95,31,6
3112,2014/03/31,2008/02/26,5,31,0.8317914540000001,51768,5,9,22
3113,2014/03/31,2008/04/10,6,52,0.8539327290000001,50423,6,26,26
3114,2014/03/31,2012/11/19,104,25,1.409586498,30544,104,7,18
3115,2014/03/31,2012/05/21,10,61,0.748196339,57533,10,27,34
3116,2014/03/31,2011/11/01,147,30,0.7293333329999999,59010,147,25,5
3117,2014/03/31,2008/08/22,22,42,0.893065253,48182,22,27,15
3118,2014/03/31,2007/12/07,37,42,0.662961867,64905,37,21,21
3119,2014/03/31,2012/12/07,7,50,0.762224998,56436,7,13,37
3120,2014/03/31,2006/03/04,28,33,0.7415218440000001,58002,28,18,15
3121,2014/03/31,2010/07/14,2,46,0.707908566,60743,2,27,19
3122,2014/03/31,2006/09/03,14,49,0.761973481,56413,14,17,32
3123,2014/03/31,2007/07/09,93,44,0.721347926,59573,93,18,26
3124,2014/03/31,2012/12/01,13,39,0.653992295,65669,13,11,28
3125,2014/03/31,2012/10/14,294,6,0.842516286,50964,294,3,3
3126,2014/03/31,2005/01/30,38,42,0.76920205,55818,38,23,19
3127,2014/03/31,2010/09/12,50,38,0.8015997309999999,53559,50,17,21
3128,2014/03/31,2011/10/27,8,47,0.752818448,57003,8,38,9
3129,2014/03/31,2011/03/09,21,64,0.7712925079999999,55636,21,43,21
3130,2014/03/31,2012/09/14,13,42,0.775359305,55343,13,16,26
3131,2014/03/31,2011/08/16,39,33,0.778722813,55082,39,10,23
3132,2014/03/31,2011/07/03,60,35,0.6740684920000001,63628,60,10,25
3133,2014/03/31,2007/02/18,7,46,0.898500555,47731,7,16,30
3134,2014/03/31,2005/09/01,4,37,0.777758915,55134,4,23,14
3135,2014/03/31,2004/11/30,55,58,0.619681778,69197,55,32,26
3136,2014/03/31,2006/06/14,84,24,0.7069526429999999,60646,84,11,13
3137,2014/03/31,2006/06/27,2,21,0.7606596640000001,56362,2,8,13
3138,2014/03/31,2009/07/28,1,49,0.732408515,58534,1,20,29
3139,2014/03/31,2005/06/21,6,51,0.7829472359999999,54753,6,13,38
3140,2014/03/31,2010/04/08,7,45,0.623447082,68748,7,10,35
3141,2014/03/31,2007/06/09,64,28,0.87166887,49159,64,19,9
3142,2014/03/31,2011/05/15,2,34,0.756069815,56664,2,17,17
3143,2014/03/31,2013/03/13,4,39,0.745903463,57429,4,2,37
3144,2014/03/31,2006/02/15,6,64,0.8617609540000001,49706,6,32,32
3145,2014/03/31,2005/06/28,17,28,1.087202071,39397,17,12,16
3146,2014/03/31,2011/08/01,92,31,0.99875341,42885,92,21,10
3147,2014/03/31,2012/03/22,7,40,0.723462871,59185,7,17,23
3148,2014/03/31,2007/06/01,17,39,0.93021008,46030,17,16,23
3149,2014/03/31,2007/01/04,57,47,0.776957137,55106,57,22,25
3150,2014/03/31,2007/03/24,6,21,1.388538626,30834,6,12,9
3151,2014/03/31,2009/04/14,37,24,0.931471715,45960,37,12,12
3152,2014/03/31,2010/05/10,17,28,0.918308448,46614,17,13,15
3153,2014/03/31,2012/12/29,3,26,0.7520880409999999,56905,3,5,21
3154,2014/03/31,2010/04/19,48,9,0.698475617,61251,48,4,5
3155,2014/03/31,2010/08/01,35,27,0.783047155,54628,35,12,15
3156,2014/03/31,2011/07/23,82,37,0.627063093,68201,82,14,23
3157,2014/03/31,2005/06/15,9,69,0.794331835,53834,9,39,30
3158,2014/03/31,2012/06/23,2,54,0.5984341360000001,71443,2,19,35
3159,2014/03/31,2006/04/25,12,27,0.6547015939999999,65297,12,10,17
3160,2014/03/31,2008/06/22,13,33,1.185359381,36062,13,0,33
3161,2014/03/31,2009/10/09,38,39,0.699112307,61136,38,22,17
3162,2014/03/31,2013/02/22,7,28,0.837937906,50987,7,3,25
3163,2014/03/31,2012/06/21,17,39,0.70174083,60879,17,10,29
3164,2014/03/31,2009/07/31,12,39,1.118270545,38197,12,16,23
3165,2014/03/31,2007/04/30,73,34,0.596664804,71582,73,13,21
3166,2014/03/31,2006/07/21,14,37,0.74283734,57494,14,20,17
3167,2014/03/31,2010/06/09,3,57,0.673447879,63410,3,47,10
3168,2014/03/31,2009/11/26,20,44,0.791576947,53946,20,23,21
3169,2014/03/31,2010/01/29,6,30,0.812740008,52540,6,5,25
3170,2014/03/31,2011/08/29,65,31,0.843534212,50611,65,16,15
3171,2014/03/31,2007/10/16,68,39,0.6831223390000001,62482,68,25,14
3172,2014/03/31,2007/06/12,26,44,0.700190834,60943,26,17,27
3173,2014/03/31,2010/03/24,1,52,0.7226676609999999,59018,1,31,21
3174,2014/03/31,2011/02/09,2,22,0.7636844079999999,55838,2,2,20
3175,2014/03/31,2006/01/26,11,36,0.814218255,52370,11,18,18
3176,2014/03/31,2009/11/06,12,43,0.780985805,54595,12,15,28
3177,2014/03/31,2012/05/08,1,40,0.8497123440000001,50164,1,12,28
3178,2014/03/31,2009/10/31,23,22,0.702746488,60652,23,7,15
3179,2014/03/31,2009/01/26,38,31,0.947905704,44965,38,9,22
3180,2014/03/31,2006/10/16,68,26,0.710885345,59954,68,15,11
3181,2014/03/31,2007/02/10,8,44,1.157924344,36798,8,18,26
3182,2014/03/31,2012/02/28,16,39,0.830035463,51321,16,27,12
3183,2014/03/31,2006/11/02,17,44,0.760353605,56023,17,18,26
3184,2014/03/31,2011/12/20,13,37,0.7388142240000001,57650,13,15,22
3185,2014/03/31,2012/03/24,7,40,0.712810403,59753,7,24,16
3186,2014/03/31,2009/04/15,225,44,0.777170958,54803,225,40,4
3187,2014/03/31,2012/12/25,44,52,0.744664813,57192,44,8,44
3188,2014/03/31,2004/12/28,122,29,0.979314064,43488,122,23,6
3189,2014/03/31,2012/05/10,25,45,0.770667753,55245,25,17,28
3190,2014/03/31,2012/11/04,4,30,1.09449748,38884,4,13,17
3191,2014/03/31,2009/12/10,43,38,0.768382053,55385,43,12,26
3192,2014/03/31,2007/12/09,52,38,0.706298196,60249,52,28,10
3193,2014/03/31,2008/10/30,248,24,0.78041374,54527,248,16,8
3194,2014/03/31,2008/04/04,79,18,1.338027487,31797,79,9,9
3195,2014/03/31,2006/07/18,13,44,0.75318828,56485,13,18,26
3196,2014/03/31,2007/06/29,2,40,0.686922294,61926,2,28,12
3197,2014/03/31,2008/11/08,57,23,1.257260663,33833,57,16,7
3198,2014/03/31,2012/05/08,37,46,0.68936023,61694,37,21,25
3199,2014/03/31,2012/05/23,382,25,0.7559999999999999,56250,382,25,0
3200,2014/03/31,2011/12/23,6,52,0.955341872,44505,6,20,32
3201,2014/03/31,2008/07/28,116,33,0.746352018,56963,116,22,11
3202,2014/03/31,2007/12/17,59,62,0.851980875,49882,59,41,21
3203,2014/03/31,2009/01/13,22,32,0.7183502940000001,59156,22,7,25
3204,2014/03/31,2005/04/13,171,19,0.893555401,47553,171,18,1
3205,2014/03/31,2004/11/27,5,60,0.666361541,63766,5,23,37
3206,2014/03/31,2012/11/18,32,17,0.810960408,52384,32,8,9
3207,2014/03/31,2011/05/30,18,41,0.690045482,61563,18,23,18
3208,2014/03/31,2007/04/14,104,23,1.463563381,29023,104,11,12
3209,2014/03/31,2012/02/24,10,34,0.911615049,46593,10,4,30
3210,2014/03/31,2010/05/20,1,51,0.7977511690000001,53241,1,22,29
3211,2014/03/31,2007/07/12,20,39,0.8212124140000001,51715,20,16,23
3212,2014/03/31,2012/05/28,1,22,0.80573643,52707,1,3,19
3213,2014/03/31,2007/04/01,1,40,0.7628825490000001,55666,1,19,21
3214,2014/03/31,2009/08/12,14,46,0.806663501,52642,14,26,20
3215,2014/03/31,2009/02/12,9,64,0.7056057179999999,60160,9,16,48
3216,2014/03/31,2012/08/10,237,5,0.6940000000000001,61160,237,2,3
3217,2014/03/31,2009/11/15,3,58,0.825726961,51392,3,26,32
3218,2014/03/31,2010/11/23,51,35,0.612732301,69242,51,18,17
3219,2014/03/31,2010/09/02,14,38,0.792521997,53529,14,24,14
3220,2014/03/31,2006/01/30,83,37,0.866225263,48965,83,13,24
3221,2014/03/31,2007/05/25,32,37,0.823279567,51519,32,27,10
3222,2014/03/31,2007/06/21,74,39,0.72935576,58146,74,32,7
3223,2014/03/31,2008/02/04,61,51,0.742530247,57113,61,39,12
3224,2014/03/31,2006/02/23,11,33,0.819751783,51729,11,16,17
3225,2014/03/31,2007/08/16,4,45,0.749825238,56534,4,10,35
3226,2014/03/31,2005/03/30,535,9,0.76064706,55729,535,9,0
3227,2014/03/31,2011/02/17,1,33,0.648639897,65348,1,13,20
3228,2014/03/31,2010/12/18,96,32,0.77247175,54868,96,15,17
3229,2014/03/31,2006/07/14,4,67,0.800388502,52947,4,30,37
3230,2014/03/31,2011/08/09,17,27,0.79972671,52984,17,14,13
3231,2014/03/31,2013/02/07,91,23,1.344286439,31518,91,6,17
3232,2014/03/31,2006/09/26,1,33,0.775525555,54628,1,16,17
3233,2014/03/31,2010/12/06,19,29,0.7037299370000001,60186,19,18,11
3234,2014/03/31,2006/12/24,68,42,0.879498702,48155,68,35,7
3235,2014/03/31,2008/05/12,2,45,0.7591587340000001,55785,2,24,21
3236,2014/03/31,2006/12/16,43,40,0.6716622259999999,63048,43,21,19
3237,2014/03/31,2011/03/01,37,23,0.730568815,57945,37,15,8
3238,2014/03/31,2008/12/17,28,46,0.665581465,63598,28,24,22
3239,2014/03/31,2007/08/09,11,46,0.7540073070000001,56110,11,28,18
3240,2014/03/31,2011/02/20,25,40,0.846733526,49956,25,24,16
3241,2014/03/31,2006/04/25,19,24,1.264095528,33456,19,12,12
3242,2014/03/31,2011/08/10,19,50,1.150412144,36759,19,27,23
3243,2014/03/31,2009/10/09,2,10,0.889144479,47550,2,5,5
3244,2014/03/31,2011/03/06,35,21,0.7965022420000001,53074,35,15,6
3245,2014/03/31,2012/05/23,1,39,1.267163969,33360,1,6,33
3246,2014/03/31,2008/08/08,353,7,0.964519316,43823,353,6,1
3247,2014/03/31,2005/09/22,18,46,0.6400514860000001,66038,18,16,30
3248,2014/03/31,2005/12/01,3,45,0.8407405490000001,50260,3,24,21
3249,2014/03/31,2007/01/13,38,40,0.749055226,56405,38,22,18
3250,2014/03/31,2011/10/19,6,65,0.893357368,47293,6,31,34
3251,2014/03/31,2010/12/06,95,35,0.645698741,65432,95,11,24
3252,2014/03/31,2007/10/19,6,48,0.706366038,59808,6,0,48
3253,2014/03/31,2012/03/05,4,56,0.666365716,63388,4,17,39
3254,2014/03/31,2007/02/09,4,41,0.8663476370000001,48752,4,36,5
3255,2014/03/31,2010/03/18,37,39,0.673168691,62742,37,14,25
3256,2014/03/31,2005/01/20,52,35,0.81315977,51931,52,28,7
3257,2014/03/31,2007/06/21,1,66,0.6110525929999999,69096,1,39,27
3258,2014/03/31,2009/11/04,56,28,0.678758522,62192,56,15,13
3259,2014/03/31,2012/06/20,2,42,1.120919207,37652,2,14,28
3260,2014/03/31,2010/02/15,31,33,0.796216017,53005,31,20,13
3261,2014/03/31,2005/11/29,13,48,0.87476149,48237,13,20,28
3262,2014/03/31,2007/08/27,38,47,0.8191876570000001,51493,38,20,27
3263,2014/03/31,2007/05/12,84,24,1.159408012,36369,84,16,8
3264,2014/03/31,2013/01/25,116,45,0.712656704,59156,116,7,38
3265,2014/03/31,2005/03/28,7,38,0.65609892,64254,7,16,22
3266,2014/03/31,2010/02/13,23,40,0.955218436,44132,23,29,11
3267,2014/03/31,2012/03/01,93,17,1.464060015,28793,93,10,7
3268,2014/03/31,2008/02/18,106,39,0.672952691,62631,106,29,10
3269,2014/03/31,2005/04/02,24,50,0.70976727,59382,24,21,29
3270,2014/03/31,2009/09/04,16,27,0.702740736,59962,16,7,20
3271,2014/03/31,2007/02/26,13,39,0.756102568,55729,13,23,16
3272,2014/03/31,2012/10/27,221,29,0.983453234,42841,221,20,9
3273,2014/03/31,2010/06/28,203,16,1.409734966,29883,203,13,3
3274,2014/03/31,2012/11/20,33,43,0.74885699,56255,33,11,32
3275,2014/03/31,2006/08/03,14,50,0.718688049,58615,14,26,24
3276,2014/03/31,2012/04/27,9,41,0.8340893070000001,50500,9,13,28
3277,2014/03/31,2009/06/18,5,44,0.661487403,63668,5,19,25
3278,2014/03/31,2012/04/21,114,34,0.8021087920000001,52504,114,15,19
3279,2014/03/31,2005/03/08,13,27,1.045584964,40276,13,16,11
3280,2014/03/31,2009/06/01,30,44,0.7014540579999999,60032,30,30,14
3281,2014/03/31,2011/02/23,19,36,0.678512915,62061,19,22,14
3282,2014/03/31,2006/06/01,65,21,0.86700976,48568,65,11,10
3283,2014/03/31,2006/03/05,6,40,0.696056082,60483,6,22,18
3284,2014/03/31,2012/06/13,63,29,0.693676449,60689,63,14,15
3285,2014/03/31,2009/11/19,3,49,0.8116079209999999,51862,3,22,27
3286,2014/03/31,2006/03/17,3,22,0.849983035,49513,3,12,10
3287,2014/03/31,2010/04/07,1,47,0.7693379770000001,54696,1,7,40
3288,2014/03/31,2006/08/08,81,39,0.876482951,48009,81,10,29
3289,2014/03/31,2011/03/13,94,28,0.775388528,54256,94,17,11
3290,2014/03/31,2008/09/02,16,37,0.695529727,60484,16,18,19
3291,2014/03/31,2005/01/04,14,38,0.8987993329999999,46799,14,12,26
3292,2014/03/31,2006/03/28,180,24,0.8235566129999999,51057,180,15,9
3293,2014/03/31,2008/09/24,84,25,0.807255918,52083,84,11,14
3294,2014/03/31,2007/05/18,12,56,0.617233209,68115,12,29,27
3295,2014/03/31,2005/03/16,21,49,0.564212843,74515,21,22,27
3296,2014/03/31,2008/12/19,1,28,0.677341368,62062,1,13,15
3297,2014/03/31,2006/12/15,3,51,0.716516423,58638,3,18,33
3298,2014/03/31,2012/10/17,11,42,0.952135086,44120,11,12,30
3299,2014/03/31,2004/11/08,3,35,0.804224886,52231,3,16,19
3300,2014/03/31,2009/08/08,33,41,0.663195484,63330,33,17,24
3301,2014/03/31,2005/03/03,66,40,0.67548796,62167,66,25,15
3302,2014/03/31,2009/12/08,7,35,0.73030087,57500,7,14,21
3303,2014/03/31,2006/03/21,12,49,0.790940161,53076,12,24,25
3304,2014/03/31,2005/04/26,39,32,0.794117814,52863,39,23,9
3305,2014/03/31,2005/12/09,11,43,0.7623333390000001,55067,11,20,23
3306,2014/03/31,2008/09/24,33,45,0.5956426920000001,70477,33,21,24
3307,2014/03/31,2010/06/17,31,52,0.803885803,52208,31,34,18
3308,2014/03/31,2009/09/07,21,40,0.819261241,51221,21,21,19
3309,2014/03/31,2006/03/02,8,58,0.632777149,66309,8,28,30
3310,2014/03/31,2010/03/18,8,80,0.7100759879999999,59088,8,28,52
3311,2014/03/31,2007/10/11,4,42,0.764036535,54906,4,21,21
3312,2014/03/31,2008/03/11,66,23,0.778438486,53890,66,11,12
3313,2014/03/31,2010/11/25,10,48,0.777502085,53945,10,15,33
3314,2014/03/31,2006/12/11,179,25,0.821155315,51077,179,14,11
3315,2014/03/31,2008/07/22,40,54,0.720862742,58175,40,21,33
3316,2014/03/31,2006/02/08,37,37,0.815743659,51408,37,13,24
3317,2014/03/31,2011/06/17,22,24,0.7243912379999999,57888,22,9,15
3318,2014/03/31,2007/06/11,13,34,0.758231347,55285,13,12,22
3319,2014/03/31,2006/09/15,46,30,1.47117612,28492,46,15,15
3320,2014/03/31,2012/04/03,47,47,0.6817373409999999,61479,47,27,20
3321,2014/03/31,2009/06/13,6,22,0.7662731540000001,54687,6,12,10
3322,2014/03/31,2006/10/31,42,38,0.708480452,59136,42,22,16
3323,2014/03/31,2011/10/13,2,67,0.5819465739999999,71988,2,31,36
3324,2014/03/31,2013/01/04,3,19,0.706842105,59261,3,3,16
3325,2014/03/31,2007/07/27,5,35,0.807939117,51837,5,9,26
3326,2014/03/31,2006/11/10,46,21,0.612995301,68317,46,11,10
3327,2014/03/31,2011/11/25,25,47,0.714297485,58618,25,18,29
3328,2014/03/31,2008/10/29,59,21,0.8061121809999999,51934,59,8,13
3329,2014/03/31,2011/08/01,3,65,0.731319242,57245,3,23,42
3330,2014/03/31,2006/03/11,34,21,0.688846692,60773,34,14,7
3331,2014/03/31,2006/07/30,6,51,0.684997218,61114,6,21,30
3332,2014/03/31,2005/06/04,9,41,0.723276991,57861,9,16,25
3333,2014/03/31,2007/07/13,14,42,0.791993603,52834,14,26,16
3334,2014/03/31,2006/04/12,9,32,0.773046507,54121,9,21,11
3335,2014/03/31,2012/10/17,129,15,0.654688645,63882,129,7,8
3336,2014/03/31,2011/07/22,109,24,1.441210628,29018,109,13,11
3337,2014/03/31,2011/04/21,5,20,0.682370281,61267,5,5,15
3338,2014/03/31,2008/10/16,61,19,0.696672277,60008,61,8,11
3339,2014/03/31,2006/01/21,61,29,0.892980155,46813,61,19,10
3340,2014/03/31,2010/09/01,128,52,0.902043763,46341,128,23,29
3341,2014/03/31,2006/02/27,21,37,0.941408752,44401,21,24,13
3342,2014/03/31,2004/12/25,5,26,0.6163812120000001,67810,5,17,9
3343,2014/03/31,2012/06/06,33,21,0.752857143,55503,33,9,12
3344,2014/03/31,2011/03/10,54,16,1.3275,31472,54,10,6
3345,2014/03/31,2007/02/18,5,52,0.8752293959999999,47734,5,26,26
3346,2014/03/31,2005/09/21,6,52,0.709762645,58857,6,23,29
3347,2014/03/31,2006/08/09,246,32,0.73487562,56842,246,22,10
3348,2014/03/31,2011/03/13,56,37,0.756167605,55237,56,20,17
3349,2014/03/31,2006/03/24,1,39,0.702504795,59438,1,19,20
3350,2014/03/31,2010/03/04,27,29,0.867235656,48138,27,13,16
3351,2014/03/31,2011/03/23,62,35,0.7105514409999999,58737,62,19,16
3352,2014/03/31,2005/10/10,6,63,0.63862023,65337,6,32,31
3353,2014/03/31,2009/01/21,301,39,0.8387655070000001,49737,301,32,7
3354,2014/03/31,2009/03/17,43,72,0.640120306,65167,43,31,41
3355,2014/03/31,2012/08/21,4,42,0.6460052039999999,64569,4,20,22
3356,2014/03/31,2011/11/15,2,23,0.645898603,64578,2,8,15
3357,2014/03/31,2010/06/26,5,40,0.854806739,48794,5,12,28
3358,2014/03/31,2005/10/28,58,49,0.7200804540000001,57921,58,20,29
3359,2014/03/31,2007/11/22,16,51,0.7858227179999999,53068,16,28,23
3360,2014/03/31,2012/09/01,137,13,0.899540964,46358,137,5,8
3361,2014/03/31,2006/04/04,6,40,0.731932997,56953,6,11,29
3362,2014/03/31,2011/01/06,26,49,0.81380255,51213,26,20,29
3363,2014/03/31,2011/08/25,68,50,0.647698691,64346,68,21,29
3364,2014/03/31,2007/03/29,6,56,0.777188998,53625,6,36,20
3365,2014/03/31,2012/01/27,283,28,0.7234002190000001,57611,283,22,6
3366,2014/03/31,2006/10/01,65,30,0.8168410220000001,51007,65,21,9
3367,2014/03/31,2006/09/30,5,32,0.602612803,69125,5,12,20
3368,2014/03/31,2010/03/25,3,63,0.710543643,58623,3,28,35
3369,2014/03/31,2004/12/01,1,33,0.623452777,66810,1,12,21
3370,2014/03/31,2009/03/06,64,43,0.8155328820000001,51062,64,18,25
3371,2014/03/31,2006/06/29,12,18,0.654444444,63630,12,9,9
3372,2014/03/31,2007/04/23,58,15,0.7509431409999999,55453,58,7,8
3373,2014/03/31,2008/06/20,17,23,0.6916226809999999,60209,17,6,17
3374,2014/03/31,2012/12/28,4,26,0.913364921,45588,4,5,21
3375,2014/03/31,2011/02/07,1,55,0.807693233,51544,1,5,50
3376,2014/03/31,2010/09/07,2,51,0.640327458,65016,2,20,31
3377,2014/03/31,2007/05/28,17,21,1.447211793,28764,17,12,9
3378,2014/03/31,2006/08/17,57,28,1.015885626,40971,57,17,11
3379,2014/03/31,2010/03/21,5,60,0.667493061,62327,5,25,35
3380,2014/03/31,2012/03/11,20,34,0.916826957,45376,20,20,14
3381,2014/03/31,2005/12/26,23,43,0.860561602,48326,23,22,21
3382,2014/03/31,2013/02/20,304,4,1.03,40376,304,2,2
3383,2014/03/31,2008/07/15,13,20,1.078650619,38551,13,5,15
3384,2014/03/31,2009/04/27,2,116,0.80098823,51911,2,44,72
3385,2014/03/31,2012/06/06,23,54,0.779655502,53324,23,26,28
3386,2014/03/31,2012/03/12,12,48,0.705291204,58945,12,26,22
3387,2014/03/31,2011/09/08,13,38,0.788800698,52689,13,10,28
3388,2014/03/31,2013/03/24,4,34,0.7385673909999999,56261,4,1,33
3389,2014/03/31,2009/12/21,33,26,1.415056191,29364,33,2,24
3390,2014/03/31,2009/11/09,9,37,0.764428214,54356,9,13,24
3391,2014/03/31,2009/10/22,18,48,0.74154556,56025,18,15,33
3392,2014/03/31,2009/12/18,25,42,0.7641785329999999,54354,25,16,26
3393,2014/03/31,2008/12/01,1,49,0.73486189,56513,1,16,33
3394,2014/03/31,2008/12/19,21,38,0.694855685,59765,21,13,25
3395,2014/03/31,2006/04/18,2,25,0.689218615,60252,2,5,20
3396,2014/03/31,2009/02/17,3,47,0.91875094,45194,3,27,20
3397,2014/03/31,2005/06/23,4,58,0.6585684829999999,63038,4,27,31
3398,2014/03/31,2011/07/06,233,38,0.7509109820000001,55281,233,22,16
3399,2014/03/31,2010/05/30,2,53,0.72038027,57617,2,28,25
3400,2014/03/31,2011/09/25,34,57,0.665170281,62397,34,45,12
3401,2014/03/31,2010/02/09,14,46,0.816640233,50819,14,21,25
3402,2014/03/31,2011/08/15,52,41,0.7834979609999999,52968,52,16,25
3403,2014/03/31,2011/05/15,8,47,0.6845202859999999,60609,8,15,32
3404,2014/03/31,2008/05/18,56,36,0.760742371,54528,56,19,17
3405,2014/03/31,2011/07/23,19,38,0.7090676920000001,58500,19,19,19
3406,2014/03/31,2007/06/13,1,43,0.862302604,48076,1,12,31
3407,2014/03/31,2008/06/28,4,40,0.748925565,55350,4,12,28
3408,2014/03/31,2007/09/16,27,35,1.240824776,33403,27,22,13
3409,2014/03/31,2009/11/06,42,53,0.814919967,50854,42,30,23
3410,2014/03/31,2007/10/10,1,37,0.766545128,54057,1,16,21
3411,2014/03/31,2006/05/30,106,38,0.917519488,45156,106,11,27
3412,2014/03/31,2008/11/22,57,32,0.776456455,53359,57,25,7
3413,2014/03/31,2009/07/10,9,50,0.7761363809999999,53380,9,19,31
3414,2014/03/31,2008/10/09,80,27,0.8272617809999999,50080,80,6,21
3415,2014/03/31,2005/02/19,42,20,1.204533903,34392,42,11,9
3416,2014/03/31,2011/09/14,16,46,0.7283168940000001,56877,16,18,28
3417,2014/03/31,2008/08/05,4,28,1.120087613,36981,4,17,11
3418,2014/03/31,2006/09/01,30,31,0.8062901029999999,51368,30,12,19
3419,2014/03/31,2012/10/15,12,20,0.691208733,59914,12,13,7
3420,2014/03/31,2005/11/09,48,40,0.663768599,62368,48,19,21
3421,2014/03/31,2011/11/21,49,56,0.655425946,63130,49,31,25
3422,2014/03/31,2010/12/13,10,56,0.732875363,56452,10,30,26
3423,2014/03/31,2009/09/24,11,46,0.7846562970000001,52720,11,9,37
3424,2014/03/31,2006/03/21,1,25,0.625874671,66082,1,9,16
3425,2014/03/31,2006/03/24,6,37,0.685360801,60338,6,15,22
3426,2014/03/31,2009/08/08,83,46,0.82870501,49900,83,25,21
3427,2014/03/31,2009/12/30,11,37,0.854636683,48360,11,15,22
3428,2014/03/31,2006/01/29,114,47,0.7230540390000001,57144,114,30,17
3429,2014/03/31,2010/10/12,29,40,0.887724489,46539,29,16,24
3430,2014/03/31,2006/02/21,21,37,0.611568044,67530,21,11,26
3431,2014/03/31,2011/03/16,12,55,0.720983415,57280,12,35,20
3432,2014/03/31,2005/08/26,12,31,0.747652662,55220,12,18,13
3433,2014/03/31,2012/08/18,62,44,0.6955042290000001,59358,62,18,26
3434,2014/03/31,2006/10/01,12,52,0.7005283170000001,58923,12,26,26
3435,2014/03/31,2010/04/30,11,19,1.270215424,32494,11,13,6
3436,2014/03/31,2008/11/07,24,41,0.6946481529999999,59415,24,23,18
3437,2014/03/31,2012/03/30,9,30,0.6861776490000001,60141,9,20,10
3438,2014/03/31,2011/11/08,13,39,0.5693723,72455,13,22,17
3439,2014/03/31,2009/06/15,12,36,0.7537812009999999,54726,12,16,20
3440,2014/03/31,2006/05/10,3,37,0.731507483,56392,3,26,11
3441,2014/03/31,2005/04/03,3,39,0.802179283,51416,3,19,20
3442,2014/03/31,2008/07/30,7,27,0.780637492,52832,7,18,9
3443,2014/03/31,2007/12/26,27,16,0.906875,45472,27,5,11
3444,2014/03/31,2011/09/19,4,25,0.805124304,51205,4,11,14
3445,2014/03/31,2013/01/05,4,31,0.7642465270000001,53917,4,7,24
3446,2014/03/31,2011/11/29,11,25,0.562190886,73290,11,16,9
3447,2014/03/31,2010/06/06,10,27,0.680131961,60548,10,9,18
3448,2014/03/31,2011/01/26,13,32,0.690201492,59655,13,10,22
3449,2014/03/31,2011/06/01,12,25,0.672202903,61251,12,11,14
3450,2014/03/31,2010/11/23,1,38,0.810384456,50799,1,17,21
3451,2014/03/31,2006/01/27,78,39,0.677067222,60799,78,16,23
3452,2014/03/31,2007/10/09,4,8,0.6774222,60765,4,1,7
3453,2014/03/31,2012/10/12,2,54,0.723369363,56898,2,17,37
3454,2014/03/31,2011/05/26,2,46,0.644957132,63801,2,19,27
3455,2014/03/31,2007/12/04,42,45,0.829948158,49574,42,23,22
3456,2014/03/31,2006/09/23,43,41,0.7955438020000001,51710,43,25,16
3457,2014/03/31,2013/02/04,3,32,0.727752539,56526,3,5,27
3458,2014/03/31,2010/03/07,7,31,0.679907273,60500,7,15,16
3459,2014/03/31,2009/11/07,15,36,0.661343452,62198,15,11,25
3460,2014/03/31,2012/05/25,10,43,0.7786462690000001,52817,10,23,20
3461,2014/03/31,2007/04/01,22,36,0.7481960590000001,54963,22,12,24
3462,2014/03/31,2006/08/17,6,40,0.616728655,66679,6,25,15
3463,2014/03/31,2012/12/30,8,36,0.502309609,81858,8,8,28
3464,2014/03/31,2006/03/06,38,51,0.680139643,60440,38,29,22
3465,2014/03/31,2012/08/10,191,37,0.7256377209999999,56647,191,30,7
3466,2014/03/31,2009/05/15,20,44,0.607245623,67685,20,34,10
3467,2014/03/31,2010/03/21,46,31,0.723175914,56812,46,13,18
3468,2014/03/31,2008/02/01,123,15,1.379882104,29772,123,12,3
3469,2014/03/31,2012/01/24,11,25,0.702053697,58514,11,6,19
3470,2014/03/31,2009/09/17,4,40,0.661857493,62046,4,13,27
3471,2014/03/31,2008/10/28,7,18,0.7320839720000001,56090,7,2,16
3472,2014/03/31,2011/04/06,3,29,0.641124055,64036,3,6,23
3473,2014/03/31,2009/11/18,18,55,0.6623341189999999,61972,18,35,20
3474,2014/03/31,2011/09/02,31,18,1.047222222,39186,31,11,7
3475,2014/03/31,2010/06/19,45,53,0.768654152,53379,45,34,19
3476,2014/03/31,2012/02/06,14,12,0.925027526,44322,14,5,7
3477,2014/03/31,2007/06/29,1,52,0.873859451,46916,1,17,35
3478,2014/03/31,2006/09/18,32,33,0.764669303,53614,32,15,18
3479,2014/03/31,2008/01/30,46,42,0.6907465079999999,59343,46,23,19
3480,2014/03/31,2006/09/12,1,33,0.8620865670000001,47547,1,10,23
3481,2014/03/31,2012/11/06,39,6,0.558333333,73392,39,4,2
3482,2014/03/31,2009/01/19,2,51,0.809186414,50640,2,22,29
3483,2014/03/31,2007/08/29,11,27,0.73658534,55619,11,16,11
3484,2014/03/31,2010/09/24,15,49,0.587039234,69786,15,14,35
3485,2014/03/31,2010/06/03,9,53,0.733525535,55844,9,28,25
3486,2014/03/31,2011/02/21,27,27,0.7348015,55743,27,12,15
3487,2014/03/31,2004/11/18,1,44,0.721196908,56788,1,17,27
3488,2014/03/31,2012/09/20,11,45,0.700180612,58468,11,24,21
3489,2014/03/31,2007/01/09,5,35,0.8965495490000001,45652,5,25,10
3490,2014/03/31,2012/05/03,115,22,0.673418788,60773,115,14,8
3491,2014/03/31,2009/11/22,37,27,0.754241765,54251,37,15,12
3492,2014/03/31,2010/03/11,22,34,0.727601985,56234,22,8,26
3493,2014/03/31,2012/10/05,6,55,0.8105798909999999,50475,6,22,33
3494,2014/03/31,2011/05/13,13,33,0.6859378559999999,59636,13,8,25
3495,2014/03/31,2006/06/05,16,31,0.8736767120000001,46819,16,9,22
3496,2014/03/31,2009/10/29,6,18,1.3935437819999998,29350,6,8,10
3497,2014/03/31,2012/04/13,69,33,0.822861397,49703,69,17,16
3498,2014/03/31,2009/09/25,1,37,0.705882749,57927,1,16,21
3499,2014/03/31,2005/07/25,10,27,0.737849602,55413,10,13,14
3500,2014/03/31,2011/07/26,72,28,0.789341069,51796,72,12,16
3501,2014/03/31,2013/03/15,3,56,0.71287037,57348,3,1,55
3502,2014/03/31,2012/04/25,25,25,1.42230804,28743,25,23,2
3503,2014/03/31,2010/05/02,13,67,0.7965636509999999,51319,13,38,29
3504,2014/03/31,2006/07/01,2,55,0.8618219779999999,47421,2,12,43
3505,2014/03/31,2007/03/04,5,34,0.765805926,53361,5,31,3
3506,2014/03/31,2009/08/08,78,40,0.789976019,51708,78,18,22
3507,2014/03/31,2007/09/10,2,27,0.66422322,61491,2,13,14
3508,2014/03/31,2010/08/03,119,20,1.413077322,28892,119,15,5
3509,2014/03/31,2011/02/17,2,41,0.787240116,51850,2,8,33
3510,2014/03/31,2012/11/19,23,28,0.789585228,51691,23,7,21
3511,2014/03/31,2006/08/28,27,44,0.89720102,45488,27,25,19
3512,2014/03/31,2011/11/27,108,27,0.827174622,49335,108,23,4
3513,2014/03/31,2009/03/12,6,42,0.825883782,49407,6,9,33
3514,2014/03/31,2012/10/29,6,13,0.686060428,59476,6,4,9
3515,2014/03/31,2007/07/30,111,19,0.7637542359999999,53417,111,11,8
3516,2014/03/31,2008/07/03,9,15,1.431145263,28500,9,3,12
3517,2014/03/31,2007/04/17,25,51,0.5944328329999999,68613,25,16,35
3518,2014/03/31,2006/07/04,12,31,0.752311127,54203,12,15,16
3519,2014/03/31,2005/10/29,24,35,0.7942868829999999,51338,24,22,13
3520,2014/03/31,2008/01/13,5,48,0.6139387510000001,66417,5,17,31
3521,2014/03/31,2009/11/11,12,37,0.667005235,61130,12,12,25
3522,2014/03/31,2006/10/18,16,55,0.68219653,59767,16,17,38
3523,2014/03/31,2012/11/15,10,34,0.972907229,41899,10,10,24
3524,2014/03/31,2009/10/20,20,50,0.7347242409999999,55465,20,40,10
3525,2014/03/31,2006/09/19,5,32,0.743568105,54805,5,17,15
3526,2014/03/31,2011/11/10,45,20,1.481980356,27490,45,15,5
3527,2014/03/31,2010/02/16,20,46,0.767305055,53092,20,27,19
3528,2014/03/31,2013/02/26,77,5,0.6659999999999999,61160,77,1,4
3529,2014/03/31,2012/03/16,28,42,0.78947697,51584,28,26,16
3530,2014/03/31,2006/11/10,22,45,1.1806024240000002,34494,22,23,22
3531,2014/03/31,2012/03/29,3,51,0.696854888,58424,3,20,31
3532,2014/03/31,2010/02/04,8,49,0.8327773,48882,8,21,28
3533,2014/03/31,2010/03/29,17,40,0.610659456,66661,17,5,35
3534,2014/03/31,2006/10/29,3,44,0.6841253890000001,59495,3,18,26
3535,2014/03/31,2006/05/03,23,48,0.718832745,56620,23,23,25
3536,2014/03/31,2008/07/16,23,51,0.778999158,52236,23,17,34
3537,2014/03/31,2011/11/13,6,37,0.688807706,59071,6,18,19
3538,2014/03/31,2010/08/24,124,34,0.6751181390000001,60268,124,25,9
3539,2014/03/31,2011/01/03,12,37,0.863405208,47119,12,5,32
3540,2014/03/31,2010/07/14,74,21,1.405709743,28933,74,10,11
3541,2014/03/31,2010/06/15,15,63,0.7735681809999999,52573,15,25,38
3542,2014/03/31,2009/07/25,51,41,0.7212355659999999,56379,51,24,17
3543,2014/03/31,2011/05/21,34,49,0.668505798,60795,34,20,29
3544,2014/03/31,2011/05/23,170,51,0.668825321,60757,170,32,19
3545,2014/03/31,2012/07/11,15,52,0.992426426,40945,15,17,35
3546,2014/03/31,2012/04/30,100,9,1.016423834,39959,100,6,3
3547,2014/03/31,2007/04/18,39,53,0.8167127829999999,49729,39,41,12
3548,2014/03/31,2009/05/30,1,71,0.655404267,61964,1,13,58
3549,2014/03/31,2008/01/17,9,50,0.646924057,62758,9,19,31
3550,2014/03/31,2012/08/24,26,51,0.845481224,48013,26,16,35
3551,2014/03/31,2011/11/18,2,43,0.501860465,80883,2,21,22
3552,2014/03/31,2011/05/17,31,34,0.8367191620000001,48512,31,14,20
3553,2014/03/31,2009/04/03,4,29,0.6862103540000001,59148,4,19,10
3554,2014/03/31,2011/09/26,2,40,0.786369414,51606,2,27,13
3555,2014/03/31,2009/08/16,151,45,0.774800466,52372,151,28,17
3556,2014/03/31,2012/01/31,20,26,0.755154894,53714,20,21,5
3557,2014/03/31,2012/06/23,49,65,0.499587927,81175,49,25,40
3558,2014/03/31,2013/01/01,66,30,0.798696209,50775,66,4,26
3559,2014/03/31,2006/09/20,11,55,0.661909892,61260,11,12,43
3560,2014/03/31,2007/05/22,13,24,1.202362186,33723,13,17,7
3561,2014/03/31,2010/01/09,9,51,0.8178364090000001,49575,9,37,14
3562,2014/03/31,2010/06/06,5,48,0.634352636,63913,5,21,27
3563,2014/03/31,2012/02/11,2,53,0.817007315,49621,2,38,15
3564,2014/03/31,2006/04/27,3,25,1.07004092,37879,3,7,18
3565,2014/03/31,2005/11/27,20,61,0.76920687,52690,20,38,23
3566,2014/03/31,2007/07/07,19,43,0.970873658,41744,19,30,13
3567,2014/03/31,2011/04/21,2,18,0.842777778,48078,2,8,10
3568,2014/03/31,2004/11/30,12,38,0.688290752,58868,12,15,23
3569,2014/03/31,2011/10/28,33,18,0.923943437,43845,33,8,10
3570,2014/03/31,2012/05/07,63,30,0.67037156,60421,63,5,25
3571,2014/03/31,2012/11/17,61,28,0.746134291,54285,61,9,19
3572,2014/03/31,2011/05/22,1,58,0.7683986340000001,52705,1,16,42
3573,2014/03/31,2008/11/18,5,36,0.759314334,53335,5,5,31
3574,2014/03/31,2011/01/12,83,42,0.7391476509999999,54778,83,19,23
3575,2014/03/31,2008/05/26,5,48,0.7480493220000001,54094,5,19,29
3576,2014/03/31,2013/02/09,13,10,0.629673729,64241,13,2,8
3577,2014/03/31,2012/03/06,13,55,0.918814029,44023,13,17,38
3578,2014/03/31,2009/11/17,2,75,0.836789283,48335,2,28,47
3579,2014/03/31,2006/02/23,20,35,0.7595509859999999,53250,20,18,17
3580,2014/03/31,2010/11/19,13,45,0.654952063,61748,13,29,16
3581,2014/03/31,2011/05/09,134,11,0.706298075,57254,134,7,4
3582,2014/03/31,2005/05/12,232,16,1.481210156,27294,232,10,6
3583,2014/03/31,2010/12/11,20,41,0.651775169,62011,20,20,21
3584,2014/03/31,2013/01/05,3,40,0.679356352,59489,3,5,35
3585,2014/03/31,2006/01/04,2,67,0.763561455,52925,2,19,48
3586,2014/03/31,2012/05/27,2,32,0.7976943120000001,50653,2,6,26
3587,2014/03/31,2010/11/22,5,67,0.799610695,50526,5,34,33
3588,2014/03/31,2010/11/17,2,57,0.622464166,64882,2,30,27
3589,2014/03/31,2007/03/28,9,49,0.8345481220000001,48387,9,23,26
3590,2014/03/31,2008/02/01,3,27,0.709762537,56893,3,12,15
3591,2014/03/31,2010/03/30,19,42,0.752382097,53667,19,24,18
3592,2014/03/31,2008/11/21,19,58,0.68684464,58773,19,28,30
3593,2014/03/31,2004/12/12,1,50,0.8677522679999999,46518,1,24,26
3594,2014/03/31,2008/04/07,7,30,0.710310421,56826,7,11,19
3595,2014/03/31,2010/04/01,1,37,0.682091255,59175,1,18,19
3596,2014/03/31,2007/05/01,110,25,0.948347471,42559,110,7,18
3597,2014/03/31,2010/07/29,7,33,0.7619145959999999,52972,7,19,14
3598,2014/03/31,2009/12/18,11,18,1.294848242,31168,11,4,14
3599,2014/03/31,2012/03/17,12,52,0.72297705,55817,12,21,31
3600,2014/03/31,2010/06/17,37,27,0.64669103,62388,37,18,9
3601,2014/03/31,2007/03/16,6,41,0.619403473,65127,6,12,29
3602,2014/03/31,2011/09/14,32,37,0.73489397,54890,32,11,26
3603,2014/03/31,2007/07/04,4,39,0.779087958,51752,4,14,25
3604,2014/03/31,2006/04/28,19,35,0.512317272,78696,19,15,20
3605,2014/03/31,2007/12/09,3,49,0.67452673,59765,3,16,33
3606,2014/03/31,2005/11/03,5,24,1.400131995,28789,5,14,10
3607,2014/03/31,2010/11/23,64,43,0.75247349,53564,64,32,11
3608,2014/03/31,2012/04/27,178,11,0.631639236,63798,178,7,4
3609,2014/03/31,2007/06/29,15,9,0.6795421509999999,59299,15,4,5
3610,2014/03/31,2009/09/17,16,46,0.8340931109999999,48308,16,26,20
3611,2014/03/31,2007/05/01,14,27,0.815487482,49407,14,14,13
3612,2014/03/31,2004/11/11,8,33,0.671128084,60031,8,11,22
3613,2014/03/31,2006/11/30,35,31,0.832016645,48422,35,11,20
3614,2014/03/31,2005/10/29,13,36,0.6860989609999999,58710,13,21,15
3615,2014/03/31,2008/04/06,34,26,0.8694670609999999,46328,34,6,20
3616,2014/03/31,2007/07/06,97,22,1.272608132,31651,97,13,9
3617,2014/03/31,2012/01/13,7,38,0.879252985,45809,7,22,16
3618,2014/03/31,2008/07/02,10,47,0.716850322,56174,10,24,23
3619,2014/03/31,2006/10/30,4,26,0.762356728,52819,4,6,20
3620,2014/03/31,2012/10/14,114,19,0.7597914859999999,52994,114,5,14
3621,2014/03/31,2009/11/15,30,33,0.6738325190000001,59744,30,16,17
3622,2014/03/31,2006/12/07,18,44,0.789580963,50974,18,13,31
3623,2014/03/31,2008/08/08,42,29,0.765062735,52602,42,19,10
3624,2014/03/31,2005/07/08,53,5,0.6579999999999999,61160,53,0,5
3625,2014/03/31,2006/04/13,25,32,0.76422253,52658,25,13,19
3626,2014/03/31,2006/10/07,35,46,0.607709419,66219,35,20,26
3627,2014/03/31,2011/10/21,58,20,0.7609999999999999,52860,58,8,12
3628,2014/03/31,2007/09/15,2,54,0.6477684539999999,62087,2,10,44
3629,2014/03/31,2012/05/26,1,41,0.521463415,77121,1,21,20
3630,2014/03/31,2009/01/08,4,37,0.698493355,57565,4,13,24
3631,2014/03/31,2010/04/18,4,35,0.8730103790000001,46054,4,0,35
3632,2014/03/31,2012/08/10,183,9,0.655110155,61368,183,8,1
3633,2014/03/31,2007/07/19,5,33,0.7056659120000001,56967,5,8,25
3634,2014/03/31,2008/04/10,14,15,0.631007538,63680,14,6,9
3635,2014/03/31,2010/11/21,118,29,0.7693182209999999,52231,118,22,7
3636,2014/03/31,2007/12/30,1,24,0.827742161,48542,1,3,21
3637,2014/03/31,2008/02/04,37,26,1.270371015,31616,37,9,17
3638,2014/03/31,2008/10/06,35,39,0.616254028,65174,35,18,21
3639,2014/03/31,2008/09/18,98,14,1.225576172,32768,98,5,9
3640,2014/03/31,2007/12/22,256,13,1.493416757,26891,256,11,2
3641,2014/03/31,2012/01/10,1,41,0.741705335,54136,1,15,26
3642,2014/03/31,2008/09/19,81,30,0.87462631,45907,81,10,20
3643,2014/03/31,2010/10/20,66,15,0.681921934,58873,66,6,9
3644,2014/03/31,2012/11/18,8,17,1.382901826,29030,8,2,15
3645,2014/03/31,2011/12/11,13,35,0.66080856,60750,13,15,20
3646,2014/03/31,2008/12/25,65,20,0.666060832,60264,65,9,11
3647,2014/03/31,2006/07/26,61,21,0.96738338,41481,61,12,9
3648,2014/03/31,2010/04/05,14,49,0.793727891,50546,14,26,23
3649,2014/03/31,2008/12/02,32,35,0.691367209,58016,32,20,15
3650,2014/03/31,2005/01/04,1,20,1.413274841,28380,1,8,12
3651,2014/03/31,2012/09/11,5,23,1.020452961,39297,5,6,17
3652,2014/03/31,2009/02/28,74,19,1.479467975,27104,74,12,7
3653,2014/03/31,2007/11/27,67,20,0.772625626,51900,67,7,13
3654,2014/03/31,2013/03/20,111,5,0.986912872,40630,111,1,4
3655,2014/03/31,2013/03/28,46,19,1.4211359609999998,28214,46,1,18
3656,2014/03/31,2007/05/04,33,26,0.912567546,43933,33,18,8
3657,2014/03/31,2009/04/24,2,35,0.937454324,42747,2,16,19
3658,2014/03/31,2008/12/04,2,43,0.9005033590000001,44501,2,25,18
3659,2014/03/31,2009/11/11,25,37,0.644668083,62154,25,21,16
3660,2014/03/31,2012/06/02,425,15,0.826666667,48450,425,15,0
3661,2014/03/31,2004/11/27,62,4,1.0357548559999998,38663,62,1,3
3662,2014/03/31,2005/04/22,12,32,0.82246272,48686,12,16,16
3663,2014/03/31,2009/11/17,300,11,1.26943812,31537,300,8,3
3664,2014/03/31,2005/03/09,68,35,0.743684514,53828,68,19,16
3665,2014/03/31,2011/12/01,21,41,0.7153241690000001,55943,21,20,21
3666,2014/03/31,2010/12/17,71,19,0.811927112,49281,71,12,7
3667,2014/03/31,2006/07/04,2,54,0.6784613820000001,58975,2,23,31
3668,2014/03/31,2012/03/30,2,24,0.793467,50424,2,10,14
3669,2014/03/31,2008/04/25,12,46,0.7562582720000001,52890,12,17,29
3670,2014/03/31,2006/10/09,49,26,0.807969334,49501,49,11,15
3671,2014/03/31,2008/02/19,48,35,0.722133093,55375,48,19,16
3672,2014/03/31,2010/11/23,21,41,0.7186689079999999,55631,21,35,6
3673,2014/03/31,2010/07/23,70,28,0.8119439820000001,49234,70,14,14
3674,2014/03/31,2012/04/24,9,45,0.715965321,55826,9,15,30
3675,2014/03/31,2005/05/20,25,27,0.697396737,57305,25,12,15
3676,2014/03/31,2007/12/14,196,8,0.6773502640000001,58987,196,4,4
3677,2014/03/31,2011/12/31,28,45,0.676920405,59024,28,15,30
3678,2014/03/31,2011/08/29,32,22,0.904503917,44166,32,12,10
3679,2014/03/31,2011/07/26,35,21,1.299543872,30737,35,10,11
3680,2014/03/31,2007/10/04,11,31,0.6820411890000001,58559,11,14,17
3681,2014/03/31,2005/10/08,14,36,0.724179573,55142,14,15,21
3682,2014/03/31,2009/11/25,44,40,0.6891201090000001,57939,44,24,16
3683,2014/03/31,2007/01/16,18,44,0.779193769,51226,18,20,24
3684,2014/03/31,2009/08/01,16,13,1.376649076,28992,16,2,11
3685,2014/03/31,2011/06/20,6,6,0.7943660909999999,50228,6,0,6
3686,2014/03/31,2005/10/21,21,19,1.463743121,27258,21,12,7
3687,2014/03/31,2008/03/21,14,29,0.753253724,52967,14,8,21
3688,2014/03/31,2006/07/10,2,44,0.683486962,58366,2,3,41
3689,2014/03/31,2013/02/10,2,29,0.8389625,47547,2,2,27
3690,2014/03/31,2012/11/21,1,61,0.7466265440000001,53420,1,11,50
3691,2014/03/31,2006/08/23,65,51,0.842882474,47317,65,29,22
3692,2014/03/31,2007/09/16,145,19,0.66135465,60296,145,10,9
3693,2014/03/31,2005/09/19,3,35,0.647852301,61517,3,15,20
3694,2014/03/31,2010/12/20,5,24,0.703508738,56650,5,7,17
3695,2014/03/31,2007/09/02,9,41,0.689176351,57828,9,27,14
3696,2014/03/31,2007/01/21,7,51,0.615955858,64701,7,25,26
3697,2014/03/31,2011/11/04,21,42,0.7322849640000001,54421,21,11,31
3698,2014/03/31,2012/05/15,44,41,0.849804453,46894,44,22,19
3699,2014/03/31,2009/08/16,43,33,0.762470003,52255,43,17,16
3700,2014/03/31,2006/12/21,47,22,0.775039015,51391,47,10,12
3701,2014/03/31,2007/05/18,1,25,0.562436982,70813,1,14,11
3702,2014/03/31,2011/01/19,1,26,0.674485095,59040,1,12,14
3703,2014/03/31,2009/07/20,47,21,0.784081163,50787,47,12,9
3704,2014/03/31,2009/12/12,126,16,0.875625,45472,126,8,8
3705,2014/03/31,2012/09/11,2,36,0.8129086529999999,48978,2,7,29
3706,2014/03/31,2008/07/20,10,41,0.777075851,51232,10,4,37
3707,2014/03/31,2011/10/18,21,30,0.7791078659999999,51091,21,16,14
3708,2014/03/31,2010/11/06,75,30,0.7697219209999999,51712,75,20,10
3709,2014/03/31,2007/09/23,1,58,0.7698325079999999,51704,1,11,47
3710,2014/03/31,2006/02/22,5,36,0.77918114,51071,5,10,26
3711,2014/03/31,2007/12/09,25,44,0.815988884,48757,25,24,20
3712,2014/03/31,2011/04/29,45,52,0.548788125,72491,45,26,26
3713,2014/03/31,2009/08/17,269,6,0.73816795,53885,269,2,4
3714,2014/03/31,2011/03/20,194,23,1.000974554,39731,194,14,9
3715,2014/03/31,2013/01/15,11,42,0.636325812,62490,11,3,39
3716,2014/03/31,2010/09/15,31,46,0.842188122,47214,31,31,15
3717,2014/03/31,2007/09/05,31,32,0.705270105,56367,31,11,21
3718,2014/03/31,2012/08/09,11,31,0.742204526,53558,11,11,20
3719,2014/03/31,2010/03/26,257,8,0.808996805,49133,257,5,3
3720,2014/03/31,2012/01/01,13,22,1.0110226409999998,39310,13,5,17
3721,2014/03/31,2006/04/01,14,34,0.7091128440000001,56033,14,11,23
3722,2014/03/31,2009/10/22,13,41,0.757813042,52429,13,18,23
3723,2014/03/31,2005/08/29,94,21,1.352303162,29377,94,15,6
3724,2014/03/31,2010/05/11,128,14,0.381284601,104188,128,13,1
3725,2014/03/31,2011/12/19,6,40,0.9426225,42143,6,19,21
3726,2014/03/31,2006/12/27,11,45,0.571751252,69476,11,26,19
3727,2014/03/31,2008/01/07,1,44,0.7284062440000001,54519,1,16,28
3728,2014/03/31,2013/02/26,25,42,0.773294257,51353,25,3,39
3729,2014/03/31,2007/03/25,86,15,1.448492266,27412,86,7,8
3730,2014/03/31,2007/04/06,18,27,0.6780453940000001,58554,18,11,16
3731,2014/03/31,2005/02/15,29,63,0.594168999,66817,29,34,29
3732,2014/03/31,2006/05/15,8,39,0.848892002,46760,8,16,23
3733,2014/03/31,2007/06/04,5,43,0.625446982,63459,5,19,24
3734,2014/03/31,2010/10/20,10,50,0.727085043,54584,10,20,30
3735,2014/03/31,2006/12/01,1,50,0.6223622679999999,63765,1,30,20
3736,2014/03/31,2012/06/10,74,16,0.8959272140000001,44294,74,3,13
3737,2014/03/31,2008/07/17,200,50,0.7456374840000001,53217,200,36,14
3738,2014/03/31,2012/07/07,2,54,0.637481402,62237,2,29,25
3739,2014/03/31,2008/08/01,294,30,0.7581352240000001,52328,294,28,2
3740,2014/03/31,2006/08/21,10,50,0.5710594370000001,69452,10,23,27
3741,2014/03/31,2005/09/01,9,36,0.662668672,59850,9,26,10
3742,2014/03/31,2013/03/24,78,7,0.697142857,56889,78,1,6
3743,2014/03/31,2006/11/14,2,51,0.7618565909999999,52047,2,28,23
3744,2014/03/31,2008/06/28,20,34,0.679668913,58323,20,16,18
3745,2014/03/31,2007/07/15,3,65,0.7917073370000001,50037,3,29,36
3746,2014/03/31,2007/08/30,1,40,0.769090803,51507,1,0,40
3747,2014/03/31,2012/11/22,2,56,0.73965865,53552,2,15,41
3748,2014/03/31,2009/03/07,2,46,0.673306363,58829,2,18,28
3749,2014/03/31,2006/02/19,93,24,0.965522377,41024,93,14,10
3750,2014/03/31,2007/03/21,19,21,0.674133828,58747,19,8,13
3751,2014/03/31,2011/01/07,22,18,0.815888243,48534,22,4,14
3752,2014/03/31,2007/09/28,72,24,0.669800873,59108,72,13,11
3753,2014/03/31,2009/04/25,110,22,1.13623913,34843,110,12,10
3754,2014/03/31,2012/02/27,8,51,0.7172738470000001,55195,8,22,29
3755,2014/03/31,2006/07/19,17,50,0.777118737,50936,17,14,36
3756,2014/03/31,2008/03/06,2,49,0.70683061,55995,2,10,39
3757,2014/03/31,2012/10/04,89,15,0.816666667,48450,89,3,12
3758,2014/03/31,2011/11/18,2,42,0.500714286,79002,2,20,22
3759,2014/03/31,2008/04/14,15,54,0.8005912,49408,15,20,34
3760,2014/03/31,2012/04/25,20,32,0.7595291409999999,52075,20,19,13
3761,2014/03/31,2011/07/19,4,52,0.748872458,52814,4,29,23
3762,2014/03/31,2009/11/16,16,35,0.908083626,43551,16,15,20
3763,2014/03/31,2011/06/09,5,28,0.835886033,47312,5,14,14
3764,2014/03/31,2011/12/12,8,37,0.736696916,53665,8,20,17
3765,2014/03/31,2009/09/04,1,63,0.7979844159999999,49539,1,16,47
3766,2014/03/31,2006/03/16,6,39,0.8199556090000001,48208,6,9,30
3767,2014/03/31,2009/10/09,8,50,0.7611981659999999,51921,8,19,31
3768,2014/03/31,2010/04/16,2,18,0.730851241,54074,2,8,10
3769,2014/03/31,2007/11/08,22,30,0.710483015,55609,22,16,14
3770,2014/03/31,2008/04/05,22,12,0.879954784,44896,22,2,10
3771,2014/03/31,2011/12/16,22,61,0.935697942,42217,22,35,26
3772,2014/03/31,2006/04/07,24,41,0.878569649,44961,24,21,20
3773,2014/03/31,2005/09/09,8,40,0.86909877,45449,8,18,22
3774,2014/03/31,2012/08/08,8,22,1.078831016,36613,8,13,9
3775,2014/03/31,2010/02/04,5,31,0.840339383,46997,5,13,18
3776,2014/03/31,2011/11/25,40,16,1.3407028090000002,29439,40,11,5
3777,2014/03/31,2007/11/20,21,39,0.6784842440000001,58169,21,20,19
3778,2014/03/31,2009/03/02,15,13,1.451458257,27190,15,6,7
3779,2014/03/31,2006/05/31,28,37,1.092412037,36123,28,17,20
3780,2014/03/31,2012/09/11,35,33,0.6980663420000001,56525,35,7,26
3781,2014/03/31,2012/08/01,8,36,0.640260139,61621,8,9,27
3782,2014/03/31,2005/11/30,10,24,1.012139815,38980,10,14,10
3783,2014/03/31,2009/11/26,11,42,0.957175406,41213,11,21,21
3784,2014/03/31,2011/09/16,120,57,0.828236505,47610,120,50,7
3785,2014/03/31,2009/10/03,5,47,0.749922025,52581,5,27,20
3786,2014/03/31,2009/04/14,39,40,0.8006323870000001,49242,39,15,25
3787,2014/03/31,2009/12/29,17,52,0.6722687740000001,58644,17,23,29
3788,2014/03/31,2007/04/29,21,46,0.665035435,59264,21,20,26
3789,2014/03/31,2007/10/20,13,39,0.7590243059999999,51922,13,14,25
3790,2014/03/31,2011/06/06,49,33,0.732248425,53811,49,15,18
3791,2014/03/31,2011/04/07,4,40,0.8025454209999999,49096,4,18,22
3792,2014/03/31,2008/07/14,6,39,0.729845145,53986,6,9,30
3793,2014/03/31,2009/02/19,2,49,0.7147617059999999,55100,2,14,35
3794,2014/03/31,2005/03/03,1,46,0.6670371999999999,59032,1,24,22
3795,2014/03/31,2007/04/06,32,42,0.882554985,44603,32,26,16
3796,2014/03/31,2013/01/05,123,17,0.824714807,47722,123,5,12
3797,2014/03/31,2008/08/05,3,36,0.794211068,49548,3,18,18
3798,2014/03/31,2011/11/23,36,7,0.89078936,44175,36,0,7
3799,2014/03/31,2007/10/22,97,43,0.56940481,69104,97,24,19
3800,2014/03/31,2012/09/26,74,22,0.767133025,51291,74,10,12
3801,2014/03/31,2008/10/16,4,43,0.8831030459999999,44553,4,19,24
3802,2014/03/31,2010/05/08,10,50,0.8011967740000001,49107,10,20,30
3803,2014/03/31,2010/04/12,1,29,0.6995378240000001,56234,1,1,28
3804,2014/03/31,2005/12/14,85,31,0.746594347,52683,85,15,16
3805,2014/03/31,2006/11/17,42,30,0.75720911,51944,42,11,19
3806,2014/03/31,2008/01/25,30,40,0.649179914,60579,30,26,14
3807,2014/03/31,2005/11/13,2,101,0.6916837570000001,56855,2,34,67
3808,2014/03/31,2007/08/25,3,45,0.573383494,68580,3,24,21
3809,2014/03/31,2010/10/08,59,34,0.751967107,52290,59,17,17
3810,2014/03/31,2007/01/09,2,57,0.745450029,52741,2,41,16
3811,2014/03/31,2008/12/10,12,33,0.702809975,55940,12,14,19
3812,2014/03/31,2012/12/02,56,6,0.6292360889999999,62468,56,0,6
3813,2014/03/31,2006/10/23,49,13,1.072307189,36655,49,1,12
3814,2014/03/31,2011/07/16,11,37,0.7770237040000001,50583,11,0,37
3815,2014/03/31,2012/04/12,71,40,0.72488593,54221,71,24,16
3816,2014/03/31,2007/05/27,1,36,0.89918619,43708,1,24,12
3817,2014/03/31,2012/01/18,6,42,0.801197822,49039,6,13,29
3818,2014/03/31,2006/03/31,20,27,0.666388215,58957,20,16,11
3819,2014/03/31,2007/10/11,70,28,0.970357143,40488,70,16,12
3820,2014/03/31,2011/11/21,123,17,1.350589954,29087,123,14,3
3821,2014/03/31,2010/06/01,21,60,0.656812549,59797,21,39,21
3822,2014/03/31,2007/03/02,72,39,0.78801565,49840,72,36,3
3823,2014/03/31,2012/03/18,119,15,0.723445531,54279,119,7,8
3824,2014/03/31,2006/03/26,9,38,0.786549486,49923,9,20,18
3825,2014/03/31,2011/06/21,13,39,0.611931055,64167,13,7,32
3826,2014/03/31,2012/03/14,7,23,0.7352173909999999,53406,7,8,15
3827,2014/03/31,2011/10/23,30,32,0.8087177640000001,48548,30,19,13
3828,2014/03/31,2009/12/31,35,33,0.927261474,42333,35,14,19
3829,2014/03/31,2010/03/02,86,26,0.777663048,50476,86,12,14
3830,2014/03/31,2011/04/18,7,46,0.600463836,65368,7,18,28
3831,2014/03/31,2009/04/17,5,39,0.6835870279999999,57418,5,22,17
3832,2014/03/31,2012/07/20,12,22,0.77051345,50930,12,8,14
3833,2014/03/31,2005/04/20,16,25,1.052450233,37274,16,8,17
3834,2014/03/31,2010/01/18,135,52,0.660651588,59378,135,37,15
3835,2014/03/31,2009/09/30,227,45,0.8768905379999999,44728,227,39,6
3836,2014/03/31,2006/06/27,32,35,0.66561458,58902,32,19,16
3837,2014/03/31,2010/08/09,89,32,0.823133595,47629,89,17,15
3838,2014/03/31,2012/06/03,36,33,0.755086962,51919,36,19,14
3839,2014/03/31,2005/11/08,72,56,0.8187457709999999,47878,72,21,35
3840,2014/03/31,2008/02/05,2,29,0.910349072,43057,2,19,10
3841,2014/03/31,2006/11/10,15,31,0.710102725,55196,15,16,15
3842,2014/03/31,2012/03/27,44,33,0.606873935,64570,44,17,16
3843,2014/03/31,2007/04/20,85,17,1.37613642,28471,85,11,6
3844,2014/03/31,2010/08/24,6,30,0.750235929,52219,6,8,22
3845,2014/03/31,2013/02/12,8,28,0.7395410259999999,52966,8,4,24
3846,2014/03/31,2006/04/06,93,15,0.928623094,42167,93,11,4
3847,2014/03/31,2005/12/01,5,30,0.7699844579999999,50831,5,8,22
3848,2014/03/31,2011/11/06,21,23,0.7383143120000001,53011,21,8,15
3849,2014/03/31,2006/03/27,65,32,0.690683832,56666,65,8,24
3850,2014/03/31,2007/04/02,88,38,0.759381051,51539,88,24,14
3851,2014/03/31,2007/01/14,34,27,0.830617942,47108,34,14,13
3852,2014/03/31,2009/03/16,77,47,0.633030303,61809,77,28,19
3853,2014/03/31,2008/05/02,5,56,0.579420861,67514,5,29,27
3854,2014/03/31,2006/05/16,4,53,0.656791544,59552,4,25,28
3855,2014/03/31,2011/07/07,19,50,0.702847233,55647,19,0,50
3856,2014/03/31,2012/06/06,18,51,0.842135165,46432,18,19,32
3857,2014/03/31,2011/05/11,2,47,0.84662798,46183,2,23,24
3858,2014/03/31,2005/09/17,53,27,0.670825554,58276,53,16,11
3859,2014/03/31,2006/11/15,20,42,0.7820176459999999,49984,20,24,18
3860,2014/03/31,2009/12/25,15,25,1.460736201,26759,15,14,11
3861,2014/03/31,2007/08/16,17,35,0.806006311,48489,17,14,21
3862,2014/03/31,2008/08/02,275,24,0.786393545,49697,275,18,6
3863,2014/03/31,2010/08/01,31,25,0.787301702,49635,31,8,17
3864,2014/03/31,2007/09/09,26,24,0.825299584,47349,26,13,11
3865,2014/03/31,2011/04/09,157,7,0.7341708640000001,53212,157,4,3
3866,2014/03/31,2009/02/21,7,40,0.650468381,60058,7,27,13
3867,2014/03/31,2008/07/23,17,20,0.748747196,52155,17,13,7
3868,2014/03/31,2005/09/09,11,58,0.744245664,52470,11,28,30
3869,2014/03/31,2009/09/30,2,41,0.759519354,51410,2,18,23
3870,2014/03/31,2010/01/05,12,27,0.766534926,50908,12,4,23
3871,2014/03/31,2012/06/26,6,18,0.774820992,50361,6,8,10
3872,2014/03/31,2012/03/28,371,7,0.610533563,63910,371,7,0
3873,2014/03/31,2011/11/15,68,36,0.856969031,45530,68,20,16
3874,2014/03/31,2010/02/22,32,35,1.020673102,38226,32,20,15
3875,2014/03/31,2009/01/09,7,35,0.735117542,53045,7,11,24
3876,2014/03/31,2007/10/30,2,30,0.987024756,39506,2,25,5
3877,2014/03/31,2005/03/03,128,46,0.648043478,60168,128,29,17
3878,2014/03/31,2006/07/13,124,28,0.881211964,44234,124,24,4
3879,2014/03/31,2008/06/24,67,21,0.625160266,62334,67,13,8
3880,2014/03/31,2008/10/28,80,45,0.8190549770000001,47565,80,22,23
3881,2014/03/31,2008/09/06,2,88,0.814303752,47835,2,37,51
3882,2014/03/31,2011/10/12,75,37,0.968527342,40213,75,11,26
3883,2014/03/31,2007/09/03,28,23,0.724289196,53756,28,15,8
3884,2014/03/31,2010/08/27,22,30,0.7790783020000001,49973,22,14,16
3885,2014/03/31,2009/02/25,13,22,0.6935669740000001,56126,13,9,13
3886,2014/03/31,2007/05/04,16,30,0.676110474,57570,16,19,11
3887,2014/03/31,2012/12/16,76,5,0.768,50680,76,2,3
3888,2014/03/31,2006/12/07,20,27,1.178734365,33019,20,18,9
3889,2014/03/31,2008/04/24,14,32,0.93541886,41601,14,15,17
3890,2014/03/31,2012/06/01,643,4,1.006199726,38663,643,4,0
3891,2014/03/31,2007/07/27,3,27,0.8007599990000001,48579,3,15,12
3892,2014/03/31,2007/06/12,115,5,0.636,61160,115,3,2
3893,2014/03/31,2011/01/06,59,48,0.647652896,60057,59,27,21
3894,2014/03/31,2012/08/07,88,30,0.629321175,61798,88,16,14
3895,2014/03/31,2012/05/27,53,21,0.758500507,51244,53,10,11
3896,2014/03/31,2013/01/21,217,6,0.965327472,40263,217,3,3
3897,2014/03/31,2012/07/31,38,31,0.653338713,59484,38,15,16
3898,2014/03/31,2007/06/02,123,52,0.618005249,62875,123,38,14
3899,2014/03/31,2011/09/14,57,27,1.111935207,34942,57,15,12
3900,2014/03/31,2011/10/11,18,53,0.610662182,63623,18,18,35
3901,2014/03/31,2011/05/11,6,37,0.757611888,51279,6,21,16
3902,2014/03/31,2012/10/29,3,21,0.7293375390000001,53256,3,0,21
3903,2014/03/31,2012/01/24,20,61,0.629071839,61735,20,28,33
3904,2014/03/31,2006/03/10,22,44,0.72481243,53580,22,28,16
3905,2014/03/31,2011/08/01,17,31,0.69673168,55732,17,12,19
3906,2014/03/31,2010/11/06,22,41,0.54972011,70635,22,22,19
3907,2014/03/31,2006/01/23,4,44,0.75058115,51725,4,23,21
3908,2014/03/31,2007/12/26,4,29,0.7994336670000001,48558,4,10,19
3909,2014/03/31,2011/11/24,1,61,0.6987652120000001,55548,1,35,26
3910,2014/03/31,2006/08/22,56,30,0.92513348,41954,56,15,15
3911,2014/03/31,2006/03/08,2,53,0.8026562979999999,48353,2,28,25
3912,2014/03/31,2012/12/20,9,29,0.62782098,61803,9,8,21
3913,2014/03/31,2010/04/13,16,45,0.660042868,58785,16,29,16
3914,2014/03/31,2009/11/02,9,36,0.940999951,41232,9,23,13
3915,2014/03/31,2005/02/10,19,47,0.795116365,48769,19,24,23
3916,2014/03/31,2006/05/22,217,4,0.7925,48928,217,2,2
3917,2014/03/31,2006/08/05,18,42,0.742327647,52233,18,27,15
3918,2014/03/31,2007/06/23,17,29,0.7125742009999999,54413,17,17,12
3919,2014/03/31,2008/02/11,6,26,1.069318439,36255,6,11,15
3920,2014/03/31,2005/12/24,8,40,0.7086885940000001,54697,8,22,18
3921,2014/03/31,2012/02/15,7,56,0.761637585,50892,7,15,41
3922,2014/03/31,2008/05/21,11,57,0.7304538,53063,11,29,28
3923,2014/03/31,2008/03/08,8,36,0.6724544929999999,57629,8,18,18
3924,2014/03/31,2009/10/21,26,33,0.676561682,57278,26,10,23
3925,2014/03/31,2012/03/17,329,26,0.757692308,51142,329,22,4
3926,2014/03/31,2005/12/08,12,34,0.759482762,51021,12,16,18
3927,2014/03/31,2005/06/21,2,22,1.4428866130000002,26855,2,6,16
3928,2014/03/31,2010/10/09,79,30,0.801567122,48337,79,13,17
3929,2014/03/31,2009/10/26,6,27,0.814060405,47579,6,16,11
3930,2014/03/31,2012/08/26,17,32,0.78888366,49089,17,15,17
3931,2014/03/31,2008/03/06,13,41,0.742943795,52113,13,23,18
3932,2014/03/31,2009/12/01,4,46,0.641991109,60288,4,24,22
3933,2014/03/31,2007/02/01,11,48,0.7287464920000001,53099,11,18,30
3934,2014/03/31,2011/10/11,10,42,0.675833435,57239,10,17,25
3935,2014/03/31,2008/08/15,23,15,1.070619396,36132,23,0,15
3936,2014/03/31,2006/12/11,3,28,0.99457805,38879,3,12,16
3937,2014/03/31,2006/02/24,44,26,1.104797703,34998,44,14,12
3938,2014/03/31,2005/06/03,12,37,0.625701708,61785,12,12,25
3939,2014/03/31,2006/04/20,15,48,0.801094003,48254,15,25,23
3940,2014/03/31,2007/07/10,31,43,0.818188265,47242,31,29,14
3941,2014/03/31,2009/11/19,34,31,0.7563806470000001,51092,34,26,5
3942,2014/03/31,2012/06/14,18,39,0.573360584,67399,18,7,32
3943,2014/03/31,2005/05/09,13,31,0.695115936,55591,13,12,19
3944,2014/03/31,2007/03/14,50,33,0.688711724,56106,50,17,16
3945,2014/03/31,2011/05/16,1,24,0.735049275,52562,1,7,17
3946,2014/03/31,2011/11/21,32,53,0.745902526,51788,32,22,31
3947,2014/03/31,2011/11/14,10,15,0.910243655,42437,10,13,2
3948,2014/03/31,2006/08/31,18,39,0.659944813,58528,18,12,27
3949,2014/03/31,2010/11/02,213,4,0.9525,40544,213,2,2
3950,2014/03/31,2011/02/01,19,33,0.915579951,42176,19,17,16
3951,2014/03/31,2010/01/16,76,5,0.74865643,51579,76,2,3
3952,2014/03/31,2011/05/07,78,28,0.785559963,49155,78,19,9
3953,2014/03/31,2009/12/18,55,27,0.888342843,43466,55,15,12
3954,2014/03/31,2012/03/15,281,38,0.836735795,46146,281,36,2
3955,2014/03/31,2011/07/28,11,34,0.780609749,49463,11,20,14
3956,2014/03/31,2012/03/09,1,34,0.658923426,58584,1,13,21
3957,2014/03/31,2008/08/07,6,31,0.8820400420000001,43754,6,10,21
3958,2014/03/31,2005/07/02,8,28,0.67439928,57223,8,13,15
3959,2014/03/31,2011/04/04,84,39,0.73025641,52845,84,17,22
3960,2014/03/31,2012/05/09,24,24,0.93232167,41384,24,5,19
3961,2014/03/31,2009/11/19,218,6,0.981422466,39312,218,4,2
3962,2014/03/31,2008/12/08,2,41,0.664179307,58079,2,26,15
3963,2014/03/31,2012/04/20,22,25,0.685531854,56256,22,19,6
3964,2014/03/31,2012/06/07,83,20,1.118026964,34490,83,10,10
3965,2014/03/31,2012/01/13,31,34,0.807807688,47735,31,2,32
3966,2014/03/31,2011/09/11,12,29,0.704204182,54755,12,4,25
3967,2014/03/31,2005/03/09,2,38,0.8312171509999999,46387,2,15,23
3968,2014/03/31,2009/03/07,33,24,0.993165988,38822,33,16,8
3969,2014/03/31,2009/10/12,13,39,0.706539681,54547,13,15,24
3970,2014/03/31,2005/08/15,75,11,0.739895355,52081,75,4,7
3971,2014/03/31,2012/01/10,224,3,1.05,36696,224,1,2
3972,2014/03/31,2012/05/01,46,19,0.712973613,54042,46,11,8
3973,2014/03/31,2007/10/31,2,47,0.8279087959999999,46533,2,20,27
3974,2014/03/31,2007/08/12,5,51,0.599831839,64224,5,20,31
3975,2014/03/31,2012/09/19,11,40,0.798693344,48230,11,11,29
3976,2014/03/31,2006/03/21,21,19,1.409157063,27333,21,3,16
3977,2014/03/31,2009/08/07,61,14,1.257375535,30631,61,6,8
3978,2014/03/31,2011/03/22,14,24,0.736640782,52283,14,9,15
3979,2014/03/31,2008/02/12,47,16,1.450449836,26543,47,9,7
3980,2014/03/31,2012/06/06,21,53,0.632654976,60848,21,26,27
3981,2014/03/31,2012/06/25,4,41,0.799514414,48148,4,13,28
3982,2014/03/31,2007/11/23,172,14,0.7723030320000001,49843,172,11,3
3983,2014/03/31,2011/01/30,11,29,0.841173051,45761,11,19,10
3984,2014/03/31,2013/03/09,12,25,0.790457953,48695,12,2,23
3985,2014/03/31,2011/08/01,11,51,0.783878174,49103,11,30,21
3986,2014/03/31,2012/05/22,31,39,0.713118885,53968,31,13,26
3987,2014/03/31,2011/10/31,8,26,1.105908843,34797,8,14,12
3988,2014/03/31,2010/01/05,66,41,0.798899155,48163,66,21,20
3989,2014/03/31,2012/05/15,157,27,0.776456912,49550,157,19,8
3990,2014/03/31,2006/01/16,6,54,0.8313242000000001,46277,6,35,19
3991,2014/03/31,2009/04/04,2,37,0.708843213,54271,2,22,15
3992,2014/03/31,2013/01/03,27,7,0.722768924,53212,27,2,5
3993,2014/03/31,2006/01/25,69,52,0.849705655,45253,69,38,14
3994,2014/03/31,2006/03/26,6,35,0.820343275,46872,6,13,22
3995,2014/03/31,2007/08/02,30,65,0.7809029609999999,49238,30,39,26
3996,2014/03/31,2008/06/01,9,62,0.73232866,52498,9,23,39
3997,2014/03/31,2012/07/21,14,20,0.899573154,42732,14,13,7
3998,2014/03/31,2006/10/14,65,51,0.617046954,62295,65,34,17
3999,2014/03/31,2007/05/08,67,33,0.774481967,49630,67,23,10
4000,2014/03/31,2011/05/13,7,7,0.607021545,63308,7,2,5
4001,2014/03/31,2008/04/17,271,18,0.418671585,91771,271,12,6
4002,2014/03/31,2013/01/26,11,51,0.689898007,55690,11,4,47
4003,2014/03/31,2006/08/20,7,53,0.5590507579999999,68718,7,26,27
4004,2014/03/31,2008/01/19,90,4,0.785,48928,90,1,3
4005,2014/03/31,2006/06/29,11,37,0.829441289,46303,11,21,16
4006,2014/03/31,2010/07/16,4,37,0.762379137,50367,4,7,30
4007,2014/03/31,2008/11/01,26,24,0.7025067709999999,54644,26,10,14
4008,2014/03/31,2009/08/05,20,31,0.708486398,54182,20,20,11
4009,2014/03/31,2008/11/25,60,19,1.348387845,28465,60,6,13
4010,2014/03/31,2011/05/24,11,42,0.750466572,51139,11,21,21
4011,2014/03/31,2008/02/26,144,21,0.827120748,46394,144,9,12
4012,2014/03/31,2008/07/01,6,59,0.735236188,52183,6,13,46
4013,2014/03/31,2008/08/18,60,23,0.7524569940000001,50981,60,17,6
4014,2014/03/31,2013/03/01,61,11,0.5700112970000001,67276,61,4,7
4015,2014/03/31,2006/09/20,19,18,1.362235645,28144,19,4,14
4016,2014/03/31,2009/10/23,153,30,0.814456152,47072,153,19,11
4017,2014/03/31,2008/08/25,10,25,0.719584632,53278,10,8,17
4018,2014/03/31,2007/04/26,1,73,0.759513771,50470,1,18,55
4019,2014/03/31,2006/11/28,50,20,1.407993827,27216,50,8,12
4020,2014/03/31,2008/02/16,9,35,0.726895007,52699,9,19,16
4021,2014/03/31,2011/10/17,4,44,0.7735364920000001,49518,4,14,30
4022,2014/03/31,2010/06/15,18,26,0.6962503640000001,54992,18,18,8
4023,2014/03/31,2005/04/30,85,50,0.789436666,48497,85,33,17
4024,2014/03/31,2011/12/28,20,42,0.707372,54121,20,14,28
4025,2014/03/31,2009/12/16,18,47,0.573776565,66722,18,12,35
4026,2014/03/31,2009/07/22,7,50,0.810918123,47205,7,23,27
4027,2014/03/31,2008/08/13,61,50,0.671576547,56998,61,34,16
4028,2014/03/31,2011/06/15,7,42,0.661768927,57826,7,13,29
4029,2014/03/31,2008/03/12,326,7,0.614083965,62312,326,6,1
4030,2014/03/31,2013/02/21,7,20,0.72980832,52431,7,1,19
4031,2014/03/31,2008/12/18,8,42,0.7010654479999999,54578,8,17,25
4032,2014/03/31,2008/08/12,1,30,0.723986072,52844,1,9,21
4033,2014/03/31,2006/06/29,71,32,0.797624945,47961,71,8,24
4034,2014/03/31,2011/11/04,23,24,1.207187007,31678,23,8,16
4035,2014/03/31,2005/02/11,23,36,0.686064515,55739,23,17,19
4036,2014/03/31,2011/04/01,19,30,0.590997929,64704,19,17,13
4037,2014/03/31,2009/03/27,61,30,0.8619160109999999,44363,61,18,12
4038,2014/03/31,2006/12/03,6,38,0.6187939020000001,61786,6,20,18
4039,2014/03/31,2011/11/03,15,41,0.85764694,44576,15,24,17
4040,2014/03/31,2009/09/28,80,42,0.614115228,62242,80,26,16
4041,2014/03/31,2006/10/17,66,25,0.844223209,45276,66,18,7
4042,2014/03/31,2009/02/19,212,4,1.020210358,37460,212,3,1
4043,2014/03/31,2012/08/23,34,32,0.761723217,50162,34,14,18
4044,2014/03/31,2008/08/28,9,35,0.7306770840000001,52283,9,15,20
4045,2014/03/31,2007/12/20,16,47,0.769100848,49669,16,31,16
4046,2014/03/31,2010/12/16,169,6,0.877608556,43526,169,4,2
4047,2014/03/31,2005/11/08,77,44,0.8223936959999999,46447,77,26,18
4048,2014/03/31,2011/05/30,137,30,0.619097997,61696,137,19,11
4049,2014/03/31,2008/04/15,58,27,1.45451253,26258,58,20,7
4050,2014/03/31,2012/04/23,144,18,0.7397635,51628,144,10,8
4051,2014/03/31,2011/03/26,81,16,0.929093475,41102,81,11,5
4052,2014/03/31,2006/01/25,91,22,1.236976609,30866,91,10,12
4053,2014/03/31,2010/06/10,4,41,0.979158716,38988,4,37,4
4054,2014/03/31,2008/12/19,5,38,0.73419281,51989,5,15,23
4055,2014/03/31,2012/10/12,15,39,0.51274602,74435,15,13,26
4056,2014/03/31,2010/11/21,74,4,0.78,48928,74,1,3
4057,2014/03/31,2008/08/18,50,17,0.780093825,48921,50,9,8
4058,2014/03/31,2010/05/15,10,47,0.6770298220000001,56367,10,19,28
4059,2014/03/31,2012/03/29,70,56,0.807954555,47222,70,31,25
4060,2014/03/31,2005/08/14,39,26,0.807336962,47213,39,15,11
4061,2014/03/31,2011/11/14,16,45,0.6091069920000001,62575,16,17,28
4062,2014/03/31,2010/07/14,28,37,0.880359115,43273,28,8,29
4063,2014/03/31,2011/03/05,73,48,0.652511519,58383,73,27,21
4064,2014/03/31,2012/08/17,63,8,0.625991257,60852,63,2,6
4065,2014/03/31,2006/09/01,1,31,0.656667816,58001,1,3,28
4066,2014/03/31,2010/01/24,13,19,1.3461336730000002,28293,13,4,15
4067,2014/03/31,2012/01/13,44,14,0.842142857,45220,44,10,4
4068,2014/03/31,2010/08/09,31,30,0.688115287,55340,31,7,23
4069,2014/03/31,2010/07/02,8,46,0.7638643159999999,49851,8,27,19
4070,2014/03/31,2005/08/11,45,27,0.7401971079999999,51444,45,13,14
4071,2014/03/31,2012/03/16,30,16,0.8896997170000001,42793,30,9,7
4072,2014/03/31,2006/06/28,6,36,0.78010267,48797,6,15,21
4073,2014/03/31,2007/01/12,21,38,0.7227833579999999,52663,21,1,37
4074,2014/03/31,2012/01/23,4,81,0.6933244679999999,54893,4,47,34
4075,2014/03/31,2006/08/17,17,30,0.977189707,38939,17,18,12
4076,2014/03/31,2008/03/02,77,17,0.8011764709999999,47481,77,11,6
4077,2014/03/31,2010/12/15,86,36,0.6698529639999999,56789,86,24,12
4078,2014/03/31,2006/06/13,42,24,0.716539005,53083,42,12,12
4079,2014/03/31,2008/11/12,7,33,0.756075987,50298,7,17,16
4080,2014/03/31,2005/07/06,17,38,0.71430077,53230,17,13,25
4081,2014/03/31,2012/05/01,48,39,0.659805626,57621,48,10,29
4082,2014/03/31,2012/06/26,71,29,0.63575074,59801,71,18,11
4083,2014/03/31,2010/03/06,88,43,0.730714931,52019,88,36,7
4084,2014/03/31,2012/02/14,264,38,0.74155853,51247,264,34,4
4085,2014/03/31,2011/09/01,81,37,0.9266761,40991,81,19,18
4086,2014/03/31,2005/10/25,14,32,0.604521525,62835,14,16,16
4087,2014/03/31,2011/04/22,624,4,1.029850325,36880,624,4,0
4088,2014/03/31,2007/07/12,22,30,0.831116023,45698,22,14,16
4089,2014/03/31,2011/05/20,3,48,0.731957984,51885,3,19,29
4090,2014/03/31,2010/01/07,94,21,1.003646987,37823,94,7,14
4091,2014/03/31,2012/03/15,6,36,0.7419590709999999,51162,6,16,20
4092,2014/03/31,2008/12/12,9,46,0.771075579,49220,9,14,32
4093,2014/03/31,2011/09/12,35,41,0.7373569990000001,51468,35,32,9
4094,2014/03/31,2005/06/10,13,17,1.450383865,26155,13,9,8
4095,2014/03/31,2006/06/02,12,30,0.67839927,55912,12,20,10
4096,2014/03/31,2011/08/27,7,45,0.578866571,65518,7,18,27
4097,2014/03/31,2007/03/05,44,36,0.796289212,47626,44,13,23
4098,2014/03/31,2009/07/11,199,4,0.775,48928,199,2,2
4099,2014/03/31,2010/03/18,9,45,0.877916647,43190,9,11,34
4100,2014/03/31,2011/06/20,72,37,0.8265607079999999,45867,72,23,14
4101,2014/03/31,2011/12/20,109,16,1.2483618159999998,30369,109,4,12
4102,2014/03/31,2010/05/16,139,18,0.804562569,47116,139,10,8
4103,2014/03/31,2006/02/16,62,40,0.6823319529999999,55550,62,15,25
4104,2014/03/31,2011/01/27,8,34,0.592647059,63954,8,16,18
4105,2014/03/31,2007/06/28,67,26,0.753559271,50294,67,5,21
4106,2014/03/31,2011/02/05,21,46,0.660318348,57390,21,24,22
4107,2014/03/31,2007/05/02,12,19,1.302620398,29091,12,5,14
4108,2014/03/31,2007/06/11,13,25,1.396420727,27134,13,8,17
4109,2014/03/31,2012/07/07,8,26,0.6165476,61450,8,9,17
4110,2014/03/31,2011/12/16,32,22,0.70768801,53521,32,16,6
4111,2014/03/31,2006/03/19,39,23,0.879034235,43085,39,10,13
4112,2014/03/31,2006/11/09,22,34,0.671832698,56365,22,20,14
4113,2014/03/31,2009/01/08,2,36,0.7189461890000001,52666,2,16,20
4114,2014/03/31,2010/02/23,83,34,0.7968382829999999,47509,83,24,10
4115,2014/03/31,2011/08/17,19,47,0.5038571829999999,75117,19,21,26
4116,2014/03/31,2007/07/11,14,28,0.748337585,50571,14,14,14
4117,2014/03/31,2009/03/23,20,32,0.7593190120000001,49810,20,17,15
4118,2014/03/31,2012/02/13,20,31,0.737188718,51304,20,26,5
4119,2014/03/31,2012/12/24,4,36,0.71582087,52822,4,9,27
4120,2014/03/31,2012/08/10,5,44,0.672575647,56215,5,6,38
4121,2014/03/31,2007/02/27,16,84,0.754716345,50096,16,42,42
4122,2014/03/31,2011/04/04,18,34,0.523154661,72255,18,20,14
4123,2014/03/31,2010/04/16,298,3,1.03,36696,298,2,1
4124,2014/03/31,2012/02/03,210,3,1.03,36696,210,2,1
4125,2014/03/31,2012/07/09,23,3,1.03,36696,23,1,2
4126,2014/03/31,2011/02/03,667,3,1.03,36696,667,3,0
4127,2014/03/31,2006/08/01,42,4,0.7725,48928,42,0,4
4128,2014/03/31,2011/03/20,107,3,1.03,36696,107,2,1
4129,2014/03/31,2012/05/02,617,3,1.03,36696,617,3,0
4130,2014/03/31,2010/06/24,174,21,1.321867917,28588,174,15,6
4131,2014/03/31,2010/01/07,71,26,1.43070766,26411,71,17,9
4132,2014/03/31,2009/09/14,8,36,0.544731129,69364,8,13,23
4133,2014/03/31,2007/06/07,2,39,0.871616877,43349,2,14,25
4134,2014/03/31,2009/03/22,38,20,1.026811437,36794,38,11,9
4135,2014/03/31,2007/11/26,7,40,0.872323127,43308,7,19,21
4136,2014/03/31,2010/07/16,14,48,0.712824085,52980,14,14,34
4137,2014/03/31,2011/10/29,5,22,0.6971304620000001,54169,5,15,7
4138,2014/03/31,2005/08/17,5,51,0.930097291,40600,5,31,20
4139,2014/03/31,2010/07/23,25,38,0.769221382,49087,25,11,27
4140,2014/03/31,2008/01/08,14,32,0.8273795279999999,45633,14,12,20
4141,2014/03/31,2011/11/18,1,41,0.489512195,77121,1,12,29
4142,2014/03/31,2012/04/22,18,31,0.692248735,54524,18,14,17
4143,2014/03/31,2008/04/19,95,24,0.762571879,49493,95,15,9
4144,2014/03/31,2007/05/26,1,24,0.8747323770000001,43139,1,15,9
4145,2014/03/31,2007/03/23,32,45,0.8297745959999999,45474,32,28,17
4146,2014/03/31,2013/01/04,31,39,0.7309651159999999,51600,31,4,35
4147,2014/03/31,2012/09/12,8,46,0.744496664,50662,8,13,33
4148,2014/03/31,2012/12/18,39,20,0.797154728,47296,39,3,17
4149,2014/03/31,2012/04/14,110,30,0.934170528,40357,110,14,16
4150,2014/03/31,2009/08/04,28,31,0.7176364540000001,52527,28,20,11
4151,2014/03/31,2009/07/30,13,24,0.598527459,62966,13,0,24
4152,2014/03/31,2013/03/13,18,43,0.847479814,44461,18,3,40
4153,2014/03/31,2012/01/18,12,34,0.586305492,64244,12,22,12
4154,2014/03/31,2012/05/12,45,18,0.791666667,47574,45,8,10
4155,2014/03/31,2009/12/08,6,35,0.691985889,54424,6,12,23
4156,2014/03/31,2011/10/22,4,47,0.739809253,50905,4,29,18
4157,2014/03/31,2012/10/28,9,39,0.709474002,53080,9,10,29
4158,2014/03/31,2009/11/25,111,9,0.554235377,67942,111,3,6
4159,2014/03/31,2012/10/23,31,21,0.7557695090000001,49824,31,6,15
4160,2014/03/31,2008/11/20,60,28,0.7864785879999999,47870,60,6,22
4161,2014/03/31,2010/02/27,6,35,0.6171176829999999,61003,6,18,17
4162,2014/03/31,2012/01/29,38,38,0.752465866,50023,38,22,16
4163,2014/03/31,2009/08/27,1,18,0.791111111,47574,1,11,7
4164,2014/03/31,2009/06/01,64,34,0.785101389,47934,64,13,21
4165,2014/03/31,2008/06/10,5,51,0.8172076,46050,5,29,22
4166,2014/03/31,2012/04/02,9,36,0.823870855,45654,9,18,18
4167,2014/03/31,2009/11/09,62,27,0.8155067220000001,46120,62,14,13
4168,2014/03/31,2011/10/15,4,30,1.205070499,31206,4,0,30
4169,2014/03/31,2012/12/03,38,49,0.840298798,44746,38,12,37
4170,2014/03/31,2006/12/02,9,66,0.726543768,51750,9,39,27
4171,2014/03/31,2005/08/21,32,27,0.743411765,50575,32,15,12
4172,2014/03/31,2007/03/01,80,20,1.415499623,26560,80,5,15
4173,2014/03/31,2006/08/28,39,29,0.749325679,50169,39,12,17
4174,2014/03/31,2008/03/18,75,42,0.623944625,60244,75,22,20
4175,2014/03/31,2007/04/17,395,9,1.0,37584,395,9,0
4176,2014/03/31,2006/04/04,1,68,0.961463034,39090,1,38,30
4177,2014/03/31,2012/02/11,33,36,0.682465042,55066,33,23,13
4178,2014/03/31,2009/07/18,88,26,0.64441005,58310,88,16,10
4179,2014/03/31,2008/06/28,5,28,0.8064570409999999,46591,5,19,9
4180,2014/03/31,2006/08/19,30,29,1.028557779,36527,30,11,18
4181,2014/03/31,2012/07/11,9,30,0.7684722709999999,48883,9,12,18
4182,2014/03/31,2008/06/19,30,33,0.577499077,65040,30,17,16
4183,2014/03/31,2010/12/05,9,59,0.7962488870000001,47162,9,27,32
4184,2014/03/31,2008/03/15,244,28,0.85742572,43787,244,21,7
4185,2014/03/31,2005/11/07,26,53,0.922844325,40681,26,31,22
4186,2014/03/31,2008/03/12,12,32,0.948190705,39590,12,8,24
4187,2014/03/31,2008/04/10,4,54,0.7242971859999999,51806,4,28,26
4188,2014/03/31,2005/12/14,2,22,1.448369939,25907,2,8,14
4189,2014/03/31,2006/02/22,26,65,0.7906225370000001,47451,26,36,29
4190,2014/03/31,2008/01/01,25,35,1.007347333,37238,25,24,11
4191,2014/03/31,2010/09/28,10,35,0.730890881,51320,10,22,13
4192,2014/03/31,2011/05/30,6,21,0.8883651140000001,42217,6,10,11
4193,2014/03/31,2012/03/10,16,38,0.475,78926,16,18,20
4194,2014/03/31,2006/09/03,65,35,0.843568953,44436,65,24,11
4195,2014/03/31,2009/08/27,9,35,0.781408498,47966,9,16,19
4196,2014/03/31,2013/01/22,27,36,0.931270188,40246,27,4,32
4197,2014/03/31,2008/11/25,18,36,0.838754952,44681,18,17,19
4198,2014/03/31,2010/10/30,165,14,0.8706749090000001,43028,165,11,3
4199,2014/03/31,2008/08/13,24,18,1.139253672,32881,24,8,10
4200,2014/03/31,2006/05/09,1,28,0.743115502,50406,1,15,13
4201,2014/03/31,2007/08/28,28,33,0.662488238,56538,28,14,19
4202,2014/03/31,2005/10/13,7,31,0.610340102,61364,7,13,18
4203,2014/03/31,2010/10/11,2,39,0.676767443,55337,2,20,19
4204,2014/03/31,2006/06/27,31,25,0.713073671,52517,31,12,13
4205,2014/03/31,2012/06/15,20,37,1.096420917,34154,20,10,27
4206,2014/03/31,2011/07/25,20,39,0.7897717879999999,47412,20,16,23
4207,2014/03/31,2009/04/20,2,35,1.081731869,34610,2,22,13
4208,2014/03/31,2009/02/11,56,38,0.698824034,53573,56,13,25
4209,2014/03/31,2011/08/02,9,15,1.334483496,28054,9,2,13
4210,2014/03/31,2007/03/15,12,45,0.6614368,56598,12,28,17
4211,2014/03/31,2011/09/28,146,15,0.723730812,51726,146,11,4
4212,2014/03/31,2008/04/28,40,11,0.821329808,45578,40,6,5
4213,2014/03/31,2006/09/26,1,49,0.712598664,52527,1,17,32
4214,2014/03/31,2009/09/05,119,26,0.848098702,44133,119,15,11
4215,2014/03/31,2008/02/08,8,31,0.628446087,59540,8,10,21
4216,2014/03/31,2009/03/29,45,14,0.80402656,46536,45,12,2
4217,2014/03/31,2006/08/14,9,47,0.6844554820000001,54663,9,25,22
4218,2014/03/31,2009/03/29,31,36,0.65202702,57365,31,14,22
4219,2014/03/31,2011/07/13,5,67,0.913670837,40928,5,43,24
4220,2014/03/31,2004/11/23,1,42,0.606972486,61605,1,22,20
4221,2014/03/31,2011/03/02,11,48,0.6559732629999999,56999,11,12,36
4222,2014/03/31,2006/05/23,4,54,0.667473442,56009,4,18,36
4223,2014/03/31,2012/07/21,116,16,1.274963504,29318,116,3,13
4224,2014/03/31,2010/08/13,18,21,0.708400523,52761,18,11,10
4225,2014/03/31,2007/06/26,19,42,0.691901544,54014,19,12,30
4226,2014/03/31,2007/05/22,3,84,0.805513547,46393,3,27,57
4227,2014/03/31,2007/05/20,98,12,0.666828576,56019,98,6,6
4228,2014/03/31,2012/04/06,163,29,0.6780323140000001,55085,163,22,7
4229,2014/03/31,2012/02/22,139,13,0.8344275879999999,44758,139,6,7
4230,2014/03/31,2011/05/01,191,19,0.873777435,42738,191,15,4
4231,2014/03/31,2007/04/13,94,29,0.972291249,38407,94,13,16
4232,2014/03/31,2011/12/26,1,45,0.549231505,67977,1,13,32
4233,2014/03/31,2007/11/28,20,24,0.827855274,45092,20,11,13
4234,2014/03/31,2006/04/22,37,30,0.707858593,52713,37,9,21
4235,2014/03/31,2012/01/17,15,38,1.129322639,33040,15,14,24
4236,2014/03/31,2009/01/22,49,25,0.750360823,49692,49,14,11
4237,2014/03/31,2010/07/25,3,29,0.788830922,47268,3,11,18
4238,2014/03/31,2010/02/28,28,36,0.6935843970000001,53758,28,17,19
4239,2014/03/31,2006/02/23,95,31,0.69225259,53858,95,20,11
4240,2014/03/31,2011/11/02,4,66,0.726523239,51315,4,30,36
4241,2014/03/31,2010/04/20,8,35,0.8201520390000001,45449,8,16,19
4242,2014/03/31,2011/03/29,65,22,0.7341712140000001,50767,65,5,17
4243,2014/03/31,2006/11/01,1,39,0.713782102,52217,1,20,19
4244,2014/03/31,2009/03/14,39,40,0.757042786,49222,39,14,26
4245,2014/03/31,2007/08/17,49,36,0.728139158,51165,49,15,21
4246,2014/03/31,2011/10/16,53,41,0.574275871,64871,53,20,21
4247,2014/03/31,2011/01/22,161,19,1.436811309,25926,161,13,6
4248,2014/03/31,2012/08/08,37,31,0.7663978109999999,48601,37,13,18
4249,2014/03/31,2007/07/20,2,39,0.750407818,49630,2,17,22
4250,2014/03/31,2009/10/01,4,44,0.614498374,60593,4,16,28
4251,2014/03/31,2011/03/10,1,51,0.826416426,45050,1,26,25
4252,2014/03/31,2011/11/28,18,41,0.82747477,44986,18,25,16
4253,2014/03/31,2006/08/26,25,26,0.954143721,39006,25,15,11
4254,2014/03/31,2010/04/26,12,23,1.347288031,27622,12,12,11
4255,2014/03/31,2006/03/28,126,20,0.6806390179999999,54662,126,8,12
4256,2014/03/31,2012/04/24,1,52,0.691808513,53779,1,25,27
4257,2014/03/31,2007/11/22,158,17,1.332734274,27916,158,9,8
4258,2014/03/31,2007/08/30,11,32,0.5902899079999999,63020,11,7,25
4259,2014/03/31,2008/06/07,82,27,0.681426242,54591,82,13,14
4260,2014/03/31,2009/07/31,14,40,0.813724379,45715,14,24,16
4261,2014/03/31,2007/06/05,30,39,0.7796721659999999,47707,30,15,24
4262,2014/03/31,2012/11/02,23,29,0.626594497,59351,23,8,21
4263,2014/03/31,2011/10/30,114,29,0.7283324520000001,51051,114,21,8
4264,2014/03/31,2010/08/14,5,24,0.7633230670000001,48702,5,8,16
4265,2014/03/31,2011/05/01,130,15,1.378786024,26961,130,10,5
4266,2014/03/31,2007/01/08,74,29,0.7605930259999999,48868,74,17,12
4267,2014/03/31,2011/03/18,31,28,0.739121028,50286,31,12,16
4268,2014/03/31,2005/01/11,24,37,0.733452012,50669,24,31,6
4269,2014/03/31,2008/02/27,56,26,0.738536139,50319,56,14,12
4270,2014/03/31,2010/09/17,68,32,0.659895558,56299,68,15,17
4271,2014/03/31,2007/10/18,12,28,0.620973,59815,12,10,18
4272,2014/03/31,2012/06/25,1,48,0.6833866959999999,54345,1,21,27
4273,2014/03/31,2009/07/02,94,15,0.851869695,43590,94,7,8
4274,2014/03/31,2008/03/04,77,40,0.826874207,44907,77,23,17
4275,2014/03/31,2008/05/03,41,42,0.7224656999999999,51385,41,20,22
4276,2014/03/31,2011/10/20,98,34,0.654450106,56720,98,17,17
4277,2014/03/31,2010/03/30,23,74,0.80561488,46074,23,43,31
4278,2014/03/31,2006/04/20,116,19,0.916370482,40504,116,14,5
4279,2014/03/31,2006/03/20,7,84,0.570311612,65081,7,30,54
4280,2014/03/31,2009/09/22,10,51,0.8354529490000001,44420,10,22,29
4281,2014/03/31,2008/08/08,13,42,0.643954841,57618,13,31,11
4282,2014/03/31,2010/06/07,37,28,1.4140272109999998,26239,37,17,11
4283,2014/03/31,2012/01/25,5,26,0.615778711,60247,5,17,9
4284,2014/03/31,2007/04/10,39,30,0.768145188,48296,39,12,18
4285,2014/03/31,2011/12/02,25,41,0.591407755,62724,25,20,21
4286,2014/03/31,2009/10/28,2,58,0.805713727,46040,2,20,38
4287,2014/03/31,2006/10/20,12,49,0.767189452,48350,12,26,23
4288,2014/03/31,2005/07/11,88,48,0.743133904,49909,88,30,18
4289,2014/03/31,2007/10/13,68,23,1.25671323,29494,68,11,12
4290,2014/03/31,2008/03/14,22,37,0.615368012,60229,22,10,27
4291,2014/03/31,2005/10/20,22,27,0.891565424,41567,22,16,11
4292,2014/03/31,2008/12/19,33,28,0.6450845129999999,57447,33,13,15
4293,2014/03/31,2012/04/27,3,39,0.6581322820000001,56304,3,18,21
4294,2014/03/31,2010/11/24,6,24,1.193975189,31035,6,11,13
4295,2014/03/31,2008/05/07,11,28,0.609139034,60827,11,16,12
4296,2014/03/31,2006/02/23,102,31,0.654436908,56616,102,14,17
4297,2014/03/31,2012/05/24,61,23,0.8694780320000001,42608,61,12,11
4298,2014/03/31,2007/08/17,4,18,1.208189616,30662,4,9,9
4299,2014/03/31,2012/07/25,1,64,0.6425551589999999,57652,1,25,39
4300,2014/03/31,2011/05/24,62,35,0.916990592,40390,62,23,12
4301,2014/03/31,2011/03/13,25,33,0.6561447429999999,56445,25,15,18
4302,2014/03/31,2012/09/28,186,25,0.820761014,45124,186,14,11
4303,2014/03/31,2012/10/25,14,32,0.850398181,43548,14,8,24
4304,2014/03/31,2007/03/10,230,39,0.657553093,56316,230,36,3
4305,2014/03/31,2006/03/13,1,57,0.858363586,43137,1,30,27
4306,2014/03/31,2012/06/10,2,34,0.595839973,62127,2,17,17
4307,2014/03/31,2011/01/13,12,41,0.71158436,52021,12,17,24
4308,2014/03/31,2005/06/02,37,23,1.219871791,30341,37,13,10
4309,2014/03/31,2012/03/01,10,38,0.743335677,49786,10,17,21
4310,2014/03/31,2013/02/09,21,27,0.8242339129999999,44897,21,6,21
4311,2014/03/31,2006/07/11,76,46,0.97416908,37982,76,36,10
4312,2014/03/31,2005/08/20,265,37,0.722288213,51219,265,31,6
4313,2014/03/31,2007/07/05,4,36,0.7798365979999999,47429,4,25,11
4314,2014/03/31,2006/05/22,12,45,0.896336427,41263,12,24,21
4315,2014/03/31,2005/12/05,51,20,0.890091465,41546,51,10,10
4316,2014/03/31,2011/01/07,57,18,0.690789882,53527,57,5,13
4317,2014/03/31,2011/09/20,5,45,0.751293312,49207,5,2,43
4318,2014/03/31,2006/12/31,24,16,0.866984942,42636,24,10,6
4319,2014/03/31,2011/03/02,40,29,0.568590548,65004,40,14,15
4320,2014/03/31,2009/08/08,36,34,0.61856263,59748,36,19,15
4321,2014/03/31,2010/12/30,17,23,0.601304348,61456,17,6,17
4322,2014/03/31,2012/02/24,187,28,1.006228249,36723,187,21,7
4323,2014/03/31,2009/12/16,8,38,0.8219005559999999,44950,8,18,20
4324,2014/03/31,2008/12/28,2,32,0.752379575,49097,2,15,17
4325,2014/03/31,2011/03/10,8,52,0.788126267,46869,8,32,20
4326,2014/03/31,2008/06/02,6,38,0.8498768870000001,43456,6,11,27
4327,2014/03/31,2010/12/24,11,34,0.65264237,56578,11,10,24
4328,2014/03/31,2008/06/11,27,35,0.70840119,52120,27,23,12
4329,2014/03/31,2012/10/20,45,32,0.690828749,53442,45,7,25
4330,2014/03/31,2008/06/13,17,73,0.716275491,51537,17,28,45
4331,2014/03/31,2011/11/12,68,37,0.7130187590000001,51763,68,7,30
4332,2014/03/31,2008/04/09,11,29,0.7743498879999999,47661,11,11,18
4333,2014/03/31,2008/04/06,9,38,0.7102831190000001,51957,9,14,24
4334,2014/03/31,2008/03/23,7,49,0.524105398,70400,7,24,25
4335,2014/03/31,2010/04/29,42,29,0.676531896,54537,42,18,11
4336,2014/03/31,2006/05/25,7,40,0.656445603,56198,7,26,14
4337,2014/03/31,2012/12/03,18,19,0.686630868,53726,18,8,11
4338,2014/03/31,2010/08/20,26,31,0.896680522,41139,26,15,16
4339,2014/03/31,2009/01/01,318,21,1.205615297,30595,318,19,2
4340,2014/03/31,2008/08/14,9,23,1.303729455,28291,9,7,16
4341,2014/03/31,2007/11/12,1,48,0.668629449,55153,1,26,22
4342,2014/03/31,2008/10/03,90,17,0.6795163759999999,54257,90,7,10
4343,2014/03/31,2007/02/02,4,38,0.687357843,53638,4,17,21
4344,2014/03/31,2005/10/05,9,46,0.61877193,59565,9,32,14
4345,2014/03/31,2008/12/01,103,28,0.8772314390000001,42011,103,19,9
4346,2014/03/31,2010/04/21,1,73,0.818717755,45007,1,31,42
4347,2014/03/31,2009/11/04,29,33,0.7382205609999999,49909,29,16,17
4348,2014/03/31,2011/07/09,270,5,0.73,50470,270,3,2
4349,2014/03/31,2012/12/06,10,25,0.705725178,52201,10,5,20
4350,2014/03/31,2006/08/06,8,54,0.628731567,58592,8,15,39
4351,2014/03/31,2009/07/04,95,21,0.975539431,37762,95,11,10
4352,2014/03/31,2006/06/15,24,23,0.842410923,43726,24,12,11
4353,2014/03/31,2006/10/10,3,55,0.7471644759999999,49296,3,22,33
4354,2014/03/31,2008/10/25,51,9,0.738291368,49882,51,7,2
4355,2014/03/31,2007/07/03,6,28,0.7030041440000001,52371,6,10,18
4356,2014/03/31,2006/08/18,5,24,0.695063251,52964,5,12,12
4357,2014/03/31,2011/06/30,2,45,0.806787899,45615,2,26,19
4358,2014/03/31,2005/12/01,36,40,0.745155013,49383,36,21,19
4359,2014/03/31,2008/01/09,17,29,0.737494138,49895,17,9,20
4360,2014/03/31,2009/10/13,35,17,1.346353591,27331,35,11,6
4361,2014/03/31,2008/09/09,50,32,0.619339977,59407,50,12,20
4362,2014/03/31,2009/10/12,38,42,0.6892627159999999,53358,38,15,27
4363,2014/03/31,2010/08/31,4,32,0.5566524389999999,66069,4,18,14
4364,2014/03/31,2012/12/26,1,47,0.8476026179999999,43389,1,4,43
4365,2014/03/31,2007/06/25,50,21,1.082451869,33970,50,13,8
4366,2014/03/31,2007/11/01,20,40,0.711193585,51693,20,21,19
4367,2014/03/31,2012/04/07,9,37,0.77789203,47254,9,25,12
4368,2014/03/31,2007/05/16,78,19,1.406224986,26135,78,12,7
4369,2014/03/31,2009/07/18,15,98,0.666699869,55116,15,43,55
4370,2014/03/31,2006/11/21,27,31,0.960882622,38227,27,15,16
4371,2014/03/31,2009/11/20,24,47,0.521166437,70471,24,28,19
4372,2014/03/31,2007/08/28,6,36,0.819643327,44803,6,24,12
4373,2014/03/31,2007/04/11,5,32,0.7768291340000001,47271,5,10,22
4374,2014/03/31,2008/11/06,68,9,0.6233470839999999,58908,68,1,8
4375,2014/03/31,2008/04/30,66,18,0.7986559790000001,45974,66,8,10
4376,2014/03/31,2011/07/11,11,41,0.687384621,53411,11,15,26
4377,2014/03/31,2012/08/28,34,7,0.7220427229999999,50839,34,2,5
4378,2014/03/31,2007/11/21,46,41,0.666568362,55067,46,18,23
4379,2014/03/31,2008/01/11,3,50,0.709561351,51727,3,28,22
4380,2014/03/31,2009/07/30,16,24,0.754454312,48645,16,10,14
4381,2014/03/31,2005/09/09,5,29,1.2983364,28264,5,6,23
4382,2014/03/31,2010/10/17,182,4,0.75,48928,182,2,2
4383,2014/03/31,2010/10/29,69,27,0.7485764140000001,49003,69,11,16
4384,2014/03/31,2012/12/24,12,46,0.871260778,42101,12,5,41
4385,2014/03/31,2011/01/18,80,32,0.787469031,46579,80,16,16
4386,2014/03/31,2010/01/29,12,52,0.774134867,47380,12,20,32
4387,2014/03/31,2012/05/19,25,30,0.860892958,42600,25,15,15
4388,2014/03/31,2011/08/03,12,42,0.641048961,57209,12,19,23
4389,2014/03/31,2007/06/17,35,28,0.634493987,57795,35,15,13
4390,2014/03/31,2006/09/12,13,20,0.7072225759999999,51843,13,1,19
4391,2014/03/31,2010/12/09,13,49,0.80604441,45485,13,22,27
4392,2014/03/31,2012/03/08,50,28,0.7205720240000001,50872,50,11,17
4393,2014/03/31,2007/02/08,6,35,0.787510796,46545,6,17,18
4394,2014/03/31,2006/03/27,19,25,0.655677992,55893,19,9,16
4395,2014/03/31,2008/05/23,3,40,0.8234791690000001,44502,3,9,31
4396,2014/03/31,2010/09/25,62,38,0.911333582,40200,62,24,14
4397,2014/03/31,2005/11/13,44,40,0.902604934,40573,44,21,19
4398,2014/03/31,2011/11/02,20,50,0.755909645,48431,20,31,19
4399,2014/03/31,2006/04/08,14,23,0.5717193770000001,64029,14,5,18
4400,2014/03/31,2012/10/12,10,33,0.834904434,43844,10,8,25
4401,2014/03/31,2012/02/10,56,34,0.726691813,50372,56,15,19
4402,2014/03/31,2008/02/22,33,61,0.8070189640000001,45350,33,42,19
4403,2014/03/31,2008/04/25,195,19,0.6737293809999999,54320,195,14,5
4404,2014/03/31,2006/06/27,1,32,0.613120058,59688,1,19,13
4405,2014/03/31,2006/06/26,11,33,0.740603558,49407,11,12,21
4406,2014/03/31,2007/06/14,32,48,0.566026458,64630,32,27,21
4407,2014/03/31,2008/06/02,11,19,1.302763177,28080,11,12,7
4408,2014/03/31,2011/08/20,21,36,0.777728075,47035,21,19,17
4409,2014/03/31,2009/03/31,37,48,0.817357824,44751,37,27,21
4410,2014/03/31,2011/09/01,7,34,0.48365126,75615,7,15,19
4411,2014/03/31,2007/05/03,5,29,0.704154741,51919,5,15,14
4412,2014/03/31,2011/07/20,241,18,0.770795083,47429,241,13,5
4413,2014/03/31,2009/03/13,4,34,0.846403446,43183,4,16,18
4414,2014/03/31,2006/09/21,6,30,0.769114515,47522,6,15,15
4415,2014/03/31,2011/06/15,113,38,0.762892122,47906,113,21,17
4416,2014/03/31,2012/05/18,36,50,0.722407331,50583,36,14,36
4417,2014/03/31,2009/12/17,79,28,0.757693568,48226,79,16,12
4418,2014/03/31,2011/10/17,12,40,0.862375546,42365,12,30,10
4419,2014/03/31,2011/02/26,3,49,0.761658953,47964,3,9,40
4420,2014/03/31,2010/09/20,4,23,1.004046507,36382,4,8,15
4421,2014/03/31,2005/06/30,57,32,0.710819465,51375,57,21,11
4422,2014/03/31,2005/05/05,4,31,0.600991374,60744,4,12,19
4423,2014/03/31,2012/03/07,32,28,0.713362059,51174,32,17,11
4424,2014/03/31,2006/05/08,17,38,0.7778041509999999,46934,17,14,24
4425,2014/03/31,2006/03/23,1,46,0.6304108429999999,57881,1,10,36
4426,2014/03/31,2009/07/08,10,34,0.769613965,47405,10,14,20
4427,2014/03/31,2012/08/21,90,23,0.762651849,47827,90,7,16
4428,2014/03/31,2005/05/30,263,29,0.81197275,44917,263,27,2
4429,2014/03/31,2012/02/23,15,31,0.752873186,48441,15,22,9
4430,2014/03/31,2006/03/09,73,37,0.823933696,44251,73,24,13
4431,2014/03/31,2011/04/14,107,32,0.785375765,46412,107,16,16
4432,2014/03/31,2007/12/27,9,33,0.7798018659999999,46736,9,20,13
4433,2014/03/31,2012/05/16,314,41,0.883590415,41232,314,32,9
4434,2014/03/31,2012/03/04,43,51,0.668147618,54519,43,30,21
4435,2014/03/31,2008/10/28,20,35,0.655764155,55545,20,20,15
4436,2014/03/31,2006/05/22,12,34,1.064412229,34214,12,20,14
4437,2014/03/31,2007/10/08,20,8,0.648648841,56137,20,4,4
4438,2014/03/31,2010/03/11,38,20,1.4193244719999998,25654,38,7,13
4439,2014/03/31,2010/12/30,10,52,0.836739835,43507,10,30,22
4440,2014/03/31,2012/06/11,7,35,0.653498052,55691,7,13,22
4441,2014/03/31,2009/12/27,50,35,0.710157488,51242,50,16,19
4442,2014/03/31,2008/06/20,124,35,0.6749691109999999,53903,124,23,12
4443,2014/03/31,2008/03/11,32,43,0.6706321439999999,54244,32,25,18
4444,2014/03/31,2007/04/29,6,21,0.659564122,55153,6,13,8
4445,2014/03/31,2010/07/17,31,14,0.804285714,45220,31,10,4
4446,2014/03/31,2010/12/15,26,23,1.192586665,30491,26,7,16
4447,2014/03/31,2009/10/08,33,49,0.735930176,49410,33,21,28
4448,2014/03/31,2012/08/31,33,44,0.6477115729999999,56139,33,17,27
4449,2014/03/31,2011/06/13,60,21,0.599909911,60607,60,8,13
4450,2014/03/31,2009/11/29,12,31,0.820733442,44298,12,21,10
4451,2014/03/31,2009/08/09,31,60,0.658688531,55190,31,20,40
4452,2014/03/31,2012/03/01,7,41,0.650020038,55894,7,15,26
4453,2014/03/31,2007/04/30,18,18,0.7958361270000001,45645,18,3,15
4454,2014/03/31,2008/05/26,16,45,0.717655589,50614,16,11,34
4455,2014/03/31,2011/02/27,18,40,0.688061899,52763,18,13,27
4456,2014/03/31,2008/02/07,4,38,0.6966571359999999,52111,4,11,27
4457,2014/03/31,2005/03/14,4,36,0.69237335,52428,4,19,17
4458,2014/03/31,2005/02/25,22,33,0.7571554620000001,47941,22,17,16
4459,2014/03/31,2012/06/07,1,46,0.8149091890000001,44543,1,23,23
4460,2014/03/31,2011/01/07,11,26,1.063078861,34136,11,16,10
4461,2014/03/31,2010/03/11,158,22,0.7955696870000001,45604,158,14,8
4462,2014/03/31,2012/04/05,9,37,0.626610579,57886,9,15,22
4463,2014/03/31,2010/01/21,50,20,0.699220952,51871,50,7,13
4464,2014/03/31,2013/01/13,82,7,0.6870878640000001,52786,82,2,5
4465,2014/03/31,2005/01/01,5,51,0.548864899,66047,5,21,30
4466,2014/03/31,2012/05/08,30,30,0.6175627370000001,58697,30,16,14
4467,2014/03/31,2006/04/09,9,25,0.612867433,59140,9,6,19
4468,2014/03/31,2011/07/06,25,28,1.153580023,31416,25,11,17
4469,2014/03/31,2007/04/04,140,21,0.673008598,53849,140,8,13
4470,2014/03/31,2008/03/24,58,37,0.723855913,50053,58,26,11
4471,2014/03/31,2010/07/08,27,29,0.760713671,47627,27,16,13
4472,2014/03/31,2011/09/07,1,29,0.700734594,51702,1,19,10
4473,2014/03/31,2010/02/04,48,16,0.678073633,53427,48,6,10
4474,2014/03/31,2009/11/09,37,45,0.598353184,60535,37,23,22
4475,2014/03/31,2006/08/24,29,50,0.7093199490000001,51055,29,28,22
4476,2014/03/31,2009/04/13,1,42,0.715980068,50573,1,20,22
4477,2014/03/31,2012/12/26,4,26,0.658713023,54966,4,4,22
4478,2014/03/31,2008/04/14,2,35,0.808367575,44780,2,9,26
4479,2014/03/31,2007/11/22,16,30,0.704265507,51396,16,6,24
4480,2014/03/31,2006/02/14,93,29,0.8005917090000001,45208,93,16,13
4481,2014/03/31,2008/04/19,19,44,0.6161544489999999,58738,19,22,22
4482,2014/03/31,2013/03/10,16,17,0.665229211,54404,16,1,16
4483,2014/03/31,2011/08/30,33,33,0.830340025,43585,33,9,24
4484,2014/03/31,2007/04/27,43,34,0.6182955960000001,58519,43,20,14
4485,2014/03/31,2007/02/19,30,51,0.7618278690000001,47487,30,34,17
4486,2014/03/31,2010/11/15,2,59,0.948162992,38149,2,19,40
4487,2014/03/31,2010/12/10,210,31,0.6903552070000001,52392,210,19,12
4488,2014/03/31,2012/01/12,134,7,0.8378986629999999,43163,134,3,4
4489,2014/03/31,2007/11/15,4,58,0.8350785070000001,43308,4,24,34
4490,2014/03/31,2008/01/14,3,44,0.7308076640000001,49476,3,16,28
4491,2014/03/31,2007/03/18,5,17,1.387606401,26057,5,8,9
4492,2014/03/31,2010/10/02,334,23,0.612342469,59036,334,19,4
4493,2014/03/31,2012/09/26,66,22,0.756236505,47796,66,11,11
4494,2014/03/31,2010/02/19,33,41,0.633971445,57012,33,15,26
4495,2014/03/31,2009/11/30,132,25,0.582541384,62041,132,15,10
4496,2014/03/31,2008/01/02,2,36,0.6901061740000001,52367,2,10,26
4497,2014/03/31,2008/04/06,73,31,0.8583937859999999,42099,73,11,20
4498,2014/03/31,2011/04/11,7,43,0.7009046109999999,51547,7,16,27
4499,2014/03/31,2011/07/19,3,36,0.516144339,69988,3,16,20
4500,2014/03/31,2012/04/23,11,48,0.70920739,50933,11,13,35
4501,2014/03/31,2011/12/10,16,23,0.7683038729999999,47013,16,12,11
4502,2014/03/31,2005/04/04,54,28,0.8741284290000001,41299,54,18,10
4503,2014/03/31,2011/02/01,12,46,0.81813663,44119,12,24,22
4504,2014/03/31,2012/08/09,91,10,0.730743845,49392,91,6,4
4505,2014/03/31,2008/06/04,24,46,0.605971219,59554,24,6,40
4506,2014/03/31,2010/04/15,20,39,0.6714973670000001,53741,20,20,19
4507,2014/03/31,2012/04/22,338,4,0.7375,48928,338,2,2
4508,2014/03/31,2010/05/10,216,4,0.89,40544,216,2,2
4509,2014/03/31,2012/12/12,3,41,0.731934358,49298,3,10,31
4510,2014/03/31,2010/12/22,34,21,1.406226665,25659,34,8,13
4511,2014/03/31,2011/12/07,65,27,1.045426253,34510,65,15,12
4512,2014/03/31,2011/08/11,9,32,0.712141108,50642,9,8,24
4513,2014/03/31,2006/10/27,233,27,0.792055044,45527,233,15,12
4514,2014/03/31,2012/09/07,17,25,0.8556243920000001,42129,17,6,19
4515,2014/03/31,2010/09/01,378,5,0.7253848629999999,49693,378,5,0
4516,2014/03/31,2005/05/17,9,26,0.724489086,49754,9,15,11
4517,2014/03/31,2008/03/28,13,24,0.696148022,51776,13,0,24
4518,2014/03/31,2011/05/08,89,6,0.78999737,45620,89,4,2
4519,2014/03/31,2010/01/18,3,33,0.8703318520000001,41404,3,18,15
4520,2014/03/31,2008/10/11,33,28,0.667490599,53985,33,10,18
4521,2014/03/31,2011/09/23,61,25,0.861025378,41848,61,11,14
4522,2014/03/31,2009/11/11,68,32,0.8681371529999999,41501,68,22,10
4523,2014/03/31,2013/03/12,89,11,0.592014036,60843,89,3,8
4524,2014/03/31,2006/11/30,11,24,0.8851731340000001,40691,11,13,11
4525,2014/03/31,2010/06/16,6,45,0.626378546,57499,6,30,15
4526,2014/03/31,2011/06/29,47,6,0.7898640259999999,45597,47,4,2
4527,2014/03/31,2012/09/28,10,33,0.78342818,45969,10,10,23
4528,2014/03/31,2009/03/01,15,54,0.680109355,52947,15,32,22
4529,2014/03/31,2012/07/07,144,33,0.783172345,45966,144,17,16
4530,2014/03/31,2011/08/17,23,62,0.968856797,37150,23,43,19
4531,2014/03/31,2007/05/14,29,17,0.8622977959999999,41740,29,10,7
4532,2014/03/31,2008/03/27,8,40,0.567306279,63429,8,29,11
4533,2014/03/31,2006/07/27,5,42,0.689960499,52151,5,26,16
4534,2014/03/31,2011/12/13,1,44,0.7889733809999999,45606,1,18,26
4535,2014/03/31,2012/09/14,38,21,0.695601137,51727,38,6,15
4536,2014/03/31,2010/11/11,38,28,0.7390792909999999,48669,38,3,25
4537,2014/03/31,2012/10/06,2,41,0.819268971,43897,2,19,22
4538,2014/03/31,2012/01/14,15,40,0.707739206,50814,15,13,27
4539,2014/03/31,2009/07/17,11,30,0.677864535,53047,11,12,18
4540,2014/03/31,2007/04/21,191,39,0.7148567570000001,50299,191,33,6
4541,2014/03/31,2005/09/17,6,34,0.81296344,44229,6,25,9
4542,2014/03/31,2009/12/04,8,31,0.8170860129999999,44005,8,11,20
4543,2014/03/31,2005/11/09,28,18,1.459932183,24625,28,8,10
4544,2014/03/31,2012/06/09,14,22,0.748364007,48032,14,8,14
4545,2014/03/31,2007/06/12,26,41,0.738895607,48624,26,24,17
4546,2014/03/31,2012/03/23,8,47,0.7222439420000001,49725,8,19,28
4547,2014/03/31,2008/06/22,10,33,0.6431398079999999,55841,10,14,19
4548,2014/03/31,2007/06/24,2,29,0.624062142,57546,2,14,15
4549,2014/03/31,2009/07/07,41,38,0.7077107890000001,50738,41,17,21
4550,2014/03/31,2010/05/11,4,36,0.610964608,58770,4,18,18
4551,2014/03/31,2007/09/29,42,46,0.949294363,37824,42,25,21
4552,2014/03/31,2012/08/10,1,52,0.610887112,58775,1,12,40
4553,2014/03/31,2011/12/29,46,14,1.00463844,35734,46,5,9
4554,2014/03/31,2010/03/05,3,26,0.707410524,50740,3,14,12
4555,2014/03/31,2011/04/01,26,30,0.8330725309999999,43085,26,11,19
4556,2014/03/31,2011/12/09,4,43,0.7149810759999999,50200,4,15,28
4557,2014/03/31,2012/10/10,202,6,0.697821183,51427,202,4,2
4558,2014/03/31,2009/02/16,65,56,0.723381046,49603,65,49,7
4559,2014/03/31,2005/08/17,35,22,1.310511322,27380,35,9,13
4560,2014/03/31,2011/07/19,4,52,0.820984578,43704,4,21,31
4561,2014/03/31,2007/07/18,5,34,0.664473299,53987,5,16,18
4562,2014/03/31,2012/04/26,4,50,0.59909926,59873,4,15,35
4563,2014/03/31,2006/03/31,4,21,1.21809409,29440,4,1,20
4564,2014/03/31,2012/03/07,171,35,0.826418117,43385,171,32,3
4565,2014/03/31,2011/08/03,16,40,0.804282125,44576,16,20,20
4566,2014/03/31,2008/01/29,17,51,0.743795929,48199,17,20,31
4567,2014/03/31,2007/02/08,6,42,0.621690314,57652,6,16,26
4568,2014/03/31,2006/06/02,13,22,0.711130975,50399,13,19,3
4569,2014/03/31,2009/02/16,14,43,0.753606351,47555,14,19,24
4570,2014/03/31,2005/07/18,17,32,0.531451811,67433,17,16,16
4571,2014/03/31,2005/09/16,16,43,0.729430962,49118,16,24,19
4572,2014/03/31,2010/10/25,86,33,0.7347170040000001,48764,86,17,16
4573,2014/03/31,2012/01/03,4,36,0.651794513,54962,4,10,26
4574,2014/03/31,2006/11/24,22,22,0.8212852490000001,43618,22,7,15
4575,2014/03/31,2010/12/16,46,6,0.7866757440000001,45535,46,4,2
4576,2014/03/31,2011/02/28,31,44,0.799116203,44818,31,19,25
4577,2014/03/31,2007/11/22,4,24,1.047563473,34188,4,6,18
4578,2014/03/31,2011/09/24,66,38,0.60884873,58822,66,16,22
4579,2014/03/31,2005/05/21,42,31,0.8740913640000001,40957,42,14,17
4580,2014/03/31,2011/04/18,35,22,0.853125134,41963,35,6,16
4581,2014/03/31,2010/03/27,33,35,0.808639454,44269,33,20,15
4582,2014/03/31,2010/12/27,22,27,0.796774926,44923,22,7,20
4583,2014/03/31,2006/09/25,5,35,0.656399098,54528,5,9,26
4584,2014/03/31,2010/12/21,24,57,0.7217594270000001,49590,24,18,39
4585,2014/03/31,2006/04/28,37,30,0.609065351,58760,37,8,22
4586,2014/03/31,2011/12/27,10,17,0.5961255120000001,60026,10,5,12
4587,2014/03/31,2009/09/12,25,40,0.7905733540000001,45260,25,19,21
4588,2014/03/31,2008/07/04,2,37,0.7844355759999999,45604,2,2,35
4589,2014/03/31,2005/10/11,42,34,0.791114822,45218,42,17,17
4590,2014/03/31,2008/10/10,67,29,0.751394543,47607,67,17,12
4591,2014/03/31,2010/10/16,10,22,0.687905223,51996,10,12,10
4592,2014/03/31,2011/03/20,32,27,0.8644532009999999,41368,32,12,15
4593,2014/03/31,2008/02/05,85,42,0.8298874079999999,43076,85,32,10
4594,2014/03/31,2007/04/09,10,37,0.727250682,49154,10,14,23
4595,2014/03/31,2006/10/30,82,67,0.783638576,45603,82,48,19
4596,2014/03/31,2009/06/30,1,20,0.728704263,49030,1,0,20
4597,2014/03/31,2011/09/19,15,47,0.6559890939999999,54464,15,35,12
4598,2014/03/31,2010/03/17,33,35,0.656870197,54390,33,10,25
4599,2014/03/31,2006/03/05,11,46,0.7895451729999999,45248,11,14,32
4600,2014/03/31,2007/12/06,69,30,0.660521479,54077,69,18,12
4601,2014/03/31,2009/09/15,164,4,0.73,48928,164,2,2
4602,2014/03/31,2009/07/30,24,34,0.784591554,45514,24,21,13
4603,2014/03/31,2011/05/25,4,15,1.436532008,24853,4,5,10
4604,2014/03/31,2011/01/28,249,8,0.6816947990000001,52372,249,3,5
4605,2014/03/31,2010/08/20,455,6,0.716383047,49832,455,6,0
4606,2014/03/31,2008/05/23,76,30,0.697170924,51204,76,17,13
4607,2014/03/31,2011/05/09,11,39,0.589922155,60505,11,8,31
4608,2014/03/31,2007/07/22,6,47,0.7440263909999999,47971,6,12,35
4609,2014/03/31,2006/01/01,27,26,0.706185718,50539,27,17,9
4610,2014/03/31,2011/04/15,41,31,0.666679868,53528,41,17,14
4611,2014/03/31,2007/03/07,39,16,1.346096945,26510,39,7,9
4612,2014/03/31,2009/07/31,39,13,1.04586216,34112,39,6,7
4613,2014/03/31,2008/09/14,178,29,1.306281863,27304,178,25,4
4614,2014/03/31,2010/04/28,29,39,0.8321253059999999,42855,29,14,25
4615,2014/03/31,2010/04/07,73,26,0.7252230059999999,49169,73,22,4
4616,2014/03/31,2010/05/01,93,35,0.672196773,53046,93,15,20
4617,2014/03/31,2006/08/14,80,38,0.686984335,51899,80,21,17
4618,2014/03/31,2006/10/11,15,34,0.6178486870000001,57695,15,23,11
4619,2014/03/31,2010/12/22,93,20,0.982171145,36285,93,6,14
4620,2014/03/31,2009/09/30,37,35,0.69540569,51246,37,15,20
4621,2014/03/31,2005/07/07,1,44,0.763716882,46652,1,22,22
4622,2014/03/31,2010/08/07,22,36,0.772956848,46093,22,20,16
4623,2014/03/31,2007/07/01,82,20,0.783562379,45464,82,16,4
4624,2014/03/31,2007/09/30,69,15,1.423438836,25023,69,12,3
4625,2014/03/31,2009/06/27,46,60,0.656498359,54246,46,42,18
4626,2014/03/31,2006/11/25,2,48,0.688882978,51691,2,27,21
4627,2014/03/31,2007/03/22,5,17,1.262253971,28208,5,2,15
4628,2014/03/31,2011/04/30,87,33,0.400170313,88954,87,21,12
4629,2014/03/31,2012/05/07,25,49,0.909001047,39151,25,22,27
4630,2014/03/31,2010/11/17,36,59,0.8156917220000001,43623,36,18,41
4631,2014/03/31,2011/11/14,58,24,0.784874029,45328,58,10,14
4632,2014/03/31,2005/07/12,33,33,0.984116134,36148,33,18,15
4633,2014/03/31,2010/11/17,304,6,1.031600209,34483,304,3,3
4634,2014/03/31,2010/08/20,13,69,0.7588885809999999,46850,13,27,42
4635,2014/03/31,2006/12/27,21,25,0.669993215,53059,21,12,13
4636,2014/03/31,2007/03/23,5,45,0.729459493,48732,5,25,20
4637,2014/03/31,2011/11/08,65,32,0.675080734,52642,65,12,20
4638,2014/03/31,2010/12/06,8,56,0.838214479,42391,8,28,28
4639,2014/03/31,2010/04/05,85,13,0.853136393,41637,85,4,9
4640,2014/03/31,2006/04/04,70,29,0.769573979,46148,70,21,8
4641,2014/03/31,2012/07/11,123,38,0.666401711,53292,123,22,16
4642,2014/03/31,2010/02/05,67,32,0.7707730209999999,46066,67,15,17
4643,2014/03/31,2005/10/01,5,30,0.774528285,45801,5,17,13
4644,2014/03/31,2007/09/16,531,4,0.725,48928,531,4,0
4645,2014/03/31,2006/01/11,91,28,0.707233432,50156,91,14,14
4646,2014/03/31,2007/08/25,13,59,0.7428210009999999,47749,13,25,34
4647,2014/03/31,2008/02/08,20,12,1.417508592,25022,20,6,6
4648,2014/03/31,2012/01/21,32,58,0.8180927,43344,32,36,22
4649,2014/03/31,2011/11/13,5,22,0.74819166,47386,5,14,8
4650,2014/03/31,2007/09/17,15,40,0.665216527,53296,15,19,21
4651,2014/03/31,2011/01/10,20,26,0.6138992120000001,57745,20,5,21
4652,2014/03/31,2006/05/14,4,51,0.703452464,50393,4,30,21
4653,2014/03/31,2009/04/03,20,34,0.7902030809999999,44859,20,17,17
4654,2014/03/31,2007/10/21,24,42,0.729017543,48623,24,21,21
4655,2014/03/31,2012/08/20,34,28,0.711657799,49807,34,12,16
4656,2014/03/31,2011/06/27,267,7,0.7275279170000001,48716,267,5,2
4657,2014/03/31,2006/12/01,10,40,0.792061644,44741,10,19,21
4658,2014/03/31,2010/11/25,28,45,0.551222157,64288,28,17,28
4659,2014/03/31,2010/12/01,33,22,0.816183523,43417,33,11,11
4660,2014/03/31,2008/03/20,14,16,1.450231654,24433,14,7,9
4661,2014/03/31,2007/04/14,2,29,0.846421729,41861,2,17,12
4662,2014/03/31,2010/04/22,12,35,0.590564446,59988,12,18,17
4663,2014/03/31,2008/01/10,9,29,0.596291471,59409,9,9,20
4664,2014/03/31,2011/07/09,79,29,0.741870118,47751,79,20,9
4665,2014/03/31,2005/09/09,29,39,0.796874775,44448,29,26,13
4666,2014/03/31,2008/03/31,4,29,0.784782965,45131,4,16,13
4667,2014/03/31,2008/11/30,43,6,0.776639472,45597,43,2,4
4668,2014/03/31,2005/08/30,18,40,0.642394412,55120,18,21,19
4669,2014/03/31,2006/07/14,9,39,0.659469567,53692,9,16,23
4670,2014/03/31,2005/09/09,19,40,0.759666724,46598,19,17,23
4671,2014/03/31,2005/02/08,14,39,0.6960784309999999,50847,14,11,28
4672,2014/03/31,2008/11/13,112,36,0.815874827,43380,112,20,16
4673,2014/03/31,2009/01/07,12,79,0.7388781940000001,47896,12,28,51
4674,2014/03/31,2010/09/25,10,19,0.794761605,44527,10,8,11
4675,2014/03/31,2012/10/03,17,8,0.627322768,56409,17,3,5
4676,2014/03/31,2005/11/17,96,36,0.8645668,40928,96,20,16
4677,2014/03/31,2006/10/21,12,29,0.709971294,49816,12,13,16
4678,2014/03/31,2009/10/17,66,30,0.681212798,51913,66,25,5
4679,2014/03/31,2012/04/29,7,18,0.7651036390000001,46218,7,4,14
4680,2014/03/31,2006/05/09,3,25,0.938634192,37670,3,2,23
4681,2014/03/31,2011/09/16,171,26,0.8922378679999999,39627,171,22,4
4682,2014/03/31,2008/04/18,21,32,0.733414442,48207,21,11,21
4683,2014/03/31,2008/12/02,3,37,0.653788257,54075,3,15,22
4684,2014/03/31,2007/02/19,15,50,0.69696512,50717,15,20,30
4685,2014/03/31,2010/10/18,115,25,0.752837579,46952,115,12,13
4686,2014/03/31,2007/07/10,16,24,0.764025208,46256,16,12,12
4687,2014/03/31,2008/04/19,20,38,0.757928927,46628,20,18,20
4688,2014/03/31,2011/01/21,42,30,0.699293009,50524,42,15,15
4689,2014/03/31,2005/07/12,28,37,0.7822041890000001,45164,28,18,19
4690,2014/03/31,2012/01/27,15,38,0.526836132,67054,15,17,21
4691,2014/03/31,2005/11/13,21,22,0.800877452,44105,21,14,8
4692,2014/03/31,2007/06/10,18,43,0.640209198,55163,18,20,23
4693,2014/03/31,2012/09/21,54,17,0.785882353,44931,54,4,13
4694,2014/03/31,2011/01/04,30,38,0.748316905,47175,30,24,14
4695,2014/03/31,2007/03/08,19,26,0.797633315,44256,19,10,16
4696,2014/03/31,2010/05/17,9,36,0.7450380999999999,47375,9,20,16
4697,2014/03/31,2007/08/01,51,31,0.697846154,50570,51,16,15
4698,2014/03/31,2011/01/07,12,28,0.84201236,41911,12,12,16
4699,2014/03/31,2008/04/06,4,23,1.245126323,28340,4,13,10
4700,2014/03/31,2010/09/02,31,51,0.712832377,49492,31,32,19
4701,2014/03/31,2012/11/20,78,30,0.7230768129999999,48781,78,8,22
4702,2014/03/31,2008/03/10,44,35,0.638064726,55279,44,11,24
4703,2014/03/31,2011/01/12,38,29,1.024643698,34423,38,16,13
4704,2014/03/31,2011/05/25,18,35,0.748496032,47122,18,20,15
4705,2014/03/31,2009/02/27,13,47,0.72774513,48464,13,26,21
4706,2014/03/31,2009/08/25,8,29,0.858883152,41062,8,13,16
4707,2014/03/31,2010/03/18,10,41,0.815712634,43234,10,0,41
4708,2014/03/31,2010/06/23,2,35,0.724883759,48649,2,12,23
4709,2014/03/31,2010/09/14,8,29,1.0064633,35027,8,5,24
4710,2014/03/31,2005/10/15,8,41,0.7020268470000001,50211,8,17,24
4711,2014/03/31,2012/07/31,360,7,0.96496304,36526,360,6,1
4712,2014/03/31,2009/11/19,31,30,0.6873151270000001,51265,31,15,15
4713,2014/03/31,2007/02/18,2,30,0.694231125,50743,2,12,18
4714,2014/03/31,2010/04/19,2,37,0.684930002,51430,2,15,22
4715,2014/03/31,2009/08/05,25,37,0.86157999,40880,25,12,25
4716,2014/03/31,2011/04/07,25,20,1.203976344,29253,25,2,18
4717,2014/03/31,2008/04/23,29,21,0.8164513440000001,43129,29,2,19
4718,2014/03/31,2005/12/17,3,34,1.11,31722,3,15,19
4719,2014/03/31,2012/08/19,61,28,0.639285714,55076,61,14,14
4720,2014/03/31,2012/04/06,1,14,0.7114285709999999,49490,1,8,6
4721,2014/03/31,2008/02/21,17,20,0.684529087,51432,17,3,17
4722,2014/03/31,2010/09/11,86,36,0.7631190929999999,46132,86,23,13
4723,2014/03/31,2007/04/12,123,22,0.855540862,41138,123,11,11
4724,2014/03/31,2012/09/14,114,4,1.0825,32508,114,2,2
4725,2014/03/31,2012/07/14,143,8,0.7466735990000001,47123,143,7,1
4726,2014/03/31,2013/02/06,6,25,0.6970745909999999,50475,6,3,22
4727,2014/03/31,2005/05/18,12,33,0.671083643,52425,12,16,17
4728,2014/03/31,2009/02/11,146,30,0.6944330390000001,50656,146,24,6
4729,2014/03/31,2009/05/27,16,27,0.64954736,54149,16,14,13
4730,2014/03/31,2013/03/09,17,28,0.831932729,42277,17,2,26
4731,2014/03/31,2012/04/20,18,27,0.7359287309999999,47791,18,11,16
4732,2014/03/31,2010/02/09,7,40,0.638569535,55073,7,16,24
4733,2014/03/31,2009/12/21,28,50,0.646121125,54423,28,27,23
4734,2014/03/31,2005/08/08,14,31,0.867713341,40522,14,16,15
4735,2014/03/31,2010/11/26,1,47,0.6585923570000001,53380,1,29,18
4736,2014/03/31,2011/12/12,8,42,0.7274181259999999,48306,8,27,15
4737,2014/03/31,2009/12/31,6,24,0.722169928,48656,6,8,16
4738,2014/03/31,2012/03/05,20,42,0.7874373570000001,44618,20,17,25
4739,2014/03/31,2008/01/24,33,35,0.700667345,50139,33,12,23
4740,2014/03/31,2010/01/12,30,49,0.755209063,46517,30,29,20
4741,2014/03/31,2010/07/09,28,40,0.650919602,53969,28,18,22
4742,2014/03/31,2009/04/10,5,29,0.610332244,57548,5,17,12
4743,2014/03/31,2012/09/02,40,37,0.59332849,59189,40,8,29
4744,2014/03/31,2011/03/27,13,34,0.736187501,47701,13,7,27
4745,2014/03/31,2011/08/23,5,33,0.753094099,46621,5,17,16
4746,2014/03/31,2007/12/01,1,32,0.764168299,45942,1,4,28
4747,2014/03/31,2004/12/01,14,36,0.622158833,56424,14,13,23
4748,2014/03/31,2011/01/13,8,35,0.7737514879999999,45358,8,14,21
4749,2014/03/31,2007/02/14,2,26,0.702667948,49941,2,16,10
4750,2014/03/31,2011/07/30,28,35,0.636492536,55131,28,15,20
4751,2014/03/31,2005/07/29,42,49,0.846672137,41432,42,23,26
4752,2014/03/31,2008/03/01,5,33,0.676120781,51879,5,17,16
4753,2014/03/31,2012/03/26,11,16,0.670855137,52284,11,8,8
4754,2014/03/31,2012/05/22,17,30,0.815587955,43005,17,16,14
4755,2014/03/31,2012/07/11,27,28,0.80832419,43382,27,8,20
4756,2014/03/31,2006/05/22,34,50,0.6022090370000001,58229,34,26,24
4757,2014/03/31,2011/12/26,321,31,0.8631012159999999,40626,321,24,7
4758,2014/03/31,2008/06/02,8,33,0.53763306,65215,8,4,29
4759,2014/03/31,2013/03/21,11,34,0.64118822,54670,11,3,31
4760,2014/03/31,2005/04/16,73,24,0.6186026689999999,56658,73,23,1
4761,2014/03/31,2008/10/24,29,46,0.803982979,43593,29,33,13
4762,2014/03/31,2008/08/10,284,20,1.433165385,24452,284,17,3
4763,2014/03/31,2011/01/17,8,32,0.617334132,56762,8,15,17
4764,2014/03/31,2012/01/20,82,6,0.77,45504,82,3,3
4765,2014/03/31,2011/04/02,12,32,0.645850646,54247,12,0,32
4766,2014/03/31,2012/02/16,6,33,0.737425955,47505,6,11,22
4767,2014/03/31,2010/02/26,62,29,0.70245829,49868,62,16,13
4768,2014/03/31,2007/12/20,476,5,1.05,33350,476,5,0
4769,2014/03/31,2012/07/09,9,19,0.819094524,42751,9,9,10
4770,2014/03/31,2012/03/01,12,25,0.6342243320000001,55204,12,15,10
4771,2014/03/31,2011/06/05,34,44,0.851778475,41097,34,22,22
4772,2014/03/31,2008/03/23,42,38,0.671957957,52090,42,24,14
4773,2014/03/31,2005/10/22,39,30,0.89431353,39135,39,18,12
4774,2014/03/31,2010/05/13,27,36,0.699839422,50007,27,14,22
4775,2014/03/31,2006/06/21,12,22,0.759582827,46072,12,16,6
4776,2014/03/31,2010/08/08,14,24,0.819680238,42688,14,12,12
4777,2014/03/31,2012/12/12,88,6,0.476666667,73392,88,2,4
4778,2014/03/31,2010/08/14,32,28,0.743274474,47061,32,15,13
4779,2014/03/31,2013/03/19,11,19,0.701514361,49856,11,1,18
4780,2014/03/31,2011/12/08,63,32,0.770771587,45374,63,14,18
4781,2014/03/31,2008/01/12,59,29,0.667524577,52387,59,7,22
4782,2014/03/31,2012/08/13,185,28,0.669448061,52234,185,23,5
4783,2014/03/31,2008/04/14,15,36,0.722409975,48403,15,16,20
4784,2014/03/31,2010/01/17,17,32,0.86004526,40654,17,23,9
4785,2014/03/31,2007/05/26,1,27,0.877393465,39846,1,11,16
4786,2014/03/31,2011/09/02,103,53,0.8806196940000001,39697,103,31,22
4787,2014/03/31,2007/12/19,20,41,0.739813745,47247,20,17,24
4788,2014/03/31,2011/10/18,11,14,0.772857143,45220,11,7,7
4789,2014/03/31,2007/04/09,202,34,0.807228715,43294,202,29,5
4790,2014/03/31,2012/09/03,20,26,0.758639995,46066,20,12,14
4791,2014/03/31,2011/09/13,28,32,0.565339212,61805,28,12,20
4792,2014/03/31,2005/08/04,5,33,0.783964051,44563,5,18,15
4793,2014/03/31,2012/08/13,50,31,0.57048714,61235,50,17,14
4794,2014/03/31,2011/09/11,2,40,0.66189728,52765,2,8,32
4795,2014/03/31,2012/09/16,33,23,0.6926347629999999,50422,33,10,13
4796,2014/03/31,2011/06/08,33,30,0.739544463,47219,33,9,21
4797,2014/03/31,2010/10/08,6,34,0.765550952,45612,6,22,12
4798,2014/03/31,2008/06/16,5,29,0.796192311,43856,5,18,11
4799,2014/03/31,2007/01/23,20,36,0.642075003,54371,20,16,20
4800,2014/03/31,2009/12/12,26,21,1.321695827,26406,26,6,15
4801,2014/03/31,2010/04/13,16,41,0.746643132,46740,16,22,19
4802,2014/03/31,2006/10/30,37,28,0.808569509,43160,37,16,12
4803,2014/03/31,2006/07/31,109,16,1.4117281000000002,24715,109,11,5
4804,2014/03/31,2012/05/10,4,31,0.604639806,57705,4,5,26
4805,2014/03/31,2008/02/23,6,40,0.79046733,44123,6,20,20
4806,2014/03/31,2009/07/29,16,63,0.763814187,45648,16,19,44
4807,2014/03/31,2012/06/22,22,42,0.7895906859999999,44147,22,10,32
4808,2014/03/31,2007/06/29,61,43,0.6627392,52592,61,28,15
4809,2014/03/31,2007/06/25,103,16,0.669868719,52026,103,11,5
4810,2014/03/31,2009/12/15,4,32,0.88485141,39370,4,14,18
4811,2014/03/31,2005/05/09,110,29,0.701844703,49634,110,11,18
4812,2014/03/31,2007/01/17,72,29,0.6583519179999999,52910,72,14,15
4813,2014/03/31,2007/03/15,2,14,1.461096149,23838,2,7,7
4814,2014/03/31,2012/04/29,24,5,0.831874223,41852,24,1,4
4815,2014/03/31,2009/03/25,12,43,0.804884743,43251,12,18,25
4816,2014/03/31,2006/07/14,5,25,0.819646793,42468,5,10,15
4817,2014/03/31,2008/04/01,5,32,0.8361286520000001,41616,5,12,20
4818,2014/03/31,2007/09/04,43,54,0.83286682,41778,43,35,19
4819,2014/03/31,2009/06/23,4,23,0.756122547,46007,4,10,13
4820,2014/03/31,2006/05/27,28,42,0.651404734,53398,28,17,25
4821,2014/03/31,2010/02/05,17,27,0.7742148959999999,44924,17,13,14
4822,2014/03/31,2007/05/14,20,31,0.816165239,42605,20,16,15
4823,2014/03/31,2007/04/18,143,53,0.885911847,39250,143,38,15
4824,2014/03/31,2010/10/19,12,63,0.759915199,45754,12,30,33
4825,2014/03/31,2007/08/22,62,39,0.707776126,49117,62,21,18
4826,2014/03/31,2005/03/04,146,37,0.6734566059999999,51620,146,25,12
4827,2014/03/31,2009/09/09,9,16,0.763728799,45516,9,7,9
4828,2014/03/31,2010/09/25,83,9,0.78609621,44216,83,4,5
4829,2014/03/31,2006/09/15,12,62,0.5701112110000001,60965,12,30,32
4830,2014/03/31,2011/06/21,273,35,0.721316079,48181,273,27,8
4831,2014/03/31,2012/07/05,10,34,0.6864602470000001,50625,10,12,22
4832,2014/03/31,2006/04/21,21,28,0.7525832159999999,46175,21,19,9
4833,2014/03/31,2009/10/01,41,39,0.737295605,47127,41,18,21
4834,2014/03/31,2006/08/06,19,57,0.647753687,53639,19,34,23
4835,2014/03/31,2006/06/07,37,30,0.7755870340000001,44793,37,3,27
4836,2014/03/31,2011/04/01,35,19,1.143797043,30371,35,8,11
4837,2014/03/31,2012/07/27,9,35,0.808496543,42961,9,13,22
4838,2014/03/31,2010/09/25,57,19,0.6328327779999999,54879,57,11,8
4839,2014/03/31,2011/02/06,189,7,0.685511687,50656,189,4,3
4840,2014/03/31,2010/03/03,244,17,1.166480094,29765,244,10,7
4841,2014/03/31,2005/10/28,9,34,0.66701266,52053,9,10,24
4842,2014/03/31,2010/11/05,16,32,0.688594044,50407,16,15,17
4843,2014/03/31,2011/04/09,10,35,0.6901165220000001,50291,10,14,21
4844,2014/03/31,2007/12/31,25,21,1.437413729,24139,25,8,13
4845,2014/03/31,2009/01/30,2,28,0.8208476459999999,42270,2,24,4
4846,2014/03/31,2010/03/25,26,33,0.6928684709999999,50065,26,8,25
4847,2014/03/31,2012/05/09,23,27,0.7592197559999999,45678,23,8,19
4848,2014/03/31,2011/03/03,8,14,1.422351421,24381,8,1,13
4849,2014/03/31,2011/01/21,10,41,0.735282019,47160,10,13,28
4850,2014/03/31,2011/12/28,158,24,0.541082987,64082,158,14,10
4851,2014/03/31,2007/09/10,8,38,0.617050826,56192,8,15,23
4852,2014/03/31,2009/10/15,1,34,0.6974272840000001,49714,1,16,18
4853,2014/03/31,2006/08/12,1,47,0.67213603,51577,1,29,18
4854,2014/03/31,2009/09/16,14,39,0.7134271190000001,48586,14,11,28
4855,2014/03/31,2006/03/20,24,37,0.7127363590000001,48623,24,16,21
4856,2014/03/31,2010/07/14,7,54,0.70007154,49483,7,30,24
4857,2014/03/31,2006/04/28,6,53,0.694708773,49858,6,23,30
4858,2014/03/31,2008/05/29,156,5,0.6924939,50002,156,1,4
4859,2014/03/31,2013/02/09,11,53,0.805283883,42993,11,6,47
4860,2014/03/31,2012/05/18,38,39,0.692065209,50024,38,8,31
4861,2014/03/31,2010/05/28,154,17,1.104367123,31341,154,10,7
4862,2014/03/31,2012/01/17,60,28,0.827798613,41810,60,23,5
4863,2014/03/31,2010/10/21,17,38,0.693106963,49933,17,21,17
4864,2014/03/31,2008/12/26,157,4,1.137550953,30420,157,2,2
4865,2014/03/31,2007/10/28,10,24,0.8103697809999999,42701,10,13,11
4866,2014/03/31,2012/06/22,8,26,0.7812013459999999,44292,8,15,11
4867,2014/03/31,2007/10/18,24,31,0.711557192,48626,24,17,14
4868,2014/03/31,2007/08/01,8,43,0.763217965,45333,8,21,22
4869,2014/03/31,2011/09/12,40,24,1.3868618169999998,24938,40,5,19
4870,2014/03/31,2007/07/14,41,36,0.7024060609999999,49234,41,18,18
4871,2014/03/31,2009/07/19,3,22,0.770255474,44897,3,13,9
4872,2014/03/31,2008/04/30,22,40,0.648157964,53354,22,25,15
4873,2014/03/31,2008/10/12,109,26,0.6872318609999999,50319,109,15,11
4874,2014/03/31,2012/06/22,87,22,0.5497109929999999,62905,87,5,17
4875,2014/03/31,2006/03/31,7,25,0.72941308,47400,7,9,16
4876,2014/03/31,2011/09/10,45,5,0.682,50680,45,1,4
4877,2014/03/31,2005/11/19,129,29,0.8569657070000001,40329,129,16,13
4878,2014/03/31,2007/05/19,2,101,0.608057603,56837,2,41,60
4879,2014/03/31,2008/08/04,46,26,0.7299733829999999,47338,46,10,16
4880,2014/03/31,2005/09/02,279,21,0.914024497,37801,279,17,4
4881,2014/03/31,2009/02/21,4,42,0.66524468,51925,4,29,13
4882,2014/03/31,2009/04/21,16,22,0.864478987,39951,16,12,10
4883,2014/03/31,2008/12/01,70,22,0.714829435,48310,70,10,12
4884,2014/03/31,2008/05/23,11,21,1.031487245,33478,11,11,10
4885,2014/03/31,2009/10/16,60,17,1.218005573,28349,60,9,8
4886,2014/03/31,2010/11/25,37,8,0.69750101,49500,37,3,5
4887,2014/03/31,2006/09/25,56,35,0.829192065,41637,56,21,14
4888,2014/03/31,2004/11/30,1,44,0.764004603,45188,1,22,22
4889,2014/03/31,2012/05/01,19,34,0.679305616,50822,19,17,17
4890,2014/03/31,2012/05/13,22,36,0.60047494,57481,22,18,18
4891,2014/03/31,2013/02/01,13,25,0.7922627740000001,43566,13,3,22
4892,2014/03/31,2011/06/22,13,12,1.037985324,33251,13,7,5
4893,2014/03/31,2011/07/05,39,25,0.644503249,53548,39,14,11
4894,2014/03/31,2009/10/05,285,30,0.710612001,48562,285,25,5
4895,2014/03/31,2006/04/02,4,27,0.6583518389999999,52416,4,9,18
4896,2014/03/31,2007/09/16,246,6,0.7583333329999999,45504,246,3,3
4897,2014/03/31,2007/05/29,40,35,0.621188924,55546,40,15,20
4898,2014/03/31,2005/11/07,97,33,0.704394218,48978,97,21,12
4899,2014/03/31,2007/04/04,294,4,0.705,48928,294,2,2
4900,2014/03/31,2011/02/13,23,22,0.759499736,45416,23,14,8
4901,2014/03/31,2012/01/23,3,45,1.074942188,32087,3,15,30
4902,2014/03/31,2012/10/27,25,37,0.8128299,42422,25,17,20
4903,2014/03/31,2012/11/08,12,8,0.723188321,47674,12,2,6
4904,2014/03/31,2012/07/10,8,40,0.7629949540000001,45186,8,10,30
4905,2014/03/31,2008/08/22,38,25,0.898557539,38365,38,16,9
4906,2014/03/31,2013/01/26,35,18,0.7603895620000001,45333,35,4,14
4907,2014/03/31,2010/12/18,45,29,0.718025705,48007,45,16,13
4908,2014/03/31,2011/11/05,9,39,0.7990364459999999,43132,9,7,32
4909,2014/03/31,2011/03/17,135,24,0.841894513,40934,135,17,7
4910,2014/03/31,2011/12/01,278,14,0.799538726,43098,278,12,2
4911,2014/03/31,2010/08/01,4,10,0.893372657,38569,4,4,6
4912,2014/03/31,2006/07/15,2,39,0.709411547,48568,2,0,39
4913,2014/03/31,2008/06/20,36,29,0.628020163,54853,36,12,17
4914,2014/03/31,2007/11/01,13,40,0.906848132,37987,13,15,25
4915,2014/03/31,2006/01/09,33,32,0.80586603,42741,33,11,21
4916,2014/03/31,2007/06/25,24,32,0.803877565,42831,24,15,17
4917,2014/03/31,2008/05/13,2,43,0.606921151,56729,2,27,16
4918,2014/03/31,2009/08/08,17,30,0.702138108,49034,17,0,30
4919,2014/03/31,2008/12/30,86,30,0.80557209,42738,86,16,14
4920,2014/03/31,2010/03/23,29,30,0.6766871740000001,50875,29,18,12
4921,2014/03/31,2011/10/18,102,27,0.698411175,49288,102,20,7
4922,2014/03/31,2005/10/10,46,22,0.576071494,59753,46,17,5
4923,2014/03/31,2011/03/03,38,34,0.7646431509999999,44991,38,25,9
4924,2014/03/31,2010/01/18,5,41,0.6213227720000001,55361,5,16,25
4925,2014/03/31,2012/12/26,10,39,0.857194028,40118,10,9,30
4926,2014/03/31,2005/03/18,14,41,0.748023233,45969,14,17,24
4927,2014/03/31,2009/02/06,31,18,1.451360182,23688,31,8,10
4928,2014/03/31,2008/06/11,1,30,0.8784084520000001,39138,1,19,11
4929,2014/03/31,2006/03/07,39,32,0.7018690790000001,48976,39,18,14
4930,2014/03/31,2012/05/18,45,33,0.768345255,44738,45,23,10
4931,2014/03/31,2010/10/30,125,5,0.562,61160,125,3,2
4932,2014/03/31,2010/12/26,233,3,0.936666667,36696,233,1,2
4933,2014/03/31,2008/06/13,10,19,0.827202715,41551,10,16,3
4934,2014/03/31,2010/02/22,143,12,0.8866666670000001,38760,143,5,7
4935,2014/03/31,2007/11/17,4,31,0.890958702,38573,4,12,19
4936,2014/03/31,2007/08/08,5,27,0.7008729709999999,49028,5,13,14
4937,2014/03/31,2010/08/15,119,7,0.660060317,52058,119,5,2
4938,2014/03/31,2007/03/17,32,47,0.761058076,45148,32,22,25
4939,2014/03/31,2011/07/17,12,52,0.8571469909999999,40084,12,30,22
4940,2014/03/31,2010/06/01,14,45,0.698971193,49154,14,24,21
4941,2014/03/31,2011/05/15,39,33,0.7472189840000001,45976,39,14,19
4942,2014/03/31,2008/08/20,7,26,0.7073335390000001,48555,7,4,22
4943,2014/03/31,2006/07/21,2,24,0.94008376,36533,2,11,13
4944,2014/03/31,2010/08/23,39,19,1.188614937,28894,39,7,12
4945,2014/03/31,2011/10/13,9,38,0.599142398,57311,9,14,24
4946,2014/03/31,2007/05/10,86,30,0.717946595,47823,86,19,11
4947,2014/03/31,2010/04/28,3,24,0.729558777,47051,3,11,13
4948,2014/03/31,2009/07/31,62,60,0.7738092879999999,44360,62,37,23
4949,2014/03/31,2011/11/23,1,25,0.7211580809999999,47596,1,9,16
4950,2014/03/31,2009/10/27,69,36,0.7394955809999999,46390,69,23,13
4951,2014/03/31,2007/04/10,3,65,0.776414919,44158,3,33,32
4952,2014/03/31,2007/08/01,13,29,1.281286718,26758,13,7,22
4953,2014/03/31,2007/06/01,4,24,1.405971453,24381,4,7,17
4954,2014/03/31,2007/06/18,165,26,0.958504236,35761,165,17,9
4955,2014/03/31,2011/11/29,72,21,0.668703736,51255,72,13,8
4956,2014/03/31,2008/02/23,20,34,0.8650849509999999,39611,20,22,12
4957,2014/03/31,2012/01/17,177,25,0.871108766,39332,177,21,4
4958,2014/03/31,2013/02/08,38,18,0.742800806,46126,38,2,16
4959,2014/03/31,2008/05/04,14,45,0.7737624209999999,44280,14,26,19
4960,2014/03/31,2007/12/13,21,31,0.685072797,50002,21,20,11
4961,2014/03/31,2007/03/12,25,27,0.750153075,45664,25,7,20
4962,2014/03/31,2010/10/28,13,32,0.60933363,56200,13,26,6
4963,2014/03/31,2005/11/10,14,37,0.635510155,53866,14,19,18
4964,2014/03/31,2009/10/17,4,28,0.793639926,43130,4,8,20
4965,2014/03/31,2012/08/13,22,21,0.784761905,43617,22,8,13
4966,2014/03/31,2006/10/06,6,29,0.827046251,41361,6,7,22
4967,2014/03/31,2006/02/17,14,43,0.6188465439999999,55260,14,22,21
4968,2014/03/31,2010/09/12,210,18,0.739556868,46239,210,11,7
4969,2014/03/31,2007/09/05,19,41,0.978329947,34945,19,27,14
4970,2014/03/31,2012/03/29,117,38,0.857497805,39869,117,24,14
4971,2014/03/31,2005/04/20,8,43,0.772750616,44241,8,27,16
4972,2014/03/31,2005/12/09,12,34,0.7959372309999999,42951,12,17,17
4973,2014/03/31,2007/10/12,35,48,0.747609423,45717,35,21,27
4974,2014/03/31,2011/12/19,1,28,0.637234455,53635,1,16,12
4975,2014/03/31,2009/12/13,35,29,0.639877558,53413,35,8,21
4976,2014/03/31,2010/07/30,15,49,0.662711072,51570,15,24,25
4977,2014/03/31,2006/11/06,74,15,0.776726975,43996,74,6,9
4978,2014/03/31,2009/01/26,7,28,0.480753613,71071,7,13,15
4979,2014/03/31,2009/06/02,4,14,1.269983644,26901,4,5,9
4980,2014/03/31,2011/02/06,11,41,0.714220935,47833,11,24,17
4981,2014/03/31,2010/04/30,31,28,0.645073268,52956,31,9,19
4982,2014/03/31,2011/02/17,195,4,0.8425,40544,195,1,3
4983,2014/03/31,2006/02/01,25,24,0.823783706,41462,25,13,11
4984,2014/03/31,2010/12/04,36,25,0.877754934,38912,36,15,10
4985,2014/03/31,2005/12/03,57,17,0.774154143,44115,57,10,7
4986,2014/03/31,2006/09/24,4,26,0.66141529,51629,4,9,17
4987,2014/03/31,2009/03/11,129,27,0.941767773,36249,129,17,10
4988,2014/03/31,2005/09/18,9,46,0.773369511,44134,9,24,22
4989,2014/03/31,2009/07/20,58,6,0.75,45504,58,3,3
4990,2014/03/31,2012/06/18,28,5,0.5579999999999999,61160,28,1,4
4991,2014/03/31,2008/07/01,20,36,0.715996979,47659,20,12,24
4992,2014/03/31,2009/03/23,11,57,0.7838252859999999,43534,11,34,23
4993,2014/03/31,2011/06/14,134,30,0.659476807,51740,134,20,10
4994,2014/03/31,2012/05/16,21,26,0.749481153,45524,21,11,15
4995,2014/03/31,2006/07/27,269,32,0.673221172,50671,269,21,11
4996,2014/03/31,2004/12/15,14,30,0.669718775,50920,14,14,16
4997,2014/03/31,2006/03/16,22,33,0.587023639,58081,22,15,18
4998,2014/03/31,2006/10/17,117,36,0.8880726440000001,38379,117,28,8
4999,2014/03/31,2008/09/19,104,28,0.523243185,65115,104,25,3
5000,2014/03/31,2007/10/30,163,17,0.719490401,47351,163,10,7
5001,2014/03/31,2010/03/25,31,19,0.8169916070000001,41700,31,8,11
5002,2014/03/31,2005/06/23,10,43,0.695163245,49006,10,26,17
5003,2014/03/31,2010/09/01,8,36,0.629171223,54140,8,21,15
5004,2014/03/31,2008/09/30,24,45,0.8281054729999999,41129,24,18,27
5005,2014/03/31,2007/05/29,7,24,0.799564983,42596,7,14,10
5006,2014/03/31,2009/09/15,24,19,1.218100161,27955,24,16,3
5007,2014/03/31,2011/03/01,14,20,0.701755977,48520,14,10,10
5008,2014/03/31,2005/10/18,10,32,0.603066976,56453,10,14,18
5009,2014/03/31,2011/12/23,82,17,0.695332244,48955,82,8,9
5010,2014/03/31,2012/09/18,25,33,0.487240481,69860,25,15,18
5011,2014/03/31,2012/06/13,8,24,0.672146059,50637,8,8,16
5012,2014/03/31,2013/02/08,17,11,1.253722507,27143,17,5,6
5013,2014/03/31,2006/12/05,144,29,0.695715454,48906,144,19,10
5014,2014/03/31,2008/04/26,5,37,0.658286671,51683,5,18,19
5015,2014/03/31,2005/11/26,100,30,0.6462980620000001,52640,100,17,13
5016,2014/03/31,2012/09/21,47,36,0.638360013,53287,47,12,24
5017,2014/03/31,2007/07/06,36,33,0.718266793,47340,36,16,17
5018,2014/03/31,2007/11/27,3,33,0.57075899,59566,3,19,14
5019,2014/03/31,2012/05/09,38,16,0.7530511740000001,45140,38,5,11
5020,2014/03/31,2007/05/15,76,15,1.285870692,26433,76,4,11
5021,2014/03/31,2007/09/06,205,24,0.839794395,40466,205,19,5
5022,2014/03/31,2010/05/12,5,23,0.6470104529999999,52523,5,0,23
5023,2014/03/31,2009/10/12,10,28,0.6580110379999999,51640,10,14,14
5024,2014/03/31,2011/03/02,181,6,0.7639439720000001,44478,181,0,6
5025,2014/03/31,2007/11/21,8,46,0.848801529,40026,8,19,27
5026,2014/03/31,2006/01/20,137,28,0.778205287,43656,137,16,12
5027,2014/03/31,2005/06/13,13,21,0.991199813,34272,13,12,9
5028,2014/03/31,2008/12/13,2,32,0.841304369,40372,2,16,16
5029,2014/03/31,2009/01/12,23,30,0.6980891690000001,48649,23,21,9
5030,2014/03/31,2009/07/15,31,45,0.7714807659999999,44011,31,16,29
5031,2014/03/31,2006/11/23,9,57,0.8024369490000001,42307,9,20,37
5032,2014/03/31,2010/09/26,22,25,0.643797276,52722,22,10,15
5033,2014/03/31,2012/10/30,151,60,0.855076597,39688,151,22,38
5034,2014/03/31,2012/02/20,34,24,0.8048786790000001,42161,34,9,15
5035,2014/03/31,2008/04/02,28,22,0.542727273,62524,28,6,16
5036,2014/03/31,2013/03/25,5,6,0.531562852,63832,5,1,5
5037,2014/03/31,2008/09/08,148,29,0.704435817,48167,148,19,10
5038,2014/03/31,2010/11/17,132,15,0.7629757090000001,44460,132,7,8
5039,2014/03/31,2008/08/28,65,38,0.7249442140000001,46786,65,13,25
5040,2014/03/31,2013/03/05,4,14,1.405228723,24134,4,1,13
5041,2014/03/31,2009/04/11,14,40,0.783972995,43252,14,17,23
5042,2014/03/31,2007/04/08,13,49,0.966207398,35092,13,28,21
5043,2014/03/31,2012/12/08,16,46,0.6437175079999999,52667,16,11,35
5044,2014/03/31,2007/11/01,2,17,1.299165964,26090,2,9,8
5045,2014/03/31,2010/10/24,33,41,0.6826827940000001,49646,33,22,19
5046,2014/03/31,2006/03/03,1,45,0.708008357,47865,1,15,30
5047,2014/03/31,2009/12/27,17,25,1.149701751,29472,17,15,10
5048,2014/03/31,2013/02/06,2,44,0.80352439,42169,2,2,42
5049,2014/03/31,2010/12/05,151,9,0.7374209840000001,45940,151,3,6
5050,2014/03/31,2005/06/27,72,33,0.699263236,48428,72,14,19
5051,2014/03/31,2007/12/26,13,36,0.851226337,39777,13,19,17
5052,2014/03/31,2012/06/02,3,38,0.595358619,56871,3,16,22
5053,2014/03/31,2006/10/08,4,39,0.751638325,45046,4,16,23
5054,2014/03/31,2008/12/02,31,37,0.833980391,40594,31,17,20
5055,2014/03/31,2010/10/16,435,7,0.640298013,52850,435,7,0
5056,2014/03/31,2011/04/12,19,37,0.787847179,42939,19,15,22
5057,2014/03/31,2006/05/24,28,30,1.072951402,31524,28,19,11
5058,2014/03/31,2007/04/02,11,32,0.778321635,43453,11,16,16
5059,2014/03/31,2010/07/16,8,35,0.7795700879999999,43381,8,17,18
5060,2014/03/31,2011/11/08,26,37,0.721040041,46902,26,28,9
5061,2014/03/31,2006/03/28,4,41,0.747436453,45242,4,7,34
5062,2014/03/31,2012/06/11,200,17,0.7523529409999999,44931,200,14,3
5063,2014/03/31,2011/12/28,82,16,1.450699112,23301,82,6,10
5064,2014/03/31,2009/06/06,50,31,0.65734451,51418,50,28,3
5065,2014/03/31,2012/04/05,18,48,0.925109761,36534,18,23,25
5066,2014/03/31,2011/10/28,44,16,1.418166254,23831,44,6,10
5067,2014/03/31,2012/01/17,32,11,0.663763088,50905,32,6,5
5068,2014/03/31,2006/12/10,13,42,0.75977287,44468,13,14,28
5069,2014/03/31,2012/05/11,27,33,0.736913798,45846,27,13,20
5070,2014/03/31,2007/10/10,16,28,0.708156775,47699,16,14,14
5071,2014/03/31,2012/02/22,9,42,0.853574462,39564,9,20,22
5072,2014/03/31,2007/04/04,23,43,0.7818122470000001,43195,23,21,22
5073,2014/03/31,2007/07/13,49,42,0.82888368,40741,49,21,21
5074,2014/03/31,2006/08/06,70,31,0.807922528,41796,70,22,9
5075,2014/03/31,2010/06/11,32,26,0.72965816,46279,32,11,15
5076,2014/03/31,2011/03/04,9,26,0.730709231,46205,9,6,20
5077,2014/03/31,2010/06/19,23,46,0.597209936,56522,23,19,27
5078,2014/03/31,2012/02/24,38,45,0.55381729,60949,38,24,21
5079,2014/03/31,2010/04/14,7,13,1.118516984,30175,7,9,4
5080,2014/03/31,2008/08/23,23,41,0.724107273,46610,23,23,18
5081,2014/03/31,2007/08/01,76,32,0.6764869090000001,49882,76,19,13
5082,2014/03/31,2011/11/17,185,29,0.807431983,41791,185,24,5
5083,2014/03/31,2013/01/11,8,39,0.720343753,46836,8,4,35
5084,2014/03/31,2008/11/03,43,21,0.966024514,34919,43,7,14
5085,2014/03/31,2012/04/25,76,23,0.868814332,38822,76,12,11
5086,2014/03/31,2007/01/04,27,17,0.814383194,41415,27,7,10
5087,2014/03/31,2009/06/28,41,34,0.875984675,38500,41,26,8
5088,2014/03/31,2009/07/04,3,23,0.8975314059999999,37572,3,0,23
5089,2014/03/31,2011/12/27,1,29,1.171653521,28781,1,16,13
5090,2014/03/31,2008/06/18,221,10,1.4925620819999998,22591,221,8,2
5091,2014/03/31,2008/09/25,15,78,0.7211035309999999,46759,15,34,44
5092,2014/03/31,2013/03/04,1,11,0.811107609,41567,1,1,10
5093,2014/03/31,2011/12/05,123,21,0.764572485,44092,123,15,6
5094,2014/03/31,2006/10/21,73,14,1.367520792,24649,73,6,8
5095,2014/03/31,2012/09/30,4,38,0.635493882,53039,4,11,27
5096,2014/03/31,2007/11/06,6,24,0.8288862109999999,40663,6,9,15
5097,2014/03/31,2006/04/17,5,38,0.747344069,45084,5,23,15
5098,2014/03/31,2010/05/27,258,34,0.73981946,45530,258,30,4
5099,2014/03/31,2009/03/17,3,26,1.262042338,26690,3,9,17
5100,2014/03/31,2011/04/05,6,25,0.5643327020000001,59681,6,21,4
5101,2014/03/31,2006/07/04,14,45,0.66105227,50947,14,24,21
5102,2014/03/31,2008/07/08,73,34,0.5908074529999999,56994,73,25,9
5103,2014/03/31,2012/05/17,21,48,0.8062520959999999,41754,21,18,30
5104,2014/03/31,2009/11/24,2,34,0.639420202,52639,2,16,18
5105,2014/03/31,2006/06/01,33,36,0.5941597670000001,56645,33,20,16
5106,2014/03/31,2011/08/23,6,27,0.649402798,51825,6,14,13
5107,2014/03/31,2012/03/06,7,48,0.733108676,45907,7,17,31
5108,2014/03/31,2007/09/19,2,13,0.8683550090000001,38754,2,4,9
5109,2014/03/31,2011/10/11,83,13,1.398043207,24070,83,5,8
5110,2014/03/31,2007/04/01,18,23,0.705378907,47703,18,14,9
5111,2014/03/31,2012/09/05,9,31,0.7607291759999999,44228,9,14,17
5112,2014/03/31,2010/09/28,224,4,0.6875,48928,224,3,1
5113,2014/03/31,2012/04/11,5,48,0.792589538,42440,5,17,31
5114,2014/03/31,2011/06/05,55,34,0.75637118,44469,55,20,14
5115,2014/03/31,2007/09/01,3,33,0.65462037,51379,3,12,21
5116,2014/03/31,2011/03/16,12,33,0.738503832,45543,12,16,17
5117,2014/03/31,2007/12/09,29,19,0.77452881,43422,29,12,7
5118,2014/03/31,2008/11/13,13,41,0.70555143,47667,13,17,24
5119,2014/03/31,2011/03/12,11,32,0.6490883470000001,51807,11,14,18
5120,2014/03/31,2007/03/06,18,24,0.8094590759999999,41540,18,8,16
5121,2014/03/31,2007/07/17,3,44,0.6416484060000001,52390,3,16,28
5122,2014/03/31,2011/01/19,13,29,0.6479346970000001,51881,13,11,18
5123,2014/03/31,2011/04/11,21,30,0.822476083,40871,21,19,11
5124,2014/03/31,2011/06/06,263,38,0.979829169,34303,263,30,8
5125,2014/03/31,2009/03/10,124,14,0.6289964060000001,53418,124,10,4
5126,2014/03/31,2012/03/15,135,26,0.574746125,58454,135,20,6
5127,2014/03/31,2012/09/23,1,33,0.679973688,49407,1,15,18
5128,2014/03/31,2006/04/06,78,33,0.725360166,46312,78,16,17
5129,2014/03/31,2012/01/07,69,31,0.744777615,45102,69,19,12
5130,2014/03/31,2011/11/18,4,27,0.776467325,43259,4,6,21
5131,2014/03/31,2012/02/07,1,38,0.712698086,47126,1,13,25
5132,2014/03/31,2008/08/01,112,22,0.928155088,36186,112,14,8
5133,2014/03/31,2005/11/30,8,21,0.888826192,37783,8,6,15
5134,2014/03/31,2009/11/07,2,31,0.8116215109999999,41375,2,18,13
5135,2014/03/31,2011/03/01,17,20,0.758846128,44251,17,12,8
5136,2014/03/31,2006/09/22,64,34,0.6427035870000001,52238,64,27,7
5137,2014/03/31,2013/02/28,15,16,0.808371623,41526,15,1,15
5138,2014/03/31,2009/07/13,2,54,0.601763324,55781,2,19,35
5139,2014/03/31,2012/08/03,14,20,0.753040045,44575,14,2,18
5140,2014/03/31,2010/05/10,31,33,0.903141635,37159,31,8,25
5141,2014/03/31,2009/09/19,14,13,1.448613054,23166,14,6,7
5142,2014/03/31,2008/08/30,25,32,0.810398493,41406,25,21,11
5143,2014/03/31,2011/01/13,30,30,0.59592927,56270,30,0,30
5144,2014/03/31,2012/06/20,179,25,1.11036858,30197,179,20,5
5145,2014/03/31,2006/06/19,10,46,0.8499366140000001,39441,10,26,20
5146,2014/03/31,2006/07/27,31,40,0.911716982,36768,31,16,24
5147,2014/03/31,2012/09/28,12,26,0.832499938,40265,12,9,17
5148,2014/03/31,2010/06/11,13,37,0.667614533,50204,13,19,18
5149,2014/03/31,2012/04/07,93,4,0.685,48928,93,0,4
5150,2014/03/31,2008/09/14,119,4,0.685,48928,119,1,3
5151,2014/03/31,2010/04/18,2,28,0.672143287,49858,2,18,10
5152,2014/03/31,2012/03/18,337,24,0.792074598,42307,337,22,2
5153,2014/03/31,2005/03/16,8,36,0.648082897,51703,8,24,12
5154,2014/03/31,2005/07/31,1,47,0.754158882,44423,1,3,44
5155,2014/03/31,2005/07/13,24,29,0.7264563279999999,46116,24,23,6
5156,2014/03/31,2005/12/27,29,29,0.8559912609999999,39137,29,17,12
5157,2014/03/31,2011/11/14,4,27,0.8525574709999999,39281,4,12,15
5158,2014/03/31,2005/12/04,8,34,0.63916708,52394,8,22,12
5159,2014/03/31,2010/11/20,10,66,0.667163064,50195,10,34,32
5160,2014/03/31,2006/07/27,10,35,0.633295068,52876,10,18,17
5161,2014/03/31,2006/12/06,12,37,0.8080975020000001,41435,12,22,15
5162,2014/03/31,2007/05/29,211,4,1.03,32508,211,2,2
5163,2014/03/31,2008/02/25,5,24,0.700653312,47772,5,17,7
5164,2014/03/31,2009/04/05,71,33,0.644547555,51929,71,23,10
5165,2014/03/31,2011/07/24,25,36,0.759467223,44071,25,23,13
5166,2014/03/31,2005/01/28,17,36,0.6074616079999999,55090,17,20,16
5167,2014/03/31,2005/04/08,25,20,1.073307352,31176,25,13,7
5168,2014/03/31,2012/12/14,18,40,0.768556433,43538,18,5,35
5169,2014/03/31,2013/01/27,99,25,0.885559085,37776,99,2,23
5170,2014/03/31,2011/06/30,83,26,0.720568111,46417,83,10,16
5171,2014/03/31,2012/09/26,22,13,0.857106942,39021,22,2,11
5172,2014/03/31,2009/12/01,13,45,0.8390920270000001,39858,13,28,17
5173,2014/03/31,2006/03/25,13,42,0.631430864,52961,13,27,15
5174,2014/03/31,2010/11/01,112,16,0.671881417,49771,112,1,15
5175,2014/03/31,2005/07/13,12,22,0.8987849790000001,37201,12,6,16
5176,2014/03/31,2011/08/09,12,37,0.797880632,41904,12,27,10
5177,2014/03/31,2007/03/17,116,27,1.223221616,27331,116,7,20
5178,2014/03/31,2010/04/10,1,33,0.772311833,43286,1,19,14
5179,2014/03/31,2011/09/20,20,67,0.7656277340000001,43657,20,35,32
5180,2014/03/31,2008/06/07,57,39,0.8125107579999999,41131,57,33,6
5181,2014/03/31,2011/12/24,101,16,0.833235162,40100,101,8,8
5182,2014/03/31,2006/06/13,2,32,0.834559397,40036,2,17,15
5183,2014/03/31,2005/07/05,41,38,0.724868635,46093,41,27,11
5184,2014/03/31,2012/07/20,125,18,1.347916969,24786,125,6,12
5185,2014/03/31,2006/08/30,4,11,1.4028395059999998,23814,4,10,1
5186,2014/03/31,2009/04/04,5,18,0.8024174209999999,41627,5,5,13
5187,2014/03/31,2012/07/05,40,29,0.926677211,36039,40,15,14
5188,2014/03/31,2008/06/25,32,24,0.7531351059999999,44343,32,10,14
5189,2014/03/31,2012/05/12,2,47,0.7697211079999999,43386,2,18,29
5190,2014/03/31,2006/12/22,5,49,0.86768897,38485,5,15,34
5191,2014/03/31,2010/06/09,54,12,0.887445977,37623,54,7,5
5192,2014/03/31,2007/09/09,8,34,1.045009234,31947,8,19,15
5193,2014/03/31,2011/04/20,1,25,1.10290459,30259,1,12,13
5194,2014/03/31,2007/03/19,152,33,0.770490497,43303,152,24,9
5195,2014/03/31,2010/12/09,23,35,0.888789865,37533,23,15,20
5196,2014/03/31,2011/01/04,26,42,0.72402596,46071,26,26,16
5197,2014/03/31,2013/01/25,15,43,0.800450422,41672,15,6,37
5198,2014/03/31,2012/10/01,95,5,0.664115585,50214,95,3,2
5199,2014/03/31,2008/05/05,13,41,0.734714399,45378,13,16,25
5200,2014/03/31,2010/04/28,133,33,0.83058309,40131,133,15,18
5201,2014/03/31,2011/12/15,81,19,1.055240462,31585,81,7,12
5202,2014/03/31,2009/07/02,157,40,0.580375035,57408,157,31,9
5203,2014/03/31,2011/09/07,10,40,0.692082009,48141,10,14,26
5204,2014/03/31,2011/03/24,3,29,0.600315344,55495,3,7,22
5205,2014/03/31,2006/09/11,23,44,0.799964694,41636,23,33,11
5206,2014/03/31,2008/07/30,13,28,0.7804489720000001,42653,13,12,16
5207,2014/03/31,2008/06/07,50,23,0.775380099,42923,50,8,15
5208,2014/03/31,2006/05/13,6,45,0.79829359,41684,6,22,23
5209,2014/03/31,2012/02/20,9,66,0.732258192,45439,9,29,37
5210,2014/03/31,2008/07/16,6,27,0.7572499890000001,43938,6,9,18
5211,2014/03/31,2006/11/04,71,43,0.689232713,48274,71,26,17
5212,2014/03/31,2009/04/24,5,29,0.6859640840000001,48502,5,16,13
5213,2014/03/31,2007/06/21,44,25,0.810099155,41047,44,7,18
5214,2014/03/31,2011/03/19,1,43,0.7490175490000001,44389,1,23,20
5215,2014/03/31,2009/12/29,42,30,0.782822463,42470,42,11,19
5216,2014/03/31,2009/09/17,66,34,0.720924448,46114,66,23,11
5217,2014/03/31,2008/12/04,266,23,0.970922313,34240,266,18,5
5218,2014/03/31,2012/02/11,44,33,0.68573919,48472,44,19,14
5219,2014/03/31,2006/02/20,1,35,0.66509457,49963,1,15,20
5220,2014/03/31,2007/12/19,1,26,0.68132159,48767,1,13,13
5221,2014/03/31,2010/03/05,6,38,0.8376932779999999,39658,6,22,16
5222,2014/03/31,2007/09/09,6,22,1.386270189,23961,6,13,9
5223,2014/03/31,2005/11/28,37,33,0.774191706,42899,37,23,10
5224,2014/03/31,2006/04/04,2,40,0.6867049940000001,48355,2,17,23
5225,2014/03/31,2012/08/16,8,36,0.678766485,48909,8,13,23
5226,2014/03/31,2008/09/25,44,32,0.583288646,56914,44,18,14
5227,2014/03/31,2011/11/29,29,23,0.8231909040000001,40324,29,7,16
5228,2014/03/31,2007/06/11,11,25,0.86073905,38563,11,16,9
5229,2014/03/31,2008/09/19,25,42,0.6027497589999999,55063,25,20,22
5230,2014/03/31,2005/01/17,98,11,0.5753343160000001,57685,98,3,8
5231,2014/03/31,2011/12/19,19,20,0.6767635359999999,49035,19,3,17
5232,2014/03/31,2011/07/12,74,34,0.7351874340000001,45136,74,20,14
5233,2014/03/31,2008/07/25,74,32,0.6134042,54092,74,17,15
5234,2014/03/31,2009/12/30,12,37,0.788230766,42086,12,13,24
5235,2014/03/31,2005/03/27,61,34,0.764543275,43374,61,15,19
5236,2014/03/31,2007/02/01,27,30,0.595644669,55672,27,16,14
5237,2014/03/31,2011/07/18,15,36,0.7135762720000001,46459,15,12,24
5238,2014/03/31,2006/08/08,12,22,1.246616021,26590,12,5,17
5239,2014/03/31,2011/08/01,4,29,0.7638891959999999,43392,4,11,18
5240,2014/03/31,2011/08/28,84,26,0.611959267,54158,84,16,10
5241,2014/03/31,2009/12/18,81,27,0.930815942,35603,81,14,13
5242,2014/03/31,2008/01/06,79,24,0.750432085,44158,79,15,9
5243,2014/03/31,2008/05/23,10,59,0.729850661,45400,10,27,32
5244,2014/03/31,2006/04/01,14,29,0.8183775440000001,40488,14,16,13
5245,2014/03/31,2008/06/20,4,15,0.741807841,44661,4,3,12
5246,2014/03/31,2006/04/25,9,30,0.6873460029999999,48199,9,16,14
5247,2014/03/31,2011/11/01,85,23,0.686099248,48283,85,9,14
5248,2014/03/31,2010/03/01,4,41,0.659233617,50249,4,16,25
5249,2014/03/31,2011/01/14,33,45,0.715420105,46298,33,25,20
5250,2014/03/31,2010/11/19,2,43,0.577504055,57333,2,8,35
5251,2014/03/31,2010/07/16,86,41,0.869450119,38081,86,23,18
5252,2014/03/31,2010/11/05,14,36,0.796126208,41582,14,22,14
5253,2014/03/31,2006/01/20,1,41,0.7578602990000001,43679,1,22,19
5254,2014/03/31,2009/08/29,28,30,0.7729072779999999,42827,28,19,11
5255,2014/03/31,2005/04/29,14,33,0.647495402,51114,14,16,17
5256,2014/03/31,2012/12/23,4,38,0.8055205320000001,41083,4,6,32
5257,2014/03/31,2012/07/20,7,45,0.615932137,53726,7,23,22
5258,2014/03/31,2006/12/06,77,33,0.627475726,52732,77,24,9
5259,2014/03/31,2009/04/17,28,50,0.6912554059999999,47865,28,20,30
5260,2014/03/31,2009/08/31,4,37,0.715428596,46244,4,14,23
5261,2014/03/31,2008/11/18,84,39,0.711307218,46511,84,27,12
5262,2014/03/31,2010/01/31,5,29,0.836607071,39544,5,7,22
5263,2014/03/31,2008/11/24,19,31,0.829045363,39900,19,17,14
5264,2014/03/31,2011/05/29,62,41,0.925059014,35754,62,17,24
5265,2014/03/31,2011/09/24,1,45,0.748065275,44213,1,22,23
5266,2014/03/31,2011/04/21,34,29,0.746542967,44301,34,14,15
5267,2014/03/31,2010/04/02,3,32,0.6909081220000001,47868,3,15,17
5268,2014/03/31,2009/12/21,108,18,0.8747931440000001,37804,108,15,3
5269,2014/03/31,2011/04/03,36,42,0.85659042,38603,36,25,17
5270,2014/03/31,2012/07/16,85,21,0.792678653,41715,85,8,13
5271,2014/03/31,2010/05/09,87,25,0.733775854,45060,87,17,8
5272,2014/03/31,2006/11/01,3,28,0.729076594,45343,3,8,20
5273,2014/03/31,2010/05/16,170,22,0.823085848,40164,170,9,13
5274,2014/03/31,2012/03/15,34,26,0.7688593229999999,42992,34,11,15
5275,2014/03/31,2012/01/10,22,42,0.5632363020000001,58675,22,14,28
5276,2014/03/31,2006/09/15,8,58,0.629205243,52494,8,25,33
5277,2014/03/31,2011/09/09,484,35,0.791646489,41713,484,35,0
5278,2014/03/31,2012/10/24,3,40,0.834650522,39559,3,10,30
5279,2014/03/31,2008/02/17,2,34,0.6166234620000001,53543,2,3,31
5280,2014/03/31,2012/10/24,11,8,0.7140450290000001,46237,11,3,5
5281,2014/03/31,2012/03/07,72,27,0.581940704,56732,72,18,9
5282,2014/03/31,2011/06/06,13,23,0.647563655,50978,13,13,10
5283,2014/03/31,2010/10/01,62,29,0.7409655190000001,44546,62,15,14
5284,2014/03/31,2006/05/15,8,43,0.7090728409999999,46540,8,16,27
5285,2014/03/31,2008/03/12,91,18,1.158168193,28491,91,5,13
5286,2014/03/31,2011/05/31,14,26,0.7043282240000001,46846,14,6,20
5287,2014/03/31,2006/11/24,113,15,0.641978441,51394,113,10,5
5288,2014/03/31,2011/05/15,220,21,0.662978518,49763,220,16,5
5289,2014/03/31,2011/10/17,5,33,0.6495171710000001,50784,5,18,15
5290,2014/03/31,2008/06/27,11,55,0.7453253940000001,44254,11,27,28
5291,2014/03/31,2006/04/13,9,31,0.665016233,49591,9,16,15
5292,2014/03/31,2007/07/06,44,35,0.775846411,42503,44,22,13
5293,2014/03/31,2011/12/16,3,22,0.725327849,45463,3,12,10
5294,2014/03/31,2012/07/10,30,36,0.736979863,44743,30,12,24
5295,2014/03/31,2010/06/04,20,36,0.750593485,43927,20,12,24
5296,2014/03/31,2009/02/09,41,25,0.829264943,39752,41,17,8
5297,2014/03/31,2010/12/10,1,25,0.665907438,49502,1,16,9
5298,2014/03/31,2012/03/03,3,53,0.770296345,42788,3,28,25
5299,2014/03/31,2010/12/10,9,24,0.582003073,56628,9,7,17
5300,2014/03/31,2008/06/14,9,36,0.7390423859999999,44590,9,24,12
5301,2014/03/31,2010/04/29,340,28,0.82449955,39964,340,25,3
5302,2014/03/31,2011/11/23,9,46,0.6871005490000001,47947,9,12,34
5303,2014/03/31,2006/11/15,22,32,0.67989289,48455,22,15,17
5304,2014/03/31,2012/11/11,69,20,0.80435771,40955,69,14,6
5305,2014/03/31,2009/12/17,76,28,0.742509243,44360,76,22,6
5306,2014/03/31,2007/11/20,144,37,0.908570404,36248,144,22,15
5307,2014/03/31,2008/06/01,64,25,0.714418605,46096,64,10,15
5308,2014/03/31,2011/05/31,3,21,0.613575887,53665,3,16,5
5309,2014/03/31,2012/05/22,128,20,0.7090000000000001,46440,128,14,6
5310,2014/03/31,2012/03/26,111,16,0.635928874,51767,111,14,2
5311,2014/03/31,2008/02/24,31,42,0.651742273,50503,31,10,32
5312,2014/03/31,2011/02/23,12,23,0.8107752570000001,40593,12,11,12
5313,2014/03/31,2013/01/06,94,29,0.632026887,52070,94,5,24
5314,2014/03/31,2012/02/18,20,36,0.627436367,52449,20,22,14
5315,2014/03/31,2010/01/04,47,28,0.6671417270000001,49320,47,17,11
5316,2014/03/31,2011/09/23,7,39,0.7129967490000001,46140,7,16,23
5317,2014/03/31,2012/07/03,98,23,0.68084858,48316,98,14,9
5318,2014/03/31,2012/02/08,65,25,0.721385587,45598,65,17,8
5319,2014/03/31,2010/10/21,8,27,0.708056357,46454,8,15,12
5320,2014/03/31,2009/09/07,21,30,0.6907636090000001,47616,21,9,21
5321,2014/03/31,2005/02/08,2,47,0.55104951,59685,2,27,20
5322,2014/03/31,2007/06/15,11,28,0.7297816579999999,45067,11,11,17
5323,2014/03/31,2011/09/14,10,25,0.67937389,48410,10,10,15
5324,2014/03/31,2005/10/04,143,53,0.665579414,49412,143,40,13
5325,2014/03/31,2009/10/18,1,24,0.8335863309999999,39447,1,13,11
5326,2014/03/31,2006/03/29,17,32,0.732525619,44888,17,17,15
5327,2014/03/31,2007/07/11,12,16,0.7775,42288,12,6,10
5328,2014/03/31,2011/01/14,24,22,0.602885783,54519,24,11,11
5329,2014/03/31,2013/01/14,4,40,0.702358422,46794,4,11,29
5330,2014/03/31,2012/01/30,44,25,0.765609057,42927,44,19,6
5331,2014/03/31,2012/05/16,109,12,1.0174428759999998,32298,109,8,4
5332,2014/03/31,2009/09/20,8,36,0.6746370209999999,48708,8,26,10
5333,2014/03/31,2013/02/01,5,29,0.673257587,48803,5,5,24
5334,2014/03/31,2006/10/20,74,42,0.644935616,50944,74,24,18
5335,2014/03/31,2009/06/22,50,14,0.775225814,42380,50,8,6
5336,2014/03/31,2012/03/03,17,36,0.8158645609999999,40269,17,24,12
5337,2014/03/31,2006/11/03,290,7,0.997831977,32924,290,2,5
5338,2014/03/31,2006/02/26,1,42,0.648993086,50620,1,21,21
5339,2014/03/31,2005/09/19,25,37,0.686833027,47828,25,20,17
5340,2014/03/31,2008/05/16,2,41,0.692821589,47413,2,10,31
5341,2014/03/31,2009/12/18,36,23,1.238750943,26516,36,10,13
5342,2014/03/31,2005/12/08,2,30,0.890129838,36892,2,12,18
5343,2014/03/31,2009/07/16,139,26,0.6923735320000001,47423,139,14,12
5344,2014/03/31,2006/10/07,6,20,1.167600839,28114,6,10,10
5345,2014/03/31,2009/01/15,8,35,0.695379335,47201,8,10,25
5346,2014/03/31,2009/12/01,125,29,0.873972778,37543,125,11,18
5347,2014/03/31,2010/09/14,68,16,0.806874662,40658,68,12,4
5348,2014/03/31,2012/01/13,73,31,0.7761577590000001,42267,73,11,20
5349,2014/03/31,2007/01/11,14,34,0.6551974279999999,50069,14,3,31
5350,2014/03/31,2007/02/01,8,35,0.717529533,45712,8,24,11
5351,2014/03/31,2011/10/13,34,29,0.7687996159999999,42653,34,12,17
5352,2014/03/31,2007/05/19,5,38,0.777724491,42162,5,19,19
5353,2014/03/31,2009/11/01,17,35,0.609165815,53813,17,9,26
5354,2014/03/31,2005/04/01,25,32,0.654449015,50083,25,23,9
5355,2014/03/31,2011/09/06,16,44,0.6962288640000001,47076,16,26,18
5356,2014/03/31,2012/10/03,6,28,0.7740546540000001,42339,6,7,21
5357,2014/03/31,2007/10/18,2,32,0.727037735,45077,2,19,13
5358,2014/03/31,2008/03/16,11,44,0.664775226,49294,11,22,22
5359,2014/03/31,2010/02/01,22,25,0.754507357,43429,22,18,7
5360,2014/03/31,2006/02/24,32,20,1.454602442,22525,32,9,11
5361,2014/03/31,2009/03/08,35,17,0.84971991,38559,35,9,8
5362,2014/03/31,2006/01/02,187,7,0.7679116859999999,42666,187,6,1
5363,2014/03/31,2010/10/07,27,29,0.754390935,43419,27,17,12
5364,2014/03/31,2007/07/09,22,31,0.698169591,46913,22,8,23
5365,2014/03/31,2012/05/01,65,36,0.737032111,44439,65,17,19
5366,2014/03/31,2011/08/23,20,15,1.170053587,27992,20,11,4
5367,2014/03/31,2010/10/18,39,40,0.7651488670000001,42790,39,14,26
5368,2014/03/31,2010/11/20,24,27,0.738059513,44360,24,19,8
5369,2014/03/31,2009/03/02,56,10,0.611872243,53508,56,0,10
5370,2014/03/31,2012/08/04,38,28,0.85616314,38237,38,8,20
5371,2014/03/31,2006/10/18,16,41,0.547957448,59739,16,12,29
5372,2014/03/31,2007/02/06,15,39,0.646860796,50602,15,17,22
5373,2014/03/31,2009/06/11,20,33,0.624166778,52441,20,9,24
5374,2014/03/31,2008/05/06,13,43,0.8740091329999999,37447,13,22,21
5375,2014/03/31,2011/01/20,83,25,0.7589266090000001,43125,83,13,12
5376,2014/03/31,2010/09/09,15,39,0.688329022,47547,15,21,18
5377,2014/03/31,2008/11/27,60,24,1.314569007,24896,60,17,7
5378,2014/03/31,2006/01/27,16,35,0.774461855,42247,16,22,13
5379,2014/03/31,2010/10/12,16,45,0.711032797,46011,16,19,26
5380,2014/03/31,2010/11/03,6,38,0.633368054,51650,6,17,21
5381,2014/03/31,2006/07/04,1,40,0.7533711820000001,43418,1,16,24
5382,2014/03/31,2005/12/03,8,30,0.808637015,40448,8,11,19
5383,2014/03/31,2009/02/22,3,37,0.667133764,49019,3,26,11
5384,2014/03/31,2006/07/23,19,26,0.742552355,44026,19,5,21
5385,2014/03/31,2011/08/04,40,15,0.6753878259999999,48398,40,5,10
5386,2014/03/31,2010/08/05,10,23,0.7195068790000001,45425,10,7,16
5387,2014/03/31,2012/01/05,17,41,0.668020276,48926,17,16,25
5388,2014/03/31,2012/05/10,19,35,0.89439272,36540,19,16,19
5389,2014/03/31,2005/09/01,10,28,0.7093565609999999,46065,10,7,21
5390,2014/03/31,2009/07/10,40,42,0.6944725490000001,47047,40,17,25
5391,2014/03/31,2012/08/26,1,25,0.868594564,37604,1,7,18
5392,2014/03/31,2005/05/06,12,41,0.663745732,49208,12,16,25
5393,2014/03/31,2010/10/10,3,31,0.5293384329999999,61702,3,15,16
5394,2014/03/31,2012/09/14,9,38,0.638435044,51158,9,17,21
5395,2014/03/31,2012/06/03,32,37,0.71766359,45510,32,9,28
5396,2014/03/31,2010/02/08,24,33,0.87133175,37477,24,5,28
5397,2014/03/31,2005/05/21,14,63,0.611694642,53380,14,17,46
5398,2014/03/31,2008/07/10,9,28,0.666255433,49007,9,14,14
5399,2014/03/31,2006/04/18,40,24,0.765913101,42624,40,10,14
5400,2014/03/31,2010/11/15,7,36,0.7292962620000001,44761,7,20,16
5401,2014/03/31,2012/05/19,27,31,0.682286031,47834,27,9,22
5402,2014/03/31,2006/01/15,9,26,0.692907767,47098,9,3,23
5403,2014/03/31,2005/04/29,7,22,0.679763765,48003,7,7,15
5404,2014/03/31,2005/01/20,49,21,0.682027677,47838,49,9,12
5405,2014/03/31,2010/12/01,63,31,0.731039883,44630,63,18,13
5406,2014/03/31,2008/07/12,69,14,1.40599526,23205,69,6,8
5407,2014/03/31,2006/10/10,20,32,0.816550447,39953,20,16,16
5408,2014/03/31,2012/03/06,5,52,0.8496163659999999,38396,5,30,22
5409,2014/03/31,2011/07/01,1,28,0.787149338,41443,1,5,23
5410,2014/03/31,2009/03/27,71,29,0.7951826209999999,41014,71,8,21
5411,2014/03/31,2013/03/07,206,6,0.637490471,51157,206,0,6
5412,2014/03/31,2010/11/06,17,24,1.464650588,22266,17,17,7
5413,2014/03/31,2005/10/11,3,17,0.707493383,46094,3,10,7
5414,2014/03/31,2005/04/07,97,32,0.655642732,49733,97,21,11
5415,2014/03/31,2010/04/14,6,45,0.57167067,57037,6,14,31
5416,2014/03/31,2008/08/03,1,51,0.820757145,39715,1,21,30
5417,2014/03/31,2011/08/22,24,38,0.7399069220000001,44049,24,21,17
5418,2014/03/31,2008/06/12,3,25,0.7580770840000001,42992,3,10,15
5419,2014/03/31,2012/06/19,25,20,0.718246755,45373,25,11,9
5420,2014/03/31,2009/12/01,18,29,0.6949334640000001,46892,18,19,10
5421,2014/03/31,2006/05/26,86,43,0.7749976209999999,42042,86,25,18
5422,2014/03/31,2012/12/05,1,37,0.717456179,45412,1,7,30
5423,2014/03/31,2008/12/03,3,38,0.64145988,50785,3,11,27
5424,2014/03/31,2010/05/26,4,13,1.373715105,23714,4,9,4
5425,2014/03/31,2008/09/09,50,19,0.698643061,46627,50,8,11
5426,2014/03/31,2012/03/29,49,18,0.741365498,43940,49,5,13
5427,2014/03/31,2012/01/02,109,30,0.775194583,42013,109,24,6
5428,2014/03/31,2010/03/10,34,34,0.753136375,43241,34,25,9
5429,2014/03/31,2010/12/24,100,8,0.636092663,51196,100,4,4
5430,2014/03/31,2010/08/13,32,28,0.623059909,52263,32,12,16
5431,2014/03/31,2007/06/11,3,35,0.72398697,44974,3,19,16
5432,2014/03/31,2010/07/02,40,30,0.7721134009999999,42169,40,12,18
5433,2014/03/31,2007/02/13,4,38,0.599261455,54323,4,11,27
5434,2014/03/31,2013/01/11,48,14,0.716803629,45414,48,2,12
5435,2014/03/31,2008/07/05,56,31,0.7619235,42719,56,26,5
5436,2014/03/31,2008/07/03,30,48,0.7486681390000001,43473,30,25,23
5437,2014/03/31,2012/05/18,151,32,0.726900002,44771,151,25,7
5438,2014/03/31,2006/03/26,3,44,0.7540989459999999,43155,3,26,18
5439,2014/03/31,2010/08/21,12,44,0.7675001770000001,42399,12,20,24
5440,2014/03/31,2011/02/04,7,48,0.72885665,44632,7,14,34
5441,2014/03/31,2007/07/03,96,29,0.789908431,41171,96,19,10
5442,2014/03/31,2007/07/16,331,24,0.733474299,44337,331,20,4
5443,2014/03/31,2012/05/21,12,46,0.934967799,34782,12,32,14
5444,2014/03/31,2012/10/12,1,33,0.706545565,46022,1,10,23
5445,2014/03/31,2006/12/31,39,23,0.54072303,60122,39,10,13
5446,2014/03/31,2005/11/13,63,34,0.814868395,39892,63,10,24
5447,2014/03/31,2010/05/19,14,51,0.764614118,42513,14,20,31
5448,2014/03/31,2005/10/09,128,14,1.2444628640000002,26120,128,5,9
5449,2014/03/31,2005/12/26,4,39,0.7862798459999999,41337,4,3,36
5450,2014/03/31,2008/05/29,12,15,1.43606327,22633,12,7,8
5451,2014/03/31,2008/10/07,4,43,0.7746175479999999,41953,4,14,29
5452,2014/03/31,2011/05/12,45,31,0.7380624570000001,44030,45,16,15
5453,2014/03/31,2004/11/19,6,33,0.7388234220000001,43975,6,22,11
5454,2014/03/31,2008/10/04,93,39,0.617719702,52594,93,28,11
5455,2014/03/31,2007/09/19,128,5,0.645635359,50318,128,0,5
5456,2014/03/31,2008/11/19,81,31,0.740019592,43896,81,20,11
5457,2014/03/31,2006/06/22,487,24,0.97285265,33390,487,24,0
5458,2014/03/31,2011/03/01,67,56,0.612828519,53003,67,34,22
5459,2014/03/31,2005/08/05,44,30,0.6120333139999999,53071,44,15,15
5460,2014/03/31,2012/04/18,98,8,0.547993825,59267,98,2,6
5461,2014/03/31,2010/07/07,159,20,1.255411383,25864,159,12,8
5462,2014/03/31,2005/03/15,199,19,0.910121374,35675,199,10,9
5463,2014/03/31,2004/12/25,24,23,0.521439126,62260,24,14,9
5464,2014/03/31,2012/04/12,56,37,0.839235562,38682,56,23,14
5465,2014/03/31,2012/12/28,69,28,0.637589228,50909,69,10,18
5466,2014/03/31,2007/12/13,39,22,0.859346836,37770,39,13,9
5467,2014/03/31,2008/12/06,7,37,0.691566522,46932,7,18,19
5468,2014/03/31,2012/08/17,25,36,0.8224298090000001,39464,25,21,15
5469,2014/03/31,2005/04/07,14,48,0.713778535,45470,14,29,19
5470,2014/03/31,2009/02/04,4,30,0.784857074,41350,4,25,5
5471,2014/03/31,2009/09/24,3,51,0.801420281,40492,3,24,27
5472,2014/03/31,2011/10/10,57,40,0.7856224279999999,41306,57,21,19
5473,2014/03/31,2012/12/28,9,7,0.93558804,34683,9,2,5
5474,2014/03/31,2011/05/18,3,40,0.8131529209999999,39890,3,27,13
5475,2014/03/31,2012/01/19,10,31,0.67826056,47820,10,5,26
5476,2014/03/31,2007/08/21,45,39,0.944566851,34330,45,21,18
5477,2014/03/31,2005/07/13,120,21,1.462276397,22171,120,11,10
5478,2014/03/31,2007/12/04,15,36,0.697773234,46462,15,16,20
5479,2014/03/31,2007/11/09,72,4,0.6625,48928,72,0,4
5480,2014/03/31,2008/03/12,8,38,0.83486696,38823,8,21,17
5481,2014/03/31,2005/08/15,7,47,0.72704907,44569,7,17,30
5482,2014/03/31,2008/07/02,116,32,0.665243589,48709,116,16,16
5483,2014/03/31,2012/06/03,41,9,0.7341883440000001,44132,41,6,3
5484,2014/03/31,2009/09/14,30,26,0.908536175,35660,30,11,15
5485,2014/03/31,2005/06/01,44,35,0.8086917779999999,40062,44,15,20
5486,2014/03/31,2013/01/27,7,14,0.761211082,42557,7,2,12
5487,2014/03/31,2013/02/08,28,38,0.655046816,49449,28,4,34
5488,2014/03/31,2007/10/06,9,48,0.676954105,47848,9,18,30
5489,2014/03/31,2005/06/02,156,48,0.932880184,34720,156,30,18
5490,2014/03/31,2008/08/23,26,43,0.761825003,42515,26,26,17
5491,2014/03/31,2007/04/23,9,39,0.6054390789999999,53487,9,25,14
5492,2014/03/31,2006/06/01,70,30,0.617438508,52446,70,20,10
5493,2014/03/31,2009/01/25,196,24,0.786239225,41183,196,23,1
5494,2014/03/31,2009/12/17,4,38,0.6969528340000001,46453,4,22,16
5495,2014/03/31,2005/06/24,24,44,0.920078724,35186,24,18,26
5496,2014/03/31,2012/03/24,13,31,0.697010749,46423,13,12,19
5497,2014/03/31,2005/02/06,2,50,0.804020975,40239,2,20,30
5498,2014/03/31,2008/01/12,38,36,0.734436599,44045,38,19,17
5499,2014/03/31,2007/05/17,38,44,0.522477789,61906,38,28,16
5500,2014/03/31,2011/08/28,40,22,0.792926955,40783,40,11,11
5501,2014/03/31,2011/08/11,69,39,0.6453871179999999,50101,69,33,6
5502,2014/03/31,2006/06/16,5,33,0.832599717,38835,5,8,25
5503,2014/03/31,2008/03/02,367,16,0.692542946,46686,367,16,0
5504,2014/03/31,2011/07/01,2,40,0.828076618,39025,2,25,15
5505,2014/03/31,2007/12/15,12,33,0.616571069,52407,12,14,19
5506,2014/03/31,2012/07/19,21,23,0.679265683,47568,21,12,11
5507,2014/03/31,2009/07/27,7,36,0.6888652940000001,46902,7,10,26
5508,2014/03/31,2011/08/16,124,45,0.8447040370000001,38248,124,31,14
5509,2014/03/31,2008/11/05,71,20,0.7916780609999999,40809,71,11,9
5510,2014/03/31,2011/01/11,3,35,0.804468075,40156,3,12,23
5511,2014/03/31,2008/12/08,10,16,0.7242260779999999,44604,10,5,11
5512,2014/03/31,2009/03/25,1,33,0.776507189,41594,1,19,14
5513,2014/03/31,2012/08/07,170,23,0.78849076,40961,170,14,9
5514,2014/03/31,2008/04/17,13,38,0.672280278,48038,13,21,17
5515,2014/03/31,2010/06/21,19,40,0.7835649640000001,41215,19,16,24
5516,2014/03/31,2005/02/12,11,29,0.786405942,41065,11,17,12
5517,2014/03/31,2005/01/22,6,27,0.857372474,37659,6,7,20
5518,2014/03/31,2008/05/28,14,69,0.846004193,38160,14,45,24
5519,2014/03/31,2006/04/05,1,31,0.603727108,53457,1,13,18
5520,2014/03/31,2005/11/25,12,57,0.614431561,52521,12,25,32
5521,2014/03/31,2012/03/16,119,25,0.7738450290000001,41698,119,13,12
5522,2014/03/31,2012/06/26,10,35,0.8565443340000001,37657,10,10,25
5523,2014/03/31,2009/08/28,11,20,0.8382143040000001,38478,11,9,11
5524,2014/03/31,2006/06/12,77,35,0.748983673,43057,77,28,7
5525,2014/03/31,2006/02/24,45,34,0.777334635,41484,45,12,22
5526,2014/03/31,2012/03/18,6,34,0.727959004,44297,6,12,22
5527,2014/03/31,2012/06/30,28,37,0.66057075,48813,28,14,23
5528,2014/03/31,2006/05/13,67,37,0.7148049129999999,45108,67,17,20
5529,2014/03/31,2009/12/28,178,24,0.842168687,38272,178,15,9
5530,2014/03/31,2008/10/05,41,18,1.328714851,24254,41,6,12
5531,2014/03/31,2011/02/26,29,34,0.794188253,40573,29,17,17
5532,2014/03/31,2011/11/12,19,36,0.7414805859999999,43449,19,19,17
5533,2014/03/31,2006/08/09,2,53,0.77978554,41313,2,29,24
5534,2014/03/31,2009/08/01,15,41,0.740776891,43481,15,18,23
5535,2014/03/31,2005/04/20,97,19,0.772450237,41698,97,14,5
5536,2014/03/31,2007/12/20,13,15,0.8018855659999999,40163,13,9,6
5537,2014/03/31,2006/10/18,69,21,0.806290278,39941,69,9,12
5538,2014/03/31,2006/06/01,29,29,0.68262359,47172,29,12,17
5539,2014/03/31,2012/07/21,301,19,0.952105263,33820,301,16,3
5540,2014/03/31,2012/08/01,109,25,0.8938909559999999,36022,109,11,14
5541,2014/03/31,2010/03/10,10,37,0.7020842959999999,45862,10,13,24
5542,2014/03/31,2011/11/12,25,30,0.770191889,41795,25,18,12
5543,2014/03/31,2008/06/01,168,38,0.956087396,33663,168,28,10
5544,2014/03/31,2008/03/27,116,19,0.796429066,40404,116,12,7
5545,2014/03/31,2005/06/20,72,24,0.65938668,48800,72,19,5
5546,2014/03/31,2009/11/17,77,19,0.697184845,46136,77,8,11
5547,2014/03/31,2011/04/21,25,30,0.7367283640000001,43654,25,25,5
5548,2014/03/31,2010/11/04,23,29,0.687943058,46749,23,7,22
5549,2014/03/31,2012/07/07,2,32,0.7623097529999999,42182,2,7,25
5550,2014/03/31,2006/05/13,4,50,0.799386685,40224,4,23,27
5551,2014/03/31,2007/02/05,129,46,0.626057048,51360,129,23,23
5552,2014/03/31,2011/05/25,31,25,0.782520201,41088,31,7,18
5553,2014/03/31,2011/09/21,16,37,0.654901817,49092,16,15,22
5554,2014/03/31,2008/06/22,21,33,0.864274384,37196,21,17,16
5555,2014/03/31,2012/07/21,48,20,1.135550885,28309,48,13,7
5556,2014/03/31,2010/12/11,2,32,0.757898857,42415,2,7,25
5557,2014/03/31,2009/09/22,76,41,0.6642045129999999,48398,76,34,7
5558,2014/03/31,2008/11/12,34,35,0.8396123809999999,38285,34,19,16
5559,2014/03/31,2010/10/11,81,42,0.759395658,42327,81,24,18
5560,2014/03/31,2006/12/15,7,27,0.682023044,47127,7,11,16
5561,2014/03/31,2008/11/25,134,30,0.7293906590000001,44064,134,9,21
5562,2014/03/31,2007/06/11,31,23,1.025576868,31333,31,8,15
5563,2014/03/31,2009/11/05,15,56,0.7134808579999999,45032,15,27,29
5564,2014/03/31,2012/04/25,4,31,0.582101877,55184,4,19,12
5565,2014/03/31,2012/10/27,73,31,0.8225672279999999,39046,73,9,22
5566,2014/03/31,2005/09/23,75,26,0.723236102,44396,75,7,19
5567,2014/03/31,2006/06/12,27,36,0.7371790340000001,43556,27,15,21
5568,2014/03/31,2005/11/01,43,25,0.947647719,33882,43,15,10
5569,2014/03/31,2006/10/09,51,27,0.672991363,47704,51,12,15
5570,2014/03/31,2006/11/06,89,27,0.815921925,39347,89,12,15
5571,2014/03/31,2012/07/10,24,51,0.902662524,35564,24,18,33
5572,2014/03/31,2008/04/09,62,40,0.7725051740000001,41554,62,15,25
5573,2014/03/31,2008/06/06,27,24,0.779551195,41176,27,18,6
5574,2014/03/31,2011/01/01,50,25,0.5063593470000001,63376,50,12,13
5575,2014/03/31,2008/11/25,3,35,0.7648528179999999,41955,3,6,29
5576,2014/03/31,2010/11/10,95,37,0.833142575,38513,95,29,8
5577,2014/03/31,2007/09/17,8,20,0.6756987320000001,47486,8,14,6
5578,2014/03/31,2011/07/29,15,36,0.715999732,44812,15,11,25
5579,2014/03/31,2005/10/18,105,37,0.8892677720000001,36068,105,18,19
5580,2014/03/31,2011/04/07,3,35,0.7079,45300,3,17,18
5581,2014/03/31,2009/08/27,22,42,0.8594227059999999,37312,22,22,20
5582,2014/03/31,2006/04/02,51,27,0.652974091,49094,51,15,12
5583,2014/03/31,2009/09/10,17,44,0.673310361,47593,17,24,20
5584,2014/03/31,2011/11/23,94,17,0.8915106829999999,35944,94,12,5
5585,2014/03/31,2011/01/09,63,31,0.6415454070000001,49948,63,18,13
5586,2014/03/31,2007/11/12,3,26,0.780647645,41041,3,16,10
5587,2014/03/31,2009/09/22,16,23,0.967052644,33128,16,15,8
5588,2014/03/31,2010/09/22,37,35,0.5641833270000001,56773,37,14,21
5589,2014/03/31,2009/08/24,59,31,0.764735686,41882,59,18,13
5590,2014/03/31,2006/12/26,10,27,0.70608176,45352,10,13,14
5591,2014/03/31,2005/09/15,2,39,0.682989183,46869,2,20,19
5592,2014/03/31,2011/05/10,81,23,0.633602336,50520,81,9,14
5593,2014/03/31,2005/04/21,118,21,0.943625936,33914,118,13,8
5594,2014/03/31,2007/01/06,7,44,0.755671832,42332,7,19,25
5595,2014/03/31,2008/03/09,43,20,0.7027745679999999,45517,43,9,11
5596,2014/03/31,2011/05/17,106,23,0.632852083,50542,106,7,16
5597,2014/03/31,2008/04/05,23,52,0.6817247479999999,46917,23,14,38
5598,2014/03/31,2012/07/20,1,55,0.7050084870000001,45361,1,18,37
5599,2014/03/31,2005/04/29,6,40,0.767738295,41650,6,25,15
5600,2014/03/31,2012/01/07,78,32,0.6723785090000001,47555,78,18,14
5601,2014/03/31,2012/11/17,6,48,0.831157265,38470,6,14,34
5602,2014/03/31,2007/05/30,21,32,0.7685105409999999,41599,21,17,15
5603,2014/03/31,2006/06/14,20,32,0.5862340229999999,54533,20,12,20
5604,2014/03/31,2008/10/31,31,28,0.660806772,48378,31,13,15
5605,2014/03/31,2005/09/04,42,20,0.816846518,39125,42,10,10
5606,2014/03/31,2005/02/26,4,45,0.814022722,39257,4,18,27
5607,2014/03/31,2011/11/15,6,32,0.75142145,42527,6,18,14
5608,2014/03/31,2005/09/27,21,31,0.732689336,43613,21,18,13
5609,2014/03/31,2011/04/06,75,23,0.777922419,41067,75,4,19
5610,2014/03/31,2008/01/04,56,25,0.7812625990000001,40876,56,13,12
5611,2014/03/31,2005/07/24,2,38,0.578400819,55197,2,20,18
5612,2014/03/31,2008/05/07,116,4,0.6525,48928,116,2,2
5613,2014/03/31,2007/04/15,32,41,0.778320899,41016,32,29,12
5614,2014/03/31,2008/01/12,44,27,0.690744163,46213,44,12,15
5615,2014/03/31,2008/08/06,22,34,0.8208777840000001,38882,22,23,11
5616,2014/03/31,2009/02/21,33,19,0.746923491,42727,33,14,5
5617,2014/03/31,2007/11/20,4,49,0.719978342,44326,4,22,27
5618,2014/03/31,2011/07/05,19,40,0.870288005,36666,19,22,18
5619,2014/03/31,2011/01/05,82,32,0.827467057,38552,82,21,11
5620,2014/03/31,2012/01/01,25,35,0.689113003,46291,25,17,18
5621,2014/03/31,2010/08/01,86,27,0.680367092,46882,86,17,10
5622,2014/03/31,2011/11/21,3,26,0.528055694,60402,3,12,14
5623,2014/03/31,2012/01/30,9,28,0.664648551,47987,9,12,16
5624,2014/03/31,2006/02/25,22,36,0.685741629,46499,22,18,18
5625,2014/03/31,2012/01/18,35,21,0.7488243720000001,42573,35,14,7
5626,2014/03/31,2009/09/24,4,52,0.7688627259999999,41450,4,24,28
5627,2014/03/31,2004/11/23,67,40,0.706448538,45111,67,17,23
5628,2014/03/31,2007/03/24,45,35,0.593346616,53705,45,15,20
5629,2014/03/31,2010/07/05,2,22,0.560199216,56873,2,8,14
5630,2014/03/31,2005/08/02,138,30,0.613697197,51915,138,20,10
5631,2014/03/31,2007/11/21,30,32,0.692912607,45976,30,15,17
5632,2014/03/31,2006/10/07,15,29,0.6872999329999999,46347,15,16,13
5633,2014/03/31,2009/07/22,1,6,0.7,45504,1,3,3
5634,2014/03/31,2006/09/07,9,38,0.662802256,48047,9,27,11
5635,2014/03/31,2012/03/21,5,33,0.667272327,47722,5,12,21
5636,2014/03/31,2007/05/09,4,25,0.852656614,37337,4,5,20
5637,2014/03/31,2009/02/04,6,42,0.676278625,47074,6,17,25
5638,2014/03/31,2012/12/30,152,12,0.8603954159999999,36999,152,2,10
5639,2014/03/31,2010/12/16,103,26,0.866035749,36756,103,15,11
5640,2014/03/31,2006/01/04,9,24,0.779577527,40831,9,7,17
5641,2014/03/31,2008/08/27,65,19,0.6589797270000001,48291,65,11,8
5642,2014/03/31,2005/09/09,6,14,0.642978599,49483,6,8,6
5643,2014/03/31,2011/05/07,23,32,0.581139611,54738,23,17,15
5644,2014/03/31,2007/09/25,129,25,0.603127892,52732,129,13,12
5645,2014/03/31,2012/07/15,410,6,0.791774547,40168,410,6,0
5646,2014/03/31,2008/06/10,12,33,0.6921264559999999,45945,12,18,15
5647,2014/03/31,2009/11/11,38,40,0.612010432,51954,38,23,17
5648,2014/03/31,2012/04/03,25,20,0.808599445,39313,25,12,8
5649,2014/03/31,2011/11/12,39,33,0.6249319729999999,50862,39,13,20
5650,2014/03/31,2011/03/14,143,27,0.68247697,46569,143,17,10
5651,2014/03/31,2012/03/27,91,29,0.708937096,44830,91,17,12
5652,2014/03/31,2010/04/22,11,37,0.8791545590000001,36135,11,10,27
5653,2014/03/31,2010/02/15,59,23,0.872249773,36417,59,13,10
5654,2014/03/31,2010/03/28,65,33,0.600239841,52910,65,16,17
5655,2014/03/31,2008/05/21,3,37,0.690327391,46000,3,19,18
5656,2014/03/31,2010/02/01,53,15,1.411145625,22503,53,2,13
5657,2014/03/31,2006/04/18,20,25,0.635851656,49938,20,12,13
5658,2014/03/31,2008/09/21,44,17,0.945781352,33570,44,6,11
5659,2014/03/31,2011/07/12,219,16,0.80234078,39568,219,10,6
5660,2014/03/31,2011/01/25,18,41,0.810358392,39175,18,21,20
5661,2014/03/31,2006/11/15,5,29,0.829479188,38248,5,12,17
5662,2014/03/31,2008/04/11,21,37,0.6952680370000001,45628,21,24,13
5663,2014/03/31,2010/11/17,5,21,1.203860721,26350,5,3,18
5664,2014/03/31,2012/12/30,6,11,1.432467486,22144,6,3,8
5665,2014/03/31,2007/04/25,4,40,0.767961551,41301,4,15,25
5666,2014/03/31,2007/11/06,7,38,0.6753354770000001,46963,7,16,22
5667,2014/03/31,2012/02/18,115,30,0.7055912259999999,44949,115,14,16
5668,2014/03/31,2008/07/04,3,45,0.83476851,37993,3,15,30
5669,2014/03/31,2012/03/23,12,24,0.7352507709999999,43127,12,9,15
5670,2014/03/31,2012/02/16,118,26,0.8464099620000001,37462,118,19,7
5671,2014/03/31,2010/10/29,94,24,0.7732367640000001,41007,94,14,10
5672,2014/03/31,2011/08/19,73,28,0.6940598179999999,45672,73,13,15
5673,2014/03/31,2011/11/01,4,26,0.746172171,42481,4,13,13
5674,2014/03/31,2005/08/13,4,26,0.908747384,34879,4,16,10
5675,2014/03/31,2011/11/12,1,28,0.7153981079999999,44297,1,12,16
5676,2014/03/31,2011/09/29,4,43,0.723766702,43781,4,11,32
5677,2014/03/31,2008/08/02,79,4,0.6475,48928,79,0,4
5678,2014/03/31,2006/04/30,18,25,0.8054275470000001,39329,18,15,10
5679,2014/03/31,2008/11/06,78,24,0.5923990570000001,53471,78,9,15
5680,2014/03/31,2009/06/27,2,21,0.476146977,66514,2,2,19
5681,2014/03/31,2011/08/30,12,25,0.833218355,38007,12,14,11
5682,2014/03/31,2012/01/22,83,32,0.7320051320000001,43254,83,13,19
5683,2014/03/31,2006/05/29,69,32,0.7476019079999999,42342,69,15,17
5684,2014/03/31,2008/12/24,2,33,0.93401257,33891,2,14,19
5685,2014/03/31,2012/05/07,15,25,0.8756,36150,15,17,8
5686,2014/03/31,2010/09/25,3,31,0.694038989,45603,3,11,20
5687,2014/03/31,2009/08/17,104,31,0.763271355,41466,104,13,18
5688,2014/03/31,2012/01/03,5,22,0.697556976,45370,5,3,19
5689,2014/03/31,2010/11/01,39,20,0.861326783,36743,39,6,14
5690,2014/03/31,2011/01/07,12,26,0.671099801,47154,12,12,14
5691,2014/03/31,2005/12/18,1,34,0.7008274090000001,45153,1,14,20
5692,2014/03/31,2008/02/19,24,35,0.803898572,39358,24,28,7
5693,2014/03/31,2012/03/16,38,11,0.8136363640000001,38885,38,5,6
5694,2014/03/31,2012/01/08,22,14,0.91714468,34476,22,5,9
5695,2014/03/31,2011/07/08,4,35,0.659038041,47975,4,15,20
5696,2014/03/31,2009/09/12,34,23,0.8312678459999999,38033,34,9,14
5697,2014/03/31,2013/02/06,34,29,1.045844581,30228,34,5,24
5698,2014/03/31,2006/11/29,2,29,0.614389727,51436,2,15,14
5699,2014/03/31,2011/05/23,18,40,0.7452825470000001,42400,18,23,17
5700,2014/03/31,2011/12/20,25,28,0.653193451,48374,25,15,13
5701,2014/03/31,2005/01/06,4,28,0.820513906,38509,4,19,9
5702,2014/03/31,2005/07/03,48,47,0.824805117,38305,48,33,14
5703,2014/03/31,2013/03/20,4,38,0.678333011,46569,4,2,36
5704,2014/03/31,2013/03/08,9,30,0.8029804,39337,9,2,28
5705,2014/03/31,2011/04/01,6,40,0.7579521020000001,41672,6,14,26
5706,2014/03/31,2006/07/10,116,23,0.756530998,41744,116,8,15
5707,2014/03/31,2011/03/02,4,35,0.7217900490000001,43753,4,21,14
5708,2014/03/31,2006/11/15,449,23,0.666209771,47385,449,23,0
5709,2014/03/31,2009/02/25,27,31,0.780205893,40458,27,15,16
5710,2014/03/31,2011/05/02,42,33,0.92242519,34220,42,23,10
5711,2014/03/31,2011/06/11,11,48,0.90007358,35064,11,22,26
5712,2014/03/31,2010/03/26,31,37,0.802770159,39301,31,20,17
5713,2014/03/31,2012/07/28,20,37,0.923863956,34136,20,6,31
5714,2014/03/31,2007/08/11,14,12,0.844499518,37344,14,8,4
5715,2014/03/31,2008/08/25,2,29,0.595971275,52915,2,14,15
5716,2014/03/31,2009/06/20,11,35,0.624737499,50476,11,17,18
5717,2014/03/31,2011/08/11,3,49,0.604385938,52169,3,17,32
5718,2014/03/31,2008/08/25,3,21,0.747891353,42155,3,5,16
5719,2014/03/31,2007/05/28,18,32,0.758312726,41570,18,16,16
5720,2014/03/31,2007/08/15,44,39,0.879462627,35841,44,24,15
5721,2014/03/31,2010/09/01,17,24,0.8280478640000001,38066,17,4,20
5722,2014/03/31,2007/11/30,147,28,0.714197218,44134,147,15,13
5723,2014/03/31,2010/11/25,7,27,1.31437573,23980,7,5,22
5724,2014/03/31,2007/06/01,37,24,0.874081089,36059,37,9,15
5725,2014/03/31,2007/08/24,18,25,0.798808588,39449,18,6,19
5726,2014/03/31,2012/12/21,81,20,1.174435499,26829,81,7,13
5727,2014/03/31,2006/11/01,5,40,0.8200067670000001,38424,5,16,24
5728,2014/03/31,2008/10/25,21,35,0.8519970790000001,36979,21,13,22
5729,2014/03/31,2008/04/24,2,35,0.796878889,39534,2,19,16
5730,2014/03/31,2008/05/22,88,20,0.909914214,34621,88,10,10
5731,2014/03/31,2006/01/12,4,37,0.779638906,40405,4,17,20
5732,2014/03/31,2004/11/27,79,29,0.730467953,43124,79,16,13
5733,2014/03/31,2011/02/13,5,33,0.659148148,47790,5,17,16
5734,2014/03/31,2007/04/05,172,37,0.65891318,47800,172,23,14
5735,2014/03/31,2012/11/18,33,25,0.6880048940000001,45767,33,16,9
5736,2014/03/31,2008/08/29,265,16,0.7200841659999999,43723,265,10,6
5737,2014/03/31,2006/10/24,103,24,0.723037617,43544,103,10,14
5738,2014/03/31,2007/05/01,69,26,0.7685015009999999,40961,69,17,9
5739,2014/03/31,2012/06/24,12,34,0.861698656,36523,12,4,30
5740,2014/03/31,2012/07/17,23,41,0.922331995,34121,23,24,17
5741,2014/03/31,2011/11/08,13,22,0.7598107059999999,41417,13,5,17
5742,2014/03/31,2012/08/20,22,36,0.511601112,61501,22,11,25
5743,2014/03/31,2008/04/04,154,12,0.811666667,38760,154,8,4
5744,2014/03/31,2007/03/05,17,17,0.661772056,47538,17,8,9
5745,2014/03/31,2012/02/26,10,35,0.722998024,43512,10,17,18
5746,2014/03/31,2006/09/14,90,23,0.689464305,45623,90,9,14
5747,2014/03/31,2010/03/18,18,14,0.688437986,45691,18,5,9
5748,2014/03/31,2006/03/28,63,25,0.8986280390000001,35001,63,16,9
5749,2014/03/31,2008/02/22,12,32,0.639658335,49171,12,13,19
5750,2014/03/31,2007/11/13,35,31,0.67254603,46763,35,20,11
5751,2014/03/31,2009/07/09,23,28,0.890621459,35304,23,15,13
5752,2014/03/31,2006/04/29,110,19,0.876347167,35879,110,13,6
5753,2014/03/31,2011/12/26,12,33,0.679109662,46297,12,19,14
5754,2014/03/31,2012/01/01,4,36,0.749963018,41912,4,16,20
5755,2014/03/31,2009/03/22,9,39,0.781238008,40234,9,28,11
5756,2014/03/31,2007/09/28,61,25,0.654979474,47987,61,10,15
5757,2014/03/31,2010/06/09,75,17,0.736435284,42671,75,9,8
5758,2014/03/31,2004/12/28,63,33,0.647085255,48560,63,24,9
5759,2014/03/31,2008/11/15,57,37,0.683371253,45974,57,22,15
5760,2014/03/31,2006/05/25,140,11,0.707995898,44374,140,8,3
5761,2014/03/31,2012/11/21,61,26,0.908073365,34594,61,5,21
5762,2014/03/31,2006/07/11,110,27,0.681802791,46073,110,18,9
5763,2014/03/31,2007/10/17,3,29,0.720812337,43578,3,20,9
5764,2014/03/31,2005/04/07,36,32,0.641131386,48993,36,18,14
5765,2014/03/31,2012/05/12,567,5,0.773939185,40582,567,5,0
5766,2014/03/31,2012/07/19,3,33,0.6758002670000001,46472,3,16,17
5767,2014/03/31,2006/11/02,2,27,1.101626031,28505,2,8,19
5768,2014/03/31,2008/02/02,24,42,0.793383278,39577,24,28,14
5769,2014/03/31,2012/10/01,18,30,0.927065371,33868,18,10,20
5770,2014/03/31,2005/10/30,1,53,0.789300618,39778,1,7,46
5771,2014/03/31,2007/05/01,2,22,0.81904834,38333,2,12,10
5772,2014/03/31,2009/04/14,43,32,0.731439055,42924,43,18,14
5773,2014/03/31,2010/11/23,14,27,0.829918046,37826,14,9,18
5774,2014/03/31,2011/03/16,143,31,0.810013676,38753,143,17,14
5775,2014/03/31,2010/08/16,12,29,0.7136581479999999,43984,12,18,11
5776,2014/03/31,2007/07/05,75,11,1.368294246,22940,75,9,2
5777,2014/03/31,2010/04/04,5,17,0.67333977,46608,5,4,13
5778,2014/03/31,2012/07/10,7,45,0.6344577220000001,49458,7,9,36
5779,2014/03/31,2006/04/14,30,31,0.647165371,48479,30,15,16
5780,2014/03/31,2006/03/30,2,16,0.610324702,51401,2,4,12
5781,2014/03/31,2013/03/12,99,32,0.679642772,46133,99,1,31
5782,2014/03/31,2012/03/27,49,24,0.62067555,50507,49,15,9
5783,2014/03/31,2008/06/01,118,34,0.781663508,40102,118,28,6
5784,2014/03/31,2010/09/13,4,34,0.767202898,40853,4,18,16
5785,2014/03/31,2012/04/29,4,24,0.666624763,47013,4,18,6
5786,2014/03/31,2011/10/31,6,23,0.670608402,46729,6,14,9
5787,2014/03/31,2012/07/24,20,21,0.894118486,35042,20,9,12
5788,2014/03/31,2012/12/11,142,6,0.608257864,51500,142,0,6
5789,2014/03/31,2009/08/01,28,21,0.587100257,53353,28,12,9
5790,2014/03/31,2008/09/28,100,22,0.837780126,37385,100,11,11
5791,2014/03/31,2012/03/07,260,3,1.03,30408,260,2,1
5792,2014/03/31,2004/11/26,6,17,1.329642493,23552,6,9,8
5793,2014/03/31,2007/12/16,133,4,0.64,48928,133,2,2
5794,2014/03/31,2011/12/17,52,24,0.7078676070000001,44232,52,13,11
5795,2014/03/31,2006/03/30,109,21,0.740043497,42302,109,12,9
5796,2014/03/31,2007/12/22,27,37,0.711618242,43986,27,19,18
5797,2014/03/31,2012/05/30,36,16,0.448503095,69784,36,10,6
5798,2014/03/31,2008/03/27,7,18,1.025417008,30515,7,8,10
5799,2014/03/31,2010/02/23,7,24,0.6971285979999999,44884,7,15,9
5800,2014/03/31,2006/06/14,30,16,0.706157665,44309,30,8,8
5801,2014/03/31,2010/01/11,13,32,0.635939634,49200,13,19,13
5802,2014/03/31,2012/09/09,125,10,1.310525368,23869,125,5,5
5803,2014/03/31,2010/06/13,5,25,0.937412868,33369,5,16,9
5804,2014/03/31,2005/10/23,94,26,0.811512793,38538,94,10,16
5805,2014/03/31,2009/09/18,2,46,0.637764703,49036,2,13,33
5806,2014/03/31,2012/04/08,660,11,1.407692654,22216,660,11,0
5807,2014/03/31,2010/06/23,164,39,0.745137492,41966,164,27,12
5808,2014/03/31,2008/03/16,9,13,1.171856682,26682,9,7,6
5809,2014/03/31,2008/04/14,102,26,0.8473851990000001,36890,102,11,15
5810,2014/03/31,2006/01/21,5,37,0.800881863,39031,5,18,19
5811,2014/03/31,2012/03/12,120,13,0.6972732340000001,44826,120,5,8
5812,2014/03/31,2008/10/11,4,22,0.793152712,39401,4,8,14
5813,2014/03/31,2010/04/20,186,16,0.66565297,46947,186,10,6
5814,2014/03/31,2008/01/12,1,35,0.6385345020000001,48939,1,14,21
5815,2014/03/31,2011/07/20,127,30,0.462853037,67507,127,16,14
5816,2014/03/31,2012/04/16,19,58,0.640467795,48782,19,29,29
5817,2014/03/31,2012/09/19,66,20,0.936376933,33364,66,8,12
5818,2014/03/31,2008/08/05,114,19,0.892462286,35000,114,11,8
5819,2014/03/31,2007/12/06,86,35,0.8376315999999999,37291,86,17,18
5820,2014/03/31,2010/07/04,10,54,0.619269627,50440,10,22,32
5821,2014/03/31,2007/10/31,32,28,0.7422718629999999,42080,32,13,15
5822,2014/03/31,2009/12/16,11,20,0.96800155,32265,11,9,11
5823,2014/03/31,2012/02/15,11,44,0.6915087240000001,45164,11,18,26
5824,2014/03/31,2012/08/10,160,5,0.739199015,42248,160,3,2
5825,2014/03/31,2007/04/23,15,44,0.79776299,39146,15,23,21
5826,2014/03/31,2008/03/18,10,30,0.617522295,50571,10,22,8
5827,2014/03/31,2007/09/05,56,19,0.7244933179999999,43104,56,14,5
5828,2014/03/31,2012/01/01,13,41,0.7898525390000001,39536,13,19,22
5829,2014/03/31,2006/09/07,15,37,0.5773928,54081,15,19,18
5830,2014/03/31,2005/08/18,6,36,0.71482337,43679,6,18,18
5831,2014/03/31,2011/10/09,127,34,0.720042207,43358,127,17,17
5832,2014/03/31,2012/08/11,22,28,1.396747797,22351,22,23,5
5833,2014/03/31,2005/11/23,69,29,0.734937373,42474,69,8,21
5834,2014/03/31,2008/08/10,11,28,0.7208383759999999,43298,11,4,24
5835,2014/03/31,2008/09/17,89,20,0.773236183,40350,89,14,6
5836,2014/03/31,2010/06/10,6,34,0.613419805,50845,6,23,11
5837,2014/03/31,2007/02/07,16,39,0.6238719620000001,49985,16,19,20
5838,2014/03/31,2006/07/01,13,25,0.757965463,41115,13,18,7
5839,2014/03/31,2009/11/07,23,36,0.7409743390000001,42049,23,18,18
5840,2014/03/31,2010/10/31,97,29,1.020746675,30522,97,18,11
5841,2014/03/31,2006/04/13,13,40,0.724249308,43007,13,20,20
5842,2014/03/31,2006/04/02,4,30,0.677470852,45972,4,5,25
5843,2014/03/31,2007/02/05,123,33,0.7637975770000001,40776,123,18,15
5844,2014/03/31,2009/12/12,18,33,0.708699768,43946,18,15,18
5845,2014/03/31,2010/10/07,14,42,0.7270735859999999,42834,14,19,23
5846,2014/03/31,2011/11/06,185,20,0.702416935,44333,185,12,8
5847,2014/03/31,2011/08/12,1,28,0.779819939,39931,1,16,12
5848,2014/03/31,2008/05/05,275,13,0.7816109840000001,39839,275,11,2
5849,2014/03/31,2005/08/16,8,27,1.116276619,27894,8,6,21
5850,2014/03/31,2012/02/24,12,39,0.724549601,42973,12,8,31
5851,2014/03/31,2011/06/28,41,23,0.728376886,42745,41,11,12
5852,2014/03/31,2006/12/11,26,27,0.7246257709999999,42955,26,16,11
5853,2014/03/31,2011/12/12,38,32,0.691058113,45033,38,4,28
5854,2014/03/31,2012/02/21,60,24,0.77751368,40023,60,12,12
5855,2014/03/31,2011/07/27,57,24,0.822932215,37811,57,9,15
5856,2014/03/31,2012/04/27,2,41,0.6493487520000001,47908,2,13,28
5857,2014/03/31,2008/11/28,104,16,1.226200126,25364,104,4,12
5858,2014/03/31,2007/08/08,79,25,0.946285906,32864,79,14,11
5859,2014/03/31,2012/10/19,2,30,0.722934025,43016,2,3,27
5860,2014/03/31,2007/11/23,7,43,0.642549603,48384,7,25,18
5861,2014/03/31,2006/05/23,6,33,0.717932476,43303,6,6,27
5862,2014/03/31,2010/01/28,37,16,0.824382741,37707,37,9,7
5863,2014/03/31,2008/07/16,1,23,0.821648514,37828,1,7,16
5864,2014/03/31,2008/04/03,21,19,0.8615507440000001,36073,21,4,15
5865,2014/03/31,2011/09/15,285,25,0.681988192,45564,285,17,8
5866,2014/03/31,2010/02/23,137,4,0.635,48928,137,0,4
5867,2014/03/31,2005/01/24,1,19,1.4542100830000002,21363,1,5,14
5868,2014/03/31,2008/01/05,2,19,0.628600166,49413,2,9,10
5869,2014/03/31,2008/12/25,11,49,0.562257662,55243,11,20,29
5870,2014/03/31,2010/04/18,99,28,0.72573669,42786,99,20,8
5871,2014/03/31,2011/07/10,6,22,1.119321918,27740,6,17,5
5872,2014/03/31,2009/09/27,3,11,0.7115179779999999,43637,3,3,8
5873,2014/03/31,2013/02/03,192,9,0.567975226,54653,192,3,6
5874,2014/03/31,2008/04/23,12,33,1.0856551559999998,28581,12,11,22
5875,2014/03/31,2011/10/20,16,16,0.73375,42288,16,6,10
5876,2014/03/31,2008/01/16,118,19,0.8012660159999999,38712,118,9,10
5877,2014/03/31,2012/08/01,1,70,0.8064334190000001,38457,1,39,31
5878,2014/03/31,2006/04/11,6,24,0.6061203310000001,51159,6,10,14
5879,2014/03/31,2011/07/15,9,26,0.8406238309999999,36885,9,15,11
5880,2014/03/31,2009/04/11,5,33,0.585137431,52972,5,13,20
5881,2014/03/31,2011/08/01,513,7,0.616198051,50290,513,7,0
5882,2014/03/31,2010/09/12,22,34,0.7057712890000001,43907,22,21,13
5883,2014/03/31,2012/06/19,6,43,0.8109861290000001,38210,6,19,24
5884,2014/03/31,2012/06/16,30,26,0.849120355,36492,30,12,14
5885,2014/03/31,2011/08/10,55,29,0.928077419,33377,55,16,13
5886,2014/03/31,2010/10/12,49,32,0.769023585,40280,49,12,20
5887,2014/03/31,2006/02/25,1,26,1.111049857,27880,1,12,14
5888,2014/03/31,2009/12/17,7,28,0.859872581,36023,7,14,14
5889,2014/03/31,2011/03/09,68,26,0.854440214,36246,68,9,17
5890,2014/03/31,2009/09/23,21,28,0.723542825,42802,21,15,13
5891,2014/03/31,2009/02/24,11,24,0.687693691,45033,11,12,12
5892,2014/03/31,2010/12/09,103,44,0.647922673,47797,103,29,15
5893,2014/03/31,2005/09/09,50,23,0.78335248,39520,50,11,12
5894,2014/03/31,2011/12/05,98,22,0.76313491,40553,98,13,9
5895,2014/03/31,2007/05/30,20,34,0.7391652129999999,41855,20,18,16
5896,2014/03/31,2007/07/03,123,13,0.798567667,38741,123,4,9
5897,2014/03/31,2008/02/14,6,41,0.784418015,39434,6,12,29
5898,2014/03/31,2010/05/18,28,16,1.3454219230000002,22990,28,8,8
5899,2014/03/31,2012/04/14,44,14,0.789272022,39177,44,7,7
5900,2014/03/31,2006/08/04,39,27,0.7808707509999999,39598,39,15,12
5901,2014/03/31,2012/04/19,173,43,0.727479468,42495,173,22,21
5902,2014/03/31,2012/04/02,12,29,0.717212658,43102,12,6,23
5903,2014/03/31,2006/04/06,79,37,0.681956982,45330,79,25,12
5904,2014/03/31,2010/10/21,16,31,0.5700322760000001,54220,16,14,17
5905,2014/03/31,2012/06/11,297,6,0.954346148,32385,297,4,2
5906,2014/03/31,2008/08/20,7,44,0.643599467,48021,7,17,27
5907,2014/03/31,2012/01/16,4,29,0.6666755120000001,46350,4,17,12
5908,2014/03/31,2006/10/21,81,25,0.8429754429999999,36650,81,22,3
5909,2014/03/31,2012/06/28,3,31,0.702479876,43978,3,5,26
5910,2014/03/31,2010/09/06,3,32,0.684587683,45123,3,16,16
5911,2014/03/31,2011/10/04,7,36,0.619775682,49840,7,10,26
5912,2014/03/31,2007/10/22,27,40,0.614168224,50290,27,25,15
5913,2014/03/31,2007/10/30,17,41,0.73820872,41836,17,20,21
5914,2014/03/31,2010/07/09,287,7,0.542857143,56889,287,5,2
5915,2014/03/31,2009/01/03,34,17,0.769525803,40131,34,13,4
5916,2014/03/31,2007/10/07,7,27,0.694098368,44486,7,12,15
5917,2014/03/31,2010/12/28,27,23,0.807001986,38262,27,13,10
5918,2014/03/31,2013/01/05,59,10,0.564439833,54698,59,0,10
5919,2014/03/31,2011/03/19,277,25,0.501015323,61606,277,10,15
5920,2014/03/31,2005/08/18,143,32,0.698980183,44155,143,21,11
5921,2014/03/31,2010/09/01,18,35,0.8893883490000001,34693,18,15,20
5922,2014/03/31,2009/05/09,10,42,0.817623085,37738,10,15,27
5923,2014/03/31,2007/11/08,6,30,0.7698390479999999,40074,6,13,17
5924,2014/03/31,2007/09/05,5,34,0.8140816,37892,5,13,21
5925,2014/03/31,2005/03/19,7,53,0.6467369789999999,47692,7,28,25
5926,2014/03/31,2012/01/17,30,19,0.596333282,51722,30,8,11
5927,2014/03/31,2007/09/22,294,19,0.786508034,39210,294,15,4
5928,2014/03/31,2008/05/21,4,46,0.889269911,34667,4,17,29
5929,2014/03/31,2009/04/11,346,40,0.816581896,37749,346,37,3
5930,2014/03/31,2010/03/15,113,28,0.575186326,53589,113,19,9
5931,2014/03/31,2009/02/14,40,19,1.435210467,21476,40,5,14
5932,2014/03/31,2006/06/04,6,44,0.77658469,39686,6,19,25
5933,2014/03/31,2007/11/02,5,28,0.6822742970000001,45170,5,11,17
5934,2014/03/31,2009/12/04,64,20,0.5703831770000001,54022,64,14,6
5935,2014/03/31,2010/12/01,22,24,0.7760399029999999,39696,22,7,17
5936,2014/03/31,2012/05/16,149,4,0.9475,32508,149,2,2
5937,2014/03/31,2006/06/25,61,15,0.70816334,43492,61,3,12
5938,2014/03/31,2007/09/20,4,25,0.700662951,43955,4,7,18
5939,2014/03/31,2011/07/19,84,40,0.736535646,41800,84,27,13
5940,2014/03/31,2007/02/26,3,34,0.960319099,32059,3,15,19
5941,2014/03/31,2012/09/07,3,34,0.7413095409999999,41526,3,11,23
5942,2014/03/31,2006/11/05,2,19,0.662679267,46453,2,11,8
5943,2014/03/31,2011/01/13,6,45,0.734476818,41907,6,16,29
5944,2014/03/31,2005/07/31,103,26,0.931028495,33058,103,12,14
5945,2014/03/31,2011/10/30,3,26,0.8531231290000001,36076,3,12,14
5946,2014/03/31,2011/04/13,16,42,0.733186983,41977,16,16,26
5947,2014/03/31,2007/02/02,1,45,0.7149278729999999,43049,1,15,30
5948,2014/03/31,2010/08/14,90,33,0.575275446,53495,90,23,10
5949,2014/03/31,2011/06/12,28,29,0.669500555,45951,28,13,16
5950,2014/03/31,2006/06/22,67,24,0.697808642,44064,67,7,17
5951,2014/03/31,2005/09/09,26,38,0.794169551,38714,26,20,18
5952,2014/03/31,2011/04/30,3,27,0.7431879709999999,41368,3,12,15
5953,2014/03/31,2008/04/14,126,28,0.8350852940000001,36814,126,10,18
5954,2014/03/31,2006/12/20,76,40,0.8136698440000001,37770,76,27,13
5955,2014/03/31,2006/12/08,33,34,0.7388208559999999,41581,33,20,14
5956,2014/03/31,2010/03/21,16,31,0.765026777,40147,16,15,16
5957,2014/03/31,2007/07/26,115,33,0.692801588,44332,115,16,17
5958,2014/03/31,2011/08/21,626,5,0.7390096009999999,41559,626,5,0
5959,2014/03/31,2006/08/12,50,17,1.3932129569999998,22042,50,8,9
5960,2014/03/31,2008/11/21,73,7,0.764683998,40158,73,6,1
5961,2014/03/31,2011/02/02,242,35,0.807756611,38005,242,21,14
5962,2014/03/31,2011/05/02,25,55,0.793734257,38669,25,21,34
5963,2014/03/31,2007/06/20,38,27,0.606622856,50596,38,19,8
5964,2014/03/31,2007/09/20,10,38,0.923893723,33215,10,12,26
5965,2014/03/31,2011/02/22,30,34,0.595321758,51545,30,14,20
5966,2014/03/31,2006/03/21,44,26,0.62412875,49165,44,7,19
5967,2014/03/31,2005/08/14,8,20,1.186758733,25851,8,12,8
5968,2014/03/31,2008/10/26,7,22,0.893807873,34321,7,13,9
5969,2014/03/31,2012/06/24,3,19,1.320228535,23235,3,4,15
5970,2014/03/31,2010/05/26,81,25,0.967318196,31710,81,14,11
5971,2014/03/31,2010/12/05,73,30,0.7625109999999999,40227,73,24,6
5972,2014/03/31,2013/02/08,17,28,0.807660768,37974,17,7,21
5973,2014/03/31,2009/05/29,20,33,0.812275665,37756,20,20,13
5974,2014/03/31,2006/11/28,3,47,0.630157399,48666,3,22,25
5975,2014/03/31,2005/10/14,21,25,0.656541212,46710,21,11,14
5976,2014/03/31,2005/04/05,14,31,0.8127256820000001,37730,14,10,21
5977,2014/03/31,2011/12/15,263,26,0.778048007,39411,263,17,9
5978,2014/03/31,2012/07/17,9,52,0.833966924,36764,9,25,27
5979,2014/03/31,2012/04/14,51,22,0.804924382,38086,51,10,12
5980,2014/03/31,2011/01/30,3,36,0.88442043,34655,3,21,15
5981,2014/03/31,2009/07/05,1,22,0.86391183,35477,1,10,12
5982,2014/03/31,2010/09/16,6,30,0.826435833,37083,6,17,13
5983,2014/03/31,2007/05/01,45,12,1.353710133,22638,45,4,8
5984,2014/03/31,2011/11/30,12,45,0.69149991,44316,12,22,23
5985,2014/03/31,2007/12/06,53,27,0.757670359,40444,53,14,13
5986,2014/03/31,2010/01/08,108,23,0.922686644,33205,108,12,11
5987,2014/03/31,2011/02/16,34,21,0.779621355,39298,34,10,11
5988,2014/03/31,2007/03/04,64,8,0.6908099940000001,44346,64,1,7
5989,2014/03/31,2005/04/19,27,27,0.770859106,39739,27,15,12
5990,2014/03/31,2011/12/20,7,33,0.804928001,38056,7,7,26
5991,2014/03/31,2009/07/14,27,28,0.7403183000000001,41376,27,8,20
5992,2014/03/31,2011/04/23,16,31,0.914480936,33493,16,14,17
5993,2014/03/31,2010/02/22,145,16,0.950348765,32228,145,8,8
5994,2014/03/31,2005/05/20,28,27,0.803854856,38100,28,8,19
5995,2014/03/31,2009/10/20,28,14,0.650948474,47044,28,2,12
5996,2014/03/31,2011/11/10,4,35,0.665973554,45981,4,16,19
5997,2014/03/31,2011/03/15,160,13,0.679872996,45038,160,5,8
5998,2014/03/31,2008/06/18,296,29,0.681838935,44901,296,27,2
5999,2014/03/31,2007/06/21,12,33,0.7130255959999999,42937,12,14,19
6000,2014/03/31,2008/08/24,6,32,0.6841914570000001,44741,6,21,11
6001,2014/03/31,2007/08/09,10,32,0.7460679029999999,41029,10,24,8
6002,2014/03/31,2006/05/24,17,20,0.692412685,44208,17,8,12
6003,2014/03/31,2006/07/22,33,31,0.767491914,39883,33,24,7
6004,2014/03/31,2012/06/19,42,39,0.681574845,44906,42,15,24
6005,2014/03/31,2008/04/16,64,24,0.82696846,37001,64,12,12
6006,2014/03/31,2007/12/14,8,37,0.592304475,51643,8,25,12
6007,2014/03/31,2005/03/25,14,24,0.732591555,41751,14,8,16
6008,2014/03/31,2011/11/21,119,16,0.634088233,48236,119,10,6
6009,2014/03/31,2006/09/22,31,22,0.628454125,48665,31,16,6
6010,2014/03/31,2009/11/06,50,28,0.641434504,47675,50,12,16
6011,2014/03/31,2007/12/12,137,33,0.718315478,42564,137,20,13
6012,2014/03/31,2011/03/19,150,31,0.828173395,36910,150,14,17
6013,2014/03/31,2008/11/28,18,27,0.7184283029999999,42540,18,13,14
6014,2014/03/31,2013/01/25,3,24,0.71592236,42684,3,6,18
6015,2014/03/31,2009/05/26,115,23,0.637986304,47897,115,15,8
6016,2014/03/31,2006/03/21,37,32,0.680194106,44924,37,22,10
6017,2014/03/31,2011/11/06,1,24,0.877744808,34813,1,13,11
6018,2014/03/31,2008/04/20,11,33,0.840588705,36351,11,18,15
6019,2014/03/31,2011/07/27,19,34,0.690876368,44228,19,19,15
6020,2014/03/31,2009/04/15,14,21,0.878443071,34780,14,5,16
6021,2014/03/31,2005/11/09,3,44,0.7875262279999999,38795,3,31,13
6022,2014/03/31,2012/11/21,177,14,0.822636383,37138,177,9,5
6023,2014/03/31,2012/04/10,26,25,0.701738911,43533,26,4,21
6024,2014/03/31,2013/03/03,2,48,0.7716669190000001,39588,2,5,43
6025,2014/03/31,2012/08/03,13,23,0.818662736,37315,13,10,13
6026,2014/03/31,2006/06/16,1,36,0.759307147,40225,1,20,16
6027,2014/03/31,2010/06/30,9,31,0.761753274,40085,9,12,19
6028,2014/03/31,2007/04/27,1,34,0.671081319,45500,1,23,11
6029,2014/03/31,2012/10/22,17,26,0.755165966,40430,17,2,24
6030,2014/03/31,2011/02/24,49,6,0.8067480709999999,37836,49,2,4
6031,2014/03/31,2006/03/20,71,27,0.67259367,45372,71,11,16
6032,2014/03/31,2008/10/09,85,22,0.694265499,43955,85,14,8
6033,2014/03/31,2008/07/04,11,29,0.6741565409999999,45266,11,23,6
6034,2014/03/31,2012/11/07,34,7,0.7421133409999999,41115,34,2,5
6035,2014/03/31,2012/11/19,18,35,0.738777482,41300,18,7,28
6036,2014/03/31,2011/10/18,238,11,0.668441718,45640,238,9,2
6037,2014/03/31,2009/11/12,13,33,0.7303162559999999,41770,13,15,18
6038,2014/03/31,2006/05/16,141,20,0.6851309409999999,44524,141,13,7
6039,2014/03/31,2007/08/24,44,33,1.248312597,24434,44,20,13
6040,2014/03/31,2008/07/28,450,7,0.7761570179999999,39282,450,7,0
6041,2014/03/31,2005/03/22,25,31,0.642752572,47432,25,13,18
6042,2014/03/31,2011/12/05,170,27,0.688049606,44309,170,18,9
6043,2014/03/31,2012/04/05,372,26,0.7700924659999999,39582,372,26,0
6044,2014/03/31,2005/07/06,11,14,0.728443542,41845,11,3,11
6045,2014/03/31,2007/07/28,12,32,0.67931189,44862,12,2,30
6046,2014/03/31,2012/05/20,6,33,0.6776764820000001,44962,6,8,25
6047,2014/03/31,2009/12/06,31,40,0.5905601429999999,51594,31,22,18
6048,2014/03/31,2011/03/11,6,9,1.082796929,28138,6,0,9
6049,2014/03/31,2010/11/25,10,25,0.760244785,40076,10,10,15
6050,2014/03/31,2007/02/02,1,15,0.7914945309999999,38487,1,9,6
6051,2014/03/31,2010/08/18,48,16,0.760007236,40076,48,7,9
6052,2014/03/31,2010/07/21,26,27,1.270563991,23972,26,20,7
6053,2014/03/31,2012/04/15,191,23,1.017535331,29931,191,18,5
6054,2014/03/31,2007/01/19,33,36,0.5974862670000001,50972,33,14,22
6055,2014/03/31,2012/05/08,13,19,1.062548062,28661,13,6,13
6056,2014/03/31,2009/07/31,6,23,0.673081293,45244,6,9,14
6057,2014/03/31,2005/02/25,44,7,0.676668741,45004,44,5,2
6058,2014/03/31,2008/02/06,173,32,0.8881120570000001,34286,173,21,11
6059,2014/03/31,2011/09/13,203,10,0.599022212,50829,203,4,6
6060,2014/03/31,2005/05/04,154,34,0.627915687,48486,154,25,9
6061,2014/03/31,2013/01/25,17,21,0.8209851140000001,37082,17,4,17
6062,2014/03/31,2010/10/16,18,35,0.70448623,43210,18,24,11
6063,2014/03/31,2011/12/13,6,50,0.7949442459999999,38293,6,31,19
6064,2014/03/31,2005/04/27,178,26,0.739553164,41156,178,20,6
6065,2014/03/31,2007/01/01,13,42,0.873036831,34862,13,19,23
6066,2014/03/31,2006/11/01,2,21,1.390818481,21882,2,13,8
6067,2014/03/31,2011/05/31,69,28,0.7346125809999999,41428,69,17,11
6068,2014/03/31,2009/11/03,114,17,1.1469238309999998,26533,114,8,9
6069,2014/03/31,2012/03/15,4,27,0.603096956,50456,4,7,20
6070,2014/03/31,2011/08/30,392,26,0.494250418,61561,392,26,0
6071,2014/03/31,2012/08/21,167,37,0.6820134529999999,44600,167,16,21
6072,2014/03/31,2011/12/07,39,37,0.544488228,55855,39,17,20
6073,2014/03/31,2011/12/15,1,32,0.7342247709999999,41420,1,6,26
6074,2014/03/31,2007/02/25,22,42,0.677095115,44914,22,26,16
6075,2014/03/31,2013/01/31,2,26,0.624590231,48686,2,1,25
6076,2014/03/31,2012/04/25,307,4,0.75,40544,307,2,2
6077,2014/03/31,2011/07/22,5,27,0.8497557570000001,35784,5,14,13
6078,2014/03/31,2010/05/27,18,26,0.635341232,47856,18,17,9
6079,2014/03/31,2009/02/07,22,28,0.6084969179999999,49964,22,16,12
6080,2014/03/31,2007/03/24,71,12,1.260108592,24127,71,1,11
6081,2014/03/31,2013/01/16,70,5,0.748002707,40630,70,1,4
6082,2014/03/31,2012/03/09,3,26,0.650479055,46717,3,2,24
6083,2014/03/31,2010/03/30,30,31,0.831568966,36540,30,9,22
6084,2014/03/31,2006/09/25,337,18,1.434061733,21188,337,17,1
6085,2014/03/31,2005/12/03,12,53,0.696437675,43626,12,30,23
6086,2014/03/31,2009/03/24,59,16,0.664812562,45695,59,12,4
6087,2014/03/31,2009/11/04,47,35,0.931708686,32604,47,5,30
6088,2014/03/31,2007/12/11,32,32,0.594252592,51110,32,12,20
6089,2014/03/31,2006/04/09,63,31,0.844228085,35969,63,17,14
6090,2014/03/31,2010/08/03,15,23,0.989387077,30689,15,9,14
6091,2014/03/31,2006/09/01,48,27,0.671696385,45202,48,18,9
6092,2014/03/31,2010/05/03,22,17,0.614216022,49421,22,7,10
6093,2014/03/31,2013/02/20,28,19,0.780074541,38905,28,3,16
6094,2014/03/31,2009/10/10,8,45,0.87470205,34687,8,21,24
6095,2014/03/31,2006/12/05,27,27,0.646773856,46895,27,9,18
6096,2014/03/31,2007/06/05,39,28,0.677390605,44769,39,8,20
6097,2014/03/31,2005/09/13,88,25,0.74479664,40716,88,10,15
6098,2014/03/31,2010/02/04,5,57,0.747011086,40590,5,27,30
6099,2014/03/31,2012/11/02,15,38,0.684126089,44318,15,9,29
6100,2014/03/31,2011/02/04,11,23,0.6957714290000001,43575,11,15,8
6101,2014/03/31,2008/02/13,213,6,0.8389581490000001,36128,213,4,2
6102,2014/03/31,2008/01/25,42,35,0.618429612,49007,42,18,17
6103,2014/03/31,2011/12/25,119,13,1.2807704009999998,23663,119,5,8
6104,2014/03/31,2011/08/06,8,33,0.765977253,39565,8,16,17
6105,2014/03/31,2007/06/03,110,25,0.801609797,37806,110,18,7
6106,2014/03/31,2005/05/07,633,8,1.246948936,24303,633,8,0
6107,2014/03/31,2012/05/26,47,15,0.69209519,43786,47,5,10
6108,2014/03/31,2011/06/07,297,14,0.762951959,39716,297,12,2
6109,2014/03/31,2011/11/07,18,26,0.7083206320000001,42778,18,8,18
6110,2014/03/31,2011/07/19,14,29,0.7267698359999999,41679,14,16,13
6111,2014/03/31,2011/11/23,16,60,0.67271241,45019,16,39,21
6112,2014/03/31,2013/03/10,24,29,0.706447752,42863,24,3,26
6113,2014/03/31,2012/09/09,94,30,0.593916268,50972,94,13,17
6114,2014/03/31,2011/03/06,32,37,0.567695222,53324,32,23,14
6115,2014/03/31,2012/07/08,108,20,0.583255738,51893,108,10,10
6116,2014/03/31,2005/12/13,5,37,0.566355605,53430,5,16,21
6117,2014/03/31,2010/12/10,298,22,0.8343700890000001,36267,298,18,4
6118,2014/03/31,2007/11/09,9,38,0.650821844,46493,9,23,15
6119,2014/03/31,2006/06/18,165,12,0.968191098,31251,165,7,5
6120,2014/03/31,2008/03/03,38,30,0.862849035,35061,38,19,11
6121,2014/03/31,2010/12/09,15,8,0.734264285,41198,15,5,3
6122,2014/03/31,2008/08/03,2,42,0.766679173,39448,2,20,22
6123,2014/03/31,2011/07/15,110,17,0.733286133,41243,110,7,10
6124,2014/03/31,2007/12/03,30,31,0.742389895,40734,30,20,11
6125,2014/03/31,2006/05/26,10,11,0.904544693,33428,10,2,9
6126,2014/03/31,2012/04/07,90,31,0.751669567,40226,90,18,13
6127,2014/03/31,2006/02/20,7,28,0.726461472,41619,7,0,28
6128,2014/03/31,2012/01/24,124,37,0.738279239,40947,124,29,8
6129,2014/03/31,2011/04/21,20,32,0.634504618,47640,20,16,16
6130,2014/03/31,2010/09/01,2,103,0.833222792,36276,2,53,50
6131,2014/03/31,2009/12/15,16,19,0.714760689,42288,16,0,19
6132,2014/03/31,2010/06/04,8,21,0.744602799,40584,8,9,12
6133,2014/03/31,2010/05/28,1,50,0.6927121209999999,43619,1,18,32
6134,2014/03/31,2008/06/13,196,11,0.697951763,43286,196,6,5
6135,2014/03/31,2009/11/01,8,34,0.80889472,37348,8,25,9
6136,2014/03/31,2005/05/04,8,27,0.641736489,47072,8,8,19
6137,2014/03/31,2010/02/09,5,38,0.720592094,41919,5,18,20
6138,2014/03/31,2006/05/25,33,14,1.059634112,28506,33,5,9
6139,2014/03/31,2012/09/23,33,30,0.7851746820000001,38470,33,3,27
6140,2014/03/31,2013/02/20,15,37,0.898896197,33602,15,5,32
6141,2014/03/31,2012/05/26,3,39,0.650915948,46400,3,6,33
6142,2014/03/31,2011/02/04,36,42,0.835171308,36163,36,20,22
6143,2014/03/31,2012/08/18,7,34,0.7438058759999999,40603,7,6,28
6144,2014/03/31,2007/07/25,2,31,0.770497257,39195,2,8,23
6145,2014/03/31,2010/02/26,10,27,0.689821127,43774,10,10,17
6146,2014/03/31,2007/10/09,133,33,0.68840352,43859,133,17,16
6147,2014/03/31,2007/02/01,1,34,0.6161310529999999,49003,1,18,16
6148,2014/03/31,2011/07/04,3,21,0.669702542,45082,3,5,16
6149,2014/03/31,2012/11/20,2,27,0.6574234999999999,45915,2,9,18
6150,2014/03/31,2012/10/29,27,33,0.614457971,49121,27,5,28
6151,2014/03/31,2009/04/26,20,41,0.7600470909999999,39710,20,25,16
6152,2014/03/31,2010/11/02,9,35,0.924,32655,9,16,19
6153,2014/03/31,2012/08/18,26,33,0.628263577,48024,26,17,16
6154,2014/03/31,2005/05/16,183,34,0.614280769,49108,183,21,13
6155,2014/03/31,2011/11/08,2,34,0.669970904,45023,2,17,17
6156,2014/03/31,2013/01/18,12,26,0.7723032209999999,39054,12,3,23
6157,2014/03/31,2012/05/24,78,25,0.769249337,39192,78,17,8
6158,2014/03/31,2005/10/11,13,35,0.7087793640000001,42527,13,17,18
6159,2014/03/31,2011/12/20,75,31,0.759188937,39701,75,25,6
6160,2014/03/31,2012/09/22,4,33,0.857957069,35126,4,5,28
6161,2014/03/31,2012/10/01,1,31,1.047982819,28753,1,17,14
6162,2014/03/31,2009/12/24,73,20,0.804445156,37452,73,10,10
6163,2014/03/31,2006/06/08,65,16,0.699267245,43084,65,6,10
6164,2014/03/31,2007/10/08,11,25,0.689853672,43669,11,13,12
6165,2014/03/31,2012/01/17,48,31,0.623265036,48318,48,10,21
6166,2014/03/31,2006/10/18,25,14,0.69094647,43583,25,6,8
6167,2014/03/31,2006/01/27,53,24,0.848231317,35501,53,17,7
6168,2014/03/31,2007/04/01,131,6,0.593981054,50670,131,4,2
6169,2014/03/31,2008/05/22,17,33,0.752880813,39954,17,19,14
6170,2014/03/31,2009/12/02,12,19,0.6847426059999999,43921,12,5,14
6171,2014/03/31,2010/04/19,39,38,0.6859903279999999,43839,39,20,18
6172,2014/03/31,2013/01/10,20,7,1.192789148,25212,20,0,7
6173,2014/03/31,2005/04/22,99,14,1.310371694,22949,99,8,6
6174,2014/03/31,2008/05/24,30,24,0.7732345079999999,38890,30,5,19
6175,2014/03/31,2011/10/02,2,71,0.693311811,43366,2,31,40
6176,2014/03/31,2011/12/02,16,43,0.8158724559999999,36850,16,19,24
6177,2014/03/31,2008/03/25,40,20,0.715229225,42033,40,11,9
6178,2014/03/31,2009/07/27,28,12,0.985333661,30510,28,7,5
6179,2014/03/31,2008/04/20,44,14,0.66660118,45098,44,7,7
6180,2014/03/31,2011/11/04,131,24,0.723575159,41545,131,23,1
6181,2014/03/31,2010/03/20,49,40,0.753575405,39878,49,26,14
6182,2014/03/31,2010/07/17,11,28,0.610798219,49197,11,13,15
6183,2014/03/31,2010/04/21,89,7,1.042398793,28827,89,4,3
6184,2014/03/31,2012/04/14,6,54,0.6735492190000001,44607,6,15,39
6185,2014/03/31,2010/08/31,72,47,0.6587753270000001,45604,72,21,26
6186,2014/03/31,2011/08/26,1,51,0.683107392,43979,1,19,32
6187,2014/03/31,2010/06/29,4,32,0.723249555,41538,4,13,19
6188,2014/03/31,2006/09/26,1,23,0.7911336999999999,37973,1,9,14
6189,2014/03/31,2007/11/12,2,45,0.611232425,49147,2,19,26
6190,2014/03/31,2012/08/29,18,12,0.775,38760,18,4,8
6191,2014/03/31,2007/07/05,1,30,0.6800554659999999,44171,1,17,13
6192,2014/03/31,2006/02/22,3,38,0.601071,49972,3,14,24
6193,2014/03/31,2006/12/06,1,44,0.732288243,41014,1,13,31
6194,2014/03/31,2008/09/10,119,25,0.7624960009999999,39387,119,14,11
6195,2014/03/31,2009/01/12,49,24,0.7527816909999999,39893,49,16,8
6196,2014/03/31,2008/05/15,12,42,0.6766404540000001,44381,12,15,27
6197,2014/03/31,2010/08/19,9,24,0.614131013,48896,9,10,14
6198,2014/03/31,2007/10/27,86,25,0.7654800629999999,39224,86,7,18
6199,2014/03/31,2007/10/10,9,42,0.626425799,47924,9,6,36
6200,2014/03/31,2012/07/27,25,16,0.841186179,35686,25,11,5
6201,2014/03/31,2010/09/30,100,31,0.7735522109999999,38804,100,11,20
6202,2014/03/31,2009/12/06,69,24,0.767081992,39126,69,16,8
6203,2014/03/31,2012/04/14,77,13,1.43498733,20915,77,8,5
6204,2014/03/31,2011/12/30,5,36,0.7135782909999999,42048,5,18,18
6205,2014/03/31,2012/04/30,236,15,1.220531711,24581,236,7,8
6206,2014/03/31,2008/05/21,17,37,0.671266335,44688,17,13,24
6207,2014/03/31,2004/12/08,67,5,0.772052298,38854,67,1,4
6208,2014/03/31,2008/04/30,134,27,0.5940250739999999,50491,134,22,5
6209,2014/03/31,2012/04/19,13,21,0.603327768,49712,13,4,17
6210,2014/03/31,2012/06/18,75,21,0.6505997960000001,46099,75,12,9
6211,2014/03/31,2007/10/28,38,30,0.79270531,37833,38,16,14
6212,2014/03/31,2013/03/15,47,13,0.6945211790000001,43179,47,1,12
6213,2014/03/31,2013/03/24,37,27,0.667037482,44955,37,2,25
6214,2014/03/31,2011/10/09,35,32,0.779924568,38445,35,16,16
6215,2014/03/31,2006/05/06,32,28,0.724098725,41408,32,12,16
6216,2014/03/31,2007/06/22,119,43,0.847706902,35367,119,39,4
6217,2014/03/31,2012/11/03,19,27,0.754502806,39733,19,9,18
6218,2014/03/31,2012/10/18,106,24,0.758672083,39513,106,10,14
6219,2014/03/31,2009/11/13,141,30,0.592149348,50620,141,21,9
6220,2014/03/31,2011/01/18,188,23,0.835571042,35873,188,22,1
6221,2014/03/31,2011/05/11,56,20,0.678120814,44200,56,11,9
6222,2014/03/31,2005/10/21,123,28,0.672774049,44545,123,14,14
6223,2014/03/31,2010/12/11,25,30,0.707442453,42357,25,13,17
6224,2014/03/31,2011/06/28,40,18,0.830094468,36097,40,3,15
6225,2014/03/31,2007/06/18,160,16,1.365076082,21950,160,10,6
6226,2014/03/31,2012/06/25,1,30,0.8519984079999999,35168,1,9,21
6227,2014/03/31,2007/02/24,26,22,0.83248583,35992,26,8,14
6228,2014/03/31,2011/08/23,13,27,0.6608324879999999,45334,13,15,12
6229,2014/03/31,2009/03/10,89,26,0.749085861,39983,89,17,9
6230,2014/03/31,2011/06/17,2,20,0.545747713,54874,2,13,7
6231,2014/03/31,2007/03/02,40,28,0.7801534929999999,38373,40,11,17
6232,2014/03/31,2011/08/16,4,37,0.650277615,46035,4,6,31
6233,2014/03/31,2005/11/15,17,42,0.671428411,44581,17,11,31
6234,2014/03/31,2010/12/27,3,36,0.763432463,39208,3,19,17
6235,2014/03/31,2012/01/14,400,9,0.823733176,36331,400,9,0
6236,2014/03/31,2006/01/29,85,22,0.938864906,31874,85,15,7
6237,2014/03/31,2008/08/02,9,17,0.747475015,40024,9,10,7
6238,2014/03/31,2006/04/30,141,19,1.347014724,22209,141,13,6
6239,2014/03/31,2007/10/18,176,12,0.702412757,42582,176,3,9
6240,2014/03/31,2005/05/13,142,30,0.697244836,42894,142,21,9
6241,2014/03/31,2011/04/14,184,41,0.7470134409999999,40026,184,33,8
6242,2014/03/31,2008/06/27,162,18,1.043908034,28641,162,10,8
6243,2014/03/31,2011/09/30,105,22,0.730715805,40905,105,7,15
6244,2014/03/31,2008/03/23,2,23,0.624950116,47811,2,11,12
6245,2014/03/31,2012/02/15,118,33,0.6343057910000001,47104,118,18,15
6246,2014/03/31,2006/04/09,27,19,0.59856539,49916,27,5,14
6247,2014/03/31,2012/03/06,75,25,0.625511148,47765,75,13,12
6248,2014/03/31,2011/04/24,61,10,1.051,28420,61,3,7
6249,2014/03/31,2009/11/08,17,30,0.506214728,59005,17,12,18
6250,2014/03/31,2011/10/21,4,31,0.923127183,32355,4,14,17
6251,2014/03/31,2007/11/11,29,25,0.68014669,43902,29,11,14
6252,2014/03/31,2012/08/11,11,33,0.670973933,44500,11,4,29
6253,2014/03/31,2011/01/11,4,50,0.71501353,41759,4,13,37
6254,2014/03/31,2009/10/05,21,39,0.78715555,37930,21,19,20
6255,2014/03/31,2007/09/14,11,30,0.715482325,41725,11,0,30
6256,2014/03/31,2012/04/30,37,12,0.679375925,43937,37,5,7
6257,2014/03/31,2007/08/19,14,39,0.6922547720000001,43113,14,25,14
6258,2014/03/31,2011/04/08,21,25,0.7185642740000001,41533,21,11,14
6259,2014/03/31,2008/01/22,84,26,0.924354964,32285,84,16,10
6260,2014/03/31,2009/01/02,4,27,0.997749097,29908,4,9,18
6261,2014/03/31,2006/12/28,21,18,0.7214204890000001,41359,21,4,14
6262,2014/03/31,2011/06/21,63,18,0.7544526490000001,39545,63,5,13
6263,2014/03/31,2011/10/06,14,42,0.660308523,45183,14,16,26
6264,2014/03/31,2011/04/11,140,13,0.8104609909999999,36812,140,6,7
6265,2014/03/31,2011/07/15,80,25,0.624777582,47748,80,11,14
6266,2014/03/31,2011/04/22,50,27,0.7420241320000001,40195,50,12,15
6267,2014/03/31,2008/05/16,8,21,0.846520875,35233,8,12,9
6268,2014/03/31,2006/10/23,100,38,0.70019443,42586,100,20,18
6269,2014/03/31,2010/03/09,8,13,0.825527962,36120,8,6,7
6270,2014/03/31,2009/03/28,20,19,1.382596216,21566,20,7,12
6271,2014/03/31,2012/07/06,108,22,0.793556466,37571,108,11,11
6272,2014/03/31,2009/06/16,41,29,0.780585339,38183,41,11,18
6273,2014/03/31,2005/12/04,25,25,0.799800075,37264,25,18,7
6274,2014/03/31,2010/04/02,11,28,0.6219867689999999,47917,11,14,14
6275,2014/03/31,2011/05/17,4,43,0.72130821,41316,4,12,31
6276,2014/03/31,2006/04/07,15,42,0.6969619420000001,42751,15,23,19
6277,2014/03/31,2005/12/02,28,24,0.8494098529999999,35076,28,10,14
6278,2014/03/31,2008/09/04,40,29,0.722596832,41231,40,10,19
6279,2014/03/31,2011/06/29,3,16,0.7833559459999999,38031,3,7,9
6280,2014/03/31,2012/09/22,2,12,0.792501197,37586,2,9,3
6281,2014/03/31,2008/08/26,29,24,1.059571683,28110,29,13,11
6282,2014/03/31,2006/03/30,41,21,0.626821989,47514,41,15,6
6283,2014/03/31,2010/02/06,188,23,1.039418211,28653,188,16,7
6284,2014/03/31,2011/07/29,75,45,0.587091375,50725,75,24,21
6285,2014/03/31,2006/10/01,1,39,0.8144655359999999,36560,1,20,19
6286,2014/03/31,2008/04/07,143,18,0.935530658,31819,143,12,6
6287,2014/03/31,2009/02/26,24,23,0.749463454,39717,24,15,8
6288,2014/03/31,2013/01/22,96,4,0.80708243,36880,96,0,4
6289,2014/03/31,2006/03/29,22,26,0.8042893040000001,37006,22,7,19
6290,2014/03/31,2009/12/05,4,52,0.8048672109999999,36976,4,25,27
6291,2014/03/31,2009/07/22,5,23,0.669500315,44428,5,9,14
6292,2014/03/31,2008/10/30,31,34,0.588628941,50523,31,22,12
6293,2014/03/31,2010/09/08,1,32,0.5965277920000001,49853,1,8,24
6294,2014/03/31,2010/10/20,163,21,0.862321812,34486,163,10,11
6295,2014/03/31,2005/07/09,10,23,1.307227449,22748,10,4,19
6296,2014/03/31,2008/02/28,45,19,0.85326827,34838,45,8,11
6297,2014/03/31,2011/01/14,74,26,0.712403835,41725,74,19,7
6298,2014/03/31,2012/02/17,11,22,0.750505731,39606,11,11,11
6299,2014/03/31,2011/12/13,444,4,0.8,37152,444,4,0
6300,2014/03/31,2011/02/02,187,22,0.7895791259999999,37636,187,18,4
6301,2014/03/31,2010/08/07,61,25,0.8963462759999999,33147,61,17,8
6302,2014/03/31,2012/10/12,18,13,0.998270775,29759,18,3,10
6303,2014/03/31,2012/12/18,36,24,0.847214915,35051,36,6,18
6304,2014/03/31,2007/06/08,20,36,0.780540427,38044,20,26,10
6305,2014/03/31,2009/04/25,28,37,0.703181215,42226,28,18,19
6306,2014/03/31,2010/02/15,1,40,0.68133546,43573,1,18,22
6307,2014/03/31,2010/07/28,46,45,0.578415197,51325,46,21,24
6308,2014/03/31,2011/06/24,1,54,0.796025098,37294,1,10,44
6309,2014/03/31,2009/08/14,33,31,0.790277918,37565,33,17,14
6310,2014/03/31,2012/09/19,42,27,0.7423493659999999,39981,42,11,16
6311,2014/03/31,2006/07/07,13,32,0.788115573,37656,13,12,20
6312,2014/03/31,2007/02/16,31,50,0.630718551,47053,31,30,20
6313,2014/03/31,2011/11/07,12,17,1.04870693,28297,12,4,13
6314,2014/03/31,2008/11/07,20,32,0.629793874,47107,20,15,17
6315,2014/03/31,2012/01/13,7,39,0.6378084279999999,46510,7,14,25
6316,2014/03/31,2011/11/09,19,54,0.86008496,34487,19,32,22
6317,2014/03/31,2010/03/13,42,12,0.734679085,40369,42,0,12
6318,2014/03/31,2012/09/11,4,40,1.023811792,28968,4,11,29
6319,2014/03/31,2009/11/29,70,33,0.848068078,34960,70,6,27
6320,2014/03/31,2011/09/08,65,23,0.754438507,39297,65,13,10
6321,2014/03/31,2007/06/29,66,30,0.638149001,46456,66,19,11
6322,2014/03/31,2012/12/30,43,16,0.585347708,50646,43,5,11
6323,2014/03/31,2009/10/15,27,34,0.69261215,42800,27,10,24
6324,2014/03/31,2011/10/09,79,64,0.7082540740000001,41846,79,34,30
6325,2014/03/31,2005/08/05,33,30,0.91280276,32468,33,13,17
6326,2014/03/31,2005/12/14,11,35,0.704313283,42077,11,19,16
6327,2014/03/31,2006/04/17,35,27,0.7347109279999999,40336,35,14,13
6328,2014/03/31,2007/03/20,27,37,0.698434317,42416,27,20,17
6329,2014/03/31,2005/10/21,14,43,0.6804178340000001,43534,14,23,20
6330,2014/03/31,2009/07/03,11,28,0.8089356529999999,36614,11,15,13
6331,2014/03/31,2009/10/19,6,33,0.7036493229999999,42090,6,6,27
6332,2014/03/31,2011/09/19,20,23,0.944215392,31366,20,8,15
6333,2014/03/31,2011/04/18,143,32,0.816230362,36282,143,21,11
6334,2014/03/31,2011/02/22,575,16,1.495354474,19804,575,16,0
6335,2014/03/31,2006/08/28,125,31,0.692363024,42763,125,15,16
6336,2014/03/31,2012/10/01,5,17,1.247497788,23731,5,0,17
6337,2014/03/31,2009/05/12,6,50,0.80398213,36822,6,20,30
6338,2014/03/31,2010/07/21,90,36,0.745185894,39727,90,24,12
6339,2014/03/31,2011/09/20,24,33,0.659096273,44914,24,12,21
6340,2014/03/31,2011/09/30,390,30,0.7488186790000001,39532,390,30,0
6341,2014/03/31,2012/12/10,11,22,1.070508861,27650,11,1,21
6342,2014/03/31,2010/02/11,32,39,0.728597523,40621,32,22,17
6343,2014/03/31,2005/01/15,31,32,0.7015771009999999,42185,31,16,16
6344,2014/03/31,2010/12/19,29,27,0.767624692,38555,29,15,12
6345,2014/03/31,2012/04/06,1,39,0.6704780570000001,44137,1,24,15
6346,2014/03/31,2012/06/20,11,14,0.727289373,40688,11,10,4
6347,2014/03/31,2005/09/01,21,37,0.7171941140000001,41249,21,16,21
6348,2014/03/31,2006/11/20,34,17,0.6912876240000001,42792,34,11,6
6349,2014/03/31,2010/04/05,30,13,1.265279572,23375,30,9,4
6350,2014/03/31,2008/05/02,1,37,0.622821253,47486,1,17,20
6351,2014/03/31,2005/03/02,14,32,0.7355536490000001,40206,14,17,15
6352,2014/03/31,2006/12/04,68,24,0.825956597,35804,68,11,13
6353,2014/03/31,2010/01/10,8,22,0.835145584,35409,8,12,10
6354,2014/03/31,2007/08/28,4,31,0.799061259,37007,4,8,23
6355,2014/03/31,2011/07/21,8,31,0.700257418,42227,8,15,16
6356,2014/03/31,2007/02/25,24,27,0.797077301,37089,24,20,7
6357,2014/03/31,2012/12/22,7,17,1.397045422,21157,7,6,11
6358,2014/03/31,2008/11/27,39,37,0.909733149,32490,39,13,24
6359,2014/03/31,2012/06/23,1,38,0.515607782,57315,1,10,28
6360,2014/03/31,2009/02/09,7,28,0.821872045,35950,7,10,18
6361,2014/03/31,2009/11/03,68,25,0.763642802,38690,68,12,13
6362,2014/03/31,2008/01/12,60,20,0.762049787,38765,60,8,12
6363,2014/03/31,2009/08/11,12,29,0.6804595609999999,43411,12,17,12
6364,2014/03/31,2010/09/17,179,12,0.638094487,46292,179,8,4
6365,2014/03/31,2006/01/20,8,23,0.7595041920000001,38886,8,9,14
6366,2014/03/31,2006/08/03,96,38,0.668828245,44156,96,13,25
6367,2014/03/31,2007/03/21,13,42,0.650900595,45370,13,17,25
6368,2014/03/31,2008/05/14,99,22,0.667803935,44220,99,14,8
6369,2014/03/31,2006/03/01,39,21,0.854740209,34547,39,14,7
6370,2014/03/31,2006/02/14,15,27,0.690182783,42783,15,13,14
6371,2014/03/31,2006/10/01,20,28,0.697525284,42320,20,16,12
6372,2014/03/31,2006/05/25,6,34,0.80800208,36533,6,17,17
6373,2014/03/31,2012/04/21,13,38,0.77081007,38293,13,15,23
6374,2014/03/31,2006/05/23,66,13,1.438808073,20513,66,10,3
6375,2014/03/31,2012/08/01,28,22,0.726241941,40638,28,8,14
6376,2014/03/31,2011/01/14,86,19,0.7053202829999999,41838,86,10,9
6377,2014/03/31,2007/07/06,1,16,0.76775121,38434,1,6,10
6378,2014/03/31,2010/12/25,5,24,1.346645214,21909,5,12,12
6379,2014/03/31,2005/05/04,28,33,0.561352946,52552,28,9,24
6380,2014/03/31,2006/02/03,28,35,0.657065416,44882,28,19,16
6381,2014/03/31,2012/08/18,166,17,0.747058824,39474,166,12,5
6382,2014/03/31,2011/10/20,14,32,0.957023466,30811,14,20,12
6383,2014/03/31,2011/02/23,34,24,0.7832513409999999,37646,34,7,17
6384,2014/03/31,2007/01/02,105,4,0.6025,48928,105,2,2
6385,2014/03/31,2007/12/01,76,26,0.702556493,41952,76,14,12
6386,2014/03/31,2011/02/18,79,34,0.66151707,44553,79,16,18
6387,2014/03/31,2013/02/06,11,27,0.7141406140000001,41262,11,3,24
6388,2014/03/31,2006/10/04,74,41,0.681449155,43239,74,20,21
6389,2014/03/31,2011/07/25,159,18,0.598625097,49218,159,14,4
6390,2014/03/31,2008/08/21,27,37,0.79298638,37152,27,25,12
6391,2014/03/31,2010/05/12,36,20,0.7379596690000001,39920,36,6,14
6392,2014/03/31,2008/02/06,89,24,0.727754144,40479,89,15,9
6393,2014/03/31,2007/05/29,2,28,0.641253646,45938,2,14,14
6394,2014/03/31,2012/02/15,18,13,0.876011421,33621,18,1,12
6395,2014/03/31,2007/12/09,39,28,0.7066566679999999,41674,39,19,9
6396,2014/03/31,2006/01/21,3,30,0.764231847,38534,3,16,14
6397,2014/03/31,2009/03/12,4,18,0.5753173779999999,51185,4,9,9
6398,2014/03/31,2011/01/20,2,33,0.776768228,37908,2,4,29
6399,2014/03/31,2005/01/06,267,24,0.644834852,45656,267,21,3
6400,2014/03/31,2007/05/21,4,21,1.104794731,26648,4,14,7
6401,2014/03/31,2006/06/30,10,12,0.8371763740000001,35164,10,6,6
6402,2014/03/31,2011/08/19,12,33,0.56529257,52073,12,16,17
6403,2014/03/31,2010/12/06,3,23,0.7200621540000001,40866,3,6,17
6404,2014/03/31,2008/07/04,14,31,0.700080895,42030,14,10,21
6405,2014/03/31,2011/02/06,62,26,0.666166229,44168,62,13,13
6406,2014/03/31,2006/03/22,70,27,0.726579402,40490,70,16,11
6407,2014/03/31,2008/12/02,1,30,0.8263332959999999,35596,1,23,7
6408,2014/03/31,2006/04/04,63,16,0.783911305,37522,63,6,10
6409,2014/03/31,2005/04/17,5,24,0.8475,34704,5,14,10
6410,2014/03/31,2012/07/29,22,37,0.668796362,43975,22,15,22
6411,2014/03/31,2004/11/30,13,30,0.599879646,49022,13,16,14
6412,2014/03/31,2006/05/29,7,23,1.083308035,27143,7,7,16
6413,2014/03/31,2010/04/16,15,23,0.808240097,36377,15,12,11
6414,2014/03/31,2006/04/25,177,27,0.926451959,31733,177,23,4
6415,2014/03/31,2009/03/26,68,22,0.67969896,43250,68,9,13
6416,2014/03/31,2008/11/03,9,31,0.764369328,38459,9,14,17
6417,2014/03/31,2007/11/07,14,32,0.831798115,35337,14,13,19
6418,2014/03/31,2012/01/18,60,18,0.66199144,44395,60,3,15
6419,2014/03/31,2005/10/23,224,22,0.972527724,30209,224,13,9
6420,2014/03/31,2010/12/28,16,23,0.757424645,38783,16,11,12
6421,2014/03/31,2005/07/11,5,37,0.73171803,40139,5,14,23
6422,2014/03/31,2008/06/06,8,29,0.952601122,30829,8,19,10
6423,2014/03/31,2006/03/30,60,22,0.593544644,49469,60,12,10
6424,2014/03/31,2009/11/30,45,23,0.732034405,40110,45,15,8
6425,2014/03/31,2010/08/27,17,34,0.734112425,39991,17,22,12
6426,2014/03/31,2009/03/30,175,3,0.8,36696,175,1,2
6427,2014/03/31,2007/06/12,3,33,0.629665558,46615,3,14,19
6428,2014/03/31,2011/07/19,24,47,0.8731774370000001,33612,24,27,20
6429,2014/03/31,2012/08/24,23,15,0.919333333,31920,23,8,7
6430,2014/03/31,2012/02/21,257,29,0.8670555209999999,33843,257,27,2
6431,2014/03/31,2011/10/07,70,14,0.763066441,38455,70,11,3
6432,2014/03/31,2009/10/16,13,43,0.7614919290000001,38534,13,17,26
6433,2014/03/31,2008/02/03,44,34,0.73686665,39820,44,15,19
6434,2014/03/31,2008/08/01,2,28,0.615424586,47670,2,13,15
6435,2014/03/31,2009/01/25,27,30,0.699270525,41948,27,15,15
6436,2014/03/31,2012/05/01,21,18,0.910043133,32226,21,6,12
6437,2014/03/31,2005/10/14,79,20,0.767792701,38196,79,10,10
6438,2014/03/31,2009/02/03,123,39,0.664582682,44127,123,21,18
6439,2014/03/31,2012/07/19,13,25,0.622157861,47130,13,9,16
6440,2014/03/31,2006/03/24,13,28,0.627140841,46755,13,14,14
6441,2014/03/31,2009/10/21,19,46,0.7441011059999999,39404,19,26,20
6442,2014/03/31,2012/09/20,34,22,0.695232517,42169,34,3,19
6443,2014/03/31,2010/12/11,54,34,0.620192295,47271,54,22,12
6444,2014/03/31,2007/11/11,26,23,0.815898828,35919,26,15,8
6445,2014/03/31,2011/10/10,10,31,0.786492283,37255,10,10,21
6446,2014/03/31,2011/10/13,69,22,0.611088262,47948,69,10,12
6447,2014/03/31,2005/09/15,30,54,0.810568773,36148,30,24,30
6448,2014/03/31,2010/01/13,2,26,0.659284011,44442,2,9,17
6449,2014/03/31,2012/03/14,5,38,0.834447767,35112,5,19,19
6450,2014/03/31,2007/03/23,149,12,1.023931779,28613,149,9,3
6451,2014/03/31,2011/01/03,10,26,0.7834018770000001,37397,10,13,13
6452,2014/03/31,2005/07/11,104,18,1.337147031,21907,104,4,14
6453,2014/03/31,2009/11/07,11,21,0.75336514,38881,11,11,10
6454,2014/03/31,2005/06/13,36,22,0.676974895,43258,36,14,8
6455,2014/03/31,2011/06/24,147,23,0.7886708859999999,37130,147,17,6
6456,2014/03/31,2005/03/26,9,28,0.670539043,43670,9,12,16
6457,2014/03/31,2007/04/29,124,23,0.782989142,37392,124,14,9
6458,2014/03/31,2010/06/13,5,40,0.677468527,43212,5,22,18
6459,2014/03/31,2010/08/18,11,33,0.8574857909999999,34134,11,17,16
6460,2014/03/31,2008/12/25,96,22,0.720119827,40642,96,10,12
6461,2014/03/31,2006/05/14,106,30,0.5827893829999999,50219,106,13,17
6462,2014/03/31,2007/07/10,116,41,0.8412162590000001,34787,116,15,26
6463,2014/03/31,2008/03/11,1,46,0.66862348,43748,1,13,33
6464,2014/03/31,2010/07/02,56,32,0.951989779,30722,56,20,12
6465,2014/03/31,2009/07/28,89,27,0.709666351,41211,89,20,7
6466,2014/03/31,2006/08/10,10,21,1.408440902,20762,10,11,10
6467,2014/03/31,2008/02/24,4,15,1.256709214,23268,4,1,14
6468,2014/03/31,2006/04/21,51,18,0.6636631479999999,44055,51,6,12
6469,2014/03/31,2010/04/05,1,32,0.7372320840000001,39658,1,12,20
6470,2014/03/31,2008/07/23,132,17,0.711446024,41092,132,4,13
6471,2014/03/31,2011/08/20,27,32,0.8868405890000001,32965,27,16,16
6472,2014/03/31,2012/10/26,19,27,0.7270411640000001,40205,19,6,21
6473,2014/03/31,2012/07/01,72,24,0.751245855,38905,72,13,11
6474,2014/03/31,2008/01/02,69,40,0.718491002,40676,69,18,22
6475,2014/03/31,2007/03/30,14,45,0.733348557,39850,14,24,21
6476,2014/03/31,2012/10/07,42,15,0.6851619109999999,42647,42,5,10
6477,2014/03/31,2011/07/24,1,22,0.764126324,38235,1,10,12
6478,2014/03/31,2006/06/16,97,23,0.679024917,43022,97,11,12
6479,2014/03/31,2012/01/08,216,13,0.7108701999999999,41094,216,12,1
6480,2014/03/31,2006/03/04,22,17,0.7091720690000001,41187,22,11,6
6481,2014/03/31,2005/07/29,5,45,0.7522031929999999,38830,5,21,24
6482,2014/03/31,2010/11/17,69,5,0.588152086,49656,69,3,2
6483,2014/03/31,2005/04/03,6,32,0.780787145,37401,6,17,15
6484,2014/03/31,2011/04/29,72,34,0.758989681,38473,72,20,14
6485,2014/03/31,2013/03/14,86,14,0.8051979920000001,36264,86,4,10
6486,2014/03/31,2005/08/06,5,33,0.866257603,33703,5,16,17
6487,2014/03/31,2005/04/23,99,18,0.835057064,34961,99,1,17
6488,2014/03/31,2005/11/15,5,45,0.614618931,47498,5,17,28
6489,2014/03/31,2012/12/21,23,20,1.403304168,20801,23,4,16
6490,2014/03/31,2009/11/17,18,36,0.6432061170000001,45382,18,22,14
6491,2014/03/31,2011/11/16,5,34,0.765687303,38120,5,20,14
6492,2014/03/31,2006/06/05,14,34,0.799987665,36482,14,25,9
6493,2014/03/31,2007/01/04,22,21,0.683517976,42695,22,12,9
6494,2014/03/31,2011/02/21,5,21,0.666160431,43807,5,8,13
6495,2014/03/31,2012/09/21,18,24,0.635855088,45890,18,12,12
6496,2014/03/31,2007/10/12,14,29,0.710426071,41073,14,12,17
6497,2014/03/31,2008/01/10,80,28,0.725076789,40240,80,19,9
6498,2014/03/31,2009/11/03,7,26,0.769667062,37905,7,16,10
6499,2014/03/31,2012/08/03,6,24,0.47430432,61501,6,0,24
6500,2014/03/31,2006/12/21,17,42,0.7465629159999999,39068,17,11,31
6501,2014/03/31,2010/04/04,396,3,1.03,28315,396,3,0
6502,2014/03/31,2009/04/03,13,29,0.669217972,43579,13,9,20
6503,2014/03/31,2006/06/07,7,32,0.756076392,38564,7,11,21
6504,2014/03/31,2012/11/05,1,52,0.67296893,43322,1,8,44
6505,2014/03/31,2013/03/05,38,9,1.063778508,27405,38,1,8
6506,2014/03/31,2006/03/01,4,36,0.70431878,41389,4,17,19
6507,2014/03/31,2012/07/28,1,27,0.716462881,40680,1,10,17
6508,2014/03/31,2006/03/24,13,32,0.7853017729999999,37114,13,15,17
6509,2014/03/31,2008/05/22,32,39,0.756050071,38545,32,18,21
6510,2014/03/31,2010/09/21,77,12,1.308671128,22267,77,6,6
6511,2014/03/31,2008/05/15,14,36,0.729916571,39914,14,15,21
6512,2014/03/31,2013/03/02,16,18,0.665110274,43800,16,0,18
6513,2014/03/31,2012/11/02,390,9,1.3591937669999998,21433,390,9,0
6514,2014/03/31,2011/11/07,58,37,0.726572804,40094,58,27,10
6515,2014/03/31,2006/11/01,27,14,0.6973160979999999,41775,27,11,3
6516,2014/03/31,2011/03/04,8,65,0.730515348,39876,8,26,39
6517,2014/03/31,2010/02/23,9,30,0.741751897,39266,9,18,12
6518,2014/03/31,2008/08/03,23,18,1.411634345,20626,23,9,9
6519,2014/03/31,2008/01/29,102,46,0.628133374,46351,102,24,22
6520,2014/03/31,2013/02/17,221,4,0.595,48928,221,1,3
6521,2014/03/31,2009/04/07,85,20,0.865370277,33637,85,14,6
6522,2014/03/31,2012/09/21,17,30,0.769766728,37810,17,17,13
6523,2014/03/31,2011/11/07,8,28,0.665115413,43756,8,11,17
6524,2014/03/31,2009/04/07,11,23,0.922711563,31539,11,9,14
6525,2014/03/31,2011/05/20,122,21,0.8390410559999999,34684,122,17,4
6526,2014/03/31,2006/03/06,116,28,0.661496408,43992,116,11,17
6527,2014/03/31,2005/11/17,3,38,0.673675681,43192,3,26,12
6528,2014/03/31,2009/12/28,31,21,0.680973058,42721,31,15,6
6529,2014/03/31,2012/07/13,61,9,0.7113224429999999,40894,61,2,7
6530,2014/03/31,2011/03/27,81,30,0.773220447,37619,81,18,12
6531,2014/03/31,2012/11/29,33,22,0.77847523,37363,33,6,16
6532,2014/03/31,2011/03/17,375,29,1.0,29086,375,29,0
6533,2014/03/31,2011/01/26,112,28,0.8098844140000001,35904,112,14,14
6534,2014/03/31,2011/01/20,8,23,0.636232328,45694,8,11,12
6535,2014/03/31,2009/02/25,13,31,0.907206305,32040,13,11,20
6536,2014/03/31,2008/03/18,20,40,0.65091868,44651,20,13,27
6537,2014/03/31,2007/08/10,5,38,0.779625734,37273,5,10,28
6538,2014/03/31,2012/02/08,26,31,0.804951801,36100,26,15,16
6539,2014/03/31,2007/09/24,26,44,0.558583979,52019,26,25,19
6540,2014/03/31,2013/03/02,1,26,0.835120023,34785,1,3,23
6541,2014/03/31,2006/07/27,2,20,0.651060559,44618,2,11,9
6542,2014/03/31,2011/09/16,59,24,0.702829212,41326,59,7,17
6543,2014/03/31,2004/11/13,6,21,0.7725356459999999,37592,6,5,16
6544,2014/03/31,2011/11/30,177,32,0.715332052,40596,177,24,8
6545,2014/03/31,2011/12/15,285,24,0.850225456,34153,285,21,3
6546,2014/03/31,2011/01/16,1,35,0.771414225,37639,1,16,19
6547,2014/03/31,2006/03/18,7,39,0.758583821,38272,7,18,21
6548,2014/03/31,2005/07/12,20,22,1.28271707,22631,20,10,12
6549,2014/03/31,2010/04/07,1,25,0.7541516840000001,38488,1,10,15
6550,2014/03/31,2005/06/23,168,30,0.72366975,40109,168,14,16
6551,2014/03/31,2007/09/03,2,22,0.686883609,42254,2,10,12
6552,2014/03/31,2005/08/02,374,11,0.8087311540000001,35883,374,11,0
6553,2014/03/31,2007/12/25,10,42,0.6922085170000001,41915,10,22,20
6554,2014/03/31,2008/03/29,33,22,0.661890887,43826,33,10,12
6555,2014/03/31,2005/11/09,5,21,0.687165261,42212,5,9,12
6556,2014/03/31,2009/03/31,18,33,0.84687104,34251,18,25,8
6557,2014/03/31,2005/04/21,98,28,0.700571953,41402,98,15,13
6558,2014/03/31,2007/04/29,31,35,0.779616915,37198,31,12,23
6559,2014/03/31,2010/09/22,98,14,0.6928718220000001,41848,98,7,7
6560,2014/03/31,2007/03/18,5,29,0.611889285,47383,5,11,18
6561,2014/03/31,2008/05/19,4,21,1.174183946,24692,4,7,14
6562,2014/03/31,2010/05/01,4,41,0.504550913,57461,4,10,31
6563,2014/03/31,2010/08/11,5,28,0.70269984,41258,5,12,16
6564,2014/03/31,2007/02/19,303,3,0.79,36696,303,1,2
6565,2014/03/31,2011/12/21,30,24,0.72917975,39744,30,12,12
6566,2014/03/31,2010/09/14,6,19,0.667368421,43415,6,10,9
6567,2014/03/31,2009/02/26,11,30,0.704319712,41137,11,11,19
6568,2014/03/31,2011/08/29,12,20,0.8545,33900,12,10,10
6569,2014/03/31,2011/07/18,63,27,0.806666667,35910,63,17,10
6570,2014/03/31,2011/09/19,74,11,1.339365608,21627,74,9,2
6571,2014/03/31,2010/10/28,654,8,0.65878005,43969,654,8,0
6572,2014/03/31,2010/07/16,86,24,0.684115591,42339,86,10,14
6573,2014/03/31,2006/09/13,18,48,0.874704479,33111,18,28,20
6574,2014/03/31,2010/12/09,58,30,0.686613947,42173,58,16,14
6575,2014/03/31,2006/04/21,8,39,0.539335407,53687,8,23,16
6576,2014/03/31,2007/12/28,4,23,1.0992657,26338,4,11,12
6577,2014/03/31,2011/12/28,171,16,0.793592457,36482,171,10,6
6578,2014/03/31,2011/07/08,77,34,0.649025692,44606,77,18,16
6579,2014/03/31,2008/01/04,521,13,1.490397487,19422,521,13,0
6580,2014/03/31,2009/04/03,40,27,0.643259676,44983,40,12,15
6581,2014/03/31,2007/09/09,27,34,0.788908883,36678,27,21,13
6582,2014/03/31,2010/10/17,33,29,0.665434808,43479,33,13,16
6583,2014/03/31,2008/10/23,9,27,0.7343807590000001,39395,9,10,17
6584,2014/03/31,2006/07/04,4,35,0.648974089,44575,4,17,18
6585,2014/03/31,2011/02/03,43,7,0.7024053029999999,41184,43,2,5
6586,2014/03/31,2007/01/10,32,49,0.750086348,38565,32,23,26
6587,2014/03/31,2009/11/22,7,48,0.6573734210000001,44004,7,26,22
6588,2014/03/31,2012/11/01,4,26,0.674197879,42905,4,6,20
6589,2014/03/31,2006/07/03,19,13,0.706741845,40925,19,7,6
6590,2014/03/31,2010/02/01,4,32,0.7372402370000001,39228,4,16,16
6591,2014/03/31,2008/03/14,1,27,0.86440947,33453,1,12,15
6592,2014/03/31,2009/01/08,69,43,0.598345922,48323,69,20,23
6593,2014/03/31,2010/01/29,75,26,0.750281029,38537,75,16,10
6594,2014/03/31,2010/05/17,21,24,0.674078987,42893,21,18,6
6595,2014/03/31,2009/10/14,91,21,0.841685639,34349,91,13,8
6596,2014/03/31,2012/04/06,73,37,0.620624504,46581,73,15,22
6597,2014/03/31,2008/04/21,12,36,0.7468713990000001,38701,12,16,20
6598,2014/03/31,2009/09/15,3,34,0.7725917609999999,37407,3,8,26
6599,2014/03/31,2008/07/02,105,20,0.67,43130,105,12,8
6600,2014/03/31,2012/11/06,91,11,1.3726169780000002,21051,91,6,5
6601,2014/03/31,2011/01/28,128,12,1.22527865,23578,128,7,5
6602,2014/03/31,2010/09/17,6,39,0.665570737,43400,6,28,11
6603,2014/03/31,2012/09/18,44,10,0.979858878,29478,44,4,6
6604,2014/03/31,2011/07/06,2,32,0.611988557,47190,2,15,17
6605,2014/03/31,2005/05/06,15,18,0.916076459,31520,15,12,6
6606,2014/03/31,2006/02/23,67,38,0.7220824790000001,39986,67,24,14
6607,2014/03/31,2006/08/13,115,14,0.7226699040000001,39949,115,10,4
6608,2014/03/31,2005/11/08,19,22,0.899272008,32102,19,16,6
6609,2014/03/31,2010/11/22,134,19,0.694086078,41590,134,6,13
6610,2014/03/31,2010/06/23,178,16,1.3986906380000002,20636,178,12,4
6611,2014/03/31,2006/02/11,24,24,0.707590645,40791,24,14,10
6612,2014/03/31,2011/03/31,19,26,0.688148298,41929,19,13,13
6613,2014/03/31,2011/01/01,15,27,0.68623207,42039,15,4,23
6614,2014/03/31,2012/07/31,245,4,0.759496077,37982,245,1,3
6615,2014/03/31,2006/10/19,159,26,0.7111548320000001,40560,159,20,6
6616,2014/03/31,2006/07/04,141,25,0.819609537,35189,141,8,17
6617,2014/03/31,2007/04/26,80,28,0.615460773,46856,80,17,11
6618,2014/03/31,2007/04/17,103,23,0.727993587,39608,103,7,16
6619,2014/03/31,2009/08/06,11,30,0.7202348059999999,40033,11,16,14
6620,2014/03/31,2012/05/31,117,10,1.427811014,20192,117,2,8
6621,2014/03/31,2011/04/25,25,21,0.765307547,37669,25,9,12
6622,2014/03/31,2007/02/20,7,23,0.9117333,31616,7,12,11
6623,2014/03/31,2011/01/27,111,15,0.708194619,40695,111,5,10
6624,2014/03/31,2011/02/20,11,36,0.847724438,33996,11,13,23
6625,2014/03/31,2011/10/04,24,23,0.780277808,36932,24,13,10
6626,2014/03/31,2013/02/02,8,47,0.688822967,41834,8,4,43
6627,2014/03/31,2012/05/08,50,19,1.424675896,20225,50,16,3
6628,2014/03/31,2009/10/05,32,15,0.973627547,29593,32,11,4
6629,2014/03/31,2012/09/17,6,30,0.753052775,38257,6,9,21
6630,2014/03/31,2006/01/11,150,8,1.051026745,27407,150,4,4
6631,2014/03/31,2008/10/15,480,6,0.955481752,30140,480,6,0
6632,2014/03/31,2009/09/19,73,22,0.778116455,37010,73,15,7
6633,2014/03/31,2007/11/01,120,31,0.637541071,45166,120,21,10
6634,2014/03/31,2007/11/08,18,29,0.749569948,38414,18,7,22
6635,2014/03/31,2008/06/12,65,43,0.686773924,41924,65,24,19
6636,2014/03/31,2008/04/20,7,29,0.7004712670000001,41102,7,20,9
6637,2014/03/31,2009/12/01,10,34,0.6800363770000001,42335,10,21,13
6638,2014/03/31,2009/01/27,7,28,0.741555286,38816,7,12,16
6639,2014/03/31,2011/05/13,57,16,0.572963789,50233,57,5,11
6640,2014/03/31,2012/03/16,58,23,0.65553741,43905,58,10,13
6641,2014/03/31,2005/07/28,132,18,0.640813272,44905,132,9,9
6642,2014/03/31,2007/12/15,39,32,0.954164069,30158,39,19,13
6643,2014/03/31,2010/12/13,36,19,0.595143241,48345,36,6,13
6644,2014/03/31,2012/11/06,48,18,0.7637967929999999,37666,48,6,12
6645,2014/03/31,2007/06/18,1,23,0.652619123,44072,1,9,14
6646,2014/03/31,2006/08/01,4,20,0.6866041159999999,41886,4,8,12
6647,2014/03/31,2005/05/03,147,14,0.7771428570000001,37002,147,6,8
6648,2014/03/31,2006/04/07,6,32,0.8193528809999999,35094,6,13,19
6649,2014/03/31,2012/09/08,15,28,0.600587547,47877,15,13,15
6650,2014/03/31,2012/09/05,17,24,0.489238034,58769,17,10,14
6651,2014/03/31,2012/01/19,4,81,0.6654961110000001,43196,4,28,53
6652,2014/03/31,2005/01/18,450,3,0.783333333,36696,450,3,0
6653,2014/03/31,2004/12/23,97,43,0.6929082670000001,41468,97,26,17
6654,2014/03/31,2011/10/10,30,30,0.850901795,33766,30,12,18
6655,2014/03/31,2008/06/12,19,24,0.7328724109999999,39204,19,20,4
6656,2014/03/31,2006/03/25,9,35,0.7203606090000001,39877,9,16,19
6657,2014/03/31,2010/06/03,12,31,0.660521063,43488,12,20,11
6658,2014/03/31,2010/12/16,19,21,0.674664835,42576,19,11,10
6659,2014/03/31,2012/03/24,34,26,0.623888442,46039,34,11,15
6660,2014/03/31,2010/08/28,3,38,0.808434993,35527,3,17,21
6661,2014/03/31,2004/11/20,18,20,0.7768636040000001,36966,18,10,10
6662,2014/03/31,2005/02/26,6,39,0.726141589,39537,6,16,23
6663,2014/03/31,2010/11/17,106,29,0.736359393,38988,106,21,8
6664,2014/03/31,2005/06/19,94,26,0.660071514,43488,94,20,6
6665,2014/03/31,2012/03/24,3,23,1.44034071,19929,3,11,12
6666,2014/03/31,2005/12/09,13,20,1.011777645,28369,13,14,6
6667,2014/03/31,2006/01/26,27,26,0.65919955,43538,27,17,9
6668,2014/03/31,2013/03/25,7,15,0.698606871,41073,7,0,15
6669,2014/03/31,2006/04/14,5,22,0.60277416,47600,5,9,13
6670,2014/03/31,2013/03/06,13,35,0.608386426,47150,13,3,32
6671,2014/03/31,2006/08/09,15,36,0.55853357,51356,15,24,12
6672,2014/03/31,2011/03/04,10,37,0.631177959,45443,10,16,21
6673,2014/03/31,2010/03/01,6,26,0.707185759,40558,6,13,13
6674,2014/03/31,2005/12/30,3,38,0.724030849,39612,3,19,19
6675,2014/03/31,2008/07/21,38,16,1.30984654,21895,38,9,7
6676,2014/03/31,2011/01/04,80,10,0.697588237,41111,80,2,8
6677,2014/03/31,2007/10/07,5,29,0.925591957,30982,5,20,9
6678,2014/03/31,2009/06/18,2,31,0.896563702,31985,2,13,18
6679,2014/03/31,2009/09/08,18,26,0.7215076109999999,39745,18,3,23
6680,2014/03/31,2012/03/17,5,27,0.729455794,39305,5,13,14
6681,2014/03/31,2010/09/27,10,45,0.746917325,38379,10,19,26
6682,2014/03/31,2012/03/12,20,28,0.732290459,39145,20,13,15
6683,2014/03/31,2012/10/26,73,33,0.71875699,39879,73,13,20
6684,2014/03/31,2012/02/15,17,20,0.873052882,32828,17,11,9
6685,2014/03/31,2012/12/14,3,30,0.7073785659999999,40516,3,6,24
6686,2014/03/31,2012/02/25,41,29,0.6717779859999999,42655,41,12,17
6687,2014/03/31,2007/02/10,26,37,0.7313581259999999,39179,26,28,9
6688,2014/03/31,2012/05/24,69,26,0.790647093,36239,69,16,10
6689,2014/03/31,2009/11/06,29,28,0.888722507,32235,29,15,13
6690,2014/03/31,2011/03/13,1,31,0.836420229,34248,1,15,16
6691,2014/03/31,2007/03/20,112,43,0.681377022,42040,112,27,16
6692,2014/03/31,2012/09/11,26,16,0.7609324690000001,37642,26,0,16
6693,2014/03/31,2005/04/17,4,95,0.733078833,39070,4,47,48
6694,2014/03/31,2012/08/18,32,10,0.781838233,36633,32,4,6
6695,2014/03/31,2008/09/13,11,38,0.673843258,42503,11,19,19
6696,2014/03/31,2009/08/23,290,37,0.910682693,31449,290,27,10
6697,2014/03/31,2012/10/23,30,24,0.560205383,51124,30,6,18
6698,2014/03/31,2012/03/10,4,35,0.6729550959999999,42557,4,9,26
6699,2014/03/31,2008/06/01,22,36,0.623106652,45953,22,9,27
6700,2014/03/31,2012/06/27,81,20,0.907585901,31548,81,14,6
6701,2014/03/31,2010/08/09,105,31,0.767882372,37287,105,23,8
6702,2014/03/31,2013/02/06,42,14,0.7046731479999999,40630,42,0,14
6703,2014/03/31,2012/09/14,17,29,0.704375415,40643,17,9,20
6704,2014/03/31,2007/03/25,7,23,0.708933994,40375,7,14,9
6705,2014/03/31,2011/03/27,8,62,0.660932182,43307,8,33,29
6706,2014/03/31,2008/02/02,26,36,0.657981839,43500,26,11,25
6707,2014/03/31,2006/07/14,10,17,1.404698174,20376,10,3,14
6708,2014/03/31,2005/05/03,17,13,1.359664037,21044,17,0,13
6709,2014/03/31,2010/06/22,61,21,0.703065638,40693,61,10,11
6710,2014/03/31,2011/02/25,13,29,0.7338468640000001,38985,13,20,9
6711,2014/03/31,2009/11/03,2,18,0.616257055,46418,2,7,11
6712,2014/03/31,2006/12/05,5,28,0.81710906,34999,5,7,21
6713,2014/03/31,2011/04/01,170,15,1.207362665,23683,170,8,7
6714,2014/03/31,2012/12/10,49,34,0.611726145,46740,49,12,22
6715,2014/03/31,2007/08/22,34,27,0.760162178,37613,34,15,12
6716,2014/03/31,2007/06/05,29,24,0.75402843,37918,29,12,12
6717,2014/03/31,2008/04/28,21,20,0.75614345,37811,21,6,14
6718,2014/03/31,2011/07/29,119,21,0.585636881,48816,119,10,11
6719,2014/03/31,2006/09/01,24,38,0.597754475,47824,24,24,14
6720,2014/03/31,2006/10/11,18,29,0.616897794,46338,18,18,11
6721,2014/03/31,2009/10/08,25,28,0.84730051,33736,25,11,17
6722,2014/03/31,2010/03/19,370,16,0.735064935,38885,370,16,0
6723,2014/03/31,2007/09/10,352,7,0.732516595,39017,352,6,1
6724,2014/03/31,2012/12/10,6,24,0.639012409,44725,6,7,17
6725,2014/03/31,2009/11/21,28,29,0.7118789390000001,40145,28,18,11
6726,2014/03/31,2012/04/30,27,25,0.6729082390000001,42469,27,10,15
6727,2014/03/31,2006/01/22,86,43,0.5803304020000001,49243,86,29,14
6728,2014/03/31,2010/04/18,27,43,0.65120391,43882,27,18,25
6729,2014/03/31,2010/12/01,37,18,0.917483061,31141,37,4,14
6730,2014/03/31,2009/11/03,50,18,0.668998571,42689,50,7,11
6731,2014/03/31,2011/03/02,1,20,0.648182396,44058,1,11,9
6732,2014/03/31,2012/10/23,2,44,0.831423206,34345,2,9,35
6733,2014/03/31,2010/05/20,8,31,0.6297406320000001,45341,8,8,23
6734,2014/03/31,2005/05/07,74,33,0.651431961,43828,74,21,12
6735,2014/03/31,2009/07/16,74,27,0.7404225240000001,38554,74,17,10
6736,2014/03/31,2013/01/28,8,29,0.712231898,40078,8,2,27
6737,2014/03/31,2010/06/02,34,34,0.724987933,39365,34,14,20
6738,2014/03/31,2011/12/30,42,32,0.650851525,43839,42,16,16
6739,2014/03/31,2007/07/13,9,26,0.615957934,46308,9,14,12
6740,2014/03/31,2011/12/24,11,27,0.762654273,37385,11,11,16
6741,2014/03/31,2009/07/25,44,23,0.7258314229999999,39270,44,16,7
6742,2014/03/31,2008/04/03,7,30,0.856187815,33288,7,18,12
6743,2014/03/31,2013/03/05,65,3,0.776666667,36696,65,0,3
6744,2014/03/31,2011/06/22,6,42,0.8150384709999999,34961,6,21,21
6745,2014/03/31,2012/02/28,295,21,0.654327738,43547,295,16,5
6746,2014/03/31,2007/12/11,45,21,0.6979368890000001,40817,45,7,14
6747,2014/03/31,2012/05/17,1,19,0.726555972,39207,1,14,5
6748,2014/03/31,2008/04/28,10,32,0.809496973,35187,10,8,24
6749,2014/03/31,2010/10/08,32,20,0.772435313,36870,32,7,13
6750,2014/03/31,2012/01/28,31,31,0.630085621,45199,31,13,18
6751,2014/03/31,2006/06/05,78,29,0.710061605,40094,78,16,13
6752,2014/03/31,2007/02/28,1,26,0.8755683040000001,32509,1,7,19
6753,2014/03/31,2006/04/26,30,26,0.749031825,37989,30,11,15
6754,2014/03/31,2012/05/30,34,25,0.5871425029999999,48455,34,16,9
6755,2014/03/31,2006/03/20,3,28,0.732998351,38808,3,15,13
6756,2014/03/31,2006/05/30,226,5,0.730239795,38950,226,1,4
6757,2014/03/31,2007/07/26,21,37,0.57731685,49263,21,24,13
6758,2014/03/31,2007/01/29,1,42,0.639885689,44440,1,23,19
6759,2014/03/31,2009/11/01,30,28,0.617588124,46043,30,11,17
6760,2014/03/31,2009/06/20,132,19,0.736004659,38635,132,8,11
6761,2014/03/31,2012/02/22,151,4,0.759511205,37439,151,1,3
6762,2014/03/31,2007/08/18,377,16,1.043457515,27245,377,16,0
6763,2014/03/31,2005/03/17,3,21,0.700806833,40566,3,7,14
6764,2014/03/31,2007/07/18,12,38,0.716163517,39690,12,12,26
6765,2014/03/31,2010/10/31,210,25,0.759205866,37437,210,16,9
6766,2014/03/31,2005/06/19,35,31,0.652584045,43548,35,18,13
6767,2014/03/31,2011/12/22,168,30,0.651559433,43612,168,21,9
6768,2014/03/31,2011/03/14,1,43,0.872863857,32554,1,18,25
6769,2014/03/31,2010/03/02,1,37,0.7225724090000001,39325,1,13,24
6770,2014/03/31,2009/11/12,16,25,0.8966890740000001,31686,16,14,11
6771,2014/03/31,2006/12/08,2,37,0.831357212,34173,2,13,24
6772,2014/03/31,2010/06/10,25,42,0.64796865,43828,25,18,24
6773,2014/03/31,2012/12/10,89,28,0.617795183,45963,89,11,17
6774,2014/03/31,2008/11/14,33,41,0.761435278,37275,33,19,22
6775,2014/03/31,2009/03/03,3,7,1.205946463,23535,3,0,7
6776,2014/03/31,2007/11/02,6,25,0.682741707,41569,6,10,15
6777,2014/03/31,2012/07/26,93,3,0.773333333,36696,93,1,2
6778,2014/03/31,2007/10/13,33,21,0.7193704679999999,39442,33,10,11
6779,2014/03/31,2006/12/03,116,26,0.853885879,33228,116,16,10
6780,2014/03/31,2011/04/15,80,14,0.680823295,41674,80,6,8
6781,2014/03/31,2008/10/15,16,24,0.652400488,43487,16,13,11
6782,2014/03/31,2012/11/21,9,3,0.936666667,30282,9,0,3
6783,2014/03/31,2006/09/21,10,22,1.0338106,27434,10,0,22
6784,2014/03/31,2009/07/01,9,46,0.6398680170000001,44324,9,20,26
6785,2014/03/31,2007/04/23,15,17,1.319071585,21499,15,6,11
6786,2014/03/31,2012/04/04,26,41,0.8249022570000001,34376,26,16,25
6787,2014/03/31,2012/12/17,83,7,0.649657258,43648,83,3,4
6788,2014/03/31,2006/10/06,27,7,0.7831119329999999,36209,27,0,7
6789,2014/03/31,2009/09/30,40,37,0.721655171,39289,40,23,14
6790,2014/03/31,2011/10/01,16,13,0.680151134,41685,16,4,9
6791,2014/03/31,2011/07/31,21,32,0.697205007,40662,21,9,23
6792,2014/03/31,2007/07/26,242,26,0.676442923,41908,242,20,6
6793,2014/03/31,2007/06/22,12,53,0.7762567779999999,36514,12,23,30
6794,2014/03/31,2010/10/01,4,23,0.727177382,38978,4,12,11
6795,2014/03/31,2008/03/24,5,20,0.816744568,34702,5,0,20
6796,2014/03/31,2011/03/22,105,13,0.853292286,33214,105,9,4
6797,2014/03/31,2007/02/01,40,29,0.6910475490000001,41010,40,15,14
6798,2014/03/31,2012/07/01,22,28,0.687943676,41190,22,17,11
6799,2014/03/31,2012/11/28,21,28,0.647818095,43737,21,5,23
6800,2014/03/31,2007/12/07,8,30,0.709492637,39932,8,11,19
6801,2014/03/31,2011/08/01,178,20,0.91489763,30966,178,12,8
6802,2014/03/31,2011/06/03,202,20,0.669018325,42346,202,14,6
6803,2014/03/31,2005/06/07,4,21,0.749161973,37815,4,2,19
6804,2014/03/31,2011/06/28,91,41,0.714755008,39634,91,21,20
6805,2014/03/31,2011/07/06,6,30,0.7991951140000001,35446,6,9,21
6806,2014/03/31,2006/08/31,4,28,0.761987733,37173,4,11,17
6807,2014/03/31,2007/06/11,23,34,0.7748026259999999,36555,23,14,20
6808,2014/03/31,2009/11/23,34,26,0.652982452,43367,34,19,7
6809,2014/03/31,2010/02/11,21,39,0.7024952240000001,40309,21,17,22
6810,2014/03/31,2010/05/16,127,29,0.661452834,42806,127,15,14
6811,2014/03/31,2010/07/30,11,26,0.699223948,40487,11,16,10
6812,2014/03/31,2011/09/29,10,6,0.709187835,39918,10,3,3
6813,2014/03/31,2011/01/01,116,17,1.063700447,26613,116,3,14
6814,2014/03/31,2008/06/12,8,36,0.723579407,39121,8,15,21
6815,2014/03/31,2009/01/07,384,7,1.369380745,20670,384,7,0
6816,2014/03/31,2012/11/20,80,14,0.7252107729999999,39023,80,5,9
6817,2014/03/31,2008/09/22,13,24,0.985474399,28710,13,21,3
6818,2014/03/31,2007/11/29,70,36,0.5468990779999999,51733,70,19,17
6819,2014/03/31,2007/09/13,9,39,0.7644671129999999,37006,9,19,20
6820,2014/03/31,2010/10/23,3,32,0.716938227,39451,3,10,22
6821,2014/03/31,2011/02/05,14,25,0.830337042,34061,14,11,14
6822,2014/03/31,2006/04/09,93,33,0.604226914,46793,93,13,20
6823,2014/03/31,2009/07/04,1,36,0.548956545,51502,1,12,24
6824,2014/03/31,2010/09/16,76,26,0.632989206,44654,76,9,17
6825,2014/03/31,2006/12/10,106,24,0.708292445,39905,106,15,9
6826,2014/03/31,2007/07/08,26,22,0.736417887,38374,26,6,16
6827,2014/03/31,2012/07/05,62,25,0.8425915979999999,33516,62,12,13
6828,2014/03/31,2009/03/02,2,19,0.6305215679999999,44788,2,2,17
6829,2014/03/31,2005/01/01,429,21,0.72982141,38692,429,21,0
6830,2014/03/31,2010/03/19,3,40,0.7399832270000001,38157,3,24,16
6831,2014/03/31,2011/07/06,389,24,0.814031598,34686,389,24,0
6832,2014/03/31,2007/09/26,1,39,0.806858319,34994,1,16,23
6833,2014/03/31,2005/07/27,99,14,1.184510404,23836,99,5,9
6834,2014/03/31,2007/06/20,99,31,0.777061074,36333,99,13,18
6835,2014/03/31,2010/12/09,100,27,0.879320313,32103,100,14,13
6836,2014/03/31,2005/07/16,70,35,0.4917599,57401,70,20,15
6837,2014/03/31,2011/08/20,19,29,0.611704378,46140,19,12,17
6838,2014/03/31,2007/09/01,6,30,0.721958251,39091,6,18,12
6839,2014/03/31,2010/03/06,4,33,0.606100767,46563,4,20,13
6840,2014/03/31,2007/09/01,74,32,0.769405927,36679,74,13,19
6841,2014/03/31,2012/05/26,17,44,0.929545455,30360,17,23,21
6842,2014/03/31,2009/03/14,72,23,0.793268025,35575,72,6,17
6843,2014/03/31,2007/06/07,4,38,0.8221288309999999,34324,4,18,20
6844,2014/03/31,2005/10/11,117,14,1.338188416,21081,117,12,2
6845,2014/03/31,2011/12/28,21,33,0.581407049,48520,21,10,23
6846,2014/03/31,2010/08/15,4,19,0.838934987,33624,4,7,12
6847,2014/03/31,2012/03/30,118,15,0.551312667,51163,118,11,4
6848,2014/03/31,2012/05/27,15,15,0.822896779,34276,15,8,7
6849,2014/03/31,2006/05/09,10,33,0.916060606,30789,10,10,23
6850,2014/03/31,2011/06/30,10,18,0.71588534,39386,10,9,9
6851,2014/03/31,2010/09/18,105,17,1.194178314,23610,105,10,7
6852,2014/03/31,2012/05/30,106,27,0.622470084,45294,106,21,6
6853,2014/03/31,2007/06/22,9,22,0.721744618,39063,9,9,13
6854,2014/03/31,2008/09/12,20,37,0.714017378,39476,20,20,17
6855,2014/03/31,2005/04/21,15,29,0.8238494590000001,34210,15,15,14
6856,2014/03/31,2010/11/08,6,21,0.58517981,48162,6,5,16
6857,2014/03/31,2009/11/12,55,20,0.5780189920000001,48758,55,10,10
6858,2014/03/31,2012/02/18,26,16,0.912038769,30901,26,10,6
6859,2014/03/31,2009/09/01,15,30,0.7204693609999999,39117,15,23,7
6860,2014/03/31,2005/10/06,34,33,0.901438442,31263,34,24,9
6861,2014/03/31,2012/08/03,105,13,0.6042541920000001,46634,105,4,9
6862,2014/03/31,2011/10/06,5,24,0.694095635,40592,5,10,14
6863,2014/03/31,2011/06/06,122,26,0.6707958279999999,41994,122,14,12
6864,2014/03/31,2009/11/07,125,19,0.828559033,33998,125,9,10
6865,2014/03/31,2011/04/08,17,26,0.7617593770000001,36979,17,15,11
6866,2014/03/31,2006/09/14,3,23,0.5850126689999999,48150,3,9,14
6867,2014/03/31,2011/08/04,127,29,1.039440097,27094,127,16,13
6868,2014/03/31,2007/04/12,29,25,0.8279699540000001,34014,29,12,13
6869,2014/03/31,2012/06/19,25,26,0.55967624,50315,25,14,12
6870,2014/03/31,2006/04/13,106,31,0.7474669429999999,37662,106,23,8
6871,2014/03/31,2011/06/02,15,32,0.8176367390000001,34427,15,9,23
6872,2014/03/31,2005/01/28,231,7,0.7131513340000001,39469,231,4,3
6873,2014/03/31,2011/10/29,1,19,0.8034101159999999,35034,1,3,16
6874,2014/03/31,2012/05/08,32,33,0.876498599,32110,32,17,16
6875,2014/03/31,2011/01/07,8,31,0.706423317,39833,8,12,19
6876,2014/03/31,2007/05/26,237,13,0.7681746209999999,36628,237,6,7
6877,2014/03/31,2005/12/13,168,27,0.7661556690000001,36719,168,19,8
6878,2014/03/31,2005/12/15,41,31,0.664440954,42340,41,22,9
6879,2014/03/31,2011/09/30,56,20,0.835037554,33685,56,7,13
6880,2014/03/31,2011/07/05,98,40,0.661875,42496,98,17,23
6881,2014/03/31,2012/09/29,5,28,0.6812280190000001,41286,5,14,14
6882,2014/03/31,2009/01/03,65,22,0.8476016390000001,33181,65,9,13
6883,2014/03/31,2009/02/12,45,14,0.7371096079999999,38154,45,8,6
6884,2014/03/31,2006/07/05,17,14,1.002173402,28062,17,2,12
6885,2014/03/31,2005/11/05,26,31,0.6914137840000001,40671,26,18,13
6886,2014/03/31,2006/11/23,41,40,0.839602269,33490,41,24,16
6887,2014/03/31,2012/05/19,12,11,1.396582203,20127,12,5,6
6888,2014/03/31,2007/02/10,26,24,0.750511041,37453,26,10,14
6889,2014/03/31,2009/09/27,24,37,0.852255306,32980,24,24,13
6890,2014/03/31,2005/09/09,12,23,0.844804028,33270,12,14,9
6891,2014/03/31,2013/01/07,53,29,0.689128761,40781,53,11,18
6892,2014/03/31,2011/06/09,9,34,0.639667228,43934,9,18,16
6893,2014/03/31,2009/07/16,1,23,0.81877692,34315,1,8,15
6894,2014/03/31,2010/11/13,94,28,0.861580578,32602,94,19,9
6895,2014/03/31,2009/11/11,43,42,0.7719519570000001,36384,43,20,22
6896,2014/03/31,2009/01/17,9,12,0.738729779,38017,9,8,4
6897,2014/03/31,2008/06/20,68,28,0.7305112659999999,38434,68,16,12
6898,2014/03/31,2006/04/16,3,29,0.565151686,49675,3,11,18
6899,2014/03/31,2008/01/17,5,16,0.961576063,29193,5,13,3
6900,2014/03/31,2012/11/24,144,10,0.950375148,29535,144,8,2
6901,2014/03/31,2006/11/14,76,22,0.98897678,28381,76,12,10
6902,2014/03/31,2005/04/02,22,35,0.798404564,35144,22,21,14
6903,2014/03/31,2006/02/19,96,28,0.652016316,43024,96,19,9
6904,2014/03/31,2008/09/13,25,27,0.711266895,39435,25,11,16
6905,2014/03/31,2012/07/18,92,35,0.887836246,31584,92,15,20
6906,2014/03/31,2008/10/17,28,22,0.548024004,51159,28,8,14
6907,2014/03/31,2012/03/16,15,20,0.753430261,37210,15,7,13
6908,2014/03/31,2007/07/18,31,29,0.7424001590000001,37760,31,14,15
6909,2014/03/31,2007/07/11,23,11,1.137077435,24653,23,4,7
6910,2014/03/31,2006/05/15,29,22,0.722161501,38811,29,4,18
6911,2014/03/31,2005/12/11,12,25,0.6960143059999999,40264,12,13,12
6912,2014/03/31,2005/04/14,116,29,0.6915648529999999,40515,116,13,16
6913,2014/03/31,2011/03/09,348,11,1.367517696,20485,348,9,2
6914,2014/03/31,2009/03/28,57,20,0.787288517,35582,57,14,6
6915,2014/03/31,2010/08/29,10,47,0.691143816,40531,10,18,29
6916,2014/03/31,2012/04/13,11,23,0.7852357459999999,35674,11,14,9
6917,2014/03/31,2013/02/09,62,23,0.6448170910000001,43437,62,3,20
6918,2014/03/31,2012/07/15,75,30,0.722721596,38753,75,20,10
6919,2014/03/31,2005/03/30,42,33,0.708646324,39522,42,17,16
6920,2014/03/31,2011/08/15,13,34,0.544061231,51477,13,16,18
6921,2014/03/31,2011/04/29,43,27,0.904448571,30965,43,18,9
6922,2014/03/31,2013/03/20,11,25,0.766100777,36556,11,1,24
6923,2014/03/31,2004/12/04,29,24,0.859417523,32585,29,11,13
6924,2014/03/31,2011/08/21,14,26,1.140240684,24555,14,6,20
6925,2014/03/31,2012/05/16,27,25,0.7672964459999999,36489,27,15,10
6926,2014/03/31,2006/06/04,10,36,0.6790191609999999,41230,10,16,20
6927,2014/03/31,2010/05/19,6,27,0.8103719890000001,34544,6,15,12
6928,2014/03/31,2009/09/02,24,23,0.742590726,37696,24,16,7
6929,2014/03/31,2005/05/16,184,22,0.762468335,36713,184,12,10
6930,2014/03/31,2010/05/20,8,22,0.7146728109999999,39167,8,7,15
6931,2014/03/31,2012/06/06,92,42,0.670232257,41764,92,19,23
6932,2014/03/31,2011/04/30,18,36,0.6963769809999999,40193,18,11,25
6933,2014/03/31,2012/06/26,2,33,0.669105841,41827,2,9,24
6934,2014/03/31,2007/06/17,21,42,0.732214605,38219,21,17,25
6935,2014/03/31,2007/04/20,5,17,0.587757168,47605,5,13,4
6936,2014/03/31,2007/04/05,6,33,0.8207712840000001,34086,6,13,20
6937,2014/03/31,2012/08/03,2,34,0.587978265,47573,2,12,22
6938,2014/03/31,2008/06/25,125,35,0.78425631,35660,125,20,15
6939,2014/03/31,2011/06/16,2,25,0.724688763,38588,2,5,20
6940,2014/03/31,2011/11/01,7,22,0.882729425,31677,7,9,13
6941,2014/03/31,2010/03/01,20,47,0.6091800310000001,45892,20,17,30
6942,2014/03/31,2010/08/20,107,28,0.7028127829999999,39772,107,15,13
6943,2014/03/31,2010/08/27,11,32,0.77960087,35853,11,12,20
6944,2014/03/31,2011/11/24,2,21,0.68805481,40613,2,14,7
6945,2014/03/31,2007/11/21,105,31,0.7964401759999999,35086,105,13,18
6946,2014/03/31,2011/01/31,18,37,0.659804255,42351,18,17,20
6947,2014/03/31,2006/02/09,20,41,0.63073065,44303,20,22,19
6948,2014/03/31,2012/02/20,6,24,0.766813965,36434,6,14,10
6949,2014/03/31,2010/07/14,12,38,0.585832372,47689,12,21,17
6950,2014/03/31,2010/01/30,165,21,0.74049063,37727,165,11,10
6951,2014/03/31,2004/11/25,145,25,0.800595822,34893,145,13,12
6952,2014/03/31,2005/06/13,25,35,0.551954121,50611,25,15,20
6953,2014/03/31,2012/04/26,58,18,0.8119022840000001,34406,58,7,11
6954,2014/03/31,2008/10/18,46,20,0.487039562,57353,46,5,15
6955,2014/03/31,2010/10/26,45,15,0.794906659,35140,45,2,13
6956,2014/03/31,2007/05/31,12,28,0.8701862929999999,32100,12,12,16
6957,2014/03/31,2009/02/06,12,19,1.045892529,26705,12,0,19
6958,2014/03/31,2007/06/19,8,24,0.608658444,45887,8,15,9
6959,2014/03/31,2010/09/15,14,22,0.543338716,51403,14,13,9
6960,2014/03/31,2012/05/08,6,26,0.704704873,39627,6,8,18
6961,2014/03/31,2012/08/11,66,11,0.7704249329999999,36241,66,8,3
6962,2014/03/31,2011/11/25,16,56,0.689036112,40513,16,19,37
6963,2014/03/31,2011/05/16,1,34,0.674879718,41361,1,18,16
6964,2014/03/31,2011/08/12,13,37,0.6204945629999999,44969,13,23,14
6965,2014/03/31,2009/03/06,15,6,0.711586492,39206,15,5,1
6966,2014/03/31,2012/08/09,65,44,0.7569843159999999,36854,65,17,27
6967,2014/03/31,2008/02/13,101,9,0.95301814,29273,101,6,3
6968,2014/03/31,2006/09/12,27,16,0.8631065529999999,32322,27,6,10
6969,2014/03/31,2010/02/24,16,31,0.657748173,42410,16,0,31
6970,2014/03/31,2011/08/09,11,21,0.739968697,37696,11,12,9
6971,2014/03/31,2006/05/20,1,26,0.403263648,69168,1,20,6
6972,2014/03/31,2012/03/09,36,21,0.675238095,41307,36,10,11
6973,2014/03/31,2013/01/18,5,11,0.717272727,38885,5,0,11
6974,2014/03/31,2006/10/26,70,24,0.898458268,31043,70,12,12
6975,2014/03/31,2008/05/16,157,14,0.8211149059999999,33967,157,5,9
6976,2014/03/31,2010/11/09,106,21,0.732611048,38069,106,8,13
6977,2014/03/31,2012/05/09,1,31,0.7375286990000001,37806,1,13,18
6978,2014/03/31,2011/12/20,39,33,1.100604864,25328,39,21,12
6979,2014/03/31,2012/01/13,17,16,1.385658248,20114,17,10,6
6980,2014/03/31,2009/03/01,23,19,0.720737005,38670,23,8,11
6981,2014/03/31,2007/07/13,6,26,0.601500788,46329,6,18,8
6982,2014/03/31,2009/09/17,120,14,0.7441653540000001,37447,120,4,10
6983,2014/03/31,2007/05/06,56,28,0.7408990109999999,37608,56,14,14
6984,2014/03/31,2008/08/25,6,44,0.653009914,42669,6,22,22
6985,2014/03/31,2007/11/06,25,32,0.772247013,36079,25,17,15
6986,2014/03/31,2007/06/30,7,26,0.870642228,31998,7,12,14
6987,2014/03/31,2006/11/16,12,37,0.728383883,38246,12,14,23
6988,2014/03/31,2006/07/25,41,21,0.575752558,48375,41,10,11
6989,2014/03/31,2009/11/15,12,32,0.755088671,36878,12,14,18
6990,2014/03/31,2012/04/01,346,5,0.7126094079999999,39074,346,1,4
6991,2014/03/31,2010/07/02,113,25,0.796713309,34947,113,20,5
6992,2014/03/31,2012/09/10,26,13,1.145975469,24296,26,3,10
6993,2014/03/31,2008/04/16,206,22,0.815967175,34120,206,17,5
6994,2014/03/31,2012/09/23,233,6,0.73514088,37869,233,5,1
6995,2014/03/31,2006/03/07,2,26,0.704801114,39495,2,11,15
6996,2014/03/31,2012/03/08,423,36,0.73877077,37674,423,36,0
6997,2014/03/31,2011/11/04,4,25,0.843893387,32979,4,8,17
6998,2014/03/31,2012/04/14,674,5,0.924704084,30093,674,5,0
6999,2014/03/31,2012/03/02,1,29,0.7079127759999999,39301,1,16,13
7000,2014/03/31,2006/06/18,9,17,0.7984141790000001,34840,9,3,14
7001,2014/03/31,2009/07/16,121,23,0.806693544,34478,121,16,7
7002,2014/03/31,2006/07/10,25,42,0.8408937259999999,33075,25,27,15
7003,2014/03/31,2009/03/13,77,29,0.6939222340000001,40069,77,15,14
7004,2014/03/31,2007/05/30,19,24,0.615674676,45155,19,11,13
7005,2014/03/31,2012/06/06,142,24,0.757083333,36720,142,15,9
7006,2014/03/31,2013/02/15,32,21,0.8083361929999999,34391,32,3,18
7007,2014/03/31,2009/08/27,195,17,0.996749857,27888,195,15,2
7008,2014/03/31,2008/06/27,16,28,0.666531258,41701,16,12,16
7009,2014/03/31,2012/03/16,29,14,0.845190659,32886,29,8,6
7010,2014/03/31,2011/11/04,85,10,1.405027806,19780,85,3,7
7011,2014/03/31,2006/01/21,1,41,0.938687046,29605,1,15,26
7012,2014/03/31,2010/11/18,97,10,1.084703908,25617,97,2,8
7013,2014/03/31,2010/05/09,26,27,0.908922438,30569,26,19,8
7014,2014/03/31,2012/06/26,14,43,0.7916031579999999,35087,14,12,31
7015,2014/03/31,2010/09/10,9,28,0.6007687310000001,46219,9,17,11
7016,2014/03/31,2008/09/21,11,31,0.794690711,34935,11,15,16
7017,2014/03/31,2005/06/11,24,25,0.7055247170000001,39345,24,13,12
7018,2014/03/31,2006/03/03,7,20,0.730994415,37962,7,6,14
7019,2014/03/31,2008/03/12,29,42,0.689107347,40262,29,20,22
7020,2014/03/31,2005/12/11,23,24,0.760387535,36487,23,11,13
7021,2014/03/31,2004/12/15,57,21,0.7349170770000001,37746,57,6,15
7022,2014/03/31,2006/11/27,74,45,0.659406199,42068,74,28,17
7023,2014/03/31,2005/05/31,1,26,0.741532312,37401,1,10,16
7024,2014/03/31,2011/04/18,20,26,0.752494845,36856,20,15,11
7025,2014/03/31,2011/10/13,107,28,0.736494755,37655,107,13,15
7026,2014/03/31,2008/05/03,19,33,0.79091521,35063,19,15,18
7027,2014/03/31,2012/11/30,215,23,0.986951384,28098,215,15,8
7028,2014/03/31,2012/12/11,3,28,0.8036216890000001,34506,3,6,22
7029,2014/03/31,2005/09/15,60,31,0.836839897,33135,60,18,13
7030,2014/03/31,2012/04/10,1,22,0.6767835090000001,40967,1,10,12
7031,2014/03/31,2012/04/29,36,31,0.664568182,41719,36,14,17
7032,2014/03/31,2011/08/08,11,24,0.760056748,36477,11,12,12
7033,2014/03/31,2012/07/19,5,10,0.516828477,53643,5,4,6
7034,2014/03/31,2011/11/02,49,21,0.8081588690000001,34305,49,5,16
7035,2014/03/31,2011/06/20,135,8,1.016684516,27266,135,5,3
7036,2014/03/31,2008/12/27,3,32,0.636575648,43544,3,14,18
7037,2014/03/31,2009/09/26,23,23,0.69395608,39936,23,14,9
7038,2014/03/31,2011/06/02,23,12,0.715,38760,23,5,7
7039,2014/03/31,2009/10/07,39,17,0.970155801,28562,39,5,12
7040,2014/03/31,2010/01/09,3,35,0.7457172470000001,37149,3,17,18
7041,2014/03/31,2006/06/17,35,28,0.732561879,37816,35,15,13
7042,2014/03/31,2008/10/12,14,26,0.639036523,43343,14,19,7
7043,2014/03/31,2011/12/20,14,17,0.684663568,40454,14,9,8
7044,2014/03/31,2010/03/04,94,24,0.68448015,40454,94,14,10
7045,2014/03/31,2006/11/21,110,22,0.70785517,39108,110,11,11
7046,2014/03/31,2008/03/13,15,14,0.7227473759999999,38302,15,3,11
7047,2014/03/31,2006/03/04,76,6,1.025044805,27006,76,4,2
7048,2014/03/31,2012/10/30,36,24,0.652880728,42399,36,10,14
7049,2014/03/31,2011/10/18,118,21,0.594106284,46592,118,16,5
7050,2014/03/31,2005/12/18,5,50,0.561779487,49267,5,13,37
7051,2014/03/31,2011/09/15,105,25,0.695658404,39778,105,15,10
7052,2014/03/31,2011/01/01,9,41,0.81603704,33909,9,29,12
7053,2014/03/31,2005/03/30,95,14,1.292245937,21412,95,9,5
7054,2014/03/31,2012/04/12,20,23,0.6796052659999999,40711,20,7,16
7055,2014/03/31,2007/06/14,44,23,0.801852593,34503,44,17,6
7056,2014/03/31,2012/05/22,24,39,0.805691026,34333,24,19,20
7057,2014/03/31,2010/02/02,14,29,0.764938053,36160,14,19,10
7058,2014/03/31,2012/03/16,120,23,0.666615092,41493,120,12,11
7059,2014/03/31,2012/05/07,49,16,0.7927778259999999,34887,49,6,10
7060,2014/03/31,2009/01/28,8,22,0.6798136579999999,40678,8,8,14
7061,2014/03/31,2008/08/29,36,23,0.611207701,45243,36,9,14
7062,2014/03/31,2011/12/03,3,19,0.691998799,39959,3,8,11
7063,2014/03/31,2012/09/27,77,18,0.884046295,31278,77,10,8
7064,2014/03/31,2007/03/07,150,14,0.7934713609999999,34848,150,9,5
7065,2014/03/31,2012/11/20,5,31,0.611050829,45250,5,12,19
7066,2014/03/31,2011/01/01,4,26,0.718341432,38485,4,10,16
7067,2014/03/31,2008/03/03,172,4,0.565,48928,172,2,2
7068,2014/03/31,2013/02/10,133,4,0.565,48928,133,2,2
7069,2014/03/31,2013/03/08,130,20,0.7321948509999999,37752,130,1,19
7070,2014/03/31,2008/01/08,183,16,0.61488877,44952,183,5,11
7071,2014/03/31,2012/01/06,2,33,0.7954093640000001,34749,2,12,21
7072,2014/03/31,2011/03/10,345,19,0.5723687479999999,48266,345,17,2
7073,2014/03/31,2007/10/20,10,32,0.818407455,33751,10,15,17
7074,2014/03/31,2011/12/04,128,21,0.787349126,35079,128,16,5
7075,2014/03/31,2009/12/14,20,22,0.644706555,42836,20,9,13
7076,2014/03/31,2005/03/02,44,16,1.339801067,20610,44,9,7
7077,2014/03/31,2011/12/31,10,27,0.721952349,38236,10,9,18
7078,2014/03/31,2007/04/24,4,27,0.595569915,46349,4,5,22
7079,2014/03/31,2007/06/03,30,37,0.7213891790000001,38260,30,21,16
7080,2014/03/31,2010/06/01,70,29,0.7235569540000001,38145,70,9,20
7081,2014/03/31,2007/10/19,124,20,0.6402067379999999,43098,124,14,6
7082,2014/03/31,2007/03/26,4,39,0.645703487,42730,4,14,25
7083,2014/03/31,2008/11/28,27,17,0.822493367,33545,27,7,10
7084,2014/03/31,2011/12/17,9,21,1.227307709,22479,9,11,10
7085,2014/03/31,2012/08/24,27,23,0.768061642,35917,27,11,12
7086,2014/03/31,2009/10/08,12,29,0.930190524,29655,12,11,18
7087,2014/03/31,2006/10/19,35,23,0.919517301,29998,35,9,14
7088,2014/03/31,2011/11/06,53,41,0.633314736,43554,53,22,19
7089,2014/03/31,2008/08/20,51,24,0.799868345,34484,51,14,10
7090,2014/03/31,2012/12/09,4,13,0.693815693,39749,4,3,10
7091,2014/03/31,2010/04/23,33,35,0.705818852,39073,33,19,16
7092,2014/03/31,2007/10/19,18,18,0.79786171,34565,18,0,18
7093,2014/03/31,2008/08/09,15,30,0.672870355,40981,15,13,17
7094,2014/03/31,2012/03/28,6,23,0.849218355,32470,6,11,12
7095,2014/03/31,2007/09/28,9,11,1.342250621,20541,9,5,6
7096,2014/03/31,2006/09/22,12,33,0.747051028,36901,12,20,13
7097,2014/03/31,2009/01/19,2,33,0.575823324,47873,2,27,6
7098,2014/03/31,2006/02/13,98,20,0.574945873,47943,98,13,7
7099,2014/03/31,2012/03/03,60,15,1.3788906680000002,19985,60,4,11
7100,2014/03/31,2012/04/16,42,20,0.78819365,34960,42,8,12
7101,2014/03/31,2010/05/21,132,32,0.630155064,43724,132,19,13
7102,2014/03/31,2012/05/30,75,28,0.65664347,41960,75,18,10
7103,2014/03/31,2012/08/02,2,18,1.4525543019999998,18968,2,9,9
7104,2014/03/31,2012/08/25,181,28,0.470906916,58506,181,20,8
7105,2014/03/31,2006/03/09,75,38,0.656982162,41934,75,28,10
7106,2014/03/31,2005/03/23,44,24,0.6782267359999999,40620,44,13,11
7107,2014/03/31,2007/09/15,9,27,0.629864154,43726,9,7,20
7108,2014/03/31,2006/03/31,39,13,1.306827521,21075,39,3,10
7109,2014/03/31,2012/09/22,70,21,0.641638164,42920,70,9,12
7110,2014/03/31,2009/12/31,9,39,0.8157734459999999,33758,9,15,24
7111,2014/03/31,2006/12/01,69,28,0.7884741590000001,34925,69,18,10
7112,2014/03/31,2011/05/16,67,3,1.0418137790000002,26431,67,0,3
7113,2014/03/31,2008/10/15,33,15,0.6167336379999999,44646,33,3,12
7114,2014/03/31,2010/11/25,7,34,0.662239915,41573,7,17,17
7115,2014/03/31,2005/09/15,85,14,1.158095759,23768,85,6,8
7116,2014/03/31,2007/11/13,24,15,0.734710106,37462,24,9,6
7117,2014/03/31,2006/03/09,83,23,0.773298775,35592,83,7,16
7118,2014/03/31,2005/04/10,471,3,0.75,36696,471,3,0
7119,2014/03/31,2008/01/19,380,3,0.75,36696,380,3,0
7120,2014/03/31,2008/06/02,52,10,1.434693739,19183,52,7,3
7121,2014/03/31,2007/02/01,70,28,0.708625431,38834,70,12,16
7122,2014/03/31,2011/05/04,23,29,0.7490733890000001,36736,23,18,11
7123,2014/03/31,2012/05/18,22,18,0.571133227,48181,22,6,12
7124,2014/03/31,2012/08/18,5,40,0.942623069,29191,5,21,19
7125,2014/03/31,2008/04/24,48,19,0.7697675,35742,48,6,13
7126,2014/03/31,2009/01/23,108,29,0.7162747340000001,38408,108,17,12
7127,2014/03/31,2011/05/26,53,21,0.870277787,31607,53,7,14
7128,2014/03/31,2006/07/05,14,22,0.922569177,29815,14,9,13
7129,2014/03/31,2007/12/18,305,29,0.974681077,28220,305,25,4
7130,2014/03/31,2007/11/05,14,26,0.898640091,30605,14,21,5
7131,2014/03/31,2006/03/01,86,32,0.6738287390000001,40815,86,20,12
7132,2014/03/31,2009/09/28,6,30,0.7838125640000001,35084,6,10,20
7133,2014/03/31,2009/09/19,428,23,0.690461245,39827,428,23,0
7134,2014/03/31,2009/09/03,26,19,0.713258975,38552,26,8,11
7135,2014/03/31,2011/10/15,47,5,0.7239608240000001,37982,47,3,2
7136,2014/03/31,2010/01/22,58,19,0.8562565409999999,32104,58,13,6
7137,2014/03/31,2005/02/25,31,28,0.825137934,33313,31,18,10
7138,2014/03/31,2011/01/10,306,8,1.3,21144,306,6,2
7139,2014/03/31,2007/07/01,17,30,0.668607915,41111,17,17,13
7140,2014/03/31,2007/02/19,8,20,0.734562609,37415,8,8,12
7141,2014/03/31,2005/12/16,132,18,1.05726255,25995,132,10,8
7142,2014/03/31,2009/05/07,7,39,0.53710141,51149,7,18,21
7143,2014/03/31,2010/01/30,28,23,0.758355234,36224,28,8,15
7144,2014/03/31,2009/06/15,212,29,0.703680098,39037,212,21,8
7145,2014/03/31,2006/02/01,113,14,1.389854273,19763,113,6,8
7146,2014/03/31,2008/03/22,156,32,0.864780555,31762,156,24,8
7147,2014/03/31,2008/12/06,17,11,0.706363636,38885,17,2,9
7148,2014/03/31,2011/09/15,17,23,0.742486887,36986,17,14,9
7149,2014/03/31,2011/02/20,6,31,0.807969279,33983,6,17,14
7150,2014/03/31,2013/01/20,60,4,0.659490727,41628,60,2,2
7151,2014/03/31,2011/03/07,61,31,0.75923062,36146,61,15,16
7152,2014/03/31,2011/04/12,48,33,0.791218535,34681,48,24,9
7153,2014/03/31,2011/08/16,11,36,0.720561727,38079,11,14,22
7154,2014/03/31,2012/01/01,28,8,1.000351478,27427,28,5,3
7155,2014/03/31,2006/12/26,58,23,0.818756155,33509,58,13,10
7156,2014/03/31,2012/06/09,22,28,0.631326721,43453,22,14,14
7157,2014/03/31,2013/02/03,65,19,0.7653971709999999,35841,65,6,13
7158,2014/03/31,2006/09/25,106,23,0.7515532779999999,36497,106,12,11
7159,2014/03/31,2010/03/08,3,32,0.656835022,41757,3,22,10
7160,2014/03/31,2009/03/17,9,26,0.93249235,29410,9,15,11
7161,2014/03/31,2008/12/01,34,20,0.8439657770000001,32493,34,13,7
7162,2014/03/31,2010/12/03,8,17,0.685413479,40002,8,5,12
7163,2014/03/31,2012/07/02,4,29,0.537583874,50999,4,13,16
7164,2014/03/31,2005/05/08,28,35,0.637936925,42965,28,14,21
7165,2014/03/31,2013/01/27,14,27,0.694582246,39461,14,7,20
7166,2014/03/31,2010/10/01,32,20,0.878286868,31206,32,9,11
7167,2014/03/31,2008/05/05,92,13,0.7057127409999999,38836,92,8,5
7168,2014/03/31,2010/07/19,126,32,0.6317687470000001,43381,126,19,13
7169,2014/03/31,2007/08/20,79,26,0.657776578,41661,79,16,10
7170,2014/03/31,2011/03/22,205,15,0.701586684,39050,205,11,4
7171,2014/03/31,2011/02/23,316,23,0.98514855,27802,316,21,2
7172,2014/03/31,2009/11/29,29,27,0.861713135,31778,29,8,19
7173,2014/03/31,2010/12/17,106,26,0.6729834090000001,40685,106,10,16
7174,2014/03/31,2010/12/20,6,38,0.756731157,36181,6,14,24
7175,2014/03/31,2010/05/16,25,30,0.736355419,37173,25,15,15
7176,2014/03/31,2009/09/28,2,28,0.757835308,36116,2,15,13
7177,2014/03/31,2012/03/21,127,19,0.914639909,29923,127,12,7
7178,2014/03/31,2005/04/08,12,57,0.617461356,44315,12,24,33
7179,2014/03/31,2012/04/25,8,44,0.708181136,38634,8,5,39
7180,2014/03/31,2011/12/16,73,9,1.233684899,22177,73,5,4
7181,2014/03/31,2008/07/28,98,18,0.866229737,31584,98,9,9
7182,2014/03/31,2011/11/05,17,18,0.903737654,30273,17,7,11
7183,2014/03/31,2005/05/10,16,20,0.887438775,30829,16,9,11
7184,2014/03/31,2011/08/02,242,15,0.888990706,30774,242,8,7
7185,2014/03/31,2012/09/07,21,34,0.8073958090000001,33880,21,11,23
7186,2014/03/31,2011/09/18,68,14,0.940062891,29098,68,7,7
7187,2014/03/31,2009/10/20,16,24,0.94291398,29005,16,11,13
7188,2014/03/31,2005/07/06,124,22,1.025238809,26674,124,14,8
7189,2014/03/31,2010/08/07,59,17,0.840229221,32545,59,10,7
7190,2014/03/31,2005/03/18,33,34,0.7844851820000001,34857,33,21,13
7191,2014/03/31,2012/01/06,79,21,0.693581703,39417,79,6,15
7192,2014/03/31,2011/12/07,5,20,0.7280428240000001,37549,5,13,7
7193,2014/03/31,2010/06/02,5,26,0.675739605,40454,5,9,17
7194,2014/03/31,2012/05/20,117,13,0.986814916,27701,117,7,6
7195,2014/03/31,2005/09/09,68,22,0.8897913140000001,30716,68,16,6
7196,2014/03/31,2005/07/16,222,24,0.7579039329999999,36058,222,14,10
7197,2014/03/31,2012/04/16,32,33,0.786009434,34767,32,7,26
7198,2014/03/31,2006/04/23,11,20,0.794837837,34379,11,11,9
7199,2014/03/31,2012/03/21,24,19,0.807894737,33820,24,12,7
7200,2014/03/31,2011/11/12,21,29,0.643440959,42462,21,5,24
7201,2014/03/31,2011/11/08,6,31,0.7052326990000001,38741,6,17,14
7202,2014/03/31,2006/05/09,13,43,0.7371294420000001,37059,13,19,24
7203,2014/03/31,2010/08/28,15,25,0.5922976839999999,46116,15,9,16
7204,2014/03/31,2010/05/01,44,22,0.669330752,40807,44,10,12
7205,2014/03/31,2013/01/02,89,23,0.823020312,33182,89,3,20
7206,2014/03/31,2011/11/24,60,29,0.652378586,41861,60,16,13
7207,2014/03/31,2005/05/07,5,31,0.554440925,49251,5,13,18
7208,2014/03/31,2010/06/10,32,18,0.916739298,29785,32,4,14
7209,2014/03/31,2011/05/14,41,28,0.745808954,36609,41,10,18
7210,2014/03/31,2008/11/08,1,38,0.655685159,41640,1,14,24
7211,2014/03/31,2006/02/24,18,29,0.7217563709999999,37828,18,5,24
7212,2014/03/31,2009/08/11,32,39,0.6899481829999999,39562,32,14,25
7213,2014/03/31,2007/09/14,94,25,0.654530347,41701,94,15,10
7214,2014/03/31,2013/01/30,51,22,0.528312815,51660,51,2,20
7215,2014/03/31,2008/08/01,96,39,0.723688049,37711,96,18,21
7216,2014/03/31,2011/01/28,74,27,0.813775385,33533,74,18,9
7217,2014/03/31,2008/03/20,58,12,0.8141666670000001,33516,58,9,3
7218,2014/03/31,2005/01/05,2,29,0.75192863,36290,2,17,12
7219,2014/03/31,2012/01/06,188,23,0.7147130620000001,38179,188,14,9
7220,2014/03/31,2009/09/30,34,23,0.858891407,31770,34,0,23
7221,2014/03/31,2011/12/05,202,20,0.958158449,28476,202,16,4
7222,2014/03/31,2011/07/11,34,9,1.144568756,23838,34,4,5
7223,2014/03/31,2008/08/30,27,24,0.7231284290000001,37725,27,12,12
7224,2014/03/31,2012/02/21,310,17,0.673146777,40524,310,14,3
7225,2014/03/31,2011/03/30,130,4,0.5575,48928,130,3,1
7226,2014/03/31,2009/03/01,240,14,0.7413906709999999,36788,240,12,2
7227,2014/03/31,2012/01/01,116,24,0.754340995,36153,116,11,13
7228,2014/03/31,2012/09/16,1,22,0.748210954,36444,1,5,17
7229,2014/03/31,2008/09/26,46,35,0.878659083,31031,46,18,17
7230,2014/03/31,2006/08/01,1,45,0.715162517,38119,1,21,24
7231,2014/03/31,2011/07/13,419,6,0.625290204,43590,419,6,0
7232,2014/03/31,2008/03/16,64,21,0.662690624,41128,64,4,17
7233,2014/03/31,2011/01/31,8,29,0.833300615,32703,8,10,19
7234,2014/03/31,2007/07/05,119,18,0.83333262,32698,119,11,7
7235,2014/03/31,2012/03/10,100,35,0.7196548079999999,37863,100,19,16
7236,2014/03/31,2012/09/05,200,23,0.844531817,32263,200,12,11
7237,2014/03/31,2009/04/27,1,86,0.5020930229999999,54266,1,43,43
7238,2014/03/31,2007/10/19,75,17,0.8734662990000001,31186,75,11,6
7239,2014/03/31,2007/04/22,96,30,0.631064081,43164,96,11,19
7240,2014/03/31,2011/08/07,84,20,0.698152762,39015,84,9,11
7241,2014/03/31,2011/06/25,18,38,0.6916021729999999,39384,18,26,12
7242,2014/03/31,2010/01/31,11,32,0.770582228,35347,11,11,21
7243,2014/03/31,2012/03/13,32,16,0.925523463,29429,32,7,9
7244,2014/03/31,2011/10/28,3,31,0.908072615,29994,3,20,11
7245,2014/03/31,2006/05/09,89,32,0.742835556,36663,89,18,14
7246,2014/03/31,2008/09/26,13,9,0.6257439920000001,43522,13,2,7
7247,2014/03/31,2007/01/20,114,20,0.69522747,39170,114,13,7
7248,2014/03/31,2007/02/22,27,13,0.70578871,38582,27,3,10
7249,2014/03/31,2011/04/19,1,30,0.618789228,44005,1,10,20
7250,2014/03/31,2006/09/25,151,14,0.735241169,37028,151,7,7
7251,2014/03/31,2012/04/12,22,38,0.7967988640000001,34166,22,28,10
7252,2014/03/31,2013/02/03,19,28,0.73319514,37122,19,4,24
7253,2014/03/31,2007/06/07,25,17,0.845042547,32200,25,6,11
7254,2014/03/31,2011/12/30,62,30,0.791024217,34397,62,8,22
7255,2014/03/31,2010/08/22,32,30,0.974352886,27924,32,10,20
7256,2014/03/31,2007/01/04,12,31,0.747055496,36417,12,3,28
7257,2014/03/31,2005/10/28,20,26,0.7514805809999999,36202,20,11,15
7258,2014/03/31,2007/10/31,68,21,0.697620977,38995,68,12,9
7259,2014/03/31,2012/01/27,13,27,0.770679436,35294,13,10,17
7260,2014/03/31,2011/12/19,2,23,0.743906515,36562,2,8,15
7261,2014/03/31,2008/07/08,116,29,0.7790214,34907,116,19,10
7262,2014/03/31,2012/10/20,66,22,0.8473312559999999,32090,66,5,17
7263,2014/03/31,2006/12/10,82,31,0.755369737,35985,82,21,10
7264,2014/03/31,2007/02/18,10,22,0.748443196,36318,10,11,11
7265,2014/03/31,2009/11/05,5,19,0.703654628,38625,5,8,11
7266,2014/03/31,2011/12/04,103,16,0.659277363,41224,103,10,6
7267,2014/03/31,2007/04/13,83,24,0.681648021,39866,83,17,7
7268,2014/03/31,2007/05/29,30,24,0.7351987879999999,36949,30,12,12
7269,2014/03/31,2011/06/07,166,29,0.747840308,36320,166,18,11
7270,2014/03/31,2012/11/27,25,21,0.668091419,40648,25,2,19
7271,2014/03/31,2012/05/09,79,3,0.74,36696,79,0,3
7272,2014/03/31,2012/09/05,125,3,0.74,36696,125,1,2
7273,2014/03/31,2010/04/29,32,35,0.872272596,31123,32,19,16
7274,2014/03/31,2008/09/13,2,37,0.7585484370000001,35789,2,13,24
7275,2014/03/31,2005/05/25,7,37,0.92112559,29469,7,13,24
7276,2014/03/31,2010/08/07,44,18,0.6841759740000001,39665,44,11,7
7277,2014/03/31,2013/03/28,16,24,0.7947061059999999,34145,16,0,24
7278,2014/03/31,2010/02/13,14,36,0.6292713529999999,43121,14,20,16
7279,2014/03/31,2012/04/03,35,16,0.5794563079999999,46828,35,4,12
7280,2014/03/31,2011/09/14,47,24,0.847215075,32026,47,15,9
7281,2014/03/31,2011/05/31,16,28,0.74065935,36627,16,9,19
7282,2014/03/31,2009/11/20,36,25,0.797919045,33994,36,9,16
7283,2014/03/31,2008/12/04,30,24,0.7307589720000001,37116,30,6,18
7284,2014/03/31,2012/11/12,4,35,0.57144326,47462,4,15,20
7285,2014/03/31,2012/03/01,14,18,0.765807991,35415,14,9,9
7286,2014/03/31,2005/01/25,27,25,0.56470151,48025,27,15,10
7287,2014/03/31,2005/03/24,3,21,0.599285351,45253,3,8,13
7288,2014/03/31,2013/01/24,40,19,0.709397562,38228,40,3,16
7289,2014/03/31,2011/02/22,44,29,0.697679522,38867,44,11,18
7290,2014/03/31,2010/09/11,124,18,0.7083078209999999,38282,124,17,1
7291,2014/03/31,2011/12/14,72,21,0.526451607,51505,72,12,9
7292,2014/03/31,2006/04/09,56,20,0.600128151,45181,56,14,6
7293,2014/03/31,2009/01/11,121,30,0.808308238,33539,121,24,6
7294,2014/03/31,2011/05/14,16,21,0.6813401029999999,39788,16,10,11
7295,2014/03/31,2011/09/08,32,22,0.509034814,53254,32,14,8
7296,2014/03/31,2005/12/07,123,16,0.794277008,34129,123,6,10
7297,2014/03/31,2011/11/13,44,5,0.7207105629999999,37604,44,1,4
7298,2014/03/31,2005/12/20,64,25,0.759800936,35667,64,17,8
7299,2014/03/31,2012/09/24,11,16,0.648547661,41774,11,3,13
7300,2014/03/31,2006/07/14,12,29,0.686646981,39454,12,15,14
7301,2014/03/31,2005/10/25,80,26,0.857310041,31599,80,8,18
7302,2014/03/31,2009/10/21,392,13,0.80700283,33565,392,13,0
7303,2014/03/31,2006/01/26,72,60,0.67468578,40147,72,36,24
7304,2014/03/31,2007/07/25,32,28,0.9001193129999999,30089,32,13,15
7305,2014/03/31,2010/03/30,117,21,0.944599609,28672,117,15,6
7306,2014/03/31,2007/11/16,5,27,0.875470326,30936,5,9,18
7307,2014/03/31,2010/03/23,8,20,0.7860388909999999,34455,8,10,10
7308,2014/03/31,2010/03/29,82,18,0.8634672659999999,31359,82,12,6
7309,2014/03/31,2005/07/09,30,24,0.731629327,37003,30,9,15
7310,2014/03/31,2007/09/17,36,26,0.660206311,41006,36,12,14
7311,2014/03/31,2012/04/18,52,48,0.58923231,45943,52,20,28
7312,2014/03/31,2005/07/07,74,53,0.753000278,35950,74,28,25
7313,2014/03/31,2005/04/03,29,38,0.739987152,36581,29,20,18
7314,2014/03/31,2006/05/29,24,4,1.05,25778,24,1,3
7315,2014/03/31,2012/10/27,2,33,0.885399261,30569,2,6,27
7316,2014/03/31,2011/09/05,1,29,0.724001819,37383,1,14,15
7317,2014/03/31,2007/09/24,89,18,0.723888889,37386,89,9,9
7318,2014/03/31,2006/06/18,14,30,0.695465971,38908,14,6,24
7319,2014/03/31,2012/06/26,1,40,0.7257301890000001,37278,1,16,24
7320,2014/03/31,2008/06/05,210,29,0.637468071,42438,210,21,8
7321,2014/03/31,2012/11/08,68,25,0.760461024,35573,68,10,15
7322,2014/03/31,2008/04/01,4,32,0.7388891009999999,36610,4,18,14
7323,2014/03/31,2008/10/12,74,10,1.400326154,19316,74,2,8
7324,2014/03/31,2012/09/11,70,14,0.7466468829999999,36226,70,9,5
7325,2014/03/31,2010/11/25,25,27,0.767228116,35254,25,11,16
7326,2014/03/31,2005/01/05,18,30,0.77550942,34873,18,15,15
7327,2014/03/31,2005/05/03,371,11,1.3230772990000002,20440,371,11,0
7328,2014/03/31,2007/07/23,11,27,0.666185948,40592,11,15,12
7329,2014/03/31,2009/09/28,102,30,0.85138525,31756,102,14,16
7330,2014/03/31,2012/05/16,44,17,0.621114481,43527,44,6,11
7331,2014/03/31,2011/07/07,179,10,0.8370000000000001,32300,179,6,4
7332,2014/03/31,2005/11/01,72,25,0.647145285,41773,72,13,12
7333,2014/03/31,2008/02/23,251,10,0.64434907,41940,251,3,7
7334,2014/03/31,2010/05/18,7,18,0.946144258,28560,7,7,11
7335,2014/03/31,2011/04/19,18,20,0.833768554,32405,18,9,11
7336,2014/03/31,2010/08/07,9,19,0.75113153,35969,9,4,15
7337,2014/03/31,2008/06/22,5,21,0.69727146,38746,5,7,14
7338,2014/03/31,2008/04/23,5,38,0.788754525,34252,5,23,15
7339,2014/03/31,2012/06/07,28,17,1.247147078,21662,28,7,10
7340,2014/03/31,2010/12/12,191,22,0.894759034,30191,191,15,7
7341,2014/03/31,2007/06/08,76,17,0.838901693,32195,76,11,6
7342,2014/03/31,2010/03/29,74,15,1.4844977730000002,18189,74,9,6
7343,2014/03/31,2012/05/30,72,25,0.6653675370000001,40581,72,17,8
7344,2014/03/31,2011/11/07,19,36,0.616928051,43767,19,16,20
7345,2014/03/31,2011/01/15,31,17,0.697573503,38706,31,6,11
7346,2014/03/31,2011/08/25,33,50,0.763321647,35368,33,19,31
7347,2014/03/31,2007/06/20,37,24,0.724932592,37236,37,12,12
7348,2014/03/31,2011/08/28,15,29,0.811233132,33273,15,5,24
7349,2014/03/31,2008/02/27,30,20,0.697373208,38705,30,8,12
7350,2014/03/31,2006/10/03,127,22,0.674328545,40025,127,14,8
7351,2014/03/31,2007/02/21,5,21,0.701549819,38469,5,3,18
7352,2014/03/31,2005/03/14,58,21,0.77739277,34715,58,14,7
7353,2014/03/31,2011/07/08,111,8,0.7970063209999999,33858,111,4,4
7354,2014/03/31,2009/11/27,25,20,0.6790382490000001,39740,25,8,12
7355,2014/03/31,2013/03/28,20,29,0.6405184079999999,42129,20,0,29
7356,2014/03/31,2013/01/14,13,21,0.643768431,41914,13,2,19
7357,2014/03/31,2011/01/29,467,24,0.670661712,40229,467,24,0
7358,2014/03/31,2009/07/13,29,26,0.76598319,35217,29,15,11
7359,2014/03/31,2006/08/08,4,18,1.076776704,25052,4,6,12
7360,2014/03/31,2008/04/24,66,22,0.6810682459999999,39607,66,7,15
7361,2014/03/31,2011/12/31,177,18,0.8678831370000001,31079,177,12,6
7362,2014/03/31,2008/02/06,263,11,1.306640826,20639,263,7,4
7363,2014/03/31,2008/03/02,129,24,0.7089277079999999,38040,129,11,13
7364,2014/03/31,2012/09/12,209,24,0.8465863000000001,31854,209,14,10
7365,2014/03/31,2007/04/21,19,26,0.8975660740000001,30042,19,7,19
7366,2014/03/31,2012/05/24,14,20,0.6845483170000001,39386,14,9,11
7367,2014/03/31,2009/11/11,198,31,0.682568933,39495,198,16,15
7368,2014/03/31,2011/01/01,10,27,0.6760805559999999,39873,10,15,12
7369,2014/03/31,2009/10/18,24,27,0.925428797,29128,24,4,23
7370,2014/03/31,2005/04/27,50,31,0.589918806,45693,50,18,13
7371,2014/03/31,2008/10/15,28,41,0.947856515,28435,28,20,21
7372,2014/03/31,2008/03/05,8,27,0.6909593890000001,39004,8,14,13
7373,2014/03/31,2011/11/28,7,26,0.644214854,41833,7,11,15
7374,2014/03/31,2012/03/02,4,23,0.8206828079999999,32835,4,10,13
7375,2014/03/31,2010/02/11,12,30,0.719410257,37457,12,10,20
7376,2014/03/31,2011/02/26,49,15,0.7210511390000001,37369,49,9,6
7377,2014/03/31,2009/07/23,33,30,0.667408536,40371,33,15,15
7378,2014/03/31,2011/02/19,13,22,0.859334886,31348,13,0,22
7379,2014/03/31,2008/02/04,73,25,0.7068756559999999,38104,73,16,9
7380,2014/03/31,2009/12/08,12,22,0.6990275359999999,38531,12,13,9
7381,2014/03/31,2010/08/01,62,14,0.851187624,31643,62,10,4
7382,2014/03/31,2005/10/21,40,29,0.657761551,40948,40,16,13
7383,2014/03/31,2006/04/12,79,27,0.7406502009999999,36358,79,23,4
7384,2014/03/31,2012/07/05,91,7,0.833315693,32313,91,3,4
7385,2014/03/31,2012/09/24,120,10,0.699467682,38492,120,3,7
7386,2014/03/31,2013/03/21,7,7,0.6371052629999999,42256,7,0,7
7387,2014/03/31,2008/09/06,86,16,0.84470171,31865,86,9,7
7388,2014/03/31,2009/02/16,10,28,0.741904342,36275,10,13,15
7389,2014/03/31,2007/07/22,364,3,0.7333333329999999,36696,364,2,1
7390,2014/03/31,2010/09/21,18,24,0.8943558890000001,30088,18,6,18
7391,2014/03/31,2012/07/25,27,12,0.886640084,30346,27,4,8
7392,2014/03/31,2007/03/03,125,28,0.959335378,28046,125,12,16
7393,2014/03/31,2011/05/06,83,28,0.626386515,42953,83,18,10
7394,2014/03/31,2006/02/19,11,33,0.90973557,29573,11,10,23
7395,2014/03/31,2009/09/26,2,29,0.7807644090000001,34458,2,11,18
7396,2014/03/31,2008/03/06,109,25,0.622102768,43243,109,12,13
7397,2014/03/31,2008/09/02,30,14,1.343280899,20025,30,1,13
7398,2014/03/31,2011/07/19,6,20,0.668849626,40213,6,5,15
7399,2014/03/31,2004/11/26,23,28,0.696460869,38614,23,18,10
7400,2014/03/31,2006/05/10,29,39,0.56285209,47779,29,16,23
7401,2014/03/31,2012/09/06,503,7,0.893155308,30108,503,7,0
7402,2014/03/31,2009/08/07,25,23,0.715254043,37592,25,11,12
7403,2014/03/31,2007/02/16,10,6,0.67305114,39949,10,4,2
7404,2014/03/31,2012/04/10,4,14,0.699023477,38463,4,11,3
7405,2014/03/31,2007/09/29,30,18,0.597042038,45031,30,9,9
7406,2014/03/31,2012/04/06,24,27,0.754184526,35648,24,13,14
7407,2014/03/31,2012/10/09,1,47,0.736215765,36512,1,14,33
7408,2014/03/31,2012/06/22,50,44,0.714082733,37639,50,22,22
7409,2014/03/31,2009/12/27,1,23,0.792493955,33914,1,8,15
7410,2014/03/31,2009/02/24,69,23,0.723922414,37120,69,14,9
7411,2014/03/31,2011/09/25,23,30,0.916059728,29333,23,14,16
7412,2014/03/31,2013/01/26,220,3,1.043507573,25750,220,0,3
7413,2014/03/31,2012/01/27,32,28,0.739270916,36347,32,17,11
7414,2014/03/31,2008/03/16,16,27,0.6383485,42089,16,16,11
7415,2014/03/31,2006/08/20,100,15,0.6714205740000001,40012,100,14,1
7416,2014/03/31,2007/02/19,242,23,0.663374904,40493,242,17,6
7417,2014/03/31,2010/05/22,82,21,0.8195508909999999,32776,82,13,8
7418,2014/03/31,2012/02/24,17,34,0.681516036,39412,17,16,18
7419,2014/03/31,2007/05/11,13,24,0.735306067,36528,13,5,19
7420,2014/03/31,2006/12/08,38,25,0.711349419,37757,38,9,16
7421,2014/03/31,2012/04/07,9,35,0.691025087,38865,9,19,16
7422,2014/03/31,2006/05/25,2,32,0.562226386,47768,2,14,18
7423,2014/03/31,2008/08/29,70,15,0.835210738,32149,70,10,5
7424,2014/03/31,2007/04/16,21,22,0.712692502,37675,21,13,9
7425,2014/03/31,2006/02/24,182,30,0.8094693040000001,33164,182,24,6
7426,2014/03/31,2010/02/18,22,29,0.6985155209999999,38431,22,13,16
7427,2014/03/31,2006/06/01,96,12,0.7929605340000001,33852,96,3,9
7428,2014/03/31,2010/12/20,27,22,0.591156184,45408,27,18,4
7429,2014/03/31,2011/09/29,292,15,0.6170336999999999,43502,292,12,3
7430,2014/03/31,2013/01/10,142,4,0.7083042970000001,37884,142,1,3
7431,2014/03/31,2011/10/31,56,9,0.804148805,33359,56,4,5
7432,2014/03/31,2012/04/20,21,33,0.711217882,37713,21,14,19
7433,2014/03/31,2006/09/22,199,5,0.66,40635,199,3,2
7434,2014/03/31,2013/01/09,250,19,0.728638439,36796,250,9,10
7435,2014/03/31,2012/02/10,550,10,0.83,32300,550,10,0
7436,2014/03/31,2005/12/27,83,20,0.884104805,30323,83,12,8
7437,2014/03/31,2011/07/11,189,10,0.71954205,37253,189,9,1
7438,2014/03/31,2012/07/01,13,18,0.829490607,32313,13,6,12
7439,2014/03/31,2008/10/10,30,15,0.683421046,39219,30,10,5
7440,2014/03/31,2012/02/20,343,32,0.747912713,35836,343,30,2
7441,2014/03/31,2008/02/08,5,17,0.924006068,29006,5,9,8
7442,2014/03/31,2010/11/02,9,27,0.758541507,35331,9,16,11
7443,2014/03/31,2008/12/11,35,40,0.6912019909999999,38769,35,18,22
7444,2014/03/31,2011/08/17,64,23,0.608986159,44001,64,17,6
7445,2014/03/31,2011/08/15,26,23,0.733082184,36552,26,8,15
7446,2014/03/31,2006/05/16,4,52,0.7808283540000001,34309,4,22,30
7447,2014/03/31,2009/12/17,14,32,0.712918352,37576,14,20,12
7448,2014/03/31,2010/12/26,307,5,1.00418038,26677,307,4,1
7449,2014/03/31,2012/07/10,132,3,0.73,36696,132,1,2
7450,2014/03/31,2011/12/13,4,42,0.7386455259999999,36265,4,14,28
7451,2014/03/31,2006/08/24,69,33,0.693886888,38599,69,21,12
7452,2014/03/31,2010/12/12,12,34,0.883365546,30319,12,11,23
7453,2014/03/31,2013/02/11,19,18,1.372882555,19507,19,0,18
7454,2014/03/31,2012/12/23,91,4,0.974608778,27478,91,2,2
7455,2014/03/31,2008/02/06,14,31,0.7940014240000001,33718,14,21,10
7456,2014/03/31,2009/02/14,93,15,0.9793576,27335,93,6,9
7457,2014/03/31,2012/04/30,27,23,0.6572509879999999,40731,27,2,21
7458,2014/03/31,2011/11/24,81,11,0.630969947,42425,81,4,7
7459,2014/03/31,2008/12/10,118,21,0.718221674,37271,118,14,7
7460,2014/03/31,2010/12/01,32,23,0.825745928,32416,32,9,14
7461,2014/03/31,2011/04/20,185,29,0.76591164,34948,185,23,6
7462,2014/03/31,2012/11/05,11,20,0.711,37640,11,7,13
7463,2014/03/31,2009/09/11,17,31,0.6324883000000001,42306,17,17,14
7464,2014/03/31,2008/11/15,27,41,0.839408941,31875,27,18,23
7465,2014/03/31,2009/10/24,1,32,0.831770412,32162,1,23,9
7466,2014/03/31,2008/07/02,10,27,0.7502948190000001,35649,10,15,12
7467,2014/03/31,2012/02/13,58,18,0.781052155,34244,58,14,4
7468,2014/03/31,2007/11/17,558,12,1.216407423,21987,558,12,0
7469,2014/03/31,2012/04/27,155,39,0.678174325,39432,155,27,12
7470,2014/03/31,2012/04/18,122,5,0.6579999999999999,40635,122,1,4
7471,2014/03/31,2006/10/23,4,25,0.903892157,29580,4,11,14
7472,2014/03/31,2011/08/01,17,18,0.739204313,36170,17,3,15
7473,2014/03/31,2011/09/14,90,15,0.825948777,32368,90,9,6
7474,2014/03/31,2006/02/23,1,31,0.79397434,33671,1,10,21
7475,2014/03/31,2011/03/24,139,35,0.640858246,41713,139,19,16
7476,2014/03/31,2005/08/27,31,30,0.662509109,40345,31,17,13
7477,2014/03/31,2012/04/27,2,26,0.679664853,39326,2,11,15
7478,2014/03/31,2009/12/20,69,27,0.879242055,30398,69,13,14
7479,2014/03/31,2011/11/15,308,10,1.5,17815,308,7,3
7480,2014/03/31,2012/09/29,1,39,0.828911843,32238,1,20,19
7481,2014/03/31,2008/04/25,14,22,0.669498672,39914,14,5,17
7482,2014/03/31,2009/09/27,22,30,0.614968931,43452,22,8,22
7483,2014/03/31,2009/04/16,1,48,0.683084848,39117,1,22,26
7484,2014/03/31,2012/06/25,115,19,0.6963041440000001,38370,115,8,11
7485,2014/03/31,2012/04/27,272,16,0.8411734890000001,31760,272,12,4
7486,2014/03/31,2006/09/20,110,22,0.711315033,37558,110,14,8
7487,2014/03/31,2011/12/29,27,25,0.697895603,38277,27,8,17
7488,2014/03/31,2006/03/17,77,37,0.720053643,37097,77,26,11
7489,2014/03/31,2011/01/10,65,15,0.606666667,44025,65,3,12
7490,2014/03/31,2005/12/10,13,25,0.820797627,32534,13,9,16
7491,2014/03/31,2008/02/18,3,29,0.824705028,32376,3,14,15
7492,2014/03/31,2009/07/13,5,25,0.766397485,34834,5,10,15
7493,2014/03/31,2010/10/10,11,44,0.465072651,57398,11,18,26
7494,2014/03/31,2005/06/29,11,36,0.728300363,36649,11,18,18
7495,2014/03/31,2006/04/03,31,37,0.642107542,41565,31,16,21
7496,2014/03/31,2007/10/03,21,25,0.754550466,35370,21,15,10
7497,2014/03/31,2005/11/09,32,21,1.425152729,18726,32,11,10
7498,2014/03/31,2008/04/12,6,31,0.809727229,32958,6,12,19
7499,2014/03/31,2012/08/16,123,23,0.8869565220000001,30084,123,11,12
7500,2014/03/31,2008/08/22,3,29,1.4175862069999998,18821,3,15,14
7501,2014/03/31,2011/05/24,89,20,0.764043991,34916,89,14,6
7502,2014/03/31,2011/05/14,222,9,1.4827273230000002,17992,222,5,4
7503,2014/03/31,2009/01/14,34,38,0.8367808520000001,31878,34,17,21
7504,2014/03/31,2009/01/31,31,18,0.488585141,54592,31,11,7
7505,2014/03/31,2010/04/21,181,20,0.8289098140000001,32178,181,10,10
7506,2014/03/31,2006/11/14,7,14,1.413993426,18861,7,6,8
7507,2014/03/31,2010/08/15,306,25,0.7976573020000001,33423,306,22,3
7508,2014/03/31,2010/11/17,6,25,0.673594299,39571,6,7,18
7509,2014/03/31,2008/11/30,73,30,0.729552733,36533,73,23,7
7510,2014/03/31,2006/03/21,1,29,0.671051744,39715,1,10,19
7511,2014/03/31,2006/06/02,322,15,0.7861761759999999,33898,322,13,2
7512,2014/03/31,2007/01/12,49,11,0.941103969,28316,49,5,6
7513,2014/03/31,2008/01/18,162,30,0.534296026,49874,162,15,15
7514,2014/03/31,2008/10/31,85,12,0.677163515,39348,85,6,6
7515,2014/03/31,2005/02/07,13,20,0.909524801,29293,13,8,12
7516,2014/03/31,2010/10/23,184,24,0.765596908,34796,184,17,7
7517,2014/03/31,2010/11/25,377,14,0.705339176,37768,377,14,0
7518,2014/03/31,2006/12/13,86,32,0.967316533,27539,86,18,14
7519,2014/03/31,2008/09/01,121,27,0.7962013929999999,33457,121,19,8
7520,2014/03/31,2008/03/12,10,28,0.8440239540000001,31561,10,9,19
7521,2014/03/31,2012/07/19,13,35,0.750879774,35475,13,17,18
7522,2014/03/31,2011/08/25,2,50,0.734185457,36278,2,22,28
7523,2014/03/31,2006/11/23,15,28,0.725074192,36729,15,9,19
7524,2014/03/31,2012/09/08,14,18,0.676220354,39382,14,6,12
7525,2014/03/31,2009/08/02,22,28,0.83070437,32057,22,15,13
7526,2014/03/31,2007/11/19,16,28,0.790838679,33672,16,15,13
7527,2014/03/31,2011/05/10,24,33,0.837735481,31786,24,19,14
7528,2014/03/31,2010/05/18,10,22,0.8768456929999999,30368,10,4,18
7529,2014/03/31,2011/10/19,20,35,0.637888559,41744,20,25,10
7530,2014/03/31,2009/09/07,128,16,1.267465251,21008,128,5,11
7531,2014/03/31,2013/01/30,213,38,0.956184012,27846,213,20,18
7532,2014/03/31,2007/12/31,70,31,0.701847164,37923,70,10,21
7533,2014/03/31,2012/07/21,159,5,0.7,38022,159,3,2
7534,2014/03/31,2011/05/15,112,23,0.797747999,33357,112,14,9
7535,2014/03/31,2005/04/23,159,26,0.8660434159999999,30726,159,18,8
7536,2014/03/31,2008/12/01,15,35,0.733479423,36279,15,20,15
7537,2014/03/31,2009/01/10,62,21,0.8293931179999999,32082,62,8,13
7538,2014/03/31,2005/11/28,3,21,0.854922073,31119,3,14,7
7539,2014/03/31,2007/09/04,122,25,0.7117940690000001,37362,122,14,11
7540,2014/03/31,2006/10/20,10,37,0.755701458,35191,10,18,19
7541,2014/03/31,2011/01/25,14,23,0.841148153,31616,14,2,21
7542,2014/03/31,2011/02/26,19,22,0.7167788890000001,37099,19,8,14
7543,2014/03/31,2012/02/22,7,36,0.6302533779999999,42190,7,20,16
7544,2014/03/31,2012/08/31,47,25,0.821476813,32367,47,13,12
7545,2014/03/31,2006/06/09,70,27,0.8104575940000001,32802,70,10,17
7546,2014/03/31,2010/10/28,20,21,0.672013448,39559,20,15,6
7547,2014/03/31,2008/10/17,3,41,0.540292683,49200,3,18,23
7548,2014/03/31,2010/07/29,34,16,0.645733754,41165,34,8,8
7549,2014/03/31,2010/06/21,63,21,0.893530321,29748,63,13,8
7550,2014/03/31,2011/12/29,27,26,0.698827552,38023,27,17,9
7551,2014/03/31,2011/03/03,45,30,0.984672596,26985,45,25,5
7552,2014/03/31,2007/03/01,59,23,0.6870836240000001,38661,59,8,15
7553,2014/03/31,2005/11/05,5,25,0.817756912,32482,5,11,14
7554,2014/03/31,2013/03/02,19,24,0.682505846,38917,19,4,20
7555,2014/03/31,2009/05/28,425,23,0.95748639,27737,425,23,0
7556,2014/03/31,2007/10/14,20,41,0.669254499,39678,20,16,25
7557,2014/03/31,2008/01/14,168,10,0.7304937970000001,36351,168,7,3
7558,2014/03/31,2008/07/19,12,54,0.8231647809999999,32255,12,19,35
7559,2014/03/31,2011/07/19,105,18,0.711425509,37320,105,7,11
7560,2014/03/31,2012/05/08,3,30,0.864762866,30700,3,11,19
7561,2014/03/31,2006/12/05,209,31,0.683311799,38852,209,24,7
7562,2014/03/31,2011/10/17,623,4,0.927666853,28618,623,4,0
7563,2014/03/31,2012/10/10,147,3,0.723333333,36696,147,1,2
7564,2014/03/31,2011/03/11,126,3,0.723333333,36696,126,2,1
7565,2014/03/31,2010/04/21,24,29,0.714430867,37153,24,12,17
7566,2014/03/31,2012/09/11,30,13,0.86777073,30584,30,2,11
7567,2014/03/31,2012/05/10,5,21,0.77038495,34446,5,17,4
7568,2014/03/31,2006/01/31,7,22,0.7874810809999999,33697,7,9,13
7569,2014/03/31,2012/04/29,86,12,0.836666667,31716,86,6,6
7570,2014/03/31,2010/01/09,32,33,0.7179340390000001,36961,32,3,30
7571,2014/03/31,2009/10/18,35,27,0.806250152,32908,35,16,11
7572,2014/03/31,2009/07/08,109,18,1.173434334,22607,109,9,9
7573,2014/03/31,2005/03/15,4,28,0.635102588,41769,4,11,17
7574,2014/03/31,2007/06/07,2,46,0.7508233559999999,35331,2,15,31
7575,2014/03/31,2009/10/01,1,22,0.7797289829999999,34020,1,4,18
7576,2014/03/31,2005/10/18,2,18,1.085511766,24435,2,0,18
7577,2014/03/31,2007/09/26,5,22,0.779724517,34013,5,9,13
7578,2014/03/31,2012/12/24,9,18,0.693459115,38241,9,7,11
7579,2014/03/31,2011/06/30,11,7,0.6939048390000001,38209,11,3,4
7580,2014/03/31,2010/08/30,20,23,0.77534932,34195,20,15,8
7581,2014/03/31,2011/04/26,86,30,0.738422225,35905,86,14,16
7582,2014/03/31,2011/07/01,16,20,0.535145845,49539,16,5,15
7583,2014/03/31,2012/02/07,494,20,0.716297017,37008,494,20,0
7584,2014/03/31,2007/01/22,359,25,0.88996541,29777,359,24,1
7585,2014/03/31,2007/08/31,2,21,0.7579095640000001,34964,2,10,11
7586,2014/03/31,2012/02/08,50,17,0.7071043920000001,37474,50,10,7
7587,2014/03/31,2011/12/16,89,35,0.629946267,42060,89,29,6
7588,2014/03/31,2009/06/30,19,11,0.759154752,34901,19,4,7
7589,2014/03/31,2013/02/11,38,21,0.914343895,28974,38,2,19
7590,2014/03/31,2012/04/12,12,34,0.813857994,32548,12,17,17
7591,2014/03/31,2008/10/18,45,21,0.701925166,37737,45,12,9
7592,2014/03/31,2005/06/29,77,18,1.2535929959999998,21130,77,11,7
7593,2014/03/31,2012/08/05,31,20,0.607062963,43629,31,8,12
7594,2014/03/31,2011/06/27,67,20,0.770579575,34370,67,3,17
7595,2014/03/31,2010/07/15,8,28,0.63654545,41606,8,1,27
7596,2014/03/31,2008/09/17,60,19,0.719146163,36822,60,16,3
7597,2014/03/31,2012/02/14,23,34,0.7151242440000001,37024,23,22,12
7598,2014/03/31,2010/04/12,22,33,0.7945712140000001,33315,22,25,8
7599,2014/03/31,2012/03/07,7,32,0.631941845,41888,7,11,21
7600,2014/03/31,2008/10/19,67,34,0.619480459,42730,67,22,12
7601,2014/03/31,2011/09/21,233,19,0.572845887,46200,233,12,7
7602,2014/03/31,2013/02/08,28,30,0.753197757,35134,28,7,23
7603,2014/03/31,2012/08/23,2,26,0.744417937,35546,2,14,12
7604,2014/03/31,2012/06/16,71,14,1.444372987,18317,71,7,7
7605,2014/03/31,2011/03/12,44,10,0.694951793,38065,44,2,8
7606,2014/03/31,2013/02/11,58,20,0.81137656,32603,58,2,18
7607,2014/03/31,2012/04/23,3,19,0.7500008509999999,35269,3,9,10
7608,2014/03/31,2010/08/02,9,31,0.794572244,33290,9,19,12
7609,2014/03/31,2005/02/12,12,33,0.663118654,39889,12,10,23
7610,2014/03/31,2010/08/25,317,19,0.7297544490000001,36245,317,17,2
7611,2014/03/31,2006/12/18,26,14,0.902875917,29295,26,6,8
7612,2014/03/31,2012/06/17,57,13,0.693309915,38146,57,7,6
7613,2014/03/31,2011/02/22,17,23,0.729891538,36234,17,5,18
7614,2014/03/31,2007/02/25,144,18,0.7943521490000001,33287,144,8,10
7615,2014/03/31,2011/01/31,115,24,0.646864832,40875,115,11,13
7616,2014/03/31,2011/07/26,16,27,0.812503458,32535,16,2,25
7617,2014/03/31,2008/11/04,204,16,0.60352177,43799,204,10,6
7618,2014/03/31,2008/02/22,120,27,0.8161218309999999,32389,120,11,16
7619,2014/03/31,2007/04/13,267,26,0.6647520370000001,39764,267,25,1
7620,2014/03/31,2012/03/27,1,32,0.8520469340000001,31022,1,13,19
7621,2014/03/31,2006/09/30,30,25,0.839501334,31484,30,18,7
7622,2014/03/31,2011/12/24,27,34,0.793235294,33320,27,17,17
7623,2014/03/31,2011/04/21,41,27,0.811731572,32560,41,9,18
7624,2014/03/31,2008/03/05,131,35,0.72871481,36267,131,23,12
7625,2014/03/31,2007/09/14,112,27,0.589166407,44854,112,11,16
7626,2014/03/31,2012/05/07,2,18,0.8413885,31408,2,4,14
7627,2014/03/31,2010/07/29,1,46,0.8415477709999999,31400,1,15,31
7628,2014/03/31,2008/03/10,40,28,0.7140944220000001,37004,40,9,19
7629,2014/03/31,2008/10/18,94,18,0.8715466059999999,30318,94,15,3
7630,2014/03/31,2011/05/05,104,4,0.54,48928,104,0,4
7631,2014/03/31,2011/11/23,52,14,0.917964559,28780,52,4,10
7632,2014/03/31,2005/06/15,13,23,0.721275016,36627,13,4,19
7633,2014/03/31,2008/01/14,8,24,0.688734781,38357,8,11,13
7634,2014/03/31,2007/08/16,15,30,0.734175421,35982,15,12,18
7635,2014/03/31,2012/07/31,9,20,0.6715,39340,9,7,13
7636,2014/03/31,2008/09/13,12,24,0.757712212,34859,12,13,11
7637,2014/03/31,2008/09/10,118,18,0.891412757,29630,118,16,2
7638,2014/03/31,2005/11/22,64,29,0.816287551,32356,64,13,16
7639,2014/03/31,2012/04/29,56,18,0.805436719,32790,56,9,9
7640,2014/03/31,2006/11/07,20,5,0.527803186,50027,20,2,3
7641,2014/03/31,2010/07/28,188,22,0.7536929090000001,35032,188,19,3
7642,2014/03/31,2007/01/04,16,40,0.930836271,28364,16,16,24
7643,2014/03/31,2012/08/05,12,41,0.782214684,33752,12,15,26
7644,2014/03/31,2005/01/09,17,33,0.623846626,42315,17,18,15
7645,2014/03/31,2012/07/21,4,29,0.661600622,39897,4,10,19
7646,2014/03/31,2012/09/19,1,18,0.81828807,32256,1,2,16
7647,2014/03/31,2011/01/13,8,25,0.643937338,40982,8,9,16
7648,2014/03/31,2006/02/19,8,28,0.664233431,39729,8,10,18
7649,2014/03/31,2006/07/04,84,22,0.5757403729999999,45835,84,12,10
7650,2014/03/31,2008/08/10,146,23,0.8630209659999999,30573,146,10,13
7651,2014/03/31,2006/04/13,94,16,0.545563344,48363,94,9,7
7652,2014/03/31,2009/07/27,34,26,0.7148062959999999,36912,34,8,18
7653,2014/03/31,2010/02/19,487,15,0.925701705,28502,487,15,0
7654,2014/03/31,2011/08/30,33,17,0.790075764,33393,33,15,2
7655,2014/03/31,2007/10/18,19,24,0.8279310129999999,31861,19,14,10
7656,2014/03/31,2011/03/07,7,30,0.7135568959999999,36962,7,16,14
7657,2014/03/31,2005/03/24,172,28,0.806709291,32689,172,16,12
7658,2014/03/31,2007/03/08,112,14,0.757280299,34820,112,0,14
7659,2014/03/31,2011/11/29,121,17,0.770318443,34229,121,10,7
7660,2014/03/31,2010/07/19,79,27,0.964571638,27325,79,20,7
7661,2014/03/31,2011/03/02,297,3,0.8666666670000001,30408,297,1,2
7662,2014/03/31,2007/04/25,102,23,0.715162175,36843,102,15,8
7663,2014/03/31,2011/06/24,11,47,0.893961118,29474,11,12,35
7664,2014/03/31,2009/02/14,13,26,0.84538032,31158,13,8,18
7665,2014/03/31,2006/12/09,83,19,0.901348392,29220,83,13,6
7666,2014/03/31,2007/07/09,2,19,0.723729768,36391,2,4,15
7667,2014/03/31,2012/04/17,10,26,0.641984301,41022,10,11,15
7668,2014/03/31,2006/10/13,33,28,0.643140233,40946,33,14,14
7669,2014/03/31,2008/11/17,3,28,0.684270901,38479,3,12,16
7670,2014/03/31,2011/11/25,61,17,0.754208898,34907,61,3,14
7671,2014/03/31,2010/03/26,34,33,0.7374380229999999,35699,34,17,16
7672,2014/03/31,2012/10/03,18,38,0.601759556,43744,18,7,31
7673,2014/03/31,2012/12/24,66,13,0.918160474,28665,66,0,13
7674,2014/03/31,2011/04/08,29,35,0.810160377,32486,29,19,16
7675,2014/03/31,2008/05/16,74,14,0.955714286,27538,74,6,8
7676,2014/03/31,2010/01/07,4,30,0.763325403,34465,4,14,16
7677,2014/03/31,2011/07/15,25,27,0.681488485,38603,25,0,27
7678,2014/03/31,2010/10/26,5,31,0.788652157,33357,5,19,12
7679,2014/03/31,2012/12/31,2,20,0.649989623,40473,2,3,17
7680,2014/03/31,2012/04/16,4,27,0.8671095659999999,30338,4,12,15
7681,2014/03/31,2011/05/20,380,4,0.5375,48928,380,4,0
7682,2014/03/31,2010/11/24,231,3,0.716666667,36696,231,1,2
7683,2014/03/31,2007/05/22,44,28,0.7290020509999999,36074,44,15,13
7684,2014/03/31,2008/10/24,31,43,0.823735551,31923,31,20,23
7685,2014/03/31,2011/02/05,61,9,1.3919247259999998,18891,61,4,5
7686,2014/03/31,2012/06/07,34,24,0.673630425,39034,34,9,15
7687,2014/03/31,2009/01/03,114,27,0.656569195,40046,114,12,15
7688,2014/03/31,2011/10/27,86,10,0.8140000000000001,32300,86,6,4
7689,2014/03/31,2005/10/12,5,34,0.7862829370000001,33435,5,9,25
7690,2014/03/31,2005/12/20,25,27,0.829088845,31707,25,15,12
7691,2014/03/31,2013/02/26,70,21,0.679697965,38671,70,2,19
7692,2014/03/31,2009/06/18,131,5,0.691996735,37982,131,3,2
7693,2014/03/31,2006/03/10,104,18,0.782893325,33560,104,11,7
7694,2014/03/31,2008/04/13,14,35,0.804624219,32652,14,14,21
7695,2014/03/31,2012/10/10,35,13,1.34863193,19480,35,5,8
7696,2014/03/31,2012/04/10,127,16,0.8239456759999999,31883,127,9,7
7697,2014/03/31,2012/01/16,122,22,0.723872533,36276,122,10,12
7698,2014/03/31,2008/07/29,25,33,0.640678785,40985,25,14,19
7699,2014/03/31,2007/02/11,251,6,0.94843592,27684,251,2,4
7700,2014/03/31,2012/07/15,16,63,0.696612985,37691,16,24,39
7701,2014/03/31,2008/03/06,15,17,1.3028184390000002,20153,15,9,8
7702,2014/03/31,2006/02/24,2,22,0.6795049040000001,38639,2,11,11
7703,2014/03/31,2010/01/05,1,32,0.731119559,35907,1,14,18
7704,2014/03/31,2007/10/08,110,22,0.956097534,27457,110,11,11
7705,2014/03/31,2006/10/30,150,13,0.791297664,33175,150,3,10
7706,2014/03/31,2011/08/14,109,13,0.634724828,41356,109,11,2
7707,2014/03/31,2011/01/03,33,10,0.721211355,36389,33,5,5
7708,2014/03/31,2007/08/31,73,25,0.6590038420000001,39823,73,7,18
7709,2014/03/31,2005/01/11,106,11,0.6849081229999999,38312,106,2,9
7710,2014/03/31,2011/09/19,38,18,0.536994883,48860,38,10,8
7711,2014/03/31,2011/12/01,26,32,0.605165182,43346,26,21,11
7712,2014/03/31,2009/10/23,63,25,0.682162956,38452,63,12,13
7713,2014/03/31,2012/10/31,31,10,1.446549937,18133,31,4,6
7714,2014/03/31,2005/08/27,10,27,0.706541135,37122,10,16,11
7715,2014/03/31,2012/06/22,564,3,0.995965592,26331,564,3,0
7716,2014/03/31,2012/08/02,9,22,0.633636364,41382,9,12,10
7717,2014/03/31,2011/12/22,3,31,0.793863086,33028,3,11,20
7718,2014/03/31,2011/02/06,65,32,0.847872712,30922,65,15,17
7719,2014/03/31,2010/03/21,60,44,0.614761246,42638,60,36,8
7720,2014/03/31,2007/10/31,4,24,0.761805156,34407,4,14,10
7721,2014/03/31,2010/07/28,4,18,1.207885253,21700,4,6,12
7722,2014/03/31,2005/08/13,235,12,0.5047475060000001,51922,235,9,3
7723,2014/03/31,2013/01/22,73,19,0.811771685,32280,73,5,14
7724,2014/03/31,2009/08/11,37,23,0.619720908,42280,37,8,15
7725,2014/03/31,2011/04/26,445,22,0.884475425,29624,445,22,0
7726,2014/03/31,2009/12/23,3,62,0.82459616,31770,3,29,33
7727,2014/03/31,2005/04/27,171,28,0.577823746,45321,171,13,15
7728,2014/03/31,2008/07/15,35,26,0.772063099,33915,35,11,15
7729,2014/03/31,2012/11/27,7,30,0.717964568,36464,7,1,29
7730,2014/03/31,2012/01/18,39,28,0.6472798989999999,40436,39,11,17
7731,2014/03/31,2008/06/07,42,21,0.681854631,38385,42,10,11
7732,2014/03/31,2013/02/01,16,18,0.764853668,34203,16,1,17
7733,2014/03/31,2007/12/26,28,23,0.724824595,36088,28,11,12
7734,2014/03/31,2007/05/26,151,23,0.8482954429999999,30835,151,10,13
7735,2014/03/31,2008/04/18,3,12,1.350807418,19358,3,0,12
7736,2014/03/31,2006/06/06,37,27,0.789444143,33120,37,14,13
7737,2014/03/31,2008/11/11,24,39,0.60421628,43268,24,11,28
7738,2014/03/31,2010/10/31,130,4,0.86,30398,130,2,2
7739,2014/03/31,2010/10/31,130,4,0.86,30398,130,2,2
7740,2014/03/31,2007/05/11,31,26,0.820548354,31859,31,6,20
7741,2014/03/31,2009/09/26,1,35,0.723956625,36104,1,13,22
7742,2014/03/31,2011/01/14,11,32,0.601747059,43433,11,22,10
7743,2014/03/31,2009/07/15,113,19,1.275032932,20497,113,10,9
7744,2014/03/31,2008/08/09,22,23,0.66841377,39099,22,8,15
7745,2014/03/31,2011/03/03,28,21,0.7988066999999999,32716,28,14,7
7746,2014/03/31,2011/03/28,16,24,0.783333333,33360,16,10,14
7747,2014/03/31,2010/07/13,130,29,0.795019015,32869,130,14,15
7748,2014/03/31,2006/09/15,17,9,0.783091955,33364,17,2,7
7749,2014/03/31,2011/06/10,11,36,0.5927231270000001,44078,11,21,15
7750,2014/03/31,2007/08/10,4,22,0.783820697,33329,4,11,11
7751,2014/03/31,2012/03/08,17,18,0.692313156,37732,17,7,11
7752,2014/03/31,2010/12/11,58,23,0.788695652,33120,58,13,10
7753,2014/03/31,2005/09/08,4,49,0.590493942,44236,4,19,30
7754,2014/03/31,2012/04/26,3,25,0.544142571,48004,3,9,16
7755,2014/03/31,2007/10/01,13,22,0.647506385,40331,13,9,13
7756,2014/03/31,2008/08/27,47,30,0.539481665,48405,47,14,16
7757,2014/03/31,2009/08/07,4,25,0.714961119,36522,4,11,14
7758,2014/03/31,2006/07/18,3,32,0.75538288,34567,3,20,12
7759,2014/03/31,2006/10/31,140,35,0.7601848990000001,34343,140,16,19
7760,2014/03/31,2011/11/24,3,46,0.710748707,36730,3,38,8
7761,2014/03/31,2005/05/12,5,27,0.680350923,38356,5,15,12
7762,2014/03/31,2007/06/04,82,17,0.677684396,38504,82,12,5
7763,2014/03/31,2006/05/19,29,26,0.7150060290000001,36488,29,11,15
7764,2014/03/31,2005/07/09,119,24,0.716762371,36397,119,13,11
7765,2014/03/31,2010/04/04,654,3,1.038056584,25131,654,3,0
7766,2014/03/31,2006/08/20,2,39,0.6995985090000001,37286,2,9,30
7767,2014/03/31,2010/09/30,2,21,0.860163253,30321,2,13,8
7768,2014/03/31,2012/06/02,23,30,0.6985895679999999,37329,23,9,21
7769,2014/03/31,2006/07/22,14,29,0.763253915,34165,14,8,21
7770,2014/03/31,2012/09/15,21,20,0.739736178,35251,21,3,17
7771,2014/03/31,2006/07/05,7,40,0.636607583,40959,7,2,38
7772,2014/03/31,2005/10/31,12,25,0.677592058,38481,12,12,13
7773,2014/03/31,2006/04/14,157,10,0.825449106,31585,157,6,4
7774,2014/03/31,2006/08/03,100,23,0.765935425,34038,100,15,8
7775,2014/03/31,2010/08/15,5,12,0.985151172,26460,5,0,12
7776,2014/03/31,2005/04/25,81,29,0.740933458,35181,81,16,13
7777,2014/03/31,2012/02/09,18,28,0.582602593,44740,18,12,16
7778,2014/03/31,2011/03/31,72,22,0.80055315,32559,72,13,9
7779,2014/03/31,2011/03/23,128,28,0.794086159,32823,128,20,8
7780,2014/03/31,2007/06/05,1,25,0.64460003,40428,1,10,15
7781,2014/03/31,2012/04/18,4,26,0.8282040359999999,31465,4,16,10
7782,2014/03/31,2012/08/01,129,20,0.837832937,31102,129,10,10
7783,2014/03/31,2007/10/30,65,17,0.65959923,39499,65,11,6
7784,2014/03/31,2012/11/10,122,23,0.634965265,41025,122,7,16
7785,2014/03/31,2008/11/14,103,14,0.909993362,28623,103,6,8
7786,2014/03/31,2012/01/12,280,10,1.464144134,17789,280,7,3
7787,2014/03/31,2011/07/29,123,26,0.959312606,27146,123,19,7
7788,2014/03/31,2011/12/28,128,29,0.699791465,37212,128,21,8
7789,2014/03/31,2012/03/16,417,21,0.754448661,34516,417,21,0
7790,2014/03/31,2005/03/03,19,40,0.61313249,42471,19,21,19
7791,2014/03/31,2009/01/18,25,17,1.373137524,18964,25,6,11
7792,2014/03/31,2013/02/03,17,22,0.585090897,44501,17,3,19
7793,2014/03/31,2008/11/29,12,35,0.7141564029999999,36457,12,17,18
7794,2014/03/31,2006/11/30,228,22,0.992230649,26239,228,14,8
7795,2014/03/31,2011/02/12,8,38,0.758558732,34317,8,14,24
7796,2014/03/31,2009/12/01,35,20,0.85896175,30301,35,12,8
7797,2014/03/31,2006/09/20,16,30,0.83167391,31292,16,14,16
7798,2014/03/31,2012/07/16,611,4,0.956232821,27214,611,4,0
7799,2014/03/31,2010/09/11,83,3,1.04724682,24844,83,2,1
7800,2014/03/31,2011/02/07,260,16,0.863579181,30127,260,12,4
7801,2014/03/31,2012/10/18,48,30,0.568921283,45721,48,11,19
7802,2014/03/31,2012/10/02,4,19,0.638283968,40751,4,8,11
7803,2014/03/31,2010/08/18,3,38,0.6490990560000001,40058,3,17,21
7804,2014/03/31,2007/08/28,17,26,0.798990535,32542,17,12,14
7805,2014/03/31,2012/01/11,2,43,0.789823772,32912,2,19,24
7806,2014/03/31,2005/09/09,20,37,0.7717372840000001,33679,20,29,8
7807,2014/03/31,2008/08/08,39,30,0.8502898740000001,30565,39,20,10
7808,2014/03/31,2007/10/01,196,24,0.7114819170000001,36527,196,17,7
7809,2014/03/31,2011/01/13,3,37,0.7127214629999999,36462,3,10,27
7810,2014/03/31,2011/05/16,304,8,1.1839447790000002,21948,304,5,3
7811,2014/03/31,2008/05/11,59,22,0.716842047,36245,59,11,11
7812,2014/03/31,2010/08/08,5,31,0.750775167,34599,5,9,22
7813,2014/03/31,2012/02/19,2,38,0.9118653,28478,2,14,24
7814,2014/03/31,2012/10/25,49,8,1.310850924,19802,49,5,3
7815,2014/03/31,2011/03/29,73,29,0.753500682,34439,73,15,14
7816,2014/03/31,2012/05/05,8,31,0.611488359,42436,8,12,19
7817,2014/03/31,2012/05/22,136,21,0.758488498,34211,136,14,7
7818,2014/03/31,2006/05/13,48,4,0.64,40544,48,0,4
7819,2014/03/31,2012/02/08,68,21,0.7796751609999999,33278,68,14,7
7820,2014/03/31,2010/11/17,48,26,0.778878782,33312,48,13,13
7821,2014/03/31,2011/11/01,32,25,0.578953675,44814,32,15,10
7822,2014/03/31,2011/01/26,13,22,0.6895478709999999,37622,13,8,14
7823,2014/03/31,2012/06/28,5,18,0.7410842240000001,35002,5,7,11
7824,2014/03/31,2007/04/09,109,38,0.852323671,30426,109,23,15
7825,2014/03/31,2007/05/10,189,3,0.706666667,36696,189,1,2
7826,2014/03/31,2006/09/21,168,30,0.902007374,28749,168,26,4
7827,2014/03/31,2008/06/23,23,11,0.940239666,27580,23,6,5
7828,2014/03/31,2005/11/15,46,18,0.896144462,28935,46,17,1
7829,2014/03/31,2008/11/20,46,26,0.8376340790000001,30952,46,13,13
7830,2014/03/31,2008/03/12,256,10,0.762556415,33989,256,6,4
7831,2014/03/31,2005/02/20,1,31,0.593397445,43674,1,9,22
7832,2014/03/31,2006/02/01,8,32,0.6264243070000001,41371,8,19,13
7833,2014/03/31,2009/11/07,106,30,0.62541542,41428,106,18,12
7834,2014/03/31,2012/06/30,427,12,0.780290113,33194,427,12,0
7835,2014/03/31,2011/07/23,23,31,0.662265975,39109,23,26,5
7836,2014/03/31,2007/10/23,58,29,0.867510718,29856,58,19,10
7837,2014/03/31,2005/03/05,58,29,0.6386878579999999,40552,58,15,14
7838,2014/03/31,2006/10/29,69,26,0.840943335,30795,69,11,15
7839,2014/03/31,2009/10/29,20,21,0.910049199,28456,20,8,13
7840,2014/03/31,2006/07/31,47,25,0.589185475,43952,47,9,16
7841,2014/03/31,2009/09/08,24,21,0.8264708140000001,31333,24,10,11
7842,2014/03/31,2011/04/05,25,16,0.884401366,29275,25,3,13
7843,2014/03/31,2009/10/11,39,28,0.679691783,38090,39,16,12
7844,2014/03/31,2012/09/03,104,12,0.813962519,31803,104,5,7
7845,2014/03/31,2007/02/17,48,38,0.691162822,37452,48,22,16
7846,2014/03/31,2012/08/24,417,18,0.769177166,33652,417,18,0
7847,2014/03/31,2008/08/19,11,5,0.976218601,26514,11,2,3
7848,2014/03/31,2011/10/04,5,26,0.8440639879999999,30662,5,16,10
7849,2014/03/31,2009/10/28,15,24,0.6762582309999999,38268,15,14,10
7850,2014/03/31,2013/02/16,7,25,0.757012463,34182,7,5,20
7851,2014/03/31,2013/01/28,1,36,0.684066672,37827,1,4,32
7852,2014/03/31,2007/12/04,16,25,0.69916455,37010,16,16,9
7853,2014/03/31,2006/03/14,12,23,0.7817571529999999,33099,12,16,7
7854,2014/03/31,2008/09/03,93,27,0.565601399,45735,93,15,12
7855,2014/03/31,2006/10/12,74,30,0.8427951909999999,30692,74,20,10
7856,2014/03/31,2008/09/15,25,20,0.7800165859999999,33160,25,10,10
7857,2014/03/31,2008/08/13,304,5,0.6577244870000001,39323,304,1,4
7858,2014/03/31,2006/04/17,78,9,1.437655364,17990,78,3,6
7859,2014/03/31,2008/03/17,4,25,0.772332985,33485,4,16,9
7860,2014/03/31,2005/01/26,23,28,0.99158371,26078,23,19,9
7861,2014/03/31,2007/06/29,38,20,0.811523732,31856,38,2,18
7862,2014/03/31,2012/02/23,154,12,1.202650507,21494,154,9,3
7863,2014/03/31,2005/10/11,118,19,0.8034339629999999,32164,118,13,6
7864,2014/03/31,2010/12/01,39,22,0.756683845,34151,39,13,9
7865,2014/03/31,2010/11/25,5,30,0.7872701790000001,32819,5,11,19
7866,2014/03/31,2011/02/24,14,17,0.600411398,43024,14,7,10
7867,2014/03/31,2013/03/27,31,25,0.681764985,37887,31,1,24
7868,2014/03/31,2011/04/05,117,3,1.002951774,25754,117,0,3
7869,2014/03/31,2004/11/10,73,23,0.824514636,31327,73,6,17
7870,2014/03/31,2005/10/27,63,19,0.765747702,33730,63,10,9
7871,2014/03/31,2010/07/30,24,23,0.87916156,29376,24,15,8
7872,2014/03/31,2011/06/08,24,35,0.7313499659999999,35312,24,22,13
7873,2014/03/31,2005/01/13,68,39,0.617085604,41844,68,19,20
7874,2014/03/31,2011/04/01,37,15,1.457509596,17716,37,9,6
7875,2014/03/31,2012/11/02,25,16,0.695,37152,25,5,11
7876,2014/03/31,2012/11/14,13,34,0.778636953,33161,13,11,23
7877,2014/03/31,2010/05/03,2,18,0.83956977,30751,2,9,9
7878,2014/03/31,2004/12/06,35,7,0.8838517379999999,29205,35,0,7
7879,2014/03/31,2011/05/18,73,29,0.691840772,37305,73,16,13
7880,2014/03/31,2011/05/18,21,29,0.84312498,30605,21,12,17
7881,2014/03/31,2010/05/26,4,21,0.825086188,31269,4,12,9
7882,2014/03/31,2006/07/12,15,20,0.640087084,40306,15,5,15
7883,2014/03/31,2011/06/15,79,20,0.82259845,31361,79,9,11
7884,2014/03/31,2008/05/02,8,30,0.599419104,43037,8,14,16
7885,2014/03/31,2013/01/16,10,31,0.86179996,29934,10,7,24
7886,2014/03/31,2005/10/24,5,19,0.821821108,31382,5,10,9
7887,2014/03/31,2006/06/02,12,30,0.6464389739999999,39893,12,13,17
7888,2014/03/31,2007/05/28,165,23,0.7408049640000001,34809,165,17,6
7889,2014/03/31,2005/03/12,43,21,0.686096743,37584,43,8,13
7890,2014/03/31,2010/02/13,34,33,0.611377152,42174,34,19,14
7891,2014/03/31,2012/08/14,12,26,0.685057658,37636,12,5,21
7892,2014/03/31,2009/12/05,10,29,0.7940289540000001,32465,10,22,7
7893,2014/03/31,2011/03/17,20,22,0.637107514,40460,20,13,9
7894,2014/03/31,2008/10/12,151,28,0.7228034659999999,35663,151,14,14
7895,2014/03/31,2007/03/16,30,16,0.793549857,32483,30,8,8
7896,2014/03/31,2012/03/09,10,23,0.7348128509999999,35079,10,9,14
7897,2014/03/31,2010/05/16,11,18,0.780026634,33040,11,0,18
7898,2014/03/31,2005/03/14,13,31,0.765717767,33653,13,14,17
7899,2014/03/31,2009/04/07,5,31,0.92790175,27766,5,14,17
7900,2014/03/31,2009/11/13,2,29,0.702276073,36686,2,16,13
7901,2014/03/31,2006/09/19,225,26,0.7033320590000001,36629,225,23,3
7902,2014/03/31,2007/09/10,8,40,0.75318655,34200,8,12,28
7903,2014/03/31,2013/03/14,17,22,0.843960224,30521,17,1,21
7904,2014/03/31,2012/08/09,29,20,0.554511754,46452,29,13,7
7905,2014/03/31,2010/10/08,17,18,0.8076536440000001,31892,17,7,11
7906,2014/03/31,2006/02/09,10,17,0.671103757,38378,10,6,11
7907,2014/03/31,2008/02/12,65,25,0.6629632679999999,38849,65,17,8
7908,2014/03/31,2011/01/18,110,11,0.881226689,29225,110,6,5
7909,2014/03/31,2007/10/01,70,27,0.804437121,32014,70,16,11
7910,2014/03/31,2012/08/29,100,17,0.737801461,34905,100,7,10
7911,2014/03/31,2007/02/15,59,11,0.6757268809999999,38108,59,9,2
7912,2014/03/31,2005/06/01,29,28,0.70071518,36746,29,15,13
7913,2014/03/31,2012/09/20,88,6,1.442733232,17847,88,0,6
7914,2014/03/31,2012/04/15,74,42,0.684326228,37624,74,32,10
7915,2014/03/31,2011/03/28,131,13,0.7827628459999999,32890,131,4,9
7916,2014/03/31,2011/01/14,56,38,0.7233803529999999,35588,56,26,12
7917,2014/03/31,2012/12/05,76,25,0.723499902,35581,76,10,15
7918,2014/03/31,2008/12/16,1,21,0.626722337,41075,1,5,16
7919,2014/03/31,2006/09/18,7,24,0.768881123,33480,7,12,12
7920,2014/03/31,2013/01/06,150,15,0.829371395,31037,150,4,11
7921,2014/03/31,2011/03/10,12,46,0.7682760270000001,33504,12,27,19
7922,2014/03/31,2012/08/12,35,21,0.471701488,54564,35,7,14
7923,2014/03/31,2009/09/01,7,29,0.63602259,40461,7,12,17
7924,2014/03/31,2007/04/12,6,22,0.6421532320000001,40070,6,13,9
7925,2014/03/31,2011/05/14,20,22,0.727587455,35361,20,5,17
7926,2014/03/31,2008/03/14,23,29,0.748851987,34355,23,16,13
7927,2014/03/31,2009/08/05,19,32,0.788564596,32618,19,11,21
7928,2014/03/31,2010/04/25,2,18,0.8388752979999999,30657,2,8,10
7929,2014/03/31,2010/12/04,44,20,0.762235824,33737,44,13,7
7930,2014/03/31,2008/08/31,120,23,0.659066561,39017,120,9,14
7931,2014/03/31,2011/04/26,6,24,0.8703131140000001,29542,6,12,12
7932,2014/03/31,2012/10/10,11,31,0.844863754,30423,11,11,20
7933,2014/03/31,2010/09/20,24,23,0.7147449240000001,35950,24,12,11
7934,2014/03/31,2007/07/08,19,26,0.666721762,38539,19,12,14
7935,2014/03/31,2006/07/02,418,9,0.712155607,36078,418,9,0
7936,2014/03/31,2005/07/16,19,45,0.913778987,28116,19,30,15
7937,2014/03/31,2009/04/10,26,29,0.610027786,42107,26,18,11
7938,2014/03/31,2010/06/07,2,29,0.677107754,37929,2,16,13
7939,2014/03/31,2011/03/06,3,41,0.77478337,33144,3,18,23
7940,2014/03/31,2008/03/03,6,29,0.691046853,37159,6,14,15
7941,2014/03/31,2009/10/21,30,20,0.79152312,32440,30,7,13
7942,2014/03/31,2009/02/23,3,37,0.556500965,46127,3,16,21
7943,2014/03/31,2010/12/15,32,32,0.646580764,39696,32,12,20
7944,2014/03/31,2010/10/11,29,31,0.738297468,34760,29,15,16
7945,2014/03/31,2006/04/12,72,24,0.751832352,34131,72,16,8
7946,2014/03/31,2011/01/24,62,33,0.90389249,28388,62,22,11
7947,2014/03/31,2009/02/10,4,27,0.704414793,36423,4,14,13
7948,2014/03/31,2005/05/27,22,25,0.686954077,37345,22,3,22
7949,2014/03/31,2010/05/10,6,19,0.7319637,35041,6,12,7
7950,2014/03/31,2012/11/03,251,23,0.620262642,41349,251,8,15
7951,2014/03/31,2010/12/07,72,15,0.793748917,32308,72,6,9
7952,2014/03/31,2012/12/08,290,3,0.843333333,30408,290,1,2
7953,2014/03/31,2009/02/22,1,24,0.6968907129999999,36793,1,17,7
7954,2014/03/31,2009/06/19,134,26,0.8123761840000001,31559,134,14,12
7955,2014/03/31,2011/11/16,312,13,0.7461538459999999,34359,312,9,4
7956,2014/03/31,2012/03/13,65,13,0.7461538459999999,34359,65,8,5
7957,2014/03/31,2007/07/16,25,27,0.7589560940000001,33777,25,16,11
7958,2014/03/31,2011/06/06,111,5,0.6759999999999999,37920,111,1,4
7959,2014/03/31,2009/12/06,82,19,0.875162854,29290,82,7,12
7960,2014/03/31,2008/01/30,102,25,0.680934378,37640,102,10,15
7961,2014/03/31,2005/05/07,4,39,0.577644487,44364,4,16,23
7962,2014/03/31,2008/11/01,70,41,0.75273507,34043,70,19,22
7963,2014/03/31,2007/06/21,23,18,0.753368712,34013,23,6,12
7964,2014/03/31,2009/07/23,21,35,0.735097111,34857,21,22,13
7965,2014/03/31,2005/04/05,107,11,0.948697697,27006,107,7,4
7966,2014/03/31,2009/06/29,87,32,0.636509068,40250,87,8,24
7967,2014/03/31,2010/12/20,20,28,0.53040169,48296,20,16,12
7968,2014/03/31,2009/06/28,22,22,0.675267085,37928,22,14,8
7969,2014/03/31,2008/04/14,64,31,0.656041037,39038,64,16,15
7970,2014/03/31,2006/11/09,71,24,0.699375154,36617,71,16,8
7971,2014/03/31,2012/05/17,18,11,0.822067172,31144,18,6,5
7972,2014/03/31,2007/08/15,11,31,0.7009045859999999,36525,11,8,23
7973,2014/03/31,2010/07/22,170,27,0.8165998790000001,31343,170,17,10
7974,2014/03/31,2009/06/08,28,27,0.872043,29349,28,8,19
7975,2014/03/31,2011/12/01,31,24,0.588716645,43472,31,3,21
7976,2014/03/31,2012/12/06,12,31,0.7342660390000001,34852,12,9,22
7977,2014/03/31,2009/03/02,28,32,0.808834761,31633,28,16,16
7978,2014/03/31,2012/09/14,146,23,0.669576823,38211,146,7,16
7979,2014/03/31,2007/02/18,20,17,0.670593247,38146,20,9,8
7980,2014/03/31,2010/09/26,208,21,0.633214913,40393,208,13,8
7981,2014/03/31,2011/03/17,9,38,0.805636026,31744,9,22,16
7982,2014/03/31,2005/06/10,101,28,0.618257779,41361,101,11,17
7983,2014/03/31,2012/01/17,144,28,0.7456186029999999,34295,144,23,5
7984,2014/03/31,2010/08/21,112,26,0.765912358,33386,112,16,10
7985,2014/03/31,2012/04/18,40,20,0.667704002,38284,40,7,13
7986,2014/03/31,2008/08/25,174,16,0.749803766,34092,174,13,3
7987,2014/03/31,2013/01/19,49,38,0.769887955,33201,49,3,35
7988,2014/03/31,2012/06/22,105,10,0.6820792529999999,37475,105,5,5
7989,2014/03/31,2007/04/06,143,26,0.759437197,33653,143,14,12
7990,2014/03/31,2010/11/19,69,26,0.6652928770000001,38412,69,12,14
7991,2014/03/31,2012/03/18,4,52,0.598290684,42713,4,13,39
7992,2014/03/31,2006/06/10,7,33,0.835073856,30600,7,11,22
7993,2014/03/31,2010/09/14,16,28,0.648283546,39401,16,20,8
7994,2014/03/31,2008/01/23,9,30,0.603947225,42293,9,16,14
7995,2014/03/31,2012/01/09,128,22,0.810506442,31514,128,15,7
7996,2014/03/31,2007/12/10,88,31,0.900789687,28353,88,11,20
7997,2014/03/31,2007/10/08,14,36,0.608279977,41982,14,17,19
7998,2014/03/31,2012/09/18,12,13,0.6806755529999999,37510,12,4,9
7999,2014/03/31,2009/02/27,250,15,1.055022935,24199,250,12,3
8000,2014/03/31,2007/07/25,144,17,0.839779598,30399,144,8,9
8001,2014/03/31,2010/08/18,23,34,0.684644227,37285,23,29,5
8002,2014/03/31,2007/09/09,65,25,0.835912425,30534,65,11,14
8003,2014/03/31,2011/08/05,82,12,0.961171951,26554,82,2,10
8004,2014/03/31,2013/01/12,12,31,0.6909242259999999,36939,12,0,31
8005,2014/03/31,2010/02/16,50,14,0.82517994,30927,50,8,6
8006,2014/03/31,2010/04/06,69,22,0.824467707,30951,69,6,16
8007,2014/03/31,2010/05/13,20,29,0.466776973,54666,20,8,21
8008,2014/03/31,2008/06/15,35,23,0.823240305,30994,35,12,11
8009,2014/03/31,2005/02/23,31,24,0.7564201009999999,33730,31,15,9
8010,2014/03/31,2007/09/07,56,23,0.896920481,28446,56,14,9
8011,2014/03/31,2011/08/15,13,26,0.785209898,32492,13,10,16
8012,2014/03/31,2012/10/08,106,15,1.21808212,20945,106,2,13
8013,2014/03/31,2008/09/01,228,11,1.184261838,21540,228,8,3
8014,2014/03/31,2006/09/27,96,24,0.6638969020000001,38410,96,7,17
8015,2014/03/31,2012/07/11,13,28,0.8155994109999999,31264,13,11,17
8016,2014/03/31,2005/10/24,137,26,0.6995207259999999,36451,137,14,12
8017,2014/03/31,2008/12/02,22,33,0.7699649690000001,33114,22,8,25
8018,2014/03/31,2012/01/26,6,28,0.63828781,39943,6,7,21
8019,2014/03/31,2007/07/03,65,17,0.7163231990000001,35588,65,8,9
8020,2014/03/31,2008/05/11,90,17,0.5834046589999999,43696,90,11,6
8021,2014/03/31,2012/03/09,23,35,0.813993677,31312,23,12,23
8022,2014/03/31,2006/09/02,11,16,0.988815723,25771,11,10,6
8023,2014/03/31,2010/09/13,213,15,0.757971321,33613,213,10,5
8024,2014/03/31,2012/03/25,180,25,0.639326641,39845,180,11,14
8025,2014/03/31,2010/04/10,71,17,0.6666890879999999,38207,71,7,10
8026,2014/03/31,2005/06/24,19,23,0.622852636,40892,19,13,10
8027,2014/03/31,2007/04/10,3,7,1.41,18062,3,0,7
8028,2014/03/31,2007/01/05,16,15,1.153201866,22084,16,4,11
8029,2014/03/31,2006/09/01,20,56,0.6469957820000001,39358,20,26,30
8030,2014/03/31,2012/03/11,20,20,0.758771715,33559,20,11,9
8031,2014/03/31,2007/01/23,17,20,0.576792008,44146,17,8,12
8032,2014/03/31,2012/10/26,30,25,0.8073196559999999,31537,30,7,18
8033,2014/03/31,2011/11/08,156,32,0.73854681,34469,156,25,7
8034,2014/03/31,2010/10/20,46,14,0.918451019,27715,46,7,7
8035,2014/03/31,2005/02/21,86,19,0.7305949890000001,34841,86,9,10
8036,2014/03/31,2007/06/24,70,30,0.7244735720000001,35133,70,9,21
8037,2014/03/31,2007/02/23,12,29,0.739861604,34394,12,10,19
8038,2014/03/31,2012/04/11,26,20,1.461623298,17409,26,7,13
8039,2014/03/31,2012/07/05,18,45,0.902372863,28198,18,21,24
8040,2014/03/31,2009/03/23,25,4,0.52,48928,25,2,2
8041,2014/03/31,2012/09/13,27,3,0.693333333,36696,27,1,2
8042,2014/03/31,2005/03/05,25,15,1.211420817,21002,25,4,11
8043,2014/03/31,2010/08/05,43,4,0.6275,40544,43,2,2
8044,2014/03/31,2009/08/19,21,31,0.789746073,32214,21,17,14
8045,2014/03/31,2011/05/26,28,24,0.630048794,40374,28,9,15
8046,2014/03/31,2007/12/01,60,24,0.7693201059999999,33064,60,6,18
8047,2014/03/31,2010/07/23,25,25,0.8425060459999999,30187,25,15,10
8048,2014/03/31,2011/02/27,17,32,0.6853322909999999,37106,17,14,18
8049,2014/03/31,2012/05/23,74,28,0.732067248,34737,74,14,14
8050,2014/03/31,2012/03/03,100,17,0.667486679,38097,100,11,6
8051,2014/03/31,2007/07/07,107,27,0.709844513,35823,107,13,14
8052,2014/03/31,2011/03/22,80,19,0.734848713,34603,80,14,5
8053,2014/03/31,2008/10/12,14,13,0.992688869,25613,14,7,6
8054,2014/03/31,2011/07/12,36,30,0.78238614,32496,36,25,5
8055,2014/03/31,2005/12/06,17,35,0.767441355,33123,17,20,15
8056,2014/03/31,2008/02/20,34,24,0.652305027,38967,34,16,8
8057,2014/03/31,2012/05/02,60,20,0.642380014,39567,60,9,11
8058,2014/03/31,2005/10/07,11,27,0.75183534,33803,11,11,16
8059,2014/03/31,2008/05/17,4,26,0.761100329,33390,4,8,18
8060,2014/03/31,2005/12/22,70,27,0.736671498,34496,70,21,6
8061,2014/03/31,2006/06/24,94,25,0.634846857,40028,94,14,11
8062,2014/03/31,2010/04/19,49,23,0.86330321,29435,49,15,8
8063,2014/03/31,2008/04/05,121,26,0.6580552679999999,38612,121,19,7
8064,2014/03/31,2006/03/10,79,16,1.174155034,21634,79,9,7
8065,2014/03/31,2012/12/10,37,4,0.835004602,30420,37,2,2
8066,2014/03/31,2010/10/09,3,19,0.704276604,36066,3,12,7
8067,2014/03/31,2012/03/06,23,37,0.810425695,31337,23,23,14
8068,2014/03/31,2011/04/29,39,25,0.678519251,37427,39,8,17
8069,2014/03/31,2008/09/05,166,30,0.785997895,32303,166,19,11
8070,2014/03/31,2009/03/30,145,29,0.7866532409999999,32276,145,20,9
8071,2014/03/31,2006/08/13,11,15,0.934041355,27179,11,8,7
8072,2014/03/31,2005/04/27,61,26,0.659661339,38475,61,21,5
8073,2014/03/31,2012/03/25,51,21,0.844727557,30043,51,6,15
8074,2014/03/31,2012/07/21,5,23,0.668628639,37955,5,7,16
8075,2014/03/31,2008/01/20,149,22,0.702419109,36129,149,9,13
8076,2014/03/31,2010/12/29,3,25,0.649871191,39050,3,10,15
8077,2014/03/31,2009/01/09,4,18,0.850752288,29829,4,10,8
8078,2014/03/31,2011/10/27,21,12,0.668467253,37958,21,6,6
8079,2014/03/31,2013/01/01,125,21,1.196190476,21210,125,0,21
8080,2014/03/31,2007/03/22,39,41,0.7676525759999999,33049,39,16,25
8081,2014/03/31,2007/07/02,43,21,0.7703695490000001,32932,43,13,8
8082,2014/03/31,2012/02/27,15,15,0.56704866,44739,15,8,7
8083,2014/03/31,2006/05/15,23,23,0.6722636209999999,37736,23,14,9
8084,2014/03/31,2006/05/15,170,20,0.7908123109999999,32069,170,12,8
8085,2014/03/31,2006/06/09,32,10,0.913822427,27752,32,3,7
8086,2014/03/31,2009/09/10,110,27,1.446666667,17523,110,11,16
8087,2014/03/31,2005/05/20,157,16,0.822808361,30808,157,12,4
8088,2014/03/31,2006/10/15,33,44,0.800357729,31672,33,14,30
8089,2014/03/31,2012/04/07,4,29,0.693642658,36542,4,16,13
8090,2014/03/31,2009/09/11,123,10,0.802891536,31568,123,8,2
8091,2014/03/31,2008/05/12,117,25,0.7425038820000001,34135,117,15,10
8092,2014/03/31,2008/09/26,69,4,0.625,40544,69,0,4
8093,2014/03/31,2009/02/14,85,10,1.259935362,20112,85,5,5
8094,2014/03/31,2010/10/22,51,8,1.455,17412,51,4,4
8095,2014/03/31,2012/09/05,130,15,0.7273333329999999,34830,130,10,5
8096,2014/03/31,2007/09/27,51,26,0.74170971,34152,51,17,9
8097,2014/03/31,2006/06/27,16,15,0.968482508,26155,16,3,12
8098,2014/03/31,2005/12/23,102,15,0.839219045,30181,102,8,7
8099,2014/03/31,2013/01/06,61,17,0.761834261,33245,61,3,14
8100,2014/03/31,2011/03/02,16,13,0.745213912,33986,16,4,9
8101,2014/03/31,2006/03/17,82,24,0.644905656,39271,82,8,16
8102,2014/03/31,2008/05/19,141,14,0.953345129,26564,141,6,8
8103,2014/03/31,2011/10/30,130,3,0.69,36696,130,2,1
8104,2014/03/31,2011/10/30,130,3,0.69,36696,130,2,1
8105,2014/03/31,2012/02/09,7,22,0.6406127770000001,39525,7,7,15
8106,2014/03/31,2009/02/12,51,23,0.906801376,27912,51,9,14
8107,2014/03/31,2011/03/29,58,25,0.767386426,32974,58,14,11
8108,2014/03/31,2010/03/24,11,27,0.743914565,34014,11,19,8
8109,2014/03/31,2012/01/04,25,68,0.8114704,31182,25,42,26
8110,2014/03/31,2005/11/26,17,27,0.732135085,34556,17,8,19
8111,2014/03/31,2007/02/22,58,20,0.66658955,37951,58,14,6
8112,2014/03/31,2012/01/15,3,20,0.710283027,35615,3,8,12
8113,2014/03/31,2005/06/30,48,27,0.63445445,39868,48,9,18
8114,2014/03/31,2008/01/06,12,14,1.084804649,23317,12,5,9
8115,2014/03/31,2011/12/18,64,17,0.89326847,28316,64,8,9
8116,2014/03/31,2007/05/03,23,22,0.954165095,26506,23,8,14
8117,2014/03/31,2006/01/13,91,22,0.7088661209999999,35674,91,11,11
8118,2014/03/31,2011/05/21,10,30,0.608330406,41567,10,16,14
8119,2014/03/31,2008/11/25,7,37,0.752303642,33612,7,19,18
8120,2014/03/31,2005/10/20,6,28,0.7735644140000001,32687,6,16,12
8121,2014/03/31,2010/02/01,119,33,0.731818182,34551,119,17,16
8122,2014/03/31,2012/08/01,119,7,1.188126792,21279,119,0,7
8123,2014/03/31,2008/01/08,8,20,0.839833904,30103,8,8,12
8124,2014/03/31,2007/06/28,13,31,0.544375054,46436,13,15,16
8125,2014/03/31,2007/02/21,77,13,1.136083869,22249,77,3,10
8126,2014/03/31,2008/07/12,11,28,0.828637466,30502,11,14,14
8127,2014/03/31,2006/10/12,13,20,0.8137268540000001,31053,13,8,12
8128,2014/03/31,2006/06/17,11,36,0.899271122,28098,11,16,20
8129,2014/03/31,2012/04/01,15,25,0.63845804,39573,15,14,11
8130,2014/03/31,2006/03/31,84,23,0.556756143,45375,84,14,9
8131,2014/03/31,2011/08/15,671,7,0.578665689,43648,671,7,0
8132,2014/03/31,2010/10/19,37,24,0.627453095,40241,37,8,16
8133,2014/03/31,2007/11/12,102,22,0.8677484879999999,29096,102,4,18
8134,2014/03/31,2010/11/09,87,29,0.702217278,35954,87,21,8
8135,2014/03/31,2012/12/27,23,17,0.8329793129999999,30309,23,4,13
8136,2014/03/31,2013/03/28,25,32,0.767614096,32889,25,0,32
8137,2014/03/31,2012/09/09,147,17,0.812908066,31055,147,9,8
8138,2014/03/31,2005/04/15,1,37,0.663307234,38059,1,25,12
8139,2014/03/31,2010/06/03,25,21,0.600360566,42045,25,9,12
8140,2014/03/31,2011/11/27,14,33,0.636298939,39667,14,15,18
8141,2014/03/31,2008/08/09,134,13,0.753778521,33484,134,3,10
8142,2014/03/31,2012/12/01,6,39,0.551657049,45750,6,0,39
8143,2014/03/31,2012/07/30,2,23,1.376188035,18337,2,14,9
8144,2014/03/31,2008/03/06,1,30,0.683242899,36933,1,15,15
8145,2014/03/31,2012/03/24,33,24,0.561522987,44938,33,19,5
8146,2014/03/31,2009/02/01,35,9,1.35810549,18580,35,5,4
8147,2014/03/31,2008/10/06,30,22,0.697018455,36196,30,5,17
8148,2014/03/31,2010/03/27,19,13,0.8716054590000001,28945,19,10,3
8149,2014/03/31,2011/01/04,2,11,0.7189638070000001,35090,2,8,3
8150,2014/03/31,2012/04/26,33,25,0.8325647709999999,30299,33,8,17
8151,2014/03/31,2009/07/14,1,42,0.73069409,34520,1,3,39
8152,2014/03/31,2011/06/03,78,13,0.7079602490000001,35622,78,4,9
8153,2014/03/31,2008/03/16,22,38,0.499137655,50525,22,20,18
8154,2014/03/31,2011/08/14,20,25,0.750654284,33594,20,14,11
8155,2014/03/31,2006/10/15,94,14,1.298481352,19412,94,6,8
8156,2014/03/31,2006/11/28,48,18,0.522467923,48243,48,6,12
8157,2014/03/31,2010/07/08,11,30,0.646200415,38999,11,15,15
8158,2014/03/31,2006/04/18,3,34,0.779448534,32332,3,14,20
8159,2014/03/31,2013/03/15,4,18,0.827180699,30465,4,0,18
8160,2014/03/31,2011/04/08,70,20,0.848657551,29692,70,8,12
8161,2014/03/31,2006/08/17,603,2,1.03,24464,603,2,0
8162,2014/03/31,2012/07/10,603,2,1.03,24464,603,2,0
8163,2014/03/31,2012/10/17,455,2,1.03,24464,455,2,0
8164,2014/03/31,2010/06/18,223,2,1.03,24464,223,1,1
8165,2014/03/31,2010/05/02,667,2,1.03,24464,667,2,0
8166,2014/03/31,2012/09/22,395,2,1.03,24464,395,2,0
8167,2014/03/31,2012/10/14,468,2,1.03,24464,468,2,0
8168,2014/03/31,2012/11/26,482,2,1.03,24464,482,2,0
8169,2014/03/31,2008/12/19,81,2,1.03,24464,81,0,2
8170,2014/03/31,2006/06/25,94,30,0.632001003,39870,94,13,17
8171,2014/03/31,2012/04/17,11,19,0.642198037,39235,11,9,10
8172,2014/03/31,2012/10/09,24,26,0.797200899,31603,24,5,21
8173,2014/03/31,2012/10/22,3,24,0.667493707,37741,3,7,17
8174,2014/03/31,2012/12/04,1,60,0.632166123,39850,1,11,49
8175,2014/03/31,2009/01/01,43,23,0.83712657,30086,43,14,9
8176,2014/03/31,2006/05/08,4,17,0.731279043,34432,4,12,5
8177,2014/03/31,2008/04/07,2,19,0.856907395,29383,2,9,10
8178,2014/03/31,2009/08/03,94,9,0.457448219,55040,94,4,5
8179,2014/03/31,2007/02/12,21,26,0.78802022,31948,21,13,13
8180,2014/03/31,2009/10/23,18,35,0.662449871,38002,18,15,20
8181,2014/03/31,2006/11/09,5,17,0.7539153609999999,33389,5,3,14
8182,2014/03/31,2013/01/01,5,16,1.121577915,22441,5,0,16
8183,2014/03/31,2007/07/17,241,23,0.693230595,36306,241,19,4
8184,2014/03/31,2006/10/19,43,12,0.8479165120000001,29681,43,0,12
8185,2014/03/31,2011/12/28,21,24,0.600973589,41876,21,6,18
8186,2014/03/31,2008/03/07,130,19,0.67596191,37228,130,9,10
8187,2014/03/31,2011/10/08,47,22,0.76040915,33093,47,19,3
8188,2014/03/31,2005/12/04,16,21,0.6766539359999999,37181,16,8,13
8189,2014/03/31,2013/02/27,10,12,0.725626785,34661,10,0,12
8190,2014/03/31,2009/11/17,6,21,0.719291577,34965,6,5,16
8191,2014/03/31,2009/01/10,12,38,0.757236458,33211,12,10,28
8192,2014/03/31,2007/04/15,121,22,0.738266933,34061,121,14,8
8193,2014/03/31,2013/02/14,9,14,0.687503008,36572,9,0,14
8194,2014/03/31,2006/07/15,303,13,1.174788805,21402,303,12,1
8195,2014/03/31,2012/12/13,71,18,0.736524299,34137,71,6,12
8196,2014/03/31,2012/01/31,49,18,1.252053185,20081,49,9,9
8197,2014/03/31,2009/04/13,207,11,1.435074491,17519,207,10,1
8198,2014/03/31,2012/02/01,2,41,0.801451525,31367,2,18,23
8199,2014/03/31,2008/11/19,1,37,0.803289982,31295,1,14,23
8200,2014/03/31,2012/01/24,19,30,0.820018267,30656,19,17,13
8201,2014/03/31,2006/11/17,3,23,0.673232805,37336,3,4,19
8202,2014/03/31,2009/09/06,75,20,0.919232373,27344,75,8,12
8203,2014/03/31,2012/04/22,119,31,0.8513138020000001,29525,119,18,13
8204,2014/03/31,2007/11/26,598,9,0.996141039,25227,598,9,0
8205,2014/03/31,2008/04/17,5,16,0.564269834,44531,5,5,11
8206,2014/03/31,2011/07/04,260,34,0.7603434809999999,33044,260,30,4
8207,2014/03/31,2011/05/28,21,26,1.133852785,22158,21,13,13
8208,2014/03/31,2012/11/29,43,33,0.706755,35547,43,3,30
8209,2014/03/31,2012/01/04,5,24,0.706591382,35554,5,10,14
8210,2014/03/31,2012/02/22,88,31,0.503531782,49887,88,13,18
8211,2014/03/31,2011/01/01,88,25,0.7910316490000001,31755,88,15,10
8212,2014/03/31,2009/03/11,230,18,0.732095369,34309,230,11,7
8213,2014/03/31,2009/07/22,101,35,0.8092595929999999,31037,101,22,13
8214,2014/03/31,2012/04/12,6,13,0.8134425909999999,30875,6,6,7
8215,2014/03/31,2007/11/14,5,29,0.572595709,43857,5,17,12
8216,2014/03/31,2007/11/11,153,24,0.6941325740000001,36176,153,11,13
8217,2014/03/31,2009/04/19,32,12,0.791666667,31716,32,3,9
8218,2014/03/31,2010/05/23,127,18,0.8453365209999999,29701,127,14,4
8219,2014/03/31,2011/12/28,345,6,0.572808579,43830,345,5,1
8220,2014/03/31,2006/03/07,191,15,0.702865703,35712,191,7,8
8221,2014/03/31,2011/12/05,1,47,0.744227599,33726,1,21,26
8222,2014/03/31,2009/07/29,11,40,0.602451875,41662,11,20,20
8223,2014/03/31,2005/10/19,40,21,0.6999339,35855,40,13,8
8224,2014/03/31,2006/02/09,29,24,0.641906333,39096,29,17,7
8225,2014/03/31,2012/05/19,12,23,0.654475654,38343,12,7,16
8226,2014/03/31,2007/12/09,78,19,0.576021256,43564,78,10,9
8227,2014/03/31,2012/03/05,19,25,0.759837997,33024,19,13,12
8228,2014/03/31,2008/05/15,30,17,0.862817153,29079,30,0,17
8229,2014/03/31,2007/04/16,10,28,0.879817608,28510,10,14,14
8230,2014/03/31,2011/05/19,68,22,1.054137844,23795,68,13,9
8231,2014/03/31,2012/07/01,51,3,0.683333333,36696,51,1,2
8232,2014/03/31,2005/05/17,23,3,0.683333333,36696,23,1,2
8233,2014/03/31,2011/01/25,113,17,0.53758753,46641,113,13,4
8234,2014/03/31,2010/12/16,22,25,0.950427645,26377,22,12,13
8235,2014/03/31,2010/07/31,135,28,0.7529394090000001,33289,135,16,12
8236,2014/03/31,2007/04/13,2,17,0.800384529,31311,2,6,11
8237,2014/03/31,2007/09/11,16,41,0.775137961,32328,16,22,19
8238,2014/03/31,2012/11/02,193,22,0.7878531,31804,193,5,17
8239,2014/03/31,2011/05/25,3,24,0.72295545,34658,3,9,15
8240,2014/03/31,2010/09/28,3,23,0.668682005,37466,3,13,10
8241,2014/03/31,2010/05/13,10,41,0.711871785,35191,10,18,23
8242,2014/03/31,2010/02/14,42,24,0.7978967990000001,31395,42,14,10
8243,2014/03/31,2011/07/31,65,20,0.746576155,33550,65,9,11
8244,2014/03/31,2007/03/14,29,45,0.706820375,35435,29,13,32
8245,2014/03/31,2011/03/05,13,29,0.476131589,52603,13,14,15
8246,2014/03/31,2005/03/18,101,17,0.937202784,26723,101,11,6
8247,2014/03/31,2007/11/11,58,27,0.761905993,32870,58,19,8
8248,2014/03/31,2011/12/01,106,22,0.7091292159999999,35313,106,15,7
8249,2014/03/31,2012/05/22,38,30,0.793500555,31555,38,13,17
8250,2014/03/31,2011/08/11,12,31,0.63318506,39544,12,14,17
8251,2014/03/31,2011/06/09,142,24,0.659689616,37953,142,15,9
8252,2014/03/31,2007/06/11,112,17,0.782287143,32005,112,9,8
8253,2014/03/31,2006/05/22,73,28,0.703668662,35577,73,14,14
8254,2014/03/31,2005/02/04,61,15,1.01696742,24616,61,8,7
8255,2014/03/31,2012/11/07,61,18,1.398396,17899,61,7,11
8256,2014/03/31,2012/10/18,13,30,0.64746959,38638,13,2,28
8257,2014/03/31,2011/02/27,121,20,0.874201845,28616,121,10,10
8258,2014/03/31,2010/06/07,19,29,0.659174704,37950,19,13,16
8259,2014/03/31,2007/11/04,108,18,0.744479207,33593,108,8,10
8260,2014/03/31,2005/10/24,57,27,0.641525911,38980,57,22,5
8261,2014/03/31,2011/06/22,37,12,0.667877404,37440,37,4,8
8262,2014/03/31,2006/12/03,327,17,0.730245021,34242,327,15,2
8263,2014/03/31,2010/06/07,81,21,0.939092172,26624,81,11,10
8264,2014/03/31,2010/03/03,20,21,0.7949098659999999,31453,20,20,1
8265,2014/03/31,2012/03/08,3,24,0.741896311,33697,3,8,16
8266,2014/03/31,2011/10/25,8,43,0.7780827290000001,32129,8,14,29
8267,2014/03/31,2010/11/14,6,26,0.63987636,39065,6,18,8
8268,2014/03/31,2005/03/19,10,22,0.7701167729999999,32456,10,9,13
8269,2014/03/31,2008/10/12,16,32,0.636440212,39272,16,9,23
8270,2014/03/31,2011/04/29,300,30,0.716701557,34871,300,28,2
8271,2014/03/31,2010/01/10,10,17,1.153158891,21669,10,13,4
8272,2014/03/31,2005/05/30,10,33,0.744814152,33549,10,20,13
8273,2014/03/31,2005/08/29,13,9,1.365904866,18290,13,2,7
8274,2014/03/31,2010/05/20,22,14,0.623776873,40049,22,12,2
8275,2014/03/31,2005/07/13,2,25,0.689754798,36215,2,11,14
8276,2014/03/31,2007/12/17,160,27,0.750020117,33305,160,16,11
8277,2014/03/31,2012/01/15,41,34,0.6980771379999999,35780,41,21,13
8278,2014/03/31,2008/06/20,3,27,0.658138652,37951,3,6,21
8279,2014/03/31,2006/03/31,269,9,1.473311114,16952,269,4,5
8280,2014/03/31,2010/02/24,28,34,0.384769887,64903,28,14,20
8281,2014/03/31,2008/09/03,24,19,0.8679819259999999,28770,24,7,12
8282,2014/03/31,2012/08/25,181,13,0.79341923,31472,181,7,6
8283,2014/03/31,2012/08/07,79,24,0.8051878490000001,31009,79,8,16
8284,2014/03/31,2012/03/26,97,18,1.021077477,24446,97,8,10
8285,2014/03/31,2005/10/10,14,19,0.816832908,30558,14,6,13
8286,2014/03/31,2010/02/09,8,15,0.697692523,35775,8,5,10
8287,2014/03/31,2009/04/23,1,25,0.7489161940000001,33327,1,10,15
8288,2014/03/31,2011/07/18,6,10,0.742221033,33624,6,4,6
8289,2014/03/31,2007/04/01,99,18,0.867646732,28760,99,9,9
8290,2014/03/31,2011/04/29,87,19,0.636092077,39228,87,6,13
8291,2014/03/31,2012/11/07,24,40,0.664026665,37577,24,6,34
8292,2014/03/31,2008/11/26,43,21,0.943325016,26451,43,11,10
8293,2014/03/31,2010/12/20,291,44,0.8802557679999999,28346,291,39,5
8294,2014/03/31,2008/01/22,2,22,0.757474196,32940,2,7,15
8295,2014/03/31,2007/10/08,29,21,1.031883039,24179,29,10,11
8296,2014/03/31,2008/12/03,13,22,0.88334667,28243,13,10,12
8297,2014/03/31,2007/01/06,13,14,0.6266847529999999,39810,13,7,7
8298,2014/03/31,2010/01/29,22,21,0.935331234,26673,22,8,13
8299,2014/03/31,2006/01/28,24,33,0.669089154,37284,24,19,14
8300,2014/03/31,2012/03/01,382,39,0.80173389,31115,382,39,0
8301,2014/03/31,2007/11/22,80,5,0.949512789,26272,80,4,1
8302,2014/03/31,2012/01/31,136,12,0.809827933,30802,136,9,3
8303,2014/03/31,2006/01/18,18,20,0.847635523,29423,18,9,11
8304,2014/03/31,2012/06/23,41,19,0.8564541609999999,29113,41,9,10
8305,2014/03/31,2010/08/31,14,18,0.712167952,35010,14,15,3
8306,2014/03/31,2012/07/31,6,59,1.112033898,22420,6,2,57
8307,2014/03/31,2006/04/04,28,26,0.63179443,39461,28,15,11
8308,2014/03/31,2009/11/29,59,39,0.8615886070000001,28931,59,19,20
8309,2014/03/31,2007/08/01,91,13,1.138111157,21897,91,4,9
8310,2014/03/31,2012/09/14,12,20,0.597942263,41672,12,3,17
8311,2014/03/31,2011/03/16,12,14,0.867410089,28723,12,6,8
8312,2014/03/31,2011/03/14,26,23,0.796705043,31269,26,14,9
8313,2014/03/31,2010/10/05,33,29,0.551208568,45194,33,6,23
8314,2014/03/31,2006/01/27,133,14,0.920285197,27069,133,4,10
8315,2014/03/31,2012/06/25,5,22,0.853039964,29201,5,13,9
8316,2014/03/31,2005/05/01,26,43,0.565575006,44043,26,26,17
8317,2014/03/31,2006/03/24,90,17,0.553381912,45013,90,7,10
8318,2014/03/31,2008/12/03,60,16,0.7157252059999999,34797,60,4,12
8319,2014/03/31,2006/03/25,4,28,0.5989799889999999,41578,4,8,20
8320,2014/03/31,2007/08/03,12,35,0.6727505540000001,37018,12,18,17
8321,2014/03/31,2008/02/24,111,18,0.806822763,30857,111,7,11
8322,2014/03/31,2013/01/13,76,18,0.658181794,37823,76,2,16
8323,2014/03/31,2012/05/08,1,36,0.7317934620000001,34018,1,7,29
8324,2014/03/31,2011/12/04,57,25,0.731883508,34011,57,13,12
8325,2014/03/31,2012/12/03,9,32,0.737704393,33734,9,7,25
8326,2014/03/31,2006/11/21,37,17,1.139335684,21842,37,9,8
8327,2014/03/31,2012/08/12,4,16,0.8333711779999999,29859,4,3,13
8328,2014/03/31,2007/01/15,2,26,0.8035733890000001,30965,2,8,18
8329,2014/03/31,2012/07/18,216,10,0.657636594,37831,216,8,2
8330,2014/03/31,2011/04/02,96,23,0.7483029990000001,33241,96,14,9
8331,2014/03/31,2012/05/15,10,19,0.754654246,32957,10,6,13
8332,2014/03/31,2011/08/20,178,19,0.7226409229999999,34416,178,11,8
8333,2014/03/31,2010/12/18,250,20,0.976811076,25460,250,12,8
8334,2014/03/31,2006/08/16,26,27,0.792277795,31390,26,19,8
8335,2014/03/31,2006/10/16,90,28,0.577340747,43076,90,15,13
8336,2014/03/31,2008/07/22,133,26,0.656634014,37873,133,15,11
8337,2014/03/31,2012/10/30,41,16,0.669375,37152,41,8,8
8338,2014/03/31,2012/07/08,39,33,0.656882149,37853,39,19,14
8339,2014/03/31,2013/03/22,3,30,0.554407796,44841,3,1,29
8340,2014/03/31,2008/12/02,33,37,0.826713445,30071,33,22,15
8341,2014/03/31,2009/12/07,10,21,0.934102439,26611,10,13,8
8342,2014/03/31,2009/04/30,3,22,0.73952099,33611,3,7,15
8343,2014/03/31,2012/12/20,58,17,0.88710161,28019,58,6,11
8344,2014/03/31,2011/03/11,25,32,0.67846809,36634,25,6,26
8345,2014/03/31,2012/06/13,45,21,0.725309654,34264,45,5,16
8346,2014/03/31,2007/11/01,74,11,1.452599088,17106,74,9,2
8347,2014/03/31,2012/04/23,408,11,0.854545455,29073,408,11,0
8348,2014/03/31,2012/12/12,2,37,0.8950547670000001,27754,2,3,34
8349,2014/03/31,2012/09/13,6,35,0.724824638,34272,6,10,25
8350,2014/03/31,2006/05/08,13,25,0.7542025990000001,32932,13,10,15
8351,2014/03/31,2010/11/14,208,11,1.346214971,18449,208,8,3
8352,2014/03/31,2010/12/13,42,27,0.5901882039999999,42082,42,9,18
8353,2014/03/31,2010/03/02,14,34,0.6039098070000001,41112,14,10,24
8354,2014/03/31,2006/03/08,138,20,0.8057575459999999,30810,138,6,14
8355,2014/03/31,2007/04/01,32,18,0.697650845,35583,32,11,7
8356,2014/03/31,2007/04/27,36,18,0.567647853,43726,36,6,12
8357,2014/03/31,2008/08/18,19,37,0.728929547,34051,19,14,23
8358,2014/03/31,2013/01/13,86,9,0.732296572,33894,86,2,7
8359,2014/03/31,2011/05/16,37,42,0.826123556,30043,37,26,16
8360,2014/03/31,2008/12/02,30,31,0.568160841,43683,30,15,16
8361,2014/03/31,2011/01/27,12,24,0.8348302320000001,29717,12,16,8
8362,2014/03/31,2010/06/30,168,17,0.7558453190000001,32816,168,12,5
8363,2014/03/31,2008/05/24,8,35,0.674177336,36789,8,12,23
8364,2014/03/31,2009/01/16,103,28,0.80918404,30651,103,10,18
8365,2014/03/31,2012/05/31,10,24,0.763354775,32491,10,11,13
8366,2014/03/31,2006/07/08,42,23,0.762912424,32509,42,12,11
8367,2014/03/31,2008/12/18,12,12,0.943129635,26297,12,5,7
8368,2014/03/31,2008/05/03,80,25,0.7284101390000001,34047,80,13,12
8369,2014/03/31,2011/10/14,168,28,0.8443090590000001,29373,168,25,3
8370,2014/03/31,2007/10/09,14,39,0.8507502570000001,29150,14,10,29
8371,2014/03/31,2011/12/16,72,13,0.68863038,36010,72,1,12
8372,2014/03/31,2007/11/19,135,35,0.709500143,34950,135,20,15
8373,2014/03/31,2010/07/25,92,39,0.774406134,32019,92,29,10
8374,2014/03/31,2008/04/27,30,17,0.763433295,32479,30,9,8
8375,2014/03/31,2007/11/21,65,15,0.912102707,27184,65,8,7
8376,2014/03/31,2012/04/18,30,35,0.752829816,32935,30,11,24
8377,2014/03/31,2012/06/02,11,21,0.7170834779999999,34572,11,8,13
8378,2014/03/31,2009/09/01,2,30,0.830969126,29831,2,16,14
8379,2014/03/31,2009/06/08,21,26,0.658355426,37645,21,14,12
8380,2014/03/31,2010/03/04,1,28,0.610376829,40602,1,7,21
8381,2014/03/31,2013/01/13,97,21,0.753300505,32898,97,2,19
8382,2014/03/31,2006/02/16,4,18,0.7213390000000001,34354,4,6,12
8383,2014/03/31,2011/06/03,2,42,0.8666679490000001,28583,2,29,13
8384,2014/03/31,2011/12/25,39,21,0.57114739,43368,39,13,8
8385,2014/03/31,2013/01/30,28,4,0.814694059,30398,28,2,2
8386,2014/03/31,2006/07/18,77,23,0.697131838,35521,77,8,15
8387,2014/03/31,2009/01/25,36,32,0.6829260559999999,36257,36,21,11
8388,2014/03/31,2006/04/10,6,42,0.6369516120000001,38873,6,18,24
8389,2014/03/31,2008/10/10,96,15,1.456224784,17003,96,9,6
8390,2014/03/31,2011/09/23,32,19,0.716527565,34555,32,8,11
8391,2014/03/31,2010/10/29,36,27,0.6899013540000001,35886,36,18,9
8392,2014/03/31,2011/07/11,61,26,0.805107317,30750,61,13,13
8393,2014/03/31,2013/02/28,13,27,0.699015162,35417,13,0,27
8394,2014/03/31,2012/01/16,38,16,0.5531119999999999,44759,38,8,8
8395,2014/03/31,2012/01/11,3,40,0.7734278929999999,32008,3,18,22
8396,2014/03/31,2007/04/24,15,30,0.6820908309999999,36287,15,12,18
8397,2014/03/31,2011/04/14,11,20,1.0417776559999998,23756,11,11,9
8398,2014/03/31,2010/09/08,90,19,0.687121835,36016,90,9,10
8399,2014/03/31,2012/08/30,1,26,0.999968885,24747,1,12,14
8400,2014/03/31,2012/02/16,98,19,0.785940478,31484,98,5,14
8401,2014/03/31,2005/12/15,5,20,0.695191627,35590,5,8,12
8402,2014/03/31,2011/10/30,13,9,0.8511111109999999,29070,13,7,2
8403,2014/03/31,2008/02/12,16,21,0.939051848,26346,16,10,11
8404,2014/03/31,2006/08/24,47,22,0.552511167,44776,47,11,11
8405,2014/03/31,2011/11/13,133,16,0.738948862,33478,133,5,11
8406,2014/03/31,2009/08/24,2,20,0.741601451,33351,2,5,15
8407,2014/03/31,2012/04/07,110,29,0.902229316,27412,110,14,15
8408,2014/03/31,2011/01/17,10,21,0.623883493,39637,10,8,13
8409,2014/03/31,2010/02/09,58,20,0.744050248,33235,58,17,3
8410,2014/03/31,2008/04/05,49,22,0.693700836,35646,49,8,14
8411,2014/03/31,2005/07/26,44,18,0.648578024,38123,44,13,5
8412,2014/03/31,2012/07/01,16,37,0.79798935,30985,16,9,28
8413,2014/03/31,2008/08/20,4,20,0.80860675,30576,4,7,13
8414,2014/03/31,2011/11/09,17,27,0.65775274,37588,17,8,19
8415,2014/03/31,2007/02/04,31,35,0.746045326,33138,31,15,20
8416,2014/03/31,2010/07/28,111,15,0.961700058,25705,111,10,5
8417,2014/03/31,2010/09/09,19,24,0.686265408,36020,19,11,13
8418,2014/03/31,2011/02/24,32,21,0.581614118,42500,32,16,5
8419,2014/03/31,2012/01/07,29,17,0.707738518,34924,29,10,7
8420,2014/03/31,2009/09/12,25,33,0.972263787,25422,25,17,16
8421,2014/03/31,2012/07/01,114,13,0.627824011,39366,114,7,6
8422,2014/03/31,2005/11/12,33,27,0.66476316,37177,33,9,18
8423,2014/03/31,2009/12/28,183,12,0.731187644,33798,183,6,6
8424,2014/03/31,2011/10/26,403,11,1.239521469,19936,403,11,0
8425,2014/03/31,2012/07/09,13,18,0.645799378,38261,13,9,9
8426,2014/03/31,2007/12/12,199,17,0.876823538,28176,199,13,4
8427,2014/03/31,2008/02/14,39,23,0.6505364060000001,37975,39,15,8
8428,2014/03/31,2010/09/09,26,29,0.694215259,35585,26,11,18
8429,2014/03/31,2008/07/23,198,24,0.882659282,27985,198,16,8
8430,2014/03/31,2005/02/18,30,22,0.714644717,34564,30,13,9
8431,2014/03/31,2009/05/21,45,23,0.580411233,42555,45,11,12
8432,2014/03/31,2010/11/10,214,26,0.753492175,32779,214,20,6
8433,2014/03/31,2012/12/25,74,20,0.7964113890000001,31012,74,7,13
8434,2014/03/31,2006/03/03,8,28,0.704010604,35082,8,10,18
8435,2014/03/31,2012/08/25,82,21,0.912487992,27066,82,15,6
8436,2014/03/31,2007/12/14,2,44,0.761221948,32440,2,24,20
8437,2014/03/31,2012/02/27,4,32,0.6107282079999999,40428,4,12,20
8438,2014/03/31,2005/11/01,104,29,0.73539291,33570,104,17,12
8439,2014/03/31,2005/10/20,29,29,0.8115000490000001,30419,29,16,13
8440,2014/03/31,2013/01/05,4,25,0.826984053,29848,4,4,21
8441,2014/03/31,2008/07/22,41,27,0.7183943070000001,34359,41,14,13
8442,2014/03/31,2012/04/27,69,19,0.8052614920000001,30651,69,6,13
8443,2014/03/31,2007/05/23,231,22,0.702052055,35155,231,19,3
8444,2014/03/31,2012/08/08,19,30,0.668922105,36896,19,9,21
8445,2014/03/31,2012/01/16,78,22,0.679077973,36333,78,15,7
8446,2014/03/31,2011/08/10,9,16,0.6927605090000001,35613,9,4,12
8447,2014/03/31,2010/04/13,9,23,0.652983246,37781,9,0,23
8448,2014/03/31,2012/09/11,2,32,0.714635397,34517,2,12,20
8449,2014/03/31,2010/10/10,39,17,0.613670656,40189,39,10,7
8450,2014/03/31,2011/07/08,247,6,0.736047935,33504,247,4,2
8451,2014/03/31,2012/05/28,79,19,0.746833656,33016,79,8,11
8452,2014/03/31,2012/10/03,2,11,0.644266416,38271,2,3,8
8453,2014/03/31,2008/03/01,93,7,0.906858288,27189,93,5,2
8454,2014/03/31,2009/03/03,113,28,0.726530528,33936,113,18,10
8455,2014/03/31,2009/09/29,74,19,0.705547447,34944,74,9,10
8456,2014/03/31,2011/04/29,17,27,0.628060382,39250,17,10,17
8457,2014/03/31,2009/08/26,42,22,0.7340488390000001,33580,42,4,18
8458,2014/03/31,2006/09/28,142,22,0.529791944,46526,142,11,11
8459,2014/03/31,2005/06/21,10,32,0.836049115,29482,10,22,10
8460,2014/03/31,2006/04/19,73,11,0.7605054,32410,73,2,9
8461,2014/03/31,2008/12/15,115,19,0.8821188259999999,27940,115,16,3
8462,2014/03/31,2011/04/01,52,27,0.847975502,29064,52,17,10
8463,2014/03/31,2012/03/06,31,18,0.799725476,30817,31,8,10
8464,2014/03/31,2010/10/10,323,20,0.6731817929999999,36602,323,19,1
8465,2014/03/31,2010/11/03,21,14,0.721276895,34161,21,6,8
8466,2014/03/31,2012/09/27,17,19,0.931727867,26443,17,10,9
8467,2014/03/31,2011/08/22,21,11,0.835193735,29499,21,9,2
8468,2014/03/31,2011/07/06,11,26,0.769276838,32026,11,10,16
8469,2014/03/31,2008/04/02,458,16,0.718724838,34278,458,16,0
8470,2014/03/31,2012/02/25,9,34,0.7386276690000001,33352,9,12,22
8471,2014/03/31,2009/11/27,2,20,0.720136233,34206,2,6,14
8472,2014/03/31,2011/07/04,80,12,0.776666667,31716,80,4,8
8473,2014/03/31,2010/11/10,33,18,0.954345619,25803,33,12,6
8474,2014/03/31,2012/09/19,58,28,0.681024145,36157,58,2,26
8475,2014/03/31,2008/05/31,3,17,0.6969205070000001,35324,3,4,13
8476,2014/03/31,2010/02/14,27,23,0.72476562,33962,27,15,8
8477,2014/03/31,2011/06/06,39,16,1.339642954,18373,39,10,6
8478,2014/03/31,2009/11/29,118,9,1.438898374,17102,118,6,3
8479,2014/03/31,2010/05/20,19,15,0.696733018,35317,19,6,9
8480,2014/03/31,2013/01/29,9,18,0.770844925,31920,9,1,17
8481,2014/03/31,2007/10/12,103,31,0.646811598,38041,103,13,18
8482,2014/03/31,2008/07/14,121,11,0.723323631,34011,121,7,4
8483,2014/03/31,2008/06/18,20,24,0.649535529,37871,20,12,12
8484,2014/03/31,2008/03/19,153,8,0.600975371,40928,153,3,5
8485,2014/03/31,2011/11/19,77,19,0.6821600329999999,36055,77,14,5
8486,2014/03/31,2005/10/03,4,16,1.151942766,21351,4,8,8
8487,2014/03/31,2010/11/19,38,22,0.7090750509999999,34683,38,11,11
8488,2014/03/31,2009/10/17,6,15,0.957875424,25671,6,5,10
8489,2014/03/31,2004/11/02,7,28,0.552618721,44495,7,4,24
8490,2014/03/31,2008/03/06,89,16,0.715584109,34360,89,10,6
8491,2014/03/31,2009/03/22,67,16,1.336855698,18392,67,11,5
8492,2014/03/31,2005/06/08,16,9,1.254972181,19591,16,4,5
8493,2014/03/31,2005/09/01,1,11,1.3896303209999998,17691,1,9,2
8494,2014/03/31,2011/04/11,116,22,0.822185869,29892,116,14,8
8495,2014/03/31,2013/02/07,15,39,0.786765167,31235,15,4,35
8496,2014/03/31,2009/08/13,1,23,0.647457975,37954,1,7,16
8497,2014/03/31,2012/05/25,23,19,0.891981995,27548,23,8,11
8498,2014/03/31,2011/03/14,12,25,0.684663657,35886,12,11,14
8499,2014/03/31,2010/09/29,12,31,0.701766302,35011,12,14,17
8500,2014/03/31,2006/04/12,32,22,0.712374007,34486,32,6,16
8501,2014/03/31,2009/11/09,31,32,0.7175484870000001,34236,31,21,11
8502,2014/03/31,2005/11/24,6,27,0.6789894129999999,36177,6,5,22
8503,2014/03/31,2007/06/07,20,34,0.969467182,25337,20,17,17
8504,2014/03/31,2009/07/29,83,22,0.701441014,35017,83,9,13
8505,2014/03/31,2006/07/25,14,32,0.8504363490000001,28876,14,8,24
8506,2014/03/31,2009/06/17,21,18,0.6448592439999999,38080,21,8,10
8507,2014/03/31,2011/12/21,26,38,0.699495784,35104,26,15,23
8508,2014/03/31,2008/04/18,80,28,0.7214011220000001,34037,80,19,9
8509,2014/03/31,2012/12/21,1,11,0.844545455,29073,1,0,11
8510,2014/03/31,2008/10/21,6,27,0.8369698309999999,29335,6,12,15
8511,2014/03/31,2010/12/16,13,21,0.575507056,42658,13,10,11
8512,2014/03/31,2011/01/14,2,23,0.79916531,30718,2,2,21
8513,2014/03/31,2008/01/21,188,25,0.6164958939999999,39819,188,20,5
8514,2014/03/31,2008/03/01,2,24,0.886244855,27698,2,10,14
8515,2014/03/31,2009/07/06,20,28,0.671666712,36545,20,8,20
8516,2014/03/31,2011/01/28,35,20,0.717816055,34195,35,12,8
8517,2014/03/31,2012/08/23,217,4,0.755,32508,217,0,4
8518,2014/03/31,2010/01/15,159,21,0.763809524,32130,159,12,9
8519,2014/03/31,2006/03/17,37,9,1.441200211,17022,37,3,6
8520,2014/03/31,2012/06/06,27,15,0.863422859,28409,27,6,9
8521,2014/03/31,2006/06/19,12,37,0.821395131,29861,12,22,15
8522,2014/03/31,2009/08/22,274,37,0.940023765,26089,274,30,7
8523,2014/03/31,2010/10/01,138,16,0.724500872,33849,138,12,4
8524,2014/03/31,2012/05/13,67,9,0.7465905559999999,32847,67,5,4
8525,2014/03/31,2011/01/24,11,11,1.4141324030000002,17341,11,2,9
8526,2014/03/31,2011/12/18,58,37,0.817108534,30009,58,17,20
8527,2014/03/31,2012/01/26,56,13,0.812357522,30180,56,7,6
8528,2014/03/31,2005/08/13,6,38,0.712129619,34424,6,10,28
8529,2014/03/31,2008/03/04,3,32,0.635473635,38574,3,18,14
8530,2014/03/31,2007/10/05,109,13,1.22514847,20004,109,8,5
8531,2014/03/31,2010/07/12,1,33,0.6295684229999999,38927,1,12,21
8532,2014/03/31,2010/06/11,145,24,0.655051855,37412,145,16,8
8533,2014/03/31,2004/12/07,46,32,0.6599892279999999,37132,46,18,14
8534,2014/03/31,2011/07/15,283,24,0.7228393609999999,33902,283,21,3
8535,2014/03/31,2010/07/12,45,22,0.719120737,34074,45,14,8
8536,2014/03/31,2012/03/27,122,11,0.701819093,34913,122,7,4
8537,2014/03/31,2004/11/29,67,26,0.551871255,44398,67,8,18
8538,2014/03/31,2013/01/31,9,34,0.656468571,37322,9,3,31
8539,2014/03/31,2008/02/16,26,26,0.5624411739999999,43561,26,12,14
8540,2014/03/31,2012/01/08,81,31,0.851708962,28766,81,19,12
8541,2014/03/31,2009/10/29,32,30,0.833858276,29381,32,15,15
8542,2014/03/31,2011/05/12,32,20,0.749505999,32672,32,4,16
8543,2014/03/31,2011/01/18,219,18,0.91710615,26698,219,12,6
8544,2014/03/31,2012/02/21,144,31,0.631329396,38777,144,19,12
8545,2014/03/31,2011/10/30,14,28,0.723488784,33837,14,7,21
8546,2014/03/31,2010/11/18,382,21,0.625282879,39151,382,21,0
8547,2014/03/31,2011/10/08,99,21,0.7178551320000001,34100,99,8,13
8548,2014/03/31,2012/06/05,365,11,1.203303348,20343,365,10,1
8549,2014/03/31,2011/02/11,95,19,0.628198127,38965,95,7,12
8550,2014/03/31,2013/03/31,1,29,0.717609805,34106,1,1,28
8551,2014/03/31,2006/05/12,80,25,0.5810396489999999,42120,80,15,10
8552,2014/03/31,2012/06/14,112,19,0.772947066,31662,112,8,11
8553,2014/03/31,2008/07/15,156,22,0.819952756,29845,156,7,15
8554,2014/03/31,2005/09/11,80,17,1.39870977,17493,80,15,2
8555,2014/03/31,2008/12/23,6,35,0.799230694,30612,6,21,14
8556,2014/03/31,2010/08/21,117,31,0.80882174,30248,117,22,9
8557,2014/03/31,2008/05/04,1,12,1.314134874,18610,1,3,9
8558,2014/03/31,2011/09/30,272,7,0.710960577,34396,272,2,5
8559,2014/03/31,2011/07/11,65,17,0.707945622,34536,65,7,10
8560,2014/03/31,2005/01/27,53,16,0.961530656,25427,53,13,3
8561,2014/03/31,2005/12/25,22,21,0.683279394,35781,22,5,16
8562,2014/03/31,2005/05/04,340,5,0.492174508,49671,340,2,3
8563,2014/03/31,2006/07/03,48,20,0.615759553,39701,48,9,11
8564,2014/03/31,2012/06/20,67,21,0.7705485329999999,31721,67,8,13
8565,2014/03/31,2005/07/21,109,8,1.480401599,16509,109,5,3
8566,2014/03/31,2011/11/03,45,6,0.621249555,39334,45,1,5
8567,2014/03/31,2011/03/25,7,28,0.757474503,32259,7,15,13
8568,2014/03/31,2005/04/22,208,18,0.76434278,31968,208,15,3
8569,2014/03/31,2010/05/12,48,34,0.6163632920000001,39643,48,16,18
8570,2014/03/31,2012/01/31,17,34,0.79566074,30708,17,12,22
8571,2014/03/31,2012/03/23,11,29,0.695744354,35111,11,13,16
8572,2014/03/31,2008/11/14,101,29,0.698931014,34949,101,16,13
8573,2014/03/31,2008/11/19,57,24,0.7921680609999999,30834,57,21,3
8574,2014/03/31,2011/01/13,4,21,0.83951777,29094,4,4,17
8575,2014/03/31,2011/12/23,143,23,0.696092583,35082,143,16,7
8576,2014/03/31,2011/06/24,81,22,0.804566091,30352,81,10,12
8577,2014/03/31,2010/06/15,25,37,0.903149737,27034,25,32,5
8578,2014/03/31,2010/04/28,72,17,0.73873207,33046,72,9,8
8579,2014/03/31,2011/10/04,2,33,0.708294254,34460,2,11,22
8580,2014/03/31,2008/04/22,82,21,0.758687597,32170,82,15,6
8581,2014/03/31,2012/05/18,190,11,1.246363636,19580,190,7,4
8582,2014/03/31,2009/01/11,162,17,0.773990167,31525,162,14,3
8583,2014/03/31,2007/05/12,4,25,0.62919349,38772,4,13,12
8584,2014/03/31,2005/09/27,11,22,0.7233239440000001,33725,11,9,13
8585,2014/03/31,2010/09/10,68,16,0.661380114,36881,68,6,10
8586,2014/03/31,2011/03/01,8,38,0.581211096,41962,8,21,17
8587,2014/03/31,2005/04/25,5,28,0.6866640390000001,35516,5,24,4
8588,2014/03/31,2012/07/14,1,15,0.79533005,30662,1,3,12
8589,2014/03/31,2004/11/28,37,22,0.6384751129999999,38193,37,11,11
8590,2014/03/31,2006/04/20,24,26,0.5681512120000001,42920,24,15,11
8591,2014/03/31,2009/09/27,18,32,0.61706582,39517,18,15,17
8592,2014/03/31,2009/01/04,2,24,0.66447382,36689,2,10,14
8593,2014/03/31,2008/04/11,24,29,0.625409205,38978,24,16,13
8594,2014/03/31,2006/04/29,70,29,0.803570039,30333,70,12,17
8595,2014/03/31,2008/09/02,21,23,0.605625792,40245,21,7,16
8596,2014/03/31,2013/03/22,12,30,0.588228551,41435,12,3,27
8597,2014/03/31,2006/02/20,35,22,0.867100918,28102,35,11,11
8598,2014/03/31,2012/02/26,249,23,0.6949452340000001,35058,249,18,5
8599,2014/03/31,2012/07/14,21,33,0.772433735,31540,21,9,24
8600,2014/03/31,2006/09/01,90,33,0.672527882,36224,90,3,30
8601,2014/03/31,2012/04/13,18,24,0.684414161,35590,18,18,6
8602,2014/03/31,2010/11/04,32,24,0.6317722729999999,38555,32,10,14
8603,2014/03/31,2007/07/12,12,25,0.658838933,36966,12,15,10
8604,2014/03/31,2009/11/01,41,21,0.5642857139999999,43155,41,14,7
8605,2014/03/31,2010/04/18,38,11,0.733803038,33184,38,1,10
8606,2014/03/31,2010/07/14,103,12,0.684398088,35570,103,10,2
8607,2014/03/31,2009/10/29,4,15,0.6587097820000001,36955,4,5,10
8608,2014/03/31,2010/07/22,36,24,0.678494857,35877,36,14,10
8609,2014/03/31,2011/09/08,27,21,0.9006308740000001,27026,27,10,11
8610,2014/03/31,2009/03/06,6,31,0.794096441,30651,6,13,18
8611,2014/03/31,2012/04/30,21,30,0.585999278,41535,21,13,17
8612,2014/03/31,2010/09/19,118,15,0.618564892,39342,118,5,10
8613,2014/03/31,2010/03/28,4,18,0.754419506,32257,4,10,8
8614,2014/03/31,2012/05/09,2,32,0.825001187,29497,2,15,17
8615,2014/03/31,2012/08/24,12,14,0.626320585,38854,12,4,10
8616,2014/03/31,2010/12/24,121,16,1.001547516,24297,121,6,10
8617,2014/03/31,2012/03/14,89,17,1.414707284,17201,89,7,10
8618,2014/03/31,2009/07/08,34,35,0.774305445,31423,34,17,18
8619,2014/03/31,2006/01/10,29,17,0.534250862,45539,29,7,10
8620,2014/03/31,2011/11/04,80,31,0.688232898,35346,80,14,17
8621,2014/03/31,2010/05/20,20,35,0.7331890390000001,33173,20,11,24
8622,2014/03/31,2007/09/27,15,18,0.67047388,36275,15,5,13
8623,2014/03/31,2006/04/26,435,8,0.680276923,35750,435,8,0
8624,2014/03/31,2012/09/26,37,19,0.74775379,32517,37,5,14
8625,2014/03/31,2011/06/04,22,10,0.934564323,26017,22,1,9
8626,2014/03/31,2010/07/13,194,21,0.681990632,35652,194,10,11
8627,2014/03/31,2011/10/23,23,26,0.690867527,35192,23,13,13
8628,2014/03/31,2010/02/18,42,19,0.650526316,37373,42,7,12
8629,2014/03/31,2006/01/30,36,28,0.656033464,37055,36,7,21
8630,2014/03/31,2010/07/05,74,36,0.431992428,56263,74,21,15
8631,2014/03/31,2012/04/21,131,22,0.671693566,36184,131,14,8
8632,2014/03/31,2007/12/11,19,24,0.781206326,31111,19,14,10
8633,2014/03/31,2008/05/20,22,39,0.77437725,31385,22,16,23
8634,2014/03/31,2009/08/26,5,33,0.574846134,42277,5,13,20
8635,2014/03/31,2013/02/18,51,9,1.421941373,17091,51,2,7
8636,2014/03/31,2012/04/19,291,22,0.832056427,29206,291,21,1
8637,2014/03/31,2007/10/28,64,18,0.682340336,35606,64,11,7
8638,2014/03/31,2010/11/29,18,19,0.558032757,43533,18,12,7
8639,2014/03/31,2007/02/01,105,18,0.8120141740000001,29913,105,9,9
8640,2014/03/31,2007/12/16,423,18,0.6991048559999999,34743,423,18,0
8641,2014/03/31,2011/05/13,2,33,0.721250334,33671,2,21,12
8642,2014/03/31,2010/11/09,35,16,0.6739077590000001,36036,35,10,6
8643,2014/03/31,2008/12/20,1,25,0.566512702,42867,1,13,12
8644,2014/03/31,2006/05/24,112,24,0.730981998,33218,112,16,8
8645,2014/03/31,2007/03/05,44,17,0.7524030859999999,32271,44,6,11
8646,2014/03/31,2005/08/19,48,18,0.649444444,37386,48,6,12
8647,2014/03/31,2005/08/08,72,15,0.764183375,31771,72,1,14
8648,2014/03/31,2012/03/29,8,52,0.5322173020000001,45614,8,22,30
8649,2014/03/31,2008/03/27,7,20,0.62351057,38931,7,7,13
8650,2014/03/31,2011/05/27,153,13,1.076521778,22546,153,5,8
8651,2014/03/31,2009/12/21,24,29,0.7314032970000001,33179,24,12,17
8652,2014/03/31,2010/09/10,27,18,0.6500324129999999,37331,27,7,11
8653,2014/03/31,2012/01/13,14,23,0.7730487420000001,31390,14,9,14
8654,2014/03/31,2007/03/03,13,34,0.7112817359999999,34110,13,20,14
8655,2014/03/31,2005/01/19,4,24,0.572922049,42347,4,17,7
8656,2014/03/31,2011/08/09,70,31,0.746987499,32478,70,21,10
8657,2014/03/31,2006/06/08,20,18,0.968260227,25055,20,11,7
8658,2014/03/31,2007/03/09,123,20,0.905242929,26798,123,13,7
8659,2014/03/31,2008/10/19,78,21,0.630014024,38505,78,6,15
8660,2014/03/31,2012/07/12,18,20,0.608318495,39875,18,10,10
8661,2014/03/31,2011/09/24,24,25,0.71850237,33760,24,11,14
8662,2014/03/31,2009/05/26,189,19,0.782714747,30990,189,12,7
8663,2014/03/31,2011/03/11,39,20,0.743431207,32627,39,10,10
8664,2014/03/31,2011/01/09,1,20,0.637834376,38026,1,10,10
8665,2014/03/31,2011/04/26,25,12,0.647587846,37452,25,7,5
8666,2014/03/31,2004/11/10,34,21,0.77228011,31402,34,6,15
8667,2014/03/31,2012/07/30,336,22,0.67846212,35744,336,19,3
8668,2014/03/31,2010/04/08,63,10,1.392668696,17413,63,6,4
8669,2014/03/31,2010/01/05,33,25,0.7492914970000001,32364,33,14,11
8670,2014/03/31,2009/10/28,49,19,0.6400393320000001,37883,49,12,7
8671,2014/03/31,2011/10/11,121,11,0.785422741,30870,121,5,6
8672,2014/03/31,2007/06/06,32,26,0.7580231359999999,31985,32,13,13
8673,2014/03/31,2011/11/10,80,8,0.6753657590000001,35898,80,4,4
8674,2014/03/31,2012/05/20,86,31,0.8128500540000001,29824,86,22,9
8675,2014/03/31,2012/01/19,12,26,0.7133648220000001,33981,12,8,18
8676,2014/03/31,2010/12/27,10,18,0.962166389,25194,10,8,10
8677,2014/03/31,2012/08/26,16,44,0.86675725,27967,16,12,32
8678,2014/03/31,2013/02/08,2,30,0.7266607709999999,33358,2,3,27
8679,2014/03/31,2011/01/13,37,21,0.869544395,27875,37,13,8
8680,2014/03/31,2008/05/02,6,27,0.620856814,39040,6,9,18
8681,2014/03/31,2009/01/31,26,17,0.716783897,33808,26,7,10
8682,2014/03/31,2010/06/29,18,27,0.68045752,35605,18,10,17
8683,2014/03/31,2010/07/12,144,18,0.74237672,32629,144,12,6
8684,2014/03/31,2011/04/25,10,20,0.7368056820000001,32874,10,13,7
8685,2014/03/31,2006/01/26,102,29,0.621488543,38971,102,15,14
8686,2014/03/31,2009/09/26,30,17,0.938131076,25817,30,6,11
8687,2014/03/31,2010/04/23,11,25,0.4664,51925,11,12,13
8688,2014/03/31,2010/06/16,74,28,0.8161786320000001,29670,74,17,11
8689,2014/03/31,2010/05/24,69,19,0.595011794,40698,69,16,3
8690,2014/03/31,2011/07/25,20,27,0.715662017,33836,20,25,2
8691,2014/03/31,2005/12/18,159,30,0.7715151029999999,31384,159,13,17
8692,2014/03/31,2009/12/31,112,13,1.336552771,18116,112,7,6
8693,2014/03/31,2008/05/02,17,39,0.5567345770000001,43489,17,17,22
8694,2014/03/31,2010/10/29,32,29,0.8644558309999999,28006,32,12,17
8695,2014/03/31,2007/03/14,2,24,0.7685325120000001,31496,2,13,11
8696,2014/03/31,2009/04/18,26,20,0.75369706,32112,26,10,10
8697,2014/03/31,2006/09/14,44,20,0.623450115,38819,44,10,10
8698,2014/03/31,2012/09/15,108,27,0.648111004,37332,108,10,17
8699,2014/03/31,2012/11/07,22,24,0.7123016459999999,33967,22,5,19
8700,2014/03/31,2007/07/02,21,14,0.7563981120000001,31986,21,8,6
8701,2014/03/31,2011/10/21,60,31,0.871939309,27747,60,16,15
8702,2014/03/31,2010/04/08,7,16,0.637433141,37953,7,12,4
8703,2014/03/31,2009/11/30,12,25,0.841475478,28750,12,13,12
8704,2014/03/31,2011/03/02,1,29,0.6898622640000001,35067,1,11,18
8705,2014/03/31,2008/03/11,80,26,0.679544356,35598,80,9,17
8706,2014/03/31,2005/03/27,19,18,0.789536523,30638,19,10,8
8707,2014/03/31,2010/08/17,392,13,0.7846183790000001,30829,392,13,0
8708,2014/03/31,2008/04/24,24,19,0.807867735,29940,24,8,11
8709,2014/03/31,2005/08/04,120,24,0.796858301,30353,120,18,6
8710,2014/03/31,2006/03/30,86,27,0.619688693,39029,86,17,10
8711,2014/03/31,2010/09/13,494,12,0.7625,31716,494,12,0
8712,2014/03/31,2006/12/01,116,19,0.518352982,46654,116,7,12
8713,2014/03/31,2010/03/11,35,31,0.800121104,30222,35,15,16
8714,2014/03/31,2008/08/26,5,33,0.734692675,32913,5,18,15
8715,2014/03/31,2008/12/04,105,11,0.846595007,28561,105,6,5
8716,2014/03/31,2008/08/12,7,33,0.573952241,42128,7,23,10
8717,2014/03/31,2012/11/07,58,20,0.6578807170000001,36753,58,12,8
8718,2014/03/31,2008/04/08,36,20,0.762629022,31700,36,17,3
8719,2014/03/31,2007/02/27,49,21,0.7221764340000001,33463,49,5,16
8720,2014/03/31,2012/03/21,16,16,0.679739529,35551,16,7,9
8721,2014/03/31,2012/07/17,26,20,0.770325522,31365,26,4,16
8722,2014/03/31,2006/09/20,23,35,0.6916200509999999,34931,23,17,18
8723,2014/03/31,2010/11/17,228,25,0.6144232479999999,39315,228,17,8
8724,2014/03/31,2007/08/01,2,18,0.8623065109999999,28012,2,11,7
8725,2014/03/31,2005/05/21,90,19,0.662854398,36435,90,14,5
8726,2014/03/31,2009/07/24,18,39,0.567598768,42549,18,4,35
8727,2014/03/31,2011/03/28,63,23,0.6482654210000001,37254,63,14,9
8728,2014/03/31,2007/08/05,132,30,0.657777384,36700,132,19,11
8729,2014/03/31,2007/06/25,10,19,0.613412031,39349,10,6,13
8730,2014/03/31,2011/09/09,314,19,0.60132664,40139,314,15,4
8731,2014/03/31,2007/02/12,20,22,0.716978195,33662,20,6,16
8732,2014/03/31,2007/08/31,34,18,1.039446574,23219,34,6,12
8733,2014/03/31,2010/02/23,10,28,0.56147258,42979,10,9,19
8734,2014/03/31,2008/09/07,2,31,0.6514945320000001,37035,2,18,13
8735,2014/03/31,2010/06/04,13,29,0.639317345,37735,13,8,21
8736,2014/03/31,2012/01/04,10,34,0.707240469,34100,10,19,15
8737,2014/03/31,2012/03/12,61,17,0.7943968640000001,30358,61,0,17
8738,2014/03/31,2011/01/04,84,31,0.746824094,32290,84,19,12
8739,2014/03/31,2007/09/08,37,13,1.108507861,21754,37,1,12
8740,2014/03/31,2012/08/14,6,15,0.6993755620000001,34479,6,7,8
8741,2014/03/31,2011/09/27,68,26,0.832804988,28952,68,14,12
8742,2014/03/31,2011/12/06,17,22,0.7858666879999999,30680,17,15,7
8743,2014/03/31,2012/06/13,79,28,0.690472003,34915,79,8,20
8744,2014/03/31,2008/09/04,219,25,0.7965115970000001,30266,219,21,4
8745,2014/03/31,2010/05/31,7,37,0.7741517859999999,31136,7,15,22
8746,2014/03/31,2011/02/19,2,20,0.612641519,39341,2,9,11
8747,2014/03/31,2012/12/07,36,24,0.846691843,28466,36,6,18
8748,2014/03/31,2005/10/27,18,13,0.960782938,25085,18,5,8
8749,2014/03/31,2012/07/09,9,26,0.640220221,37644,9,10,16
8750,2014/03/31,2006/12/05,249,26,0.789350454,30529,249,22,4
8751,2014/03/31,2010/09/07,120,23,0.677014695,35591,120,14,9
8752,2014/03/31,2007/10/29,49,4,0.652380862,36932,49,0,4
8753,2014/03/31,2011/09/01,74,22,0.68181988,35332,74,4,18
8754,2014/03/31,2007/10/27,156,11,0.847531225,28423,156,6,5
8755,2014/03/31,2010/10/25,6,29,0.673563839,35762,6,14,15
8756,2014/03/31,2005/09/26,33,23,0.65896982,36547,33,12,11
8757,2014/03/31,2007/09/17,2,28,0.5296999689999999,45462,2,14,14
8758,2014/03/31,2008/06/18,41,19,0.7308066520000001,32951,41,8,11
8759,2014/03/31,2006/06/19,80,26,0.628275673,38328,80,18,8
8760,2014/03/31,2009/08/12,4,28,0.714508175,33701,4,19,9
8761,2014/03/31,2011/02/07,45,16,0.668735661,36003,45,5,11
8762,2014/03/31,2006/06/04,260,22,0.719000568,33479,260,17,5
8763,2014/03/31,2011/06/12,34,13,0.8287599859999999,29040,34,9,4
8764,2014/03/31,2011/12/06,20,17,0.648317304,37119,20,4,13
8765,2014/03/31,2013/03/29,46,14,0.7611801359999999,31615,46,0,14
8766,2014/03/31,2013/03/09,67,4,0.7924566140000001,30367,67,1,3
8767,2014/03/31,2010/03/17,14,26,0.7309526120000001,32920,14,15,11
8768,2014/03/31,2010/01/20,139,30,0.615318126,39104,139,17,13
8769,2014/03/31,2009/12/13,6,47,0.517667499,46478,6,8,39
8770,2014/03/31,2010/12/13,25,38,0.6798965659999999,35385,25,22,16
8771,2014/03/31,2006/05/12,7,23,0.652816045,36846,7,11,12
8772,2014/03/31,2009/04/10,129,19,0.7164057429999999,33573,129,12,7
8773,2014/03/31,2008/10/06,341,7,1.3,18501,341,6,1
8774,2014/03/31,2011/04/06,517,8,0.623993358,38544,517,8,0
8775,2014/03/31,2012/01/20,30,29,0.674505427,35657,30,13,16
8776,2014/03/31,2009/07/13,1,33,0.677555925,35494,1,21,12
8777,2014/03/31,2012/01/05,26,17,0.7894996879999999,30461,26,10,7
8778,2014/03/31,2009/07/16,81,30,0.878285975,27380,81,21,9
8779,2014/03/31,2011/11/25,161,22,0.922578653,26064,161,10,12
8780,2014/03/31,2012/04/18,12,27,0.642973688,37398,12,14,13
8781,2014/03/31,2011/04/13,51,27,0.731005351,32894,51,12,15
8782,2014/03/31,2010/11/21,16,20,0.713437973,33703,16,17,3
8783,2014/03/31,2009/11/22,5,18,0.830884965,28939,5,2,16
8784,2014/03/31,2011/04/10,12,15,1.071835325,22432,12,0,15
8785,2014/03/31,2006/03/27,11,21,0.594834607,40419,11,11,10
8786,2014/03/31,2005/06/28,23,19,0.524097835,45873,23,6,13
8787,2014/03/31,2006/05/08,90,19,0.565839414,42482,90,9,10
8788,2014/03/31,2013/03/27,19,23,0.648726856,37050,19,1,22
8789,2014/03/31,2006/05/01,69,36,0.959104513,25059,69,18,18
8790,2014/03/31,2007/11/01,48,24,0.799802662,30050,48,10,14
8791,2014/03/31,2005/04/17,3,31,0.609631894,39418,3,15,16
8792,2014/03/31,2006/02/14,3,46,0.7018520359999999,34238,3,17,29
8793,2014/03/31,2011/10/30,23,25,0.633603998,37919,23,13,12
8794,2014/03/31,2012/11/17,27,29,0.802183785,29948,27,4,25
8795,2014/03/31,2010/11/29,13,29,0.948135065,25336,13,15,14
8796,2014/03/31,2007/09/24,38,13,0.6642830670000001,36154,38,10,3
8797,2014/03/31,2007/10/24,77,22,0.680578765,35282,77,12,10
8798,2014/03/31,2011/02/28,32,32,0.806871555,29756,32,9,23
8799,2014/03/31,2008/05/12,23,17,0.81391863,29495,23,4,13
8800,2014/03/31,2011/06/08,47,21,0.625983361,38343,47,12,9
8801,2014/03/31,2009/09/13,23,21,0.6958856959999999,34487,23,14,7
8802,2014/03/31,2009/12/10,8,24,0.5083333329999999,47208,8,5,19
8803,2014/03/31,2007/03/26,152,19,0.886522093,27068,152,12,7
8804,2014/03/31,2008/12/17,15,46,0.757202272,31690,15,11,35
8805,2014/03/31,2006/09/17,25,37,0.720841795,33286,25,22,15
8806,2014/03/31,2008/02/24,75,30,0.771775984,31087,75,12,18
8807,2014/03/31,2010/10/27,44,22,1.320062724,18175,44,13,9
8808,2014/03/31,2011/04/19,7,21,0.74132237,32351,7,14,7
8809,2014/03/31,2011/04/22,39,30,0.8206960990000001,29220,39,13,17
8810,2014/03/31,2006/03/28,16,19,0.7209744440000001,33260,16,15,4
8811,2014/03/31,2008/06/27,2,23,0.768522756,31200,2,10,13
8812,2014/03/31,2007/06/27,6,4,0.49,48928,6,1,3
8813,2014/03/31,2005/03/19,3,26,0.6356357220000001,37713,3,7,19
8814,2014/03/31,2009/12/28,69,21,0.603924098,39683,69,7,14
8815,2014/03/31,2007/08/05,12,27,0.685629685,34954,12,10,17
8816,2014/03/31,2009/11/24,32,28,0.588455909,40723,32,15,13
8817,2014/03/31,2007/03/25,33,16,0.8963157890000001,26733,33,9,7
8818,2014/03/31,2012/11/24,38,27,0.967201276,24772,38,8,19
8819,2014/03/31,2005/02/12,2,18,0.620340738,38622,2,11,7
8820,2014/03/31,2012/05/02,44,14,0.836983195,28623,44,5,9
8821,2014/03/31,2011/11/16,1,16,0.7058800129999999,33937,1,5,11
8822,2014/03/31,2010/12/28,30,29,0.732662487,32695,30,8,21
8823,2014/03/31,2007/04/19,5,24,0.879538778,27232,5,15,9
8824,2014/03/31,2011/08/01,9,67,0.612781559,39086,9,25,42
8825,2014/03/31,2008/01/18,99,25,0.7585069990000001,31574,99,11,14
8826,2014/03/31,2008/09/07,15,31,0.566495623,42270,15,11,20
8827,2014/03/31,2009/07/27,103,22,0.7175296659999999,33372,103,16,6
8828,2014/03/31,2006/05/20,12,25,0.797286713,30030,12,7,18
8829,2014/03/31,2011/01/24,6,19,0.7420542379999999,32265,6,9,10
8830,2014/03/31,2011/01/25,26,33,0.7312593540000001,32739,26,23,10
8831,2014/03/31,2013/02/16,6,9,0.726233427,32961,6,1,8
8832,2014/03/31,2007/12/05,81,4,0.7873929209999999,30398,81,0,4
8833,2014/03/31,2010/06/30,170,22,0.7287999390000001,32840,170,12,10
8834,2014/03/31,2009/08/08,37,24,0.75533489,31682,37,11,13
8835,2014/03/31,2008/05/11,186,8,0.7174053859999999,33346,186,6,2
8836,2014/03/31,2009/08/25,35,17,0.77452485,30885,35,10,7
8837,2014/03/31,2011/01/18,55,13,1.4689990780000002,16275,55,6,7
8838,2014/03/31,2009/09/07,112,20,0.8432665509999999,28351,112,13,7
8839,2014/03/31,2009/01/18,1,23,0.75158545,31808,1,14,9
8840,2014/03/31,2013/01/15,7,22,0.623613097,38330,7,4,18
8841,2014/03/31,2007/06/09,143,21,0.582386394,41041,143,13,8
8842,2014/03/31,2011/02/24,8,31,0.796478723,30009,8,13,18
8843,2014/03/31,2008/12/07,89,26,0.662993952,36046,89,12,14
8844,2014/03/31,2010/10/21,63,23,0.7243902729999999,32982,63,10,13
8845,2014/03/31,2005/06/14,13,21,0.76182424,31361,13,1,20
8846,2014/03/31,2012/09/02,72,16,1.284196947,18604,72,3,13
8847,2014/03/31,2009/01/16,7,25,0.7927287209999999,30135,7,12,13
8848,2014/03/31,2010/06/04,60,32,0.691397389,34543,60,14,18
8849,2014/03/31,2008/09/14,32,25,0.593099928,40259,32,10,15
8850,2014/03/31,2010/04/01,2,22,0.6867745279999999,34767,2,9,13
8851,2014/03/31,2010/07/25,42,18,0.551123321,43318,42,6,12
8852,2014/03/31,2007/12/10,7,24,0.571896366,41743,7,11,13
8853,2014/03/31,2010/05/31,79,21,0.531194232,44941,79,8,13
8854,2014/03/31,2010/08/09,16,18,0.7991373190000001,29872,16,15,3
8855,2014/03/31,2010/04/16,267,21,0.811862435,29397,267,15,6
8856,2014/03/31,2011/11/13,347,14,1.217244898,19600,347,11,3
8857,2014/03/31,2008/04/22,59,25,0.705586939,33811,59,14,11
8858,2014/03/31,2005/10/11,2,36,0.792942897,30086,2,10,26
8859,2014/03/31,2005/09/09,48,27,0.6259636279999999,38106,48,15,12
8860,2014/03/31,2010/10/14,72,16,0.871800073,27360,72,8,8
8861,2014/03/31,2006/02/13,324,3,0.65,36696,324,2,1
8862,2014/03/31,2012/09/24,168,3,0.65,36696,168,1,2
8863,2014/03/31,2012/07/17,90,3,0.65,36696,90,1,2
8864,2014/03/31,2011/05/19,18,26,0.787358048,30292,18,12,14
8865,2014/03/31,2012/05/18,31,19,0.632062916,37733,31,12,7
8866,2014/03/31,2007/01/08,18,18,1.357476806,17569,18,8,10
8867,2014/03/31,2008/03/16,27,29,0.609038206,39156,27,13,16
8868,2014/03/31,2007/12/03,72,22,0.6733019929999999,35418,72,12,10
8869,2014/03/31,2011/04/17,164,10,0.845,28220,164,8,2
8870,2014/03/31,2010/02/11,58,20,0.871996636,27346,58,13,7
8871,2014/03/31,2005/05/19,55,19,0.7400062070000001,32223,55,9,10
8872,2014/03/31,2011/06/30,2,27,0.745743237,31975,2,16,11
8873,2014/03/31,2010/09/12,13,31,0.6753034809999999,35307,13,16,15
8874,2014/03/31,2011/08/26,3,19,0.6956456790000001,34274,3,10,9
8875,2014/03/31,2008/04/14,3,20,0.702891385,33918,3,3,17
8876,2014/03/31,2012/05/06,40,24,0.606599578,39301,40,7,17
8877,2014/03/31,2013/02/27,8,27,0.7968364920000001,29913,8,1,26
8878,2014/03/31,2011/05/24,176,15,0.718476773,33173,176,12,3
8879,2014/03/31,2013/01/21,4,17,0.6537585029999999,36456,4,2,15
8880,2014/03/31,2010/03/04,20,21,0.604516399,39423,20,3,18
8881,2014/03/31,2006/08/17,64,18,0.8454953159999999,28184,64,6,12
8882,2014/03/31,2012/03/06,11,16,0.675901858,35255,11,7,9
8883,2014/03/31,2008/01/21,33,5,0.561512159,42436,33,0,5
8884,2014/03/31,2010/03/22,13,28,0.625054432,38121,13,9,19
8885,2014/03/31,2012/12/15,56,11,1.243588727,19160,56,4,7
8886,2014/03/31,2010/09/10,11,24,0.73521185,32405,11,16,8
8887,2014/03/31,2009/03/06,65,24,0.756010728,31507,65,17,7
8888,2014/03/31,2012/04/29,574,3,0.783333333,30408,574,3,0
8889,2014/03/31,2011/12/13,94,29,0.6365970870000001,37415,94,17,12
8890,2014/03/31,2009/06/01,4,23,0.494408694,48173,4,13,10
8891,2014/03/31,2005/11/05,2,32,0.829108442,28725,2,20,12
8892,2014/03/31,2008/11/21,117,20,0.6729532290000001,35385,117,16,4
8893,2014/03/31,2006/05/08,136,23,0.701426762,33944,136,13,10
8894,2014/03/31,2008/12/10,4,24,0.657982366,36181,4,10,14
8895,2014/03/31,2009/08/04,85,22,0.765310079,31105,85,12,10
8896,2014/03/31,2005/12/24,124,8,0.7109293990000001,33484,124,1,7
8897,2014/03/31,2012/04/26,11,27,0.671612685,35444,11,9,18
8898,2014/03/31,2010/03/25,30,22,0.6759058379999999,35216,30,16,6
8899,2014/03/31,2007/08/24,21,31,0.7816285709999999,30450,21,12,19
8900,2014/03/31,2009/01/06,72,36,0.758523759,31377,72,21,15
8901,2014/03/31,2007/05/18,29,22,0.798474883,29801,29,9,13
8902,2014/03/31,2009/04/21,17,24,0.974229446,24424,17,0,24
8903,2014/03/31,2006/10/01,6,12,1.3674862069999998,17400,6,8,4
8904,2014/03/31,2009/03/03,11,21,0.682992795,34837,11,7,14
8905,2014/03/31,2007/06/17,11,22,0.592774359,40139,11,0,22
8906,2014/03/31,2007/03/13,6,25,0.687155277,34622,6,16,9
8907,2014/03/31,2010/09/05,2,28,0.690289321,34460,2,12,16
8908,2014/03/31,2011/12/16,26,34,0.650805768,36549,26,11,23
8909,2014/03/31,2006/11/06,21,19,0.718300513,33110,21,8,11
8910,2014/03/31,2005/03/26,138,19,0.6869727609999999,34619,138,9,10
8911,2014/03/31,2007/05/26,60,21,0.903621371,26316,60,8,13
8912,2014/03/31,2012/05/07,17,27,0.529220889,44923,17,15,12
8913,2014/03/31,2005/09/09,151,18,0.789921917,30096,151,6,12
8914,2014/03/31,2012/07/13,384,11,0.837121879,28397,384,11,0
8915,2014/03/31,2007/08/13,76,30,0.560963844,42372,76,19,11
8916,2014/03/31,2011/12/01,33,16,0.7128301490000001,33341,33,10,6
8917,2014/03/31,2009/10/01,73,26,0.625628356,37988,73,13,13
8918,2014/03/31,2005/04/06,109,31,0.684731579,34703,109,15,16
8919,2014/03/31,2011/08/01,8,13,0.7256079759999999,32748,8,9,4
8920,2014/03/31,2006/07/27,14,20,0.815178222,29149,14,8,12
8921,2014/03/31,2011/03/06,4,31,0.637868478,37241,4,19,12
8922,2014/03/31,2010/07/20,1,19,0.606821642,39146,1,12,7
8923,2014/03/31,2006/10/25,43,17,1.0682352940000002,22236,43,9,8
8924,2014/03/31,2011/11/29,24,34,0.801012782,29651,24,20,14
8925,2014/03/31,2008/12/09,29,19,0.6364035370000001,37320,29,13,6
8926,2014/03/31,2009/04/02,102,23,0.6715877729999999,35364,102,19,4
8927,2014/03/31,2010/05/19,157,22,0.831958593,28546,157,9,13
8928,2014/03/31,2012/06/13,8,24,0.7409156709999999,32053,8,6,18
8929,2014/03/31,2011/10/25,175,22,0.811989264,29247,175,19,3
8930,2014/03/31,2011/12/30,103,30,0.51825604,45821,103,20,10
8931,2014/03/31,2010/05/24,3,38,0.626255835,37915,3,14,24
8932,2014/03/31,2005/12/17,5,30,0.8040255999999999,29531,5,9,21
8933,2014/03/31,2011/05/29,172,33,0.7046857009999999,33694,172,23,10
8934,2014/03/31,2012/12/23,64,18,0.683824309,34720,64,2,16
8935,2014/03/31,2010/04/05,29,26,0.73783267,32164,29,6,20
8936,2014/03/31,2011/10/17,7,11,0.748389467,31710,7,6,5
8937,2014/03/31,2012/02/28,172,25,0.6993740420000001,33932,172,13,12
8938,2014/03/31,2010/06/11,7,24,0.79056033,30018,7,6,18
8939,2014/03/31,2006/03/28,76,41,0.917686983,25858,76,17,24
8940,2014/03/31,2012/06/29,7,20,0.858181555,27650,7,9,11
8941,2014/03/31,2012/05/24,93,4,0.7800105190000001,30420,93,2,2
8942,2014/03/31,2006/09/10,15,40,0.759901355,31223,15,31,9
8943,2014/03/31,2011/03/09,17,19,0.748312512,31698,17,10,9
8944,2014/03/31,2013/01/13,13,16,0.724484254,32739,13,0,16
8945,2014/03/31,2010/07/09,158,32,0.662967073,35776,158,26,6
8946,2014/03/31,2007/06/01,193,24,0.794385571,29857,193,13,11
8947,2014/03/31,2011/11/27,61,18,0.7574874640000001,31311,61,6,12
8948,2014/03/31,2009/06/09,28,21,0.754136221,31449,28,13,8
8949,2014/03/31,2012/08/12,19,17,1.051507493,22554,19,7,10
8950,2014/03/31,2011/12/22,4,20,0.646421251,36686,4,6,14
8951,2014/03/31,2012/04/23,31,31,0.7301157779999999,32476,31,15,16
8952,2014/03/31,2006/12/29,19,33,0.535320825,44292,19,12,21
8953,2014/03/31,2012/06/09,35,16,0.7146548659999999,33161,35,7,9
8954,2014/03/31,2010/12/12,69,18,0.750736575,31565,69,14,4
8955,2014/03/31,2010/11/21,12,44,0.77480807,30584,12,18,26
8956,2014/03/31,2011/02/16,28,23,0.631517631,37519,28,10,13
8957,2014/03/31,2008/10/02,2,24,0.727184862,32581,2,10,14
8958,2014/03/31,2006/07/03,47,32,0.7771792679999999,30485,47,10,22
8959,2014/03/31,2011/10/11,28,17,0.7208344240000001,32861,28,9,8
8960,2014/03/31,2006/07/20,59,18,0.928964625,25498,59,7,11
8961,2014/03/31,2006/09/25,31,15,0.91000269,26026,31,6,9
8962,2014/03/31,2012/11/09,160,18,0.746014175,31745,160,7,11
8963,2014/03/31,2010/06/18,14,9,0.7267972009999999,32584,14,4,5
8964,2014/03/31,2006/02/11,30,36,0.664462903,35636,30,27,9
8965,2014/03/31,2007/10/14,6,33,0.8220451390000001,28800,6,12,21
8966,2014/03/31,2009/04/13,87,16,1.412161646,16765,87,4,12
8967,2014/03/31,2006/12/04,121,20,0.596579551,39679,121,14,6
8968,2014/03/31,2012/12/04,1,33,0.6073207279999999,38977,1,11,22
8969,2014/03/31,2005/10/20,13,28,0.7935931740000001,29826,13,15,13
8970,2014/03/31,2010/09/08,114,22,0.6938051129999999,34112,114,10,12
8971,2014/03/31,2012/09/23,12,21,0.6574731229999999,35997,12,10,11
8972,2014/03/31,2009/12/24,62,12,0.992527367,23843,62,5,7
8973,2014/03/31,2011/10/02,46,4,0.78,30336,46,2,2
8974,2014/03/31,2005/10/08,38,36,0.67849167,34873,38,20,16
8975,2014/03/31,2010/03/14,24,18,1.070731807,22096,24,7,11
8976,2014/03/31,2005/04/04,3,23,0.829249185,28529,3,2,21
8977,2014/03/31,2011/12/30,124,12,0.627002465,37731,124,5,7
8978,2014/03/31,2011/03/24,15,20,0.794372502,29777,15,9,11
8979,2014/03/31,2011/11/02,4,20,0.816570462,28966,4,1,19
8980,2014/03/31,2012/04/24,3,15,0.6917171190000001,34191,3,9,6
8981,2014/03/31,2012/09/23,13,25,0.979803621,24137,13,12,13
8982,2014/03/31,2011/01/04,351,18,0.874441609,27042,351,17,1
8983,2014/03/31,2012/06/15,4,12,1.036792089,22803,4,3,9
8984,2014/03/31,2012/06/23,21,33,0.91575767,25816,21,17,16
8985,2014/03/31,2012/09/25,73,26,0.705786032,33491,73,4,22
8986,2014/03/31,2007/09/12,10,21,0.780079535,30301,10,6,15
8987,2014/03/31,2012/04/26,7,24,1.306791441,18086,7,10,14
8988,2014/03/31,2010/04/27,195,26,0.931540402,25370,195,23,3
8989,2014/03/31,2007/05/27,60,28,0.6575882120000001,35936,60,15,13
8990,2014/03/31,2008/05/15,111,17,0.843968141,27998,111,8,9
8991,2014/03/31,2007/07/26,95,30,0.7321137759999999,32274,95,22,8
8992,2014/03/31,2009/08/19,287,22,0.7187470340000001,32874,287,17,5
8993,2014/03/31,2011/10/12,10,35,0.717673592,32922,10,12,23
8994,2014/03/31,2011/09/06,122,28,0.782287796,30195,122,14,14
8995,2014/03/31,2012/06/04,46,21,0.773406025,30540,46,3,18
8996,2014/03/31,2010/02/12,86,17,0.781927025,30202,86,4,13
8997,2014/03/31,2009/09/07,35,26,0.6975468909999999,33855,35,14,12
8998,2014/03/31,2008/09/29,4,38,0.428641083,55088,4,14,24
8999,2014/03/31,2008/01/04,39,13,1.295207065,18231,39,7,6
9000,2014/03/31,2011/02/25,12,26,0.7633985320000001,30931,12,14,12
9001,2014/03/31,2007/06/26,18,25,0.666196818,35444,18,15,10
9002,2014/03/31,2011/12/22,192,9,0.704346866,33523,192,5,4
9003,2014/03/31,2009/06/01,27,24,0.645839807,36556,27,13,11
9004,2014/03/31,2012/07/19,55,31,0.605412094,38996,55,12,19
9005,2014/03/31,2007/05/31,5,36,0.479576664,49228,5,18,18
9006,2014/03/31,2007/03/14,109,22,0.903892633,26116,109,8,14
9007,2014/03/31,2012/04/08,434,24,0.881546708,26773,434,24,0
9008,2014/03/31,2010/10/27,308,5,0.77218114,30562,308,2,3
9009,2014/03/31,2011/04/15,9,21,0.780476631,30233,9,7,14
9010,2014/03/31,2008/04/25,128,12,0.637864771,36989,128,3,9
9011,2014/03/31,2012/09/18,2,20,0.610730243,38631,2,5,15
9012,2014/03/31,2011/02/27,51,28,0.638529826,36948,51,15,13
9013,2014/03/31,2012/01/09,210,12,0.536977581,43935,210,11,1
9014,2014/03/31,2013/03/11,53,17,0.715248173,32981,53,1,16
9015,2014/03/31,2008/11/06,6,31,0.754812148,31248,6,13,18
9016,2014/03/31,2012/01/02,18,27,0.8090946520000001,29149,18,11,16
9017,2014/03/31,2011/07/06,147,14,0.799895858,29479,147,10,4
9018,2014/03/31,2006/12/01,5,36,0.6754738709999999,34904,5,19,17
9019,2014/03/31,2012/02/26,211,24,0.666740477,35361,211,17,7
9020,2014/03/31,2012/04/09,34,38,0.6587846860000001,35785,34,24,14
9021,2014/03/31,2012/08/11,47,14,0.764590036,30832,47,3,11
9022,2014/03/31,2008/04/12,12,29,0.915119186,25758,12,18,11
9023,2014/03/31,2009/10/18,56,21,0.6748605540000001,34924,56,17,4
9024,2014/03/31,2007/05/06,33,24,0.660873198,35662,33,7,17
9025,2014/03/31,2008/01/16,3,28,0.8456404740000001,27870,3,13,15
9026,2014/03/31,2012/06/13,36,36,0.765768131,30776,36,18,18
9027,2014/03/31,2008/04/22,11,26,0.710176892,33184,11,12,14
9028,2014/03/31,2012/03/01,2,30,0.8676748040000001,27159,2,14,16
9029,2014/03/31,2009/03/09,31,21,0.707829378,33290,31,6,15
9030,2014/03/31,2010/01/14,19,25,0.657224702,35852,19,11,14
9031,2014/03/31,2010/04/12,5,25,0.6299537479999999,37404,5,13,12
9032,2014/03/31,2010/02/23,25,16,0.542441007,43437,25,3,13
9033,2014/03/31,2008/10/15,61,22,0.7932932659999999,29700,61,12,10
9034,2014/03/31,2008/01/19,311,8,0.661613311,35610,311,7,1
9035,2014/03/31,2006/03/25,27,20,0.579823292,40632,27,8,12
9036,2014/03/31,2011/04/29,98,20,0.570089052,41324,98,10,10
9037,2014/03/31,2012/09/19,128,24,0.587897285,40072,128,11,13
9038,2014/03/31,2008/05/20,137,29,0.6488159960000001,36309,137,21,8
9039,2014/03/31,2011/07/05,17,19,0.738078393,31916,17,12,7
9040,2014/03/31,2010/11/29,13,18,0.8357051120000001,28187,13,8,10
9041,2014/03/31,2011/12/10,73,19,0.754332607,31226,73,9,10
9042,2014/03/31,2007/02/26,66,35,0.6531953189999999,36059,66,18,17
9043,2014/03/31,2008/02/10,53,14,0.562616693,41862,53,10,4
9044,2014/03/31,2006/04/04,17,18,0.780563124,30171,17,8,10
9045,2014/03/31,2010/11/14,277,22,0.5908759029999999,39856,277,15,7
9046,2014/03/31,2011/09/23,367,28,0.82091714,28687,367,28,0
9047,2014/03/31,2008/10/23,58,23,0.7824346959999999,30090,58,10,13
9048,2014/03/31,2011/07/19,136,22,0.736584465,31954,136,11,11
9049,2014/03/31,2006/05/20,140,29,0.974156661,24154,140,14,15
9050,2014/03/31,2010/09/26,8,18,0.712327933,33025,8,10,8
9051,2014/03/31,2013/03/07,7,32,0.62474664,37654,7,0,32
9052,2014/03/31,2009/08/11,326,25,0.860133826,27349,326,23,2
9053,2014/03/31,2011/07/08,109,14,0.701205175,33547,109,12,2
9054,2014/03/31,2012/03/25,76,19,0.947598695,24824,76,10,9
9055,2014/03/31,2011/04/28,67,23,0.793894627,29628,67,16,7
9056,2014/03/31,2010/11/28,76,21,0.728531516,32285,76,11,10
9057,2014/03/31,2011/06/24,101,4,0.5825,40376,101,2,2
9058,2014/03/31,2009/07/25,30,21,0.643644325,36539,30,12,9
9059,2014/03/31,2010/03/23,134,19,1.064033032,22100,134,9,10
9060,2014/03/31,2009/07/27,22,34,0.682505369,34454,22,8,26
9061,2014/03/31,2007/01/10,75,24,0.7261682420000001,32382,75,4,20
9062,2014/03/31,2007/06/15,73,21,0.846689111,27772,73,14,7
9063,2014/03/31,2013/01/06,44,15,0.695075982,33824,44,1,14
9064,2014/03/31,2006/01/01,5,45,0.786001739,29908,5,16,29
9065,2014/03/31,2009/11/12,289,14,1.36824447,17180,289,9,5
9066,2014/03/31,2010/03/18,26,24,0.7149102740000001,32878,26,7,17
9067,2014/03/31,2008/09/25,11,24,0.584512784,40208,11,2,22
9068,2014/03/31,2009/12/28,43,4,0.772506903,30420,43,2,2
9069,2014/03/31,2006/04/26,144,18,0.888723855,26439,144,12,6
9070,2014/03/31,2010/11/01,115,15,0.6918051470000001,33964,115,8,7
9071,2014/03/31,2008/08/16,20,23,0.572534542,41037,20,12,11
9072,2014/03/31,2011/11/17,50,23,0.753259378,31190,50,11,12
9073,2014/03/31,2012/04/18,8,26,0.945460436,24846,8,13,13
9074,2014/03/31,2008/06/15,19,13,0.6469230770000001,36309,19,7,6
9075,2014/03/31,2013/02/28,7,19,0.915703091,25651,7,4,15
9076,2014/03/31,2012/08/15,51,11,0.6956861059999999,33763,51,7,4
9077,2014/03/31,2012/08/06,68,16,1.377615249,17050,68,5,11
9078,2014/03/31,2011/10/08,18,24,0.637791566,36827,18,11,13
9079,2014/03/31,2008/08/19,85,22,0.66214181,35470,85,12,10
9080,2014/03/31,2006/11/11,26,28,0.688743951,34099,26,15,13
9081,2014/03/31,2011/04/25,19,41,0.7672789959999999,30599,19,11,30
9082,2014/03/31,2006/08/23,4,21,0.670235818,35027,4,8,13
9083,2014/03/31,2011/07/17,11,20,1.087861909,21580,11,7,13
9084,2014/03/31,2009/09/07,2,47,0.7387858759999999,31776,2,8,39
9085,2014/03/31,2008/07/09,81,21,0.894036865,26258,81,11,10
9086,2014/03/31,2004/12/02,61,21,0.732893135,32031,61,8,13
9087,2014/03/31,2009/07/16,119,17,0.859051383,27324,119,10,7
9088,2014/03/31,2009/07/11,4,29,0.517233817,45373,4,13,16
9089,2014/03/31,2012/09/19,149,21,0.747851429,31379,149,12,9
9090,2014/03/31,2007/11/05,49,25,0.7356401659999999,31898,49,6,19
9091,2014/03/31,2006/11/27,131,36,0.828772295,28313,131,28,8
9092,2014/03/31,2012/09/23,61,30,0.606526044,38685,61,12,18
9093,2014/03/31,2012/01/02,12,22,0.658732169,35612,12,9,13
9094,2014/03/31,2012/07/27,9,21,0.92085149,25473,9,12,9
9095,2014/03/31,2008/12/30,48,19,0.731277902,32076,48,16,3
9096,2014/03/31,2010/02/15,43,15,0.804166295,29165,43,11,4
9097,2014/03/31,2007/11/20,100,26,0.770299865,30447,100,17,9
9098,2014/03/31,2009/07/17,5,18,0.564860178,41517,5,8,10
9099,2014/03/31,2012/04/15,162,23,0.836588533,28029,162,15,8
9100,2014/03/31,2011/10/12,13,20,0.8898026720000001,26352,13,13,7
9101,2014/03/31,2010/07/09,81,24,0.935140384,25074,81,18,6
9102,2014/03/31,2005/09/23,45,22,0.77799124,30138,45,17,5
9103,2014/03/31,2010/07/19,3,14,0.6782255779999999,34569,3,6,8
9104,2014/03/31,2013/01/06,31,19,0.855399518,27408,31,5,14
9105,2014/03/31,2009/06/12,10,19,0.6264589070000001,37415,10,8,11
9106,2014/03/31,2008/04/19,62,14,0.913295796,25663,62,4,10
9107,2014/03/31,2012/08/31,108,12,0.7655918859999999,30614,108,1,11
9108,2014/03/31,2011/12/17,23,9,0.817028063,28685,23,3,6
9109,2014/03/31,2011/07/01,2,38,0.7504598290000001,31229,2,13,25
9110,2014/03/31,2010/01/01,70,10,1.3243960890000002,17693,70,4,6
9111,2014/03/31,2009/05/23,12,23,0.641157635,36540,12,12,11
9112,2014/03/31,2006/11/20,10,37,0.7458062459999999,31411,10,20,17
9113,2014/03/31,2009/02/12,93,18,0.593349544,39480,93,10,8
9114,2014/03/31,2012/03/21,205,22,0.723746022,32365,205,19,3
9115,2014/03/31,2006/03/31,70,17,0.589048385,39764,70,9,8
9116,2014/03/31,2010/11/29,75,28,0.710049115,32984,75,22,6
9117,2014/03/31,2008/05/13,1,66,0.513136722,45640,1,12,54
9118,2014/03/31,2007/06/06,60,26,0.741851183,31569,60,8,18
9119,2014/03/31,2012/07/17,7,30,0.8750840870000001,26758,7,13,17
9120,2014/03/31,2007/01/25,59,18,0.780118635,30008,59,11,7
9121,2014/03/31,2012/04/25,29,17,1.343130774,17427,29,5,12
9122,2014/03/31,2012/03/11,70,23,0.935704805,25014,70,12,11
9123,2014/03/31,2006/07/06,10,40,0.8589063020000001,27247,10,24,16
9124,2014/03/31,2007/09/11,56,17,0.731764706,31977,56,12,5
9125,2014/03/31,2012/03/15,12,22,0.605337869,38654,12,15,7
9126,2014/03/31,2012/07/14,112,14,1.407146295,16624,112,5,9
9127,2014/03/31,2008/02/22,93,29,0.620676185,37682,93,23,6
9128,2014/03/31,2011/09/29,63,24,0.6949505220000001,33651,63,11,13
9129,2014/03/31,2009/01/30,73,17,0.7817332440000001,29915,73,12,5
9130,2014/03/31,2005/03/26,128,21,0.604167463,38707,128,14,7
9131,2014/03/31,2009/09/17,27,12,0.800056795,29228,27,11,1
9132,2014/03/31,2012/06/27,65,22,0.635617984,36789,65,7,15
9133,2014/03/31,2010/11/11,309,14,0.7370839109999999,31724,309,13,1
9134,2014/03/31,2010/05/18,1,4,0.769979583,30367,1,2,2
9135,2014/03/31,2006/12/28,5,24,0.7063762729999999,33093,5,1,23
9136,2014/03/31,2012/01/15,153,8,0.663415257,35236,153,2,6
9137,2014/03/31,2010/11/17,11,32,0.7830105190000001,29852,11,21,11
9138,2014/03/31,2006/01/02,19,18,0.639682214,36534,19,6,12
9139,2014/03/31,2006/03/29,198,16,0.601552976,38848,198,9,7
9140,2014/03/31,2011/05/27,277,24,0.7560555179999999,30909,277,19,5
9141,2014/03/31,2008/05/07,175,12,1.432531265,16312,175,7,5
9142,2014/03/31,2010/08/12,86,23,0.8319186129999999,28088,86,19,4
9143,2014/03/31,2009/03/02,32,30,0.726844397,32146,32,14,16
9144,2014/03/31,2008/04/08,62,14,0.773961839,30188,62,5,9
9145,2014/03/31,2006/11/03,1,14,0.665937215,35072,1,9,5
9146,2014/03/31,2010/12/13,16,24,0.651291168,35859,16,12,12
9147,2014/03/31,2007/02/26,76,18,0.85029491,27466,76,6,12
9148,2014/03/31,2012/10/30,43,14,0.771566269,30263,43,4,10
9149,2014/03/31,2012/04/17,29,27,0.807723813,28908,29,15,12
9150,2014/03/31,2008/04/01,13,27,0.747830056,31222,13,19,8
9151,2014/03/31,2010/04/07,100,25,0.6379239870000001,36599,100,11,14
9152,2014/03/31,2008/10/08,40,29,0.5963191379999999,39143,40,19,10
9153,2014/03/31,2011/09/08,63,24,0.81388054,28679,63,11,13
9154,2014/03/31,2012/01/27,4,31,0.782289439,29837,4,16,15
9155,2014/03/31,2011/11/16,84,19,1.185256208,19691,84,12,7
9156,2014/03/31,2010/10/10,58,21,0.633953432,36806,58,15,6
9157,2014/03/31,2005/01/25,12,17,0.716169618,32579,12,7,10
9158,2014/03/31,2012/07/06,85,21,0.730823179,31925,85,6,15
9159,2014/03/31,2009/03/20,132,10,0.66,35350,132,5,5
9160,2014/03/31,2009/01/09,132,10,0.66,35350,132,5,5
9161,2014/03/31,2005/05/05,8,12,0.770247606,30290,8,7,5
9162,2014/03/31,2007/03/16,79,19,0.580531044,40185,79,9,10
9163,2014/03/31,2013/01/10,37,16,0.7667887440000001,30418,37,3,13
9164,2014/03/31,2011/04/26,115,14,0.608845933,38308,115,5,9
9165,2014/03/31,2009/03/03,10,31,0.796966684,29265,10,12,19
9166,2014/03/31,2010/02/28,58,19,0.712079936,32751,58,11,8
9167,2014/03/31,2008/06/29,2,19,0.694314595,33586,2,9,10
9168,2014/03/31,2011/04/27,196,22,0.63791596,36554,196,13,9
9169,2014/03/31,2004/12/18,40,25,0.6575484420000001,35455,40,14,11
9170,2014/03/31,2007/05/13,4,29,0.706519762,32992,4,15,14
9171,2014/03/31,2010/02/17,75,17,0.781695677,29817,75,10,7
9172,2014/03/31,2013/01/05,4,16,0.887761018,26253,4,2,14
9173,2014/03/31,2012/09/11,5,26,0.663644184,35108,5,10,16
9174,2014/03/31,2011/08/22,30,20,0.7532468959999999,30928,30,12,8
9175,2014/03/31,2011/04/12,40,21,0.711489479,32743,40,3,18
9176,2014/03/31,2009/05/31,34,11,0.937914066,24833,34,2,9
9177,2014/03/31,2008/04/12,127,24,0.951436275,24480,127,11,13
9178,2014/03/31,2005/03/22,115,20,0.970401667,24000,115,12,8
9179,2014/03/31,2011/06/06,20,32,0.8938505240000001,26051,20,22,10
9180,2014/03/31,2009/08/16,15,29,0.595891536,39073,15,16,13
9181,2014/03/31,2009/12/06,14,21,0.785763415,29630,14,5,16
9182,2014/03/31,2007/04/07,5,25,0.657923755,35386,5,10,15
9183,2014/03/31,2011/09/22,70,25,0.690884945,33697,70,13,12
9184,2014/03/31,2010/12/24,2,25,0.588264012,39574,2,16,9
9185,2014/03/31,2008/12/06,8,20,0.840638613,27685,8,5,15
9186,2014/03/31,2010/11/05,67,25,0.664759769,35008,67,10,15
9187,2014/03/31,2006/08/28,190,24,0.7378474270000001,31539,190,16,8
9188,2014/03/31,2012/04/25,12,22,0.843142143,27599,12,7,15
9189,2014/03/31,2007/10/19,178,4,1.018510899,22846,178,2,2
9190,2014/03/31,2008/03/25,1,24,0.6766159709999999,34388,1,5,19
9191,2014/03/31,2005/09/09,80,24,0.822965478,28272,80,8,16
9192,2014/03/31,2006/07/05,23,32,0.642904287,36181,23,12,20
9193,2014/03/31,2009/06/25,61,25,0.777173405,29930,61,12,13
9194,2014/03/31,2011/10/14,179,19,0.7928261240000001,29337,179,10,9
9195,2014/03/31,2010/04/19,11,22,0.702641994,33100,11,11,11
9196,2014/03/31,2006/11/29,35,30,0.7725880629999999,30092,35,19,11
9197,2014/03/31,2007/09/05,73,17,0.641000221,36262,73,11,6
9198,2014/03/31,2006/05/11,199,11,0.806370512,28825,199,6,5
9199,2014/03/31,2009/10/15,73,21,0.8487325179999999,27385,73,15,6
9200,2014/03/31,2012/03/05,360,3,0.6333333329999999,36696,360,2,1
9201,2014/03/31,2009/02/16,7,35,0.8358783540000001,27802,7,7,28
9202,2014/03/31,2012/11/18,103,29,0.826949575,28101,103,9,20
9203,2014/03/31,2012/08/22,4,24,0.722797512,32150,4,6,18
9204,2014/03/31,2004/11/27,2,16,0.897050263,25904,2,9,7
9205,2014/03/31,2012/06/15,59,14,1.182303857,19654,59,12,2
9206,2014/03/31,2012/10/16,5,24,0.680281063,34156,5,2,22
9207,2014/03/31,2010/04/29,109,23,0.74434933,31214,109,11,12
9208,2014/03/31,2008/06/21,90,30,0.705735593,32919,90,15,15
9209,2014/03/31,2008/05/15,110,11,0.799090909,29073,110,3,8
9210,2014/03/31,2012/07/23,3,20,0.7902,29400,3,7,13
9211,2014/03/31,2010/05/04,107,35,0.74077134,31361,107,26,9
9212,2014/03/31,2007/07/27,4,34,0.892669562,26023,4,9,25
9213,2014/03/31,2008/09/01,8,32,0.7283967259999999,31891,8,11,21
9214,2014/03/31,2009/09/08,15,31,0.654236424,35504,15,14,17
9215,2014/03/31,2011/10/08,7,25,0.735070418,31597,7,14,11
9216,2014/03/31,2011/08/21,16,27,0.635020916,36575,16,6,21
9217,2014/03/31,2006/06/28,7,22,0.63087051,36806,7,6,16
9218,2014/03/31,2012/08/06,44,13,0.731216578,31753,44,3,10
9219,2014/03/31,2007/10/01,16,17,1.056071884,21980,16,9,8
9220,2014/03/31,2011/03/30,72,23,0.851342747,27265,72,17,6
9221,2014/03/31,2007/07/08,37,18,0.5224767029999999,44426,37,4,14
9222,2014/03/31,2009/10/21,139,12,1.484794652,15632,139,10,2
9223,2014/03/31,2009/06/15,103,19,0.67253919,34511,103,12,7
9224,2014/03/31,2010/11/08,74,27,0.7361781959999999,31527,74,13,14
9225,2014/03/31,2013/01/12,31,30,0.678448362,34209,31,2,28
9226,2014/03/31,2010/04/12,24,29,0.735129391,31571,24,17,12
9227,2014/03/31,2010/09/01,434,16,0.621564032,37333,434,16,0
9228,2014/03/31,2008/06/13,139,20,0.634634887,36564,139,10,10
9229,2014/03/31,2011/04/01,8,22,0.757682286,30625,8,2,20
9230,2014/03/31,2012/02/24,69,14,0.546649233,42447,69,10,4
9231,2014/03/31,2007/09/02,174,19,0.6975629190000001,33257,174,10,9
9232,2014/03/31,2010/02/10,2,28,0.774727825,29944,2,15,13
9233,2014/03/31,2010/06/01,8,23,0.604256206,38391,8,16,7
9234,2014/03/31,2012/04/30,9,21,0.943333333,24591,9,13,8
9235,2014/03/31,2008/05/06,20,26,0.857035135,27067,20,14,12
9236,2014/03/31,2012/10/11,51,5,0.744241666,31167,51,1,4
9237,2014/03/31,2010/12/07,110,17,0.746090523,31086,110,1,16
9238,2014/03/31,2012/07/20,77,24,0.6964341479999999,33302,77,14,10
9239,2014/03/31,2010/03/27,33,20,0.728223785,31843,33,14,6
9240,2014/03/31,2010/07/18,12,21,0.7972399090000001,29086,12,0,21
9241,2014/03/31,2007/04/17,186,17,0.668522704,34685,186,10,7
9242,2014/03/31,2006/06/30,103,23,0.589266328,39350,103,12,11
9243,2014/03/31,2007/07/01,87,15,0.802079283,28909,87,8,7
9244,2014/03/31,2013/01/25,22,18,0.62,37386,22,5,13
9245,2014/03/31,2010/12/10,38,28,0.743696217,31167,38,10,18
9246,2014/03/31,2012/09/05,4,15,1.305845547,17740,4,5,10
9247,2014/03/31,2010/06/17,293,19,0.742661195,31189,293,17,2
9248,2014/03/31,2006/06/30,5,10,1.4855291169999998,15592,5,8,2
9249,2014/03/31,2012/12/20,24,20,0.573299255,40397,24,3,17
9250,2014/03/31,2009/05/29,13,25,0.590050446,39250,13,5,20
9251,2014/03/31,2007/06/10,4,14,0.796428571,29078,4,0,14
9252,2014/03/31,2012/05/07,11,22,0.745196703,31062,11,18,4
9253,2014/03/31,2011/01/01,17,17,0.604832245,38270,17,6,11
9254,2014/03/31,2010/08/25,38,16,0.782214863,29591,38,10,6
9255,2014/03/31,2008/06/18,133,29,0.5729003189999999,40399,133,12,17
9256,2014/03/31,2012/02/10,2,19,0.609935428,37942,2,9,10
9257,2014/03/31,2010/11/24,15,20,0.671465049,34463,15,13,7
9258,2014/03/31,2012/12/08,89,16,0.562835008,41111,89,7,9
9259,2014/03/31,2011/03/24,59,27,0.650613576,35562,59,4,23
9260,2014/03/31,2006/03/04,8,30,0.7799615679999999,29663,8,13,17
9261,2014/03/31,2010/07/12,8,36,0.8038501090000001,28781,8,30,6
9262,2014/03/31,2005/04/27,11,28,0.620466651,37287,11,7,21
9263,2014/03/31,2006/06/22,6,25,0.972134723,23797,6,12,13
9264,2014/03/31,2010/05/11,47,23,0.725163323,31900,47,11,12
9265,2014/03/31,2007/01/14,3,36,0.743672958,31103,3,0,36
9266,2014/03/31,2012/03/09,105,17,0.648055026,35692,105,10,7
9267,2014/03/31,2010/12/13,20,24,0.662436272,34914,20,11,13
9268,2014/03/31,2007/08/01,18,28,0.635332125,36402,18,15,13
9269,2014/03/31,2010/06/10,65,18,0.726503,31833,65,12,6
9270,2014/03/31,2012/12/23,85,12,0.6065500420000001,38128,85,1,11
9271,2014/03/31,2008/12/17,27,22,0.632715732,36550,27,8,14
9272,2014/03/31,2007/05/10,75,27,0.873074832,26486,75,11,16
9273,2014/03/31,2012/11/09,1,33,0.843346099,27417,1,9,24
9274,2014/03/31,2013/02/04,87,13,0.644594067,35868,87,4,9
9275,2014/03/31,2009/05/10,22,20,0.633292793,36507,22,8,12
9276,2014/03/31,2009/11/28,94,21,0.86847096,26618,94,11,10
9277,2014/03/31,2012/08/17,81,11,0.7407604059999999,31207,81,7,4
9278,2014/03/31,2009/04/19,85,4,0.76,30416,85,2,2
9279,2014/03/31,2010/07/14,62,25,0.869704941,26571,62,16,9
9280,2014/03/31,2010/10/29,10,11,0.694158907,33290,10,3,8
9281,2014/03/31,2012/08/02,125,14,0.5727630570000001,40343,125,6,8
9282,2014/03/31,2009/11/02,46,20,0.634627026,36410,46,10,10
9283,2014/03/31,2007/07/22,65,18,0.748036842,30889,65,13,5
9284,2014/03/31,2005/11/22,28,15,0.8752098640000001,26398,28,10,5
9285,2014/03/31,2011/03/19,137,4,0.76,30398,137,2,2
9286,2014/03/31,2009/08/11,6,23,0.896492937,25768,6,12,11
9287,2014/03/31,2005/12/01,1,28,0.747676722,30896,1,0,28
9288,2014/03/31,2008/01/08,6,25,0.6768586999999999,34126,6,13,12
9289,2014/03/31,2012/06/17,235,16,0.743774915,31055,235,4,12
9290,2014/03/31,2007/06/17,15,20,0.699763362,33004,15,10,10
9291,2014/03/31,2007/06/22,3,27,0.658500998,35070,3,17,10
9292,2014/03/31,2012/02/26,125,11,0.694824868,33232,125,6,5
9293,2014/03/31,2007/06/13,199,11,0.83568626,27628,199,8,3
9294,2014/03/31,2013/02/27,69,18,0.838333333,27540,69,3,15
9295,2014/03/31,2007/05/19,49,17,0.832904203,27715,49,8,9
9296,2014/03/31,2012/08/11,29,21,0.8028677259999999,28751,29,3,18
9297,2014/03/31,2009/03/14,23,26,0.7470723020000001,30898,23,15,11
9298,2014/03/31,2011/06/09,391,7,0.706845603,32656,391,7,0
9299,2014/03/31,2008/03/08,57,14,0.921412375,25050,57,8,6
9300,2014/03/31,2008/06/23,114,21,0.7952727340000001,29021,114,11,10
9301,2014/03/31,2006/07/04,4,27,0.592146449,38976,4,12,15
9302,2014/03/31,2010/01/09,18,11,0.8454213690000001,27292,18,2,9
9303,2014/03/31,2008/09/27,77,19,0.7986596970000001,28889,77,9,10
9304,2014/03/31,2011/06/15,165,22,0.67644275,34105,165,15,7
9305,2014/03/31,2008/02/06,65,32,0.842284129,27389,65,20,12
9306,2014/03/31,2008/10/31,65,11,0.7741873340000001,29797,65,0,11
9307,2014/03/31,2010/07/17,2,22,0.567845889,40620,2,15,7
9308,2014/03/31,2006/02/14,8,22,0.5704120189999999,40435,8,19,3
9309,2014/03/31,2011/06/11,10,37,0.7221343809999999,31939,10,21,16
9310,2014/03/31,2010/10/07,28,25,0.686427062,33597,28,12,13
9311,2014/03/31,2008/03/30,71,16,1.361757898,16935,71,2,14
9312,2014/03/31,2010/03/30,65,36,0.647678135,35605,65,16,20
9313,2014/03/31,2011/07/01,24,35,0.842767443,27361,24,16,19
9314,2014/03/31,2007/08/27,5,22,0.793843214,29046,5,3,19
9315,2014/03/31,2011/03/13,141,34,0.927991307,24847,141,23,11
9316,2014/03/31,2012/01/28,120,15,0.907358208,25407,120,12,3
9317,2014/03/31,2009/12/06,40,15,0.6041631279999999,38154,40,9,6
9318,2014/03/31,2007/07/20,3,23,0.753984298,30570,3,13,10
9319,2014/03/31,2011/10/26,186,18,0.7306495279999999,31546,186,14,4
9320,2014/03/31,2009/08/11,45,33,0.7556960659999999,30500,45,18,15
9321,2014/03/31,2007/10/19,5,29,0.7459097090000001,30900,5,12,17
9322,2014/03/31,2010/12/23,3,29,0.78018076,29542,3,15,14
9323,2014/03/31,2007/08/02,71,24,0.7046429009999999,32708,71,10,14
9324,2014/03/31,2007/01/05,27,29,0.60127472,38330,27,19,10
9325,2014/03/31,2006/10/16,23,17,0.75111303,30682,23,11,6
9326,2014/03/31,2008/12/19,45,18,0.701636928,32842,45,7,11
9327,2014/03/31,2012/07/18,29,30,0.632960277,36402,29,14,16
9328,2014/03/31,2010/11/17,29,11,0.6044532189999999,38114,29,4,7
9329,2014/03/31,2012/02/10,47,12,0.789715451,29169,47,6,6
9330,2014/03/31,2012/11/19,6,30,0.8201645059999999,28084,6,15,15
9331,2014/03/31,2012/04/06,9,18,0.6997141290000001,32917,9,9,9
9332,2014/03/31,2007/02/16,229,21,0.8630216959999999,26687,229,16,5
9333,2014/03/31,2010/03/01,117,32,0.638760956,36052,117,16,16
9334,2014/03/31,2012/08/05,30,25,0.899874946,25589,30,13,12
9335,2014/03/31,2013/02/06,73,18,0.656116826,35095,73,6,12
9336,2014/03/31,2008/03/01,2,24,0.5965761310000001,38585,2,14,10
9337,2014/03/31,2007/11/12,225,22,0.686509679,33527,225,14,8
9338,2014/03/31,2010/12/09,25,15,1.269697689,18127,25,12,3
9339,2014/03/31,2007/06/06,10,21,0.6305082329999999,36499,10,11,10
9340,2014/03/31,2008/04/26,11,20,0.884207877,26025,11,9,11
9341,2014/03/31,2008/02/01,77,19,0.7999874840000001,28763,77,10,9
9342,2014/03/31,2012/11/02,150,3,0.7566666670000001,30408,150,0,3
9343,2014/03/31,2006/04/27,8,29,0.800534869,28736,8,17,12
9344,2014/03/31,2006/01/30,394,6,0.7393770890000001,31112,394,6,0
9345,2014/03/31,2012/04/15,16,39,0.883931138,26023,16,19,20
9346,2014/03/31,2005/06/11,102,32,0.843159708,27281,102,28,4
9347,2014/03/31,2008/01/29,134,23,0.792281276,29032,134,12,11
9348,2014/03/31,2010/05/24,434,25,0.8357218120000001,27521,434,25,0
9349,2014/03/31,2006/03/22,85,12,0.6791666670000001,33864,85,8,4
9350,2014/03/31,2012/01/15,45,20,0.6067013139999999,37906,45,5,15
9351,2014/03/31,2012/04/26,184,19,0.707871083,32486,184,14,5
9352,2014/03/31,2011/11/04,58,8,0.671663405,34237,58,4,4
9353,2014/03/31,2011/06/22,151,16,0.943487198,24372,151,6,10
9354,2014/03/31,2005/01/03,75,17,0.687647059,33439,75,8,9
9355,2014/03/31,2013/02/03,37,14,0.6813334520000001,33747,37,0,14
9356,2014/03/31,2006/05/14,9,31,0.7222041779999999,31835,9,18,13
9357,2014/03/31,2008/10/15,24,23,0.737483801,31174,24,18,5
9358,2014/03/31,2009/09/07,38,22,0.6908582759999999,33276,38,16,6
9359,2014/03/31,2009/01/09,10,19,0.7191890879999999,31964,10,9,10
9360,2014/03/31,2007/01/11,9,20,0.768059342,29928,9,9,11
9361,2014/03/31,2009/02/07,101,15,1.173301174,19590,101,7,8
9362,2014/03/31,2007/03/11,116,6,0.729725662,31494,116,4,2
9363,2014/03/31,2008/03/11,2,24,0.710830782,32331,2,12,12
9364,2014/03/31,2009/02/01,3,10,0.744427525,30866,3,7,3
9365,2014/03/31,2006/06/02,102,14,0.635594036,36151,102,0,14
9366,2014/03/31,2009/01/19,14,34,0.71315631,32218,14,24,10
9367,2014/03/31,2012/01/25,28,11,0.68845679,33372,28,3,8
9368,2014/03/31,2011/07/16,58,23,0.6024604689999999,38135,58,10,13
9369,2014/03/31,2009/08/08,15,24,0.694485052,33081,15,11,13
9370,2014/03/31,2011/10/27,115,8,0.634629133,36199,115,5,3
9371,2014/03/31,2008/07/24,2,50,0.797400722,28808,2,0,50
9372,2014/03/31,2011/05/21,178,17,0.83814512,27398,178,11,6
9373,2014/03/31,2008/11/15,105,17,0.905706059,25352,105,12,5
9374,2014/03/31,2007/01/07,32,20,0.724157388,31705,32,6,14
9375,2014/03/31,2009/08/01,1,33,0.644182379,35640,1,15,18
9376,2014/03/31,2010/02/19,21,37,0.731654025,31378,21,23,14
9377,2014/03/31,2012/11/20,3,24,0.73468798,31248,3,8,16
9378,2014/03/31,2010/03/08,20,18,0.8578341620000001,26761,20,8,10
9379,2014/03/31,2007/02/01,1,66,0.853386869,26898,1,35,31
9380,2014/03/31,2010/07/05,39,23,0.7344910240000001,31249,39,15,8
9381,2014/03/31,2012/11/28,3,22,0.757667877,30290,3,3,19
9382,2014/03/31,2008/06/21,39,24,0.717660579,31978,39,12,12
9383,2014/03/31,2008/10/25,21,16,0.702877577,32649,21,3,13
9384,2014/03/31,2006/11/08,17,28,0.768641053,29854,17,20,8
9385,2014/03/31,2010/11/02,101,28,0.654742745,35043,101,16,12
9386,2014/03/31,2007/04/07,122,23,0.647658217,35426,122,15,8
9387,2014/03/31,2009/12/02,27,19,0.7949338229999999,28862,27,3,16
9388,2014/03/31,2012/03/22,183,15,0.7848074159999999,29234,183,8,7
9389,2014/03/31,2009/02/17,41,26,0.669720925,34256,41,13,13
9390,2014/03/31,2012/06/18,10,42,0.56123792,40875,10,21,21
9391,2014/03/31,2006/10/12,77,21,0.623435878,36797,77,12,9
9392,2014/03/31,2005/03/10,12,17,1.3757349330000002,16675,12,4,13
9393,2014/03/31,2009/08/19,96,31,0.745372543,30775,96,13,18
9394,2014/03/31,2012/08/27,57,14,1.024568966,22388,57,2,12
9395,2014/03/31,2010/09/24,5,26,0.7715575590000001,29726,5,14,12
9396,2014/03/31,2012/11/02,12,26,0.691440458,33170,12,3,23
9397,2014/03/31,2008/08/25,65,36,0.563805005,40678,65,24,12
9398,2014/03/31,2009/10/26,375,7,1.014285714,22610,375,7,0
9399,2014/03/31,2010/02/06,204,13,0.8832704159999999,25960,204,10,3
9400,2014/03/31,2012/04/19,39,10,0.755868333,30334,39,6,4
9401,2014/03/31,2008/07/10,117,19,0.82606089,27755,117,7,12
9402,2014/03/31,2007/11/15,27,20,0.58189253,39397,27,6,14
9403,2014/03/31,2011/05/19,427,11,1.343448195,17064,427,11,0
9404,2014/03/31,2012/02/17,13,25,0.68712847,33362,13,15,10
9405,2014/03/31,2010/04/23,279,31,0.823756334,27825,279,25,6
9406,2014/03/31,2006/05/23,35,21,0.889502076,25767,35,9,12
9407,2014/03/31,2009/03/04,1,16,0.61247134,37421,1,0,16
9408,2014/03/31,2012/07/31,37,23,0.652877735,35104,37,1,22
9409,2014/03/31,2012/01/17,252,17,0.7834162929999999,29251,252,16,1
9410,2014/03/31,2006/07/02,79,19,0.71871942,31884,79,5,14
9411,2014/03/31,2011/06/28,2,37,0.533012354,42983,2,14,23
9412,2014/03/31,2011/11/26,6,29,0.656441916,34898,6,11,18
9413,2014/03/31,2011/03/09,64,20,0.837893485,27339,64,14,6
9414,2014/03/31,2012/08/16,1,27,0.7919488240000001,28920,1,7,20
9415,2014/03/31,2008/05/27,118,26,0.7740304859999999,29587,118,14,12
9416,2014/03/31,2007/07/21,225,23,0.6977153220000001,32823,225,12,11
9417,2014/03/31,2011/12/04,7,28,0.930551831,24609,7,23,5
9418,2014/03/31,2012/06/05,40,21,0.845238341,27083,40,5,16
9419,2014/03/31,2010/12/28,44,35,0.5580734820000001,41017,44,16,19
9420,2014/03/31,2007/06/23,21,25,0.667055515,34315,21,7,18
9421,2014/03/31,2007/09/01,23,31,0.654422043,34968,23,15,16
9422,2014/03/31,2012/08/01,77,5,0.647348515,35350,77,4,1
9423,2014/03/31,2006/07/12,17,31,0.785038252,29149,17,23,8
9424,2014/03/31,2009/04/10,42,31,0.659928186,34673,42,16,15
9425,2014/03/31,2005/10/18,13,10,1.450009506,15780,13,4,6
9426,2014/03/31,2006/04/20,11,14,0.6996904909999999,32697,11,3,11
9427,2014/03/31,2008/08/18,102,12,0.7716666670000001,29640,102,0,12
9428,2014/03/31,2005/11/27,193,8,0.79929927,28613,193,4,4
9429,2014/03/31,2007/01/09,74,5,0.601983364,37991,74,0,5
9430,2014/03/31,2009/09/02,145,22,0.657191218,34798,145,10,12
9431,2014/03/31,2008/07/17,77,16,0.699553353,32688,77,9,7
9432,2014/03/31,2006/04/07,11,33,0.80360336,28454,11,17,16
9433,2014/03/31,2008/04/11,8,22,0.6867511709999999,33292,8,8,14
9434,2014/03/31,2006/05/25,103,21,0.5501446210000001,41557,103,11,10
9435,2014/03/31,2006/05/15,110,15,0.600263614,38086,110,12,3
9436,2014/03/31,2013/01/30,7,22,0.8094723420000001,28238,7,3,19
9437,2014/03/31,2012/05/16,49,24,0.7994341070000001,28592,49,16,8
9438,2014/03/31,2008/07/16,44,6,0.645842211,35389,44,0,6
9439,2014/03/31,2010/05/30,29,20,0.7570351479999999,30187,29,7,13
9440,2014/03/31,2011/05/16,131,21,0.8100960690000001,28209,131,13,8
9441,2014/03/31,2012/01/08,49,31,0.633907737,36049,49,15,16
9442,2014/03/31,2008/11/20,27,18,0.7006906070000001,32609,27,9,9
9443,2014/03/31,2011/03/09,18,20,0.663567445,34428,18,7,13
9444,2014/03/31,2011/05/18,63,17,0.6999574120000001,32638,63,7,10
9445,2014/03/31,2008/12/27,422,6,0.665542509,34322,422,6,0
9446,2014/03/31,2006/08/31,21,22,0.906262498,25204,21,12,10
9447,2014/03/31,2008/02/28,11,9,1.064647618,21454,11,6,3
9448,2014/03/31,2012/07/22,23,24,0.7208875140000001,31684,23,15,9
9449,2014/03/31,2011/06/24,21,11,0.989615251,23080,21,4,7
9450,2014/03/31,2007/11/21,36,22,0.873344295,26152,36,12,10
9451,2014/03/31,2013/01/05,74,18,0.833057704,27416,74,8,10
9452,2014/03/31,2010/03/26,16,14,0.804366569,28393,16,5,9
9453,2014/03/31,2008/07/30,60,26,0.666537653,34260,60,16,10
9454,2014/03/31,2006/04/27,36,24,0.774826592,29468,36,18,6
9455,2014/03/31,2005/12/03,115,21,0.6905132159999999,33066,115,17,4
9456,2014/03/31,2007/04/06,64,34,0.8640459429999999,26424,64,19,15
9457,2014/03/31,2012/05/17,67,30,0.775537061,29438,67,18,12
9458,2014/03/31,2010/06/08,94,22,0.860838235,26520,94,17,5
9459,2014/03/31,2010/04/09,19,34,0.681911405,33478,19,21,13
9460,2014/03/31,2011/10/16,32,11,1.0700740640000002,21333,32,5,6
9461,2014/03/31,2009/12/15,61,20,0.7052072909999999,32370,61,13,7
9462,2014/03/31,2006/03/09,83,13,0.92726896,24617,83,8,5
9463,2014/03/31,2006/06/14,171,22,0.71056884,32118,171,15,7
9464,2014/03/31,2007/10/10,10,16,0.8188971429999999,27864,10,11,5
9465,2014/03/31,2011/09/21,91,10,0.84760104,26920,91,3,7
9466,2014/03/31,2013/03/25,25,26,0.776538462,29380,25,2,24
9467,2014/03/31,2012/12/15,339,4,0.75,30416,339,2,2
9468,2014/03/31,2008/02/11,285,4,0.749993424,30412,285,3,1
9469,2014/03/31,2008/06/05,123,17,1.077853599,21161,123,11,6
9470,2014/03/31,2011/12/21,13,36,0.627204301,36363,13,12,24
9471,2014/03/31,2012/07/22,102,23,0.651529825,35004,102,13,10
9472,2014/03/31,2012/05/03,20,20,0.655439,34795,20,9,11
9473,2014/03/31,2013/01/04,346,3,0.75,30408,346,1,2
9474,2014/03/31,2011/01/04,66,29,0.786050536,29009,66,2,27
9475,2014/03/31,2012/06/23,8,20,0.656714874,34711,8,9,11
9476,2014/03/31,2011/11/11,11,26,0.552043979,41292,11,17,9
9477,2014/03/31,2012/03/27,37,14,0.7081189809999999,32190,37,9,5
9478,2014/03/31,2008/08/08,18,20,0.6766252079999999,33688,18,7,13
9479,2014/03/31,2012/01/25,7,30,0.799735457,28502,7,16,14
9480,2014/03/31,2009/08/06,9,12,0.68,33516,9,6,6
9481,2014/03/31,2007/07/01,3,22,0.652194368,34944,3,7,15
9482,2014/03/31,2012/08/29,43,16,0.75688266,30109,43,4,12
9483,2014/03/31,2005/11/08,68,12,1.428766694,15949,68,8,4
9484,2014/03/31,2007/09/03,122,18,0.790453726,28828,122,15,3
9485,2014/03/31,2011/09/08,75,28,0.6432725420000001,35422,75,14,14
9486,2014/03/31,2012/08/14,12,18,0.705856235,32275,12,8,10
9487,2014/03/31,2010/08/29,6,28,0.6008289379999999,37916,6,10,18
9488,2014/03/31,2008/05/10,75,19,0.93988778,24238,75,14,5
9489,2014/03/31,2007/03/10,18,14,0.8055154,28279,18,7,7
9490,2014/03/31,2010/02/26,136,13,1.049875559,21697,136,7,6
9491,2014/03/31,2005/08/12,3,27,0.8581656870000001,26544,3,16,11
9492,2014/03/31,2012/01/20,245,4,0.75,30367,245,2,2
9493,2014/03/31,2009/07/13,424,20,0.658783882,34569,424,20,0
9494,2014/03/31,2008/03/01,211,15,0.772468198,29479,211,8,7
9495,2014/03/31,2009/11/01,68,35,0.7533480020000001,30224,68,24,11
9496,2014/03/31,2012/12/17,58,5,0.607831055,37456,58,1,4
9497,2014/03/31,2012/04/30,410,15,0.99264443,22935,410,15,0
9498,2014/03/31,2012/07/25,95,35,0.919712335,24751,95,19,16
9499,2014/03/31,2012/03/22,13,23,0.651583889,34933,13,9,14
9500,2014/03/31,2008/06/28,12,15,0.74433402,30579,12,1,14
9501,2014/03/31,2012/03/06,4,14,0.8088436390000001,28140,4,11,3
9502,2014/03/31,2009/02/25,71,25,0.664368031,34258,71,12,13
9503,2014/03/31,2011/05/15,100,22,0.55755267,40820,100,9,13
9504,2014/03/31,2010/04/08,165,28,0.707766133,32155,165,15,13
9505,2014/03/31,2010/02/17,27,25,0.7043244000000001,32312,27,15,10
9506,2014/03/31,2011/05/22,256,22,0.793231665,28688,256,15,7
9507,2014/03/31,2010/03/05,11,20,0.721321203,31547,11,9,11
9508,2014/03/31,2007/01/10,6,32,0.953540898,23864,6,14,18
9509,2014/03/31,2004/11/30,21,19,0.65503872,34737,21,9,10
9510,2014/03/31,2012/07/12,5,26,0.637525779,35688,5,10,16
9511,2014/03/31,2007/10/01,155,6,1.4119175869999998,16114,155,3,3
9512,2014/03/31,2008/09/28,27,32,0.704321228,32301,27,17,15
9513,2014/03/31,2012/12/19,77,25,0.700760535,32464,77,7,18
9514,2014/03/31,2012/03/07,18,21,0.716399937,31755,18,12,9
9515,2014/03/31,2008/12/20,119,30,0.5430124129999999,41890,119,22,8
9516,2014/03/31,2005/01/26,7,26,0.583153684,39002,7,10,16
9517,2014/03/31,2012/06/16,192,18,0.6370796679999999,35698,192,12,6
9518,2014/03/31,2012/06/13,295,12,0.716535589,31737,295,11,1
9519,2014/03/31,2006/11/01,15,22,0.597260137,38053,15,3,19
9520,2014/03/31,2012/03/26,371,24,0.602749045,37704,371,24,0
9521,2014/03/31,2012/04/22,81,17,0.7618805740000001,29826,81,10,7
9522,2014/03/31,2008/10/20,1,25,0.566146179,40129,1,15,10
9523,2014/03/31,2012/05/18,17,28,0.833800051,27247,17,6,22
9524,2014/03/31,2012/04/28,27,32,0.596300136,38096,27,14,18
9525,2014/03/31,2009/02/02,2,15,1.131556242,20074,2,3,12
9526,2014/03/31,2011/04/08,15,27,0.7160508809999999,31721,15,13,14
9527,2014/03/31,2007/03/28,35,15,0.612760602,37068,35,8,7
9528,2014/03/31,2009/08/01,154,4,0.888629108,25560,154,2,2
9529,2014/03/31,2010/11/14,31,29,0.5635756120000001,40298,31,10,19
9530,2014/03/31,2011/08/10,10,17,0.717887333,31633,10,11,6
9531,2014/03/31,2008/08/23,4,18,0.696685893,32594,4,8,10
9532,2014/03/31,2005/03/31,9,14,0.656975089,34563,9,6,8
9533,2014/03/31,2012/05/01,5,29,0.7882346809999999,28805,5,7,22
9534,2014/03/31,2010/09/12,67,15,0.696331012,32603,67,6,9
9535,2014/03/31,2010/09/23,43,52,0.715457439,31731,43,29,23
9536,2014/03/31,2005/03/24,45,26,0.628785419,36103,45,14,12
9537,2014/03/31,2005/09/07,13,28,0.609799065,37226,13,18,10
9538,2014/03/31,2006/09/25,10,26,0.60757287,37361,10,16,10
9539,2014/03/31,2012/08/31,4,20,0.709995308,31968,4,13,7
9540,2014/03/31,2012/09/06,136,24,0.6919010459999999,32803,136,18,6
9541,2014/03/31,2011/11/30,19,34,0.656226219,34586,19,22,12
9542,2014/03/31,2008/07/20,5,25,0.543361188,41765,5,11,14
9543,2014/03/31,2010/04/07,6,20,0.677678315,33480,6,13,7
9544,2014/03/31,2009/08/03,72,18,0.8021436909999999,28283,72,8,10
9545,2014/03/31,2012/03/28,186,23,0.586852398,38658,186,16,7
9546,2014/03/31,2010/06/13,99,28,0.675591292,33579,99,17,11
9547,2014/03/31,2008/03/07,7,13,0.6558386820000001,34590,7,3,10
9548,2014/03/31,2007/10/24,4,40,0.829696427,27341,4,0,40
9549,2014/03/31,2012/05/11,8,28,0.6468958539999999,35066,8,8,20
9550,2014/03/31,2012/07/12,114,11,0.7315166559999999,31009,114,6,5
9551,2014/03/31,2008/06/19,146,25,0.659944718,34369,146,13,12
9552,2014/03/31,2012/07/24,136,10,1.234939562,18366,136,7,3
9553,2014/03/31,2012/11/22,49,21,0.7589555929999999,29883,49,0,21
9554,2014/03/31,2006/03/20,10,19,0.746093364,30397,10,11,8
9555,2014/03/31,2007/09/04,9,27,0.7640785040000001,29680,9,16,11
9556,2014/03/31,2008/12/23,10,28,0.627451371,36141,10,9,19
9557,2014/03/31,2012/07/21,25,22,0.7882316540000001,28767,25,16,6
9558,2014/03/31,2005/04/06,25,35,0.708327502,32012,25,12,23
9559,2014/03/31,2007/12/01,17,22,0.62663516,36183,17,8,14
9560,2014/03/31,2010/11/05,13,20,0.784,28920,13,13,7
9561,2014/03/31,2011/10/18,105,30,0.768147445,29516,105,11,19
9562,2014/03/31,2008/01/21,60,23,0.562911163,40276,60,13,10
9563,2014/03/31,2012/06/30,16,32,0.730067633,31050,16,15,17
9564,2014/03/31,2012/09/11,87,32,0.7625,29728,87,4,28
9565,2014/03/31,2008/08/13,8,20,0.701623228,32306,8,6,14
9566,2014/03/31,2009/07/12,20,18,0.84934535,26686,20,7,11
9567,2014/03/31,2006/03/01,52,15,1.417831092,15985,52,7,8
9568,2014/03/31,2007/08/20,199,8,0.77625,29192,199,3,5
9569,2014/03/31,2011/11/08,60,26,0.669767084,33832,60,19,7
9570,2014/03/31,2010/09/02,102,20,0.772893301,29316,102,11,9
9571,2014/03/31,2007/09/13,32,27,0.6709371479999999,33762,32,10,17
9572,2014/03/31,2011/07/19,48,19,0.7146405020000001,31697,48,9,10
9573,2014/03/31,2012/12/08,6,17,0.665551246,34032,6,7,10
9574,2014/03/31,2011/03/11,108,11,0.439749146,51504,108,6,5
9575,2014/03/31,2011/11/25,17,19,0.647755627,34963,17,11,8
9576,2014/03/31,2007/05/10,255,12,1.300923192,17407,255,4,8
9577,2014/03/31,2007/12/26,49,20,0.831863199,27222,49,14,6
9578,2014/03/31,2012/04/05,7,18,0.7368161409999999,30730,7,8,10
9579,2014/03/31,2006/10/19,42,25,0.870387558,26009,42,14,11
9580,2014/03/31,2006/06/29,4,18,0.739998039,30590,4,13,5
9581,2014/03/31,2006/01/19,14,25,0.7033419320000001,32176,14,12,13
9582,2014/03/31,2012/01/24,492,3,0.6166666670000001,36696,492,3,0
9583,2014/03/31,2009/12/04,6,24,0.62508011,36200,6,16,8
9584,2014/03/31,2009/04/01,14,26,0.700614337,32295,14,11,15
9585,2014/03/31,2010/04/08,452,16,0.727548395,31098,452,16,0
9586,2014/03/31,2011/11/20,32,15,0.560874114,40338,32,6,9
9587,2014/03/31,2012/08/04,31,11,0.778181818,29073,31,4,7
9588,2014/03/31,2011/08/16,80,6,0.675255492,33504,80,4,2
9589,2014/03/31,2011/11/07,5,17,0.760507261,29748,5,6,11
9590,2014/03/31,2010/09/15,14,28,0.488758157,46278,14,19,9
9591,2014/03/31,2010/07/24,16,20,0.7758496,29149,16,12,8
9592,2014/03/31,2007/09/06,47,21,0.665343356,33988,47,12,9
9593,2014/03/31,2008/07/16,48,24,0.967589542,23369,48,20,4
9594,2014/03/31,2007/01/01,129,15,0.605935297,37309,129,10,5
9595,2014/03/31,2005/01/26,123,24,0.794548522,28451,123,15,9
9596,2014/03/31,2007/07/13,24,29,0.770270215,29347,24,14,15
9597,2014/03/31,2011/04/30,70,17,0.757698522,29833,70,12,5
9598,2014/03/31,2008/11/13,11,21,0.918732417,24598,11,6,15
9599,2014/03/31,2012/09/29,95,12,0.767902732,29424,95,5,7
9600,2014/03/31,2009/07/11,26,23,0.6390225420000001,35357,26,11,12
9601,2014/03/31,2010/01/10,18,20,1.403476208,16098,18,18,2
9602,2014/03/31,2011/09/02,113,21,0.7456435640000001,30300,113,13,8
9603,2014/03/31,2009/03/28,5,13,1.054845924,21418,5,7,6
9604,2014/03/31,2012/12/01,19,15,0.740227057,30521,19,3,12
9605,2014/03/31,2010/10/28,55,22,0.607983799,37159,55,12,10
9606,2014/03/31,2009/11/09,27,14,0.931238818,24257,27,4,10
9607,2014/03/31,2009/11/21,122,6,0.59358562,38052,122,2,4
9608,2014/03/31,2008/04/17,72,20,0.678850084,33272,72,8,12
9609,2014/03/31,2008/07/30,13,23,0.723195312,31227,13,10,13
9610,2014/03/31,2012/06/10,8,27,0.681210402,33146,8,6,21
9611,2014/03/31,2011/08/23,97,31,0.691765445,32632,97,18,13
9612,2014/03/31,2012/11/25,25,34,0.505848685,44622,25,7,27
9613,2014/03/31,2009/11/04,89,26,0.72954685,30939,89,13,13
9614,2014/03/31,2006/09/25,119,17,0.76374742,29551,119,14,3
9615,2014/03/31,2008/05/09,14,21,0.783189437,28817,14,9,12
9616,2014/03/31,2011/11/20,362,24,0.8039238390000001,28072,362,22,2
9617,2014/03/31,2011/09/26,9,27,0.616121775,36625,9,12,15
9618,2014/03/31,2011/12/02,130,9,0.67745174,33309,130,3,6
9619,2014/03/31,2007/09/05,60,19,0.717689592,31436,60,9,10
9620,2014/03/31,2008/03/06,9,11,0.6846166920000001,32950,9,5,6
9621,2014/03/31,2011/03/04,16,20,0.5714588660000001,39469,16,15,5
9622,2014/03/31,2011/11/02,1,28,0.692344057,32576,1,9,19
9623,2014/03/31,2008/03/08,164,14,0.760242381,29664,164,9,5
9624,2014/03/31,2009/09/03,33,24,0.842012247,26781,33,11,13
9625,2014/03/31,2010/10/20,23,46,0.708235811,31839,23,18,28
9626,2014/03/31,2012/07/23,48,25,0.639311704,35261,48,10,15
9627,2014/03/31,2012/03/05,23,15,0.7611841970000001,29615,23,0,15
9628,2014/03/31,2012/06/27,85,14,0.528018364,42692,85,6,8
9629,2014/03/31,2007/04/29,35,20,0.791666257,28471,35,6,14
9630,2014/03/31,2010/10/16,379,9,1.267393016,17783,379,9,0
9631,2014/03/31,2007/06/22,63,23,0.663626432,33959,63,13,10
9632,2014/03/31,2007/02/04,152,31,0.731061648,30820,152,21,10
9633,2014/03/31,2006/03/29,11,15,0.584218742,38566,11,7,8
9634,2014/03/31,2012/11/09,104,14,0.77684539,29002,104,5,9
9635,2014/03/31,2005/04/18,214,38,0.734821085,30657,214,23,15
9636,2014/03/31,2009/12/03,13,22,0.76806533,29328,13,12,10
9637,2014/03/31,2008/03/19,22,29,0.595099997,37851,22,12,17
9638,2014/03/31,2008/06/25,12,27,0.8231725320000001,27363,12,1,26
9639,2014/03/31,2009/06/20,18,26,0.885239742,25444,18,7,19
9640,2014/03/31,2009/03/08,4,27,0.8859627109999999,25423,4,10,17
9641,2014/03/31,2011/10/24,98,29,0.604486526,37256,98,6,23
9642,2014/03/31,2006/03/31,3,13,0.589424728,38208,3,4,9
9643,2014/03/31,2012/08/24,20,8,0.640971396,35135,20,5,3
9644,2014/03/31,2006/11/05,22,13,1.445129308,15583,22,6,7
9645,2014/03/31,2007/10/11,29,19,0.678654049,33181,29,7,12
9646,2014/03/31,2008/12/23,1,41,0.864586582,26039,1,23,18
9647,2014/03/31,2008/05/13,34,20,0.711044503,31661,34,9,11
9648,2014/03/31,2007/08/01,81,21,0.7657142859999999,29400,81,17,4
9649,2014/03/31,2012/08/02,28,38,0.783417224,28728,28,8,30
9650,2014/03/31,2010/04/26,373,12,0.762278978,29522,373,12,0
9651,2014/03/31,2012/09/30,32,22,0.651216287,34556,32,8,14
9652,2014/03/31,2011/06/27,182,15,0.720902858,31212,182,7,8
9653,2014/03/31,2008/02/01,18,23,0.603602489,37277,18,11,12
9654,2014/03/31,2006/01/10,116,21,0.556932845,40399,116,12,9
9655,2014/03/31,2011/11/05,233,11,0.74401918,30240,233,10,1
9656,2014/03/31,2007/03/22,113,26,0.790433545,28463,113,12,14
9657,2014/03/31,2012/06/15,3,37,0.7542870079999999,29818,3,18,19
9658,2014/03/31,2011/04/12,80,15,0.820061996,27421,80,8,7
9659,2014/03/31,2011/07/24,13,14,0.755283824,29772,13,6,8
9660,2014/03/31,2011/07/12,14,30,0.66182827,33972,14,8,22
9661,2014/03/31,2012/07/12,43,20,0.667196414,33689,43,4,16
9662,2014/03/31,2012/12/10,132,10,0.8205987809999999,27389,132,2,8
9663,2014/03/31,2010/09/19,127,16,0.984626068,22825,127,14,2
9664,2014/03/31,2011/01/26,70,16,0.8001335140000001,28087,70,10,6
9665,2014/03/31,2010/07/29,4,29,0.748247653,30034,4,15,14
9666,2014/03/31,2007/11/16,12,23,0.718334878,31283,12,6,17
9667,2014/03/31,2011/07/26,4,23,0.6853447220000001,32780,4,13,10
9668,2014/03/31,2006/05/15,60,15,0.54930559,40898,60,10,5
9669,2014/03/31,2006/10/16,42,22,0.7226434159999999,31081,42,13,9
9670,2014/03/31,2011/05/29,7,27,0.761616141,29490,7,11,16
9671,2014/03/31,2012/08/03,139,8,0.60612636,37053,139,4,4
9672,2014/03/31,2010/12/12,34,17,0.861355425,26073,34,13,4
9673,2014/03/31,2005/11/01,25,15,0.937949628,23942,25,8,7
9674,2014/03/31,2013/03/20,83,15,0.523243703,42917,83,2,13
9675,2014/03/31,2005/09/06,8,16,0.7711216040000001,29119,8,5,11
9676,2014/03/31,2012/12/20,9,34,0.606371199,37026,9,4,30
9677,2014/03/31,2008/09/12,159,15,0.784544502,28617,159,12,3
9678,2014/03/31,2007/05/23,20,22,0.700869755,32032,20,9,13
9679,2014/03/31,2010/03/27,9,65,0.719235895,31213,9,35,30
9680,2014/03/31,2009/04/15,1,23,0.5638836979999999,39810,1,7,16
9681,2014/03/31,2010/02/28,10,27,0.7974385390000001,28148,10,17,10
9682,2014/03/31,2008/04/01,4,34,0.869863975,25804,4,15,19
9683,2014/03/31,2007/07/24,74,19,0.6005263160000001,37373,74,12,7
9684,2014/03/31,2007/08/05,236,11,1.259638547,17817,236,9,2
9685,2014/03/31,2008/08/01,127,16,0.529388829,42394,127,6,10
9686,2014/03/31,2008/05/29,3,20,0.7993613540000001,28075,3,5,15
9687,2014/03/31,2007/03/02,5,33,0.721263821,31112,5,24,9
9688,2014/03/31,2012/07/31,10,23,0.63431867,35372,10,9,14
9689,2014/03/31,2012/04/24,11,35,0.620830105,36140,11,12,23
9690,2014/03/31,2011/07/30,137,14,0.903400443,24835,137,10,4
9691,2014/03/31,2009/09/12,135,22,0.68994618,32516,135,10,12
9692,2014/03/31,2004/12/09,25,24,0.657291532,34130,25,5,19
9693,2014/03/31,2011/01/10,54,11,0.88859531,25244,54,9,2
9694,2014/03/31,2008/01/18,54,5,0.6731124709999999,33324,54,0,5
9695,2014/03/31,2011/07/04,9,16,0.916346515,24478,9,12,4
9696,2014/03/31,2010/02/17,33,18,0.725940898,30896,33,11,7
9697,2014/03/31,2013/03/17,27,22,0.6312733620000001,35528,27,4,18
9698,2014/03/31,2005/05/14,76,22,0.637606687,35173,76,12,10
9699,2014/03/31,2006/05/25,95,18,0.8267654759999999,27123,95,9,9
9700,2014/03/31,2012/06/27,146,15,0.76,29505,146,7,8
9701,2014/03/31,2012/12/27,169,5,0.8543278459999999,26244,169,1,4
9702,2014/03/31,2012/04/13,4,19,0.825103415,27172,4,10,9
9703,2014/03/31,2007/02/15,1,35,0.711262811,31517,1,10,25
9704,2014/03/31,2012/02/22,15,28,0.61059599,36712,15,17,11
9705,2014/03/31,2011/03/03,7,14,0.844258597,26551,7,3,11
9706,2014/03/31,2007/09/15,46,23,0.684132837,32762,46,9,14
9707,2014/03/31,2010/11/23,28,26,0.644329577,34784,28,15,11
9708,2014/03/31,2010/03/04,63,28,0.57384901,39049,63,15,13
9709,2014/03/31,2009/07/07,104,13,0.894018513,25064,104,7,6
9710,2014/03/31,2012/06/23,262,14,0.689285714,32508,262,9,5
9711,2014/03/31,2010/12/29,135,22,0.6732492040000001,33282,135,17,5
9712,2014/03/31,2012/09/08,14,26,0.658048107,34049,14,10,16
9713,2014/03/31,2010/08/28,208,16,0.946752725,23666,208,9,7
9714,2014/03/31,2010/10/23,240,11,1.072649777,20881,240,9,2
9715,2014/03/31,2007/11/02,4,17,0.908820045,24645,4,7,10
9716,2014/03/31,2010/11/15,14,21,0.70549014,31746,14,7,14
9717,2014/03/31,2012/06/21,55,12,0.8311433979999999,26946,55,3,9
9718,2014/03/31,2010/09/07,31,19,0.538094861,41619,31,9,10
9719,2014/03/31,2012/11/06,1,20,0.802709155,27898,1,4,16
9720,2014/03/31,2011/12/24,5,33,0.787933146,28420,5,11,22
9721,2014/03/31,2012/09/27,16,25,0.657565639,34050,16,11,14
9722,2014/03/31,2008/09/10,233,9,0.624704947,35841,233,7,2
9723,2014/03/31,2011/07/12,3,15,0.919876325,24338,3,5,10
9724,2014/03/31,2010/09/13,4,23,0.70460846,31772,4,8,15
9725,2014/03/31,2005/02/02,61,16,0.924641279,24211,61,10,6
9726,2014/03/31,2008/04/17,66,9,1.240382868,18048,66,5,4
9727,2014/03/31,2008/04/27,6,24,0.889056319,25178,6,12,12
9728,2014/03/31,2008/08/09,42,3,0.61,36696,42,0,3
9729,2014/03/31,2012/09/12,103,9,0.77,29070,103,5,4
9730,2014/03/31,2007/12/04,87,30,0.664619588,33674,87,18,12
9731,2014/03/31,2010/04/22,64,30,0.58686474,38134,64,19,11
9732,2014/03/31,2011/08/30,27,16,0.7094978120000001,31542,27,6,10
9733,2014/03/31,2007/01/09,8,23,0.73761561,30339,8,11,12
9734,2014/03/31,2009/01/10,23,16,0.713931078,31340,23,3,13
9735,2014/03/31,2010/10/12,57,23,0.699057052,32006,57,14,9
9736,2014/03/31,2007/09/27,13,30,0.763464255,29305,13,15,15
9737,2014/03/31,2012/02/26,10,28,0.691015321,32374,10,12,16
9738,2014/03/31,2007/08/01,30,23,0.8481728909999999,26375,30,17,6
9739,2014/03/31,2011/03/15,78,20,0.77808,28750,78,2,18
9740,2014/03/31,2009/04/30,32,26,0.713193647,31356,32,19,7
9741,2014/03/31,2012/09/28,7,19,0.727587935,30733,7,5,14
9742,2014/03/31,2012/09/17,7,21,0.6924372870000001,32290,7,3,18
9743,2014/03/31,2005/11/13,30,22,0.606577762,36856,30,12,10
9744,2014/03/31,2010/06/17,2,28,0.773137106,28912,2,0,28
9745,2014/03/31,2012/11/12,6,16,0.7603809909999999,29397,6,5,11
9746,2014/03/31,2011/10/07,19,20,0.819461005,27273,19,11,9
9747,2014/03/31,2007/12/11,6,18,0.804530401,27779,6,7,11
9748,2014/03/31,2007/12/04,28,15,0.6838805920000001,32678,28,5,10
9749,2014/03/31,2005/03/08,158,17,0.8833425579999999,25295,158,10,7
9750,2014/03/31,2012/04/15,34,25,0.81024369,27576,34,9,16
9751,2014/03/31,2011/07/10,5,23,0.72343836,30881,5,11,12
9752,2014/03/31,2007/09/11,14,26,0.499740934,44699,14,12,14
9753,2014/03/31,2012/04/10,132,10,1.459478602,15305,132,3,7
9754,2014/03/31,2011/06/25,21,21,0.469742177,47552,21,12,9
9755,2014/03/31,2011/01/13,104,20,1.367110676,16336,104,10,10
9756,2014/03/31,2008/05/30,296,27,0.8766677140000001,25472,296,23,4
9757,2014/03/31,2008/03/01,18,31,0.669062818,33366,18,14,17
9758,2014/03/31,2009/09/21,318,7,0.823839312,27096,318,3,4
9759,2014/03/31,2012/01/25,79,24,0.6333465739999999,35245,79,10,14
9760,2014/03/31,2006/06/01,21,20,0.808391583,27611,21,15,5
9761,2014/03/31,2012/11/15,1,21,0.75630714,29511,1,4,17
9762,2014/03/31,2009/11/28,95,17,0.693744404,32168,95,7,10
9763,2014/03/31,2011/08/22,130,22,0.948245517,23534,130,15,7
9764,2014/03/31,2008/01/25,94,21,0.705661207,31624,94,11,10
9765,2014/03/31,2012/01/16,61,12,0.718833194,31042,61,3,9
9766,2014/03/31,2010/05/18,411,15,0.584911374,38138,411,15,0
9767,2014/03/31,2012/09/20,122,10,0.8440000000000001,26430,122,4,6
9768,2014/03/31,2010/11/17,47,22,0.8223540909999999,27123,47,10,12
9769,2014/03/31,2012/06/30,191,9,0.8425096320000001,26474,191,7,2
9770,2014/03/31,2008/07/23,6,16,0.614005891,36324,6,0,16
9771,2014/03/31,2009/08/10,72,22,0.644230747,34618,72,7,15
9772,2014/03/31,2013/03/09,5,23,0.912187359,24445,5,1,22
9773,2014/03/31,2005/11/25,130,31,0.6911269879999999,32263,130,7,24
9774,2014/03/31,2005/09/20,32,25,0.7152878140000001,31166,32,9,16
9775,2014/03/31,2010/11/04,13,29,0.802654377,27773,13,23,6
9776,2014/03/31,2006/01/15,99,16,0.692503573,32190,99,8,8
9777,2014/03/31,2011/09/26,1,19,0.7587439579999999,29378,1,8,11
9778,2014/03/31,2012/01/10,43,19,0.684901503,32539,43,10,9
9779,2014/03/31,2007/06/18,81,26,0.7008130459999999,31794,81,14,12
9780,2014/03/31,2007/06/18,26,28,0.7606708320000001,29292,26,13,15
9781,2014/03/31,2005/11/05,33,13,1.471499802,15142,33,10,3
9782,2014/03/31,2007/01/07,322,19,0.924051263,24111,322,16,3
9783,2014/03/31,2011/06/17,15,27,0.661850455,33662,15,13,14
9784,2014/03/31,2008/01/29,9,9,1.280287455,17394,9,5,4
9785,2014/03/31,2010/08/11,38,16,0.801857333,27771,38,13,3
9786,2014/03/31,2006/05/19,7,15,0.8229528070000001,27059,7,9,6
9787,2014/03/31,2006/08/03,61,4,0.732474505,30398,61,0,4
9788,2014/03/31,2011/12/22,21,23,0.644519481,34546,21,5,18
9789,2014/03/31,2011/12/20,79,19,0.642316236,34664,79,12,7
9790,2014/03/31,2009/06/20,58,4,0.732362326,30398,58,3,1
9791,2014/03/31,2005/04/12,79,3,0.606666667,36696,79,0,3
9792,2014/03/31,2012/07/07,20,14,0.78377777,28403,20,6,8
9793,2014/03/31,2010/11/08,39,20,0.6974887190000001,31912,39,14,6
9794,2014/03/31,2011/07/07,108,16,0.897381365,24803,108,14,2
9795,2014/03/31,2010/04/07,147,22,0.661349857,33648,147,17,5
9796,2014/03/31,2011/05/01,165,18,0.657222222,33858,165,9,9
9797,2014/03/31,2008/04/08,1,11,0.785979159,28310,1,6,5
9798,2014/03/31,2012/03/28,11,19,0.7004832670000001,31763,11,10,9
9799,2014/03/31,2007/01/09,214,19,0.672590096,33076,214,13,6
9800,2014/03/31,2012/11/29,131,14,0.684285714,32508,131,6,8
9801,2014/03/31,2008/08/18,27,26,0.799659164,27814,27,12,14
9802,2014/03/31,2011/08/02,81,17,1.109695155,20043,81,0,17
9803,2014/03/31,2005/11/24,15,23,0.7642892,29101,15,11,12
9804,2014/03/31,2011/10/04,11,18,0.6849194670000001,32471,11,11,7
9805,2014/03/31,2008/02/02,22,25,0.7394643209999999,30074,22,8,17
9806,2014/03/31,2012/05/07,26,26,0.69596282,31953,26,19,7
9807,2014/03/31,2008/10/23,25,29,0.963173077,23088,25,20,9
9808,2014/03/31,2010/09/29,167,23,0.561917421,39574,167,15,8
9809,2014/03/31,2005/04/09,69,14,0.8282697609999999,26846,69,7,7
9810,2014/03/31,2007/06/09,36,28,0.75595077,29413,36,15,13
9811,2014/03/31,2012/05/04,3,37,0.648462391,34287,3,17,20
9812,2014/03/31,2009/01/12,12,27,0.658548325,33761,12,20,7
9813,2014/03/31,2008/08/28,113,11,1.3962580080000002,15922,113,5,6
9814,2014/03/31,2006/03/31,13,30,0.448660894,49548,13,18,12
9815,2014/03/31,2009/04/22,80,27,0.585561058,37964,80,13,14
9816,2014/03/31,2012/03/12,283,18,0.674235237,32971,283,11,7
9817,2014/03/31,2011/06/26,11,24,0.604933058,36748,11,12,12
9818,2014/03/31,2012/06/03,26,15,0.74433551,29865,26,11,4
9819,2014/03/31,2010/02/27,49,17,0.664992072,33427,49,2,15
9820,2014/03/31,2009/11/30,17,18,0.677579406,32806,17,7,11
9821,2014/03/31,2010/07/17,72,27,0.757265077,29350,72,11,16
9822,2014/03/31,2006/04/04,31,27,0.785501873,28294,31,10,17
9823,2014/03/31,2011/12/13,339,22,0.701118438,31696,339,21,1
9824,2014/03/31,2005/02/11,24,18,0.757197083,29348,24,8,10
9825,2014/03/31,2012/04/25,12,24,0.6534451729999999,34007,12,15,9
9826,2014/03/31,2010/04/20,145,4,0.8751711240000001,25391,145,2,2
9827,2014/03/31,2007/11/05,33,20,0.741423805,29969,33,3,17
9828,2014/03/31,2012/07/14,113,20,0.705108375,31511,113,11,9
9829,2014/03/31,2010/02/19,24,24,0.760511741,29214,24,12,12
9830,2014/03/31,2006/11/13,77,9,1.040618267,21350,77,6,3
9831,2014/03/31,2010/06/20,143,24,0.741026154,29976,143,16,8
9832,2014/03/31,2008/05/02,24,22,0.780846224,28444,24,12,10
9833,2014/03/31,2011/10/01,66,15,0.753580347,29472,66,9,6
9834,2014/03/31,2013/03/28,4,6,0.5711995879999999,38880,4,0,6
9835,2014/03/31,2008/11/10,12,17,0.670388203,33127,12,7,10
9836,2014/03/31,2012/05/02,103,16,0.934676965,23759,103,5,11
9837,2014/03/31,2012/03/01,117,18,1.110224,20000,117,11,7
9838,2014/03/31,2012/11/26,41,15,0.7423452909999999,29911,41,1,14
9839,2014/03/31,2008/09/28,7,26,0.8456375690000001,26256,7,13,13
9840,2014/03/31,2011/04/05,2,14,1.35136762,16430,2,9,5
9841,2014/03/31,2010/08/01,124,23,0.82698525,26848,124,11,12
9842,2014/03/31,2012/01/21,33,25,0.640652143,34655,33,12,13
9843,2014/03/31,2012/07/05,346,8,1.05,21144,346,7,1
9844,2014/03/31,2008/08/08,27,15,0.7584001779999999,29272,27,7,8
9845,2014/03/31,2009/07/07,6,20,0.707036117,31398,6,9,11
9846,2014/03/31,2008/05/23,21,31,0.8174712690000001,27148,21,13,18
9847,2014/03/31,2012/10/28,12,27,0.604226748,36728,12,5,22
9848,2014/03/31,2013/02/25,9,26,0.777947765,28525,9,3,23
9849,2014/03/31,2011/03/21,33,40,0.681682645,32544,33,21,19
9850,2014/03/31,2011/11/12,17,25,0.768279481,28875,17,5,20
9851,2014/03/31,2006/01/09,207,4,0.8202266509999999,27046,207,1,3
9852,2014/03/31,2011/08/25,2,44,0.673429066,32939,2,10,34
9853,2014/03/31,2005/08/08,72,24,0.7031416620000001,31547,72,16,8
9854,2014/03/31,2008/12/10,74,20,0.7282569440000001,30458,74,9,11
9855,2014/03/31,2006/07/28,59,14,0.533702385,41557,59,5,9
9856,2014/03/31,2006/10/19,259,11,1.186252139,18696,259,9,2
9857,2014/03/31,2009/09/10,263,10,1.3713313130000002,16172,263,8,2
9858,2014/03/31,2005/06/15,21,27,0.71954544,30821,21,15,12
9859,2014/03/31,2012/09/01,427,13,0.734615385,30186,427,13,0
9860,2014/03/31,2011/09/13,330,16,0.808571272,27423,330,14,2
9861,2014/03/31,2009/07/10,33,3,0.973233551,22783,33,2,1
9862,2014/03/31,2013/01/22,30,27,0.787871078,28141,30,3,24
9863,2014/03/31,2013/03/08,11,26,0.786763662,28180,11,2,24
9864,2014/03/31,2012/02/07,75,23,0.869998823,25483,75,14,9
9865,2014/03/31,2012/02/26,6,35,0.7374594990000001,30061,6,20,15
9866,2014/03/31,2010/10/17,100,3,1.028088303,21562,100,1,2
9867,2014/03/31,2007/09/13,36,21,0.532529368,41627,36,7,14
9868,2014/03/31,2006/08/25,485,16,0.7093801,31247,485,16,0
9869,2014/03/31,2007/12/04,82,18,0.608934095,36401,82,10,8
9870,2014/03/31,2007/03/07,16,21,0.572406436,38717,16,12,9
9871,2014/03/31,2011/03/23,121,19,0.827830911,26767,121,13,6
9872,2014/03/31,2009/02/13,21,11,0.5843659000000001,37912,21,7,4
9873,2014/03/31,2005/09/29,12,39,0.778784406,28447,12,25,14
9874,2014/03/31,2008/04/11,26,16,0.923388771,23991,26,5,11
9875,2014/03/31,2007/12/21,6,30,0.8320653640000001,26620,6,14,16
9876,2014/03/31,2009/08/01,68,20,0.847245811,26142,68,14,6
9877,2014/03/31,2011/08/22,11,28,0.755758258,29304,11,18,10
9878,2014/03/31,2012/07/25,16,23,0.6957046370000001,31832,16,8,15
9879,2014/03/31,2004/11/30,30,20,0.6747476990000001,32818,30,13,7
9880,2014/03/31,2010/07/29,46,26,0.8619330479999999,25690,46,22,4
9881,2014/03/31,2005/06/02,81,23,0.653544379,33879,81,13,10
9882,2014/03/31,2011/09/10,33,20,0.7673886520000001,28851,33,7,13
9883,2014/03/31,2011/03/15,118,12,0.689595066,32104,118,6,6
9884,2014/03/31,2012/11/15,3,15,0.601887711,36780,3,2,13
9885,2014/03/31,2005/05/17,59,30,0.6565614710000001,33715,59,13,17
9886,2014/03/31,2010/11/19,14,27,0.802570248,27581,14,13,14
9887,2014/03/31,2010/06/10,1,30,0.722513627,30637,1,14,16
9888,2014/03/31,2009/12/06,179,14,0.8291893309999999,26694,179,12,2
9889,2014/03/31,2012/11/15,422,21,0.502380952,44058,422,21,0
9890,2014/03/31,2011/07/06,83,26,0.580302824,38141,83,17,9
9891,2014/03/31,2008/11/28,58,31,0.6896220240000001,32092,58,9,22
9892,2014/03/31,2012/10/07,21,37,0.781554355,28314,21,15,22
9893,2014/03/31,2008/03/07,277,4,0.79312211,27901,277,3,1
9894,2014/03/31,2011/09/25,102,30,0.8050351179999999,27479,102,12,18
9895,2014/03/31,2009/10/12,31,20,0.676421123,32703,31,10,10
9896,2014/03/31,2012/06/07,368,18,0.90531227,24434,368,18,0
9897,2014/03/31,2008/08/11,96,25,0.800353137,27638,96,13,12
9898,2014/03/31,2009/11/24,108,27,0.7650178120000001,28913,108,15,12
9899,2014/03/31,2012/02/19,10,27,0.8182431929999999,27032,10,20,7
9900,2014/03/31,2008/09/02,66,33,0.790080737,27992,66,16,17
9901,2014/03/31,2009/08/21,229,18,0.955191809,23148,229,16,2
9902,2014/03/31,2006/08/21,4,21,0.7193444379999999,30737,4,7,14
9903,2014/03/31,2009/08/04,308,16,0.602419487,36702,308,12,4
9904,2014/03/31,2009/01/07,16,17,0.555105699,39830,16,0,17
9905,2014/03/31,2007/03/07,38,30,0.659973729,33497,38,13,17
9906,2014/03/31,2011/05/08,6,35,0.690258588,32020,6,22,13
9907,2014/03/31,2013/02/12,27,27,0.655197747,33730,27,0,27
9908,2014/03/31,2009/07/22,13,22,0.722585919,30581,13,14,8
9909,2014/03/31,2011/10/14,45,14,0.666012359,33175,45,3,11
9910,2014/03/31,2012/05/23,325,9,0.694444444,31815,325,7,2
9911,2014/03/31,2007/12/25,79,7,0.7648333159999999,28887,79,4,3
9912,2014/03/31,2012/08/15,18,23,0.808988575,27308,18,7,16
9913,2014/03/31,2013/01/07,85,12,0.613259584,36023,85,3,9
9914,2014/03/31,2007/02/16,1,28,0.7254881409999999,30442,1,7,21
9915,2014/03/31,2011/03/24,31,15,0.7050743890000001,31322,31,10,5
9916,2014/03/31,2012/09/04,48,33,0.652449257,33847,48,17,16
9917,2014/03/31,2012/03/19,3,11,0.946758703,23324,3,3,8
9918,2014/03/31,2010/02/25,123,16,0.6480470770000001,34072,123,6,10
9919,2014/03/31,2008/03/28,31,17,0.764297584,28886,31,11,6
9920,2014/03/31,2011/08/23,2,13,0.590103713,37411,2,9,4
9921,2014/03/31,2009/02/15,2,21,0.8228087959999999,26830,2,8,13
9922,2014/03/31,2007/11/21,14,25,0.893631285,24702,14,3,22
9923,2014/03/31,2008/07/05,34,24,0.7619014909999999,28972,34,15,9
9924,2014/03/31,2008/04/07,26,27,0.7707115920000001,28640,26,17,10
9925,2014/03/31,2008/12/26,44,27,0.565250986,39046,44,18,9
9926,2014/03/31,2008/05/17,5,30,0.7963739040000001,27713,5,14,16
9927,2014/03/31,2007/08/16,17,28,0.6934231940000001,31827,17,22,6
9928,2014/03/31,2009/12/25,29,40,0.694208374,31789,29,27,13
9929,2014/03/31,2005/07/11,14,26,0.5657218310000001,39005,14,9,17
9930,2014/03/31,2012/03/06,3,45,0.723928337,30476,3,26,19
9931,2014/03/31,2007/07/11,20,19,0.766818672,28771,20,1,18
9932,2014/03/31,2011/12/21,73,45,0.701808494,31435,73,27,18
9933,2014/03/31,2012/10/25,49,20,0.670059835,32924,49,18,2
9934,2014/03/31,2010/10/19,133,19,1.050827895,20993,133,10,9
9935,2014/03/31,2010/01/02,30,31,0.725980253,30385,30,11,20
9936,2014/03/31,2010/06/04,33,28,0.7268779040000001,30345,33,18,10
9937,2014/03/31,2009/10/10,9,27,0.6737168170000001,32735,9,10,17
9938,2014/03/31,2010/10/01,37,12,0.618882559,35635,37,8,4
9939,2014/03/31,2008/07/01,27,20,0.69245706,31847,27,12,8
9940,2014/03/31,2010/02/05,56,21,0.623205867,35382,56,8,13
9941,2014/03/31,2011/09/19,82,23,0.690043187,31954,82,10,13
9942,2014/03/31,2006/08/12,2,17,0.796853157,27669,2,5,12
9943,2014/03/31,2008/12/10,104,14,0.727416353,30306,104,5,9
9944,2014/03/31,2012/10/29,57,32,0.7320516140000001,30108,57,20,12
9945,2014/03/31,2007/03/21,11,21,0.801411897,27502,11,6,15
9946,2014/03/31,2012/06/26,151,16,0.707533627,31151,151,3,13
9947,2014/03/31,2006/02/28,1,18,0.8748886509999999,25191,1,9,9
9948,2014/03/31,2012/12/21,61,5,0.7106742770000001,31011,61,2,3
9949,2014/03/31,2006/10/13,134,12,0.634478003,34732,134,5,7
9950,2014/03/31,2012/11/28,8,24,0.6993646259999999,31509,8,0,24
9951,2014/03/31,2008/02/16,8,30,0.874351415,25201,8,16,14
9952,2014/03/31,2011/08/08,2,37,0.68725889,32060,2,24,13
9953,2014/03/31,2011/10/24,142,16,0.8054494609999999,27355,142,7,9
9954,2014/03/31,2012/12/21,36,21,0.594551759,37056,36,2,19
9955,2014/03/31,2010/02/24,150,20,0.8045398770000001,27384,150,9,11
9956,2014/03/31,2007/03/06,79,8,1.181236594,18648,79,5,3
9957,2014/03/31,2007/05/24,25,31,0.6780397109999999,32485,25,17,14
9958,2014/03/31,2010/03/11,137,24,0.600014438,36709,137,15,9
9959,2014/03/31,2008/06/01,29,15,0.7717786190000001,28539,29,4,11
9960,2014/03/31,2011/06/24,1,26,0.810004414,27189,1,13,13
9961,2014/03/31,2011/02/26,36,11,0.86887394,25345,36,4,7
9962,2014/03/31,2008/03/30,35,19,0.8158712159999999,26991,35,12,7
9963,2014/03/31,2008/02/24,7,25,0.779001698,28268,7,7,18
9964,2014/03/31,2012/09/26,6,24,0.7669265059999999,28710,6,7,17
9965,2014/03/31,2010/08/12,27,20,1.042332055,21123,27,10,10
9966,2014/03/31,2007/01/07,29,27,0.515962927,42672,29,12,15
9967,2014/03/31,2008/02/08,38,17,0.727190989,30274,38,9,8
9968,2014/03/31,2009/11/27,6,17,0.693005635,31767,6,7,10
9969,2014/03/31,2011/01/19,51,20,0.71037141,30990,51,2,18
9970,2014/03/31,2007/12/10,340,29,0.741504985,29688,340,20,9
9971,2014/03/31,2006/12/20,186,12,0.767422695,28685,186,5,7
9972,2014/03/31,2011/02/17,7,28,0.63340949,34753,7,10,18
9973,2014/03/31,2006/03/20,44,18,0.780966895,28183,44,7,11
9974,2014/03/31,2008/04/06,3,27,0.602372441,36532,3,12,15
9975,2014/03/31,2012/05/17,4,24,0.604200049,36421,4,7,17
9976,2014/03/31,2012/05/25,35,11,0.548181818,40139,35,3,8
9977,2014/03/31,2006/01/26,24,11,0.675116293,32590,24,2,9
9978,2014/03/31,2008/11/17,4,26,0.847624148,25957,4,8,18
9979,2014/03/31,2012/02/17,21,21,0.5671233760000001,38792,21,12,9
9980,2014/03/31,2011/09/27,58,11,0.958046858,22963,58,7,4
9981,2014/03/31,2011/01/09,47,24,0.652312209,33721,47,13,11
9982,2014/03/31,2007/01/08,25,21,0.674778821,32598,25,12,9
9983,2014/03/31,2010/01/12,47,21,0.77677826,28317,47,14,7
9984,2014/03/31,2010/05/21,19,18,0.73047162,30109,19,7,11
9985,2014/03/31,2011/12/05,133,17,0.8163513859999999,26939,133,13,4
9986,2014/03/31,2011/04/02,117,21,0.854179452,25745,117,6,15
9987,2014/03/31,2005/09/15,25,23,0.512413134,42911,25,11,12
9988,2014/03/31,2005/01/02,85,23,0.510764031,43048,85,19,4
9989,2014/03/31,2010/12/24,56,15,0.838371463,26226,56,7,8
9990,2014/03/31,2012/04/05,98,16,0.7573405209999999,29032,98,10,6
9991,2014/03/31,2010/11/04,63,15,0.581618168,37802,63,7,8
9992,2014/03/31,2009/12/29,204,28,0.6991679390000001,31440,204,25,3
9993,2014/03/31,2010/12/27,368,22,0.763573835,28787,368,22,0
9994,2014/03/31,2012/08/19,14,15,0.763654715,28782,14,1,14
9995,2014/03/31,2006/09/05,1,24,0.7725830490000001,28447,1,11,13
9996,2014/03/31,2004/11/10,20,19,0.67808917,32410,20,13,6
9997,2014/03/31,2011/04/08,14,21,0.633957883,34665,14,9,12
9998,2014/03/31,2008/10/25,51,4,0.722503288,30416,51,2,2
9999,2014/03/31,2005/11/10,116,20,0.667536681,32919,116,11,9
10000,2014/03/31,2009/12/08,119,14,0.625325555,35140,119,10,4
10001,2014/03/31,2011/01/24,52,16,1.128904363,19459,52,10,6
10002,2014/03/31,2013/01/12,90,5,0.942068448,23317,90,0,5
10003,2014/03/31,2013/02/04,2,27,0.6255350120000001,35102,2,4,23
10004,2014/03/31,2010/06/19,32,30,0.808612206,27151,32,18,12
10005,2014/03/31,2007/10/26,264,16,0.66532412,32997,264,15,1
10006,2014/03/31,2009/12/24,25,17,0.561728683,39076,25,6,11
10007,2014/03/31,2005/11/24,167,21,0.8571842540000001,25606,167,12,9
10008,2014/03/31,2006/03/04,19,23,0.63697449,34457,19,10,13
10009,2014/03/31,2008/10/05,5,21,0.6630401810000001,33100,5,0,21
10010,2014/03/31,2012/09/04,183,4,0.855526275,25652,183,3,1
10011,2014/03/31,2007/02/17,153,23,0.77222058,28416,153,17,6
10012,2014/03/31,2012/10/10,48,24,0.797156247,27527,48,6,18
10013,2014/03/31,2011/08/10,5,25,0.776858316,28246,5,15,10
10014,2014/03/31,2007/08/11,50,15,0.8683235709999999,25268,50,5,10
10015,2014/03/31,2008/12/13,267,13,0.6901000279999999,31791,267,11,2
10016,2014/03/31,2005/11/09,109,22,0.7367893609999999,29776,109,14,8
10017,2014/03/31,2011/08/29,38,10,0.607396866,36118,38,4,6
10018,2014/03/31,2009/06/24,24,22,0.653738897,33550,24,11,11
10019,2014/03/31,2013/03/17,1,22,0.5921575929999999,37032,1,0,22
10020,2014/03/31,2009/06/22,3,18,0.789046094,27791,3,6,12
10021,2014/03/31,2008/11/16,221,21,0.751507267,29172,221,16,5
10022,2014/03/31,2012/11/15,41,19,0.703943422,31143,41,1,18
10023,2014/03/31,2006/09/01,61,23,0.770458284,28454,61,14,9
10024,2014/03/31,2012/04/28,106,14,0.77395128,28325,106,6,8
10025,2014/03/31,2009/04/15,83,22,0.71432938,30688,83,9,13
10026,2014/03/31,2010/08/18,6,30,0.728498222,30091,6,14,16
10027,2014/03/31,2005/12/07,107,15,0.832229689,26340,107,8,7
10028,2014/03/31,2013/02/11,130,16,0.671655278,32635,130,2,14
10029,2014/03/31,2012/01/28,11,20,0.6855459290000001,31973,11,9,11
10030,2014/03/31,2008/04/15,87,24,0.621688743,35257,87,12,12
10031,2014/03/31,2011/07/12,12,18,0.580333616,37768,12,6,12
10032,2014/03/31,2010/02/01,67,22,0.767522852,28553,67,12,10
10033,2014/03/31,2009/10/04,100,19,0.73567985,29786,100,13,6
10034,2014/03/31,2012/04/02,39,28,0.7391297309999999,29646,39,19,9
10035,2014/03/31,2012/05/10,36,21,0.661655089,33110,36,16,5
10036,2014/03/31,2007/06/15,24,27,0.8126621159999999,26956,24,18,9
10037,2014/03/31,2010/07/12,61,28,0.5743898470000001,38138,61,14,14
10038,2014/03/31,2010/07/03,308,15,0.640089129,34220,308,10,5
10039,2014/03/31,2010/12/06,277,17,0.770749903,28417,277,14,3
10040,2014/03/31,2012/10/23,83,10,0.7452245809999999,29388,83,6,4
10041,2014/03/31,2010/05/10,18,8,0.7338522890000001,29842,18,3,5
10042,2014/03/31,2013/03/11,7,38,0.7732066940000001,28322,7,2,36
10043,2014/03/31,2009/12/04,7,11,0.746233642,29344,7,5,6
10044,2014/03/31,2012/12/31,151,18,0.7610026409999999,28774,151,3,15
10045,2014/03/31,2010/04/22,6,10,0.7280724209999999,30074,6,3,7
10046,2014/03/31,2009/08/26,89,13,1.435107499,15256,89,0,13
10047,2014/03/31,2008/09/15,12,27,0.587973144,37235,12,15,12
10048,2014/03/31,2012/04/19,66,23,0.7574184279999999,28901,66,10,13
10049,2014/03/31,2012/03/14,38,21,0.744310245,29409,38,8,13
10050,2014/03/31,2011/09/22,14,29,0.8026255959999999,27270,14,19,10
10051,2014/03/31,2011/06/25,44,17,0.7793287520000001,28082,44,6,11
10052,2014/03/31,2008/09/13,178,8,0.64535095,33908,178,4,4
10053,2014/03/31,2006/08/03,7,26,0.881797042,24813,7,13,13
10054,2014/03/31,2008/11/14,67,19,0.7149308759999999,30597,67,7,12
10055,2014/03/31,2012/06/23,7,24,0.6031033720000001,36267,7,7,17
10056,2014/03/31,2012/04/26,21,16,0.806753596,27110,21,9,7
10057,2014/03/31,2009/04/30,170,15,0.642166662,34057,170,9,6
10058,2014/03/31,2011/10/05,34,22,0.7511878259999999,29112,34,9,13
10059,2014/03/31,2008/03/22,72,16,0.8131469159999999,26893,72,4,12
10060,2014/03/31,2010/04/19,15,22,0.7402694740000001,29539,15,1,21
10061,2014/03/31,2007/02/26,81,23,0.611774054,35743,81,13,10
10062,2014/03/31,2009/04/16,29,46,0.7944923690000001,27520,29,29,17
10063,2014/03/31,2007/08/23,110,17,1.037147194,21081,110,9,8
10064,2014/03/31,2008/09/17,47,12,1.441204351,15170,47,7,5
10065,2014/03/31,2011/05/19,43,17,0.700831917,31193,43,10,7
10066,2014/03/31,2008/03/25,7,13,0.871844141,25074,7,7,6
10067,2014/03/31,2007/01/12,48,21,0.769121424,28421,48,7,14
10068,2014/03/31,2007/11/23,5,20,0.662000727,33018,5,11,9
10069,2014/03/31,2008/06/22,105,26,0.62323173,35071,105,12,14
10070,2014/03/31,2005/10/13,200,24,0.791871966,27602,200,18,6
10071,2014/03/31,2008/04/25,93,17,0.653650148,33437,93,10,7
10072,2014/03/31,2011/04/17,46,28,0.81196753,26917,46,21,7
10073,2014/03/31,2011/01/21,20,9,0.8037419090000001,27192,20,6,3
10074,2014/03/31,2011/07/10,230,29,0.634100801,34464,230,19,10
10075,2014/03/31,2011/12/14,8,18,0.844118351,25889,8,11,7
10076,2014/03/31,2008/05/23,103,14,0.711041395,30728,103,8,6
10077,2014/03/31,2013/01/08,1,19,0.6435865789999999,33946,1,0,19
10078,2014/03/31,2005/08/30,130,22,0.832285595,26247,130,11,11
10079,2014/03/31,2011/08/06,42,9,0.6911411390000001,31600,42,3,6
10080,2014/03/31,2008/03/07,34,25,0.7167891959999999,30469,34,13,12
10081,2014/03/31,2012/08/20,16,18,0.917667577,23795,16,4,14
10082,2014/03/31,2012/03/25,14,24,0.7003560320000001,31177,14,11,13
10083,2014/03/31,2010/02/24,9,13,0.7077462640000001,30851,9,4,9
10084,2014/03/31,2011/12/15,6,30,0.7010937,31142,6,15,15
10085,2014/03/31,2010/02/03,171,4,0.7175,30424,171,2,2
10086,2014/03/31,2005/05/16,11,27,0.80162315,27231,11,10,17
10087,2014/03/31,2007/07/12,10,18,0.8737988870000001,24981,10,5,13
10088,2014/03/31,2010/01/14,1,21,0.634731439,34387,1,7,14
10089,2014/03/31,2009/07/09,33,14,1.30727839,16696,33,10,4
10090,2014/03/31,2009/11/30,240,21,0.634451744,34400,240,14,7
10091,2014/03/31,2011/03/18,16,11,0.734024485,29733,16,8,3
10092,2014/03/31,2010/10/24,26,35,0.7775764270000001,28066,26,16,19
10093,2014/03/31,2008/04/17,213,19,1.08229518,20164,213,10,9
10094,2014/03/31,2006/12/15,18,22,0.7677676529999999,28423,18,14,8
10095,2014/03/31,2010/06/19,83,28,0.530515426,41131,83,13,15
10096,2014/03/31,2006/08/08,57,25,0.926499618,23546,57,17,8
10097,2014/03/31,2007/09/05,40,41,0.752628528,28982,40,13,28
10098,2014/03/31,2010/07/23,11,32,0.776853316,28074,11,21,11
10099,2014/03/31,2012/12/27,32,27,0.8062794390000001,27047,32,5,22
10100,2014/03/31,2007/07/15,34,20,0.796074545,27393,34,7,13
10101,2014/03/31,2009/12/03,32,28,0.658631709,33107,32,11,17
10102,2014/03/31,2010/09/02,55,20,0.604394212,36077,55,5,15
10103,2014/03/31,2012/06/16,17,15,0.7481220829999999,29144,17,7,8
10104,2014/03/31,2011/03/31,299,14,0.720905363,30242,299,13,1
10105,2014/03/31,2007/07/06,33,23,0.775626156,28108,33,15,8
10106,2014/03/31,2010/11/17,148,17,0.740240747,29450,148,12,5
10107,2014/03/31,2012/01/17,1,35,0.608270878,35839,1,19,16
10108,2014/03/31,2012/01/10,102,16,0.621757339,35053,102,10,6
10109,2014/03/31,2010/05/20,216,25,0.5462020910000001,39893,216,24,1
10110,2014/03/31,2011/07/13,11,16,0.6580063420000001,33110,11,6,10
10111,2014/03/31,2011/01/26,6,12,0.667250314,32651,6,3,9
10112,2014/03/31,2007/01/23,29,26,0.681124175,31979,29,11,15
10113,2014/03/31,2008/10/25,101,19,0.608154125,35815,101,5,14
10114,2014/03/31,2012/08/09,27,26,0.573902445,37948,27,13,13
10115,2014/03/31,2007/11/14,1,27,0.7826770890000001,27825,1,9,18
10116,2014/03/31,2010/07/23,170,14,0.754571696,28858,170,9,5
10117,2014/03/31,2012/06/03,157,11,0.741486137,29358,157,2,9
10118,2014/03/31,2006/04/12,157,14,1.012586407,21497,157,7,7
10119,2014/03/31,2011/12/21,5,32,0.6860093290000001,31729,5,10,22
10120,2014/03/31,2007/08/23,69,35,0.665682958,32696,69,13,22
10121,2014/03/31,2011/01/19,105,22,0.626160198,34757,105,15,7
10122,2014/03/31,2012/12/21,248,5,0.621794806,35001,248,4,1
10123,2014/03/31,2012/07/14,4,33,0.7852581820000001,27713,4,20,13
10124,2014/03/31,2010/04/18,8,21,0.748615268,29067,8,12,9
10125,2014/03/31,2008/04/21,73,9,0.7172890909999999,30333,73,3,6
10126,2014/03/31,2012/05/04,26,13,0.595303582,36547,26,2,11
10127,2014/03/31,2011/10/02,69,10,1.311766763,16584,69,3,7
10128,2014/03/31,2010/02/17,14,25,0.75743854,28718,14,11,14
10129,2014/03/31,2010/01/07,67,28,0.7775770359999999,27974,67,11,17
10130,2014/03/31,2013/01/21,58,20,0.639692656,34001,58,4,16
10131,2014/03/31,2008/05/03,3,28,0.72584735,29964,3,13,15
10132,2014/03/31,2009/07/28,139,28,0.705898734,30810,139,16,12
10133,2014/03/31,2005/02/26,30,23,0.6486542989999999,33529,30,11,12
10134,2014/03/31,2007/11/14,173,15,0.7891328009999999,27560,173,11,4
10135,2014/03/31,2010/02/21,44,20,0.634842806,34257,44,11,9
10136,2014/03/31,2007/02/03,8,19,0.792526147,27441,8,5,14
10137,2014/03/31,2007/12/09,4,30,0.715503126,30390,4,10,20
10138,2014/03/31,2006/07/06,36,44,0.6411169760000001,33913,36,30,14
10139,2014/03/31,2006/06/13,11,10,0.69158407,31438,11,3,7
10140,2014/03/31,2006/02/16,383,21,0.701948723,30969,383,21,0
10141,2014/03/31,2005/11/23,343,13,1.049577519,20711,343,11,2
10142,2014/03/31,2010/09/25,13,17,0.7475444509999999,29077,13,9,8
10143,2014/03/31,2005/09/09,26,20,0.78070074,27842,26,6,14
10144,2014/03/31,2012/10/31,10,23,0.650123527,33434,10,4,19
10145,2014/03/31,2008/09/30,61,14,0.7278719770000001,29854,61,5,9
10146,2014/03/31,2008/12/02,84,7,0.6365821,34135,84,3,4
10147,2014/03/31,2009/02/10,6,18,0.660507995,32894,6,3,15
10148,2014/03/31,2012/08/25,69,16,0.7515098579999999,28910,69,5,11
10149,2014/03/31,2010/09/04,125,21,0.922776739,23542,125,14,7
10150,2014/03/31,2010/10/19,69,26,0.919135181,23635,69,16,10
10151,2014/03/31,2013/02/08,32,10,0.6777835320000001,32051,32,3,7
10152,2014/03/31,2012/03/13,15,11,0.7903707879999999,27482,15,3,8
10153,2014/03/31,2011/11/24,137,26,0.972016649,22344,137,22,4
10154,2014/03/31,2011/09/29,180,7,1.470739487,14767,180,3,4
10155,2014/03/31,2009/11/24,5,28,0.652878187,33264,5,13,15
10156,2014/03/31,2009/10/09,20,21,0.848078035,25604,20,12,9
10157,2014/03/31,2012/11/09,3,18,0.914940165,23732,3,3,15
10158,2014/03/31,2012/06/03,12,30,0.612285263,35462,12,11,19
10159,2014/03/31,2012/02/16,12,22,0.70428071,30829,12,9,13
10160,2014/03/31,2011/05/09,11,17,0.653052096,33246,11,11,6
10161,2014/03/31,2008/10/13,75,16,0.6516595629999999,33316,75,7,9
10162,2014/03/31,2011/10/31,16,17,0.846984238,25632,16,8,9
10163,2014/03/31,2012/11/09,19,17,0.680556426,31900,19,1,16
10164,2014/03/31,2012/09/19,3,26,0.7929787779999999,27377,3,9,17
10165,2014/03/31,2006/06/06,12,30,0.718576677,30211,12,19,11
10166,2014/03/31,2005/11/23,41,27,0.73367569,29589,41,15,12
10167,2014/03/31,2007/02/02,13,21,0.671183291,32342,13,3,18
10168,2014/03/31,2009/12/02,31,18,0.7546632590000001,28761,31,2,16
10169,2014/03/31,2006/01/19,24,26,0.820711854,26438,24,10,16
10170,2014/03/31,2010/02/10,6,29,0.6779697509999999,32001,6,12,17
10171,2014/03/31,2012/03/15,206,25,0.781028263,27775,206,16,9
10172,2014/03/31,2007/09/20,136,16,0.968774453,22390,136,8,8
10173,2014/03/31,2012/06/19,19,22,0.7588530440000001,28580,19,11,11
10174,2014/03/31,2006/04/03,270,11,0.695093922,31196,270,7,4
10175,2014/03/31,2007/06/19,35,32,0.574964994,37708,35,16,16
10176,2014/03/31,2008/07/15,5,24,0.8116864490000001,26707,5,14,10
10177,2014/03/31,2011/11/05,7,27,0.424581048,51056,7,10,17
10178,2014/03/31,2010/10/27,61,27,1.078972125,20090,61,17,10
10179,2014/03/31,2005/06/11,54,19,0.71838962,30173,54,9,10
10180,2014/03/31,2008/07/09,15,22,0.735783631,29459,15,7,15
10181,2014/03/31,2012/10/16,16,27,0.503033489,43089,16,3,24
10182,2014/03/31,2009/12/06,62,19,0.802180398,27018,62,12,7
10183,2014/03/31,2006/06/15,9,20,0.624463941,34707,9,8,12
10184,2014/03/31,2013/01/13,87,14,1.161351409,18662,87,1,13
10185,2014/03/31,2005/06/29,33,20,0.6550456410000001,33084,33,12,8
10186,2014/03/31,2007/04/06,33,10,1.41185301,15348,33,3,7
10187,2014/03/31,2006/01/28,52,26,0.770973102,28106,52,16,10
10188,2014/03/31,2011/07/09,11,26,0.6837370229999999,31691,11,19,7
10189,2014/03/31,2013/03/14,1,32,0.698032412,31038,1,1,31
10190,2014/03/31,2008/12/11,90,22,0.505061895,42895,90,16,6
10191,2014/03/31,2010/12/06,12,24,0.771431878,28082,12,9,15
10192,2014/03/31,2009/09/11,137,25,0.875276195,24747,137,12,13
10193,2014/03/31,2006/02/19,4,36,0.828834717,26131,4,23,13
10194,2014/03/31,2011/01/30,10,22,0.4762567070000001,45476,10,3,19
10195,2014/03/31,2005/07/09,107,25,0.768678167,28173,107,18,7
10196,2014/03/31,2008/03/04,7,21,0.7850534709999999,27585,7,7,14
10197,2014/03/31,2008/06/27,48,35,0.8936907270000001,24231,48,16,19
10198,2014/03/31,2008/08/12,213,2,0.885,24464,213,0,2
10199,2014/03/31,2007/03/03,2,19,0.8368609640000001,25871,2,10,9
10200,2014/03/31,2006/10/08,16,24,0.668532345,32385,16,11,13
10201,2014/03/31,2012/06/22,53,19,0.612336454,35357,53,8,11
10202,2014/03/31,2009/11/10,11,32,0.751969918,28788,11,15,17
10203,2014/03/31,2005/10/15,8,18,0.5785930020000001,37413,8,11,7
10204,2014/03/31,2007/10/16,11,20,0.661238392,32736,11,13,7
10205,2014/03/31,2004/12/07,19,31,0.617353335,35063,19,15,16
10206,2014/03/31,2011/07/24,433,17,0.904059642,23943,433,17,0
10207,2014/03/31,2009/09/21,37,30,0.715734555,30236,37,16,14
10208,2014/03/31,2006/07/10,13,22,0.658277205,32871,13,14,8
10209,2014/03/31,2008/06/19,8,26,0.8657697390000001,24989,8,16,10
10210,2014/03/31,2009/06/25,113,26,0.54959938,39364,113,15,11
10211,2014/03/31,2007/09/02,19,22,0.59579675,36310,19,12,10
10212,2014/03/31,2011/06/16,110,26,0.6307459679999999,34291,110,17,9
10213,2014/03/31,2007/07/13,83,21,0.761227607,28413,83,9,12
10214,2014/03/31,2012/07/27,201,23,0.7345659259999999,29442,201,13,10
10215,2014/03/31,2006/08/29,133,14,0.658225286,32856,133,7,7
10216,2014/03/31,2006/05/27,111,20,0.7480410940000001,28909,111,10,10
10217,2014/03/31,2012/11/24,1,12,1.35031972,16014,1,9,3
10218,2014/03/31,2011/10/17,29,12,1.426483045,15158,29,4,8
10219,2014/03/31,2005/05/01,127,19,0.724734019,29833,127,9,10
10220,2014/03/31,2012/12/12,112,22,0.80516684,26852,112,4,18
10221,2014/03/31,2011/07/08,42,14,0.8153611159999999,26515,42,8,6
10222,2014/03/31,2005/06/14,33,13,1.231842165,17550,33,5,8
10223,2014/03/31,2006/01/08,79,16,0.7669121609999999,28188,79,4,12
10224,2014/03/31,2007/01/25,40,21,0.7320118520000001,29530,40,10,11
10225,2014/03/31,2008/10/14,82,21,0.545153594,39650,82,8,13
10226,2014/03/31,2010/01/12,2,24,0.827566336,26117,2,7,17
10227,2014/03/31,2006/03/31,114,24,0.615947217,35087,114,13,11
10228,2014/03/31,2007/11/01,101,27,0.768889917,28106,101,11,16
10229,2014/03/31,2011/11/08,249,19,0.7962406040000001,27140,249,14,5
10230,2014/03/31,2012/08/07,101,14,0.6744302609999999,32041,101,5,9
10231,2014/03/31,2012/07/18,75,16,0.7177011990000001,30107,75,4,12
10232,2014/03/31,2009/06/30,146,16,0.6795138059999999,31798,146,10,6
10233,2014/03/31,2012/06/15,12,23,0.85132871,25378,12,8,15
10234,2014/03/31,2006/12/08,109,18,0.659789834,32736,109,6,12
10235,2014/03/31,2006/04/06,191,21,0.715324237,30194,191,17,4
10236,2014/03/31,2011/07/20,40,26,0.605857155,35647,40,12,14
10237,2014/03/31,2008/12/26,115,21,0.7172366720000001,30105,115,13,8
10238,2014/03/31,2007/10/20,38,18,0.6921390559999999,31196,38,3,15
10239,2014/03/31,2011/05/29,20,29,0.717212663,30104,20,14,15
10240,2014/03/31,2011/11/09,131,10,0.786108138,27465,131,3,7
10241,2014/03/31,2010/02/23,12,21,0.824212677,26190,12,15,6
10242,2014/03/31,2010/03/13,67,25,0.685551815,31487,67,17,8
10243,2014/03/31,2009/12/10,378,21,0.739425185,29192,378,21,0
10244,2014/03/31,2008/05/10,5,17,0.832655943,25923,5,9,8
10245,2014/03/31,2009/10/13,35,19,0.7030591840000001,30701,35,5,14
10246,2014/03/31,2010/11/03,26,16,0.825311735,26144,26,10,6
10247,2014/03/31,2012/12/29,106,23,0.750322715,28756,106,10,13
10248,2014/03/31,2005/09/10,178,21,0.6962063959999999,30989,178,12,9
10249,2014/03/31,2005/03/11,20,23,0.8274659609999999,26073,20,6,17
10250,2014/03/31,2013/01/19,8,24,0.497937402,43324,8,1,23
10251,2014/03/31,2012/01/20,4,21,0.734252647,29377,4,15,6
10252,2014/03/31,2012/02/04,4,24,0.59357884,36333,4,0,24
10253,2014/03/31,2012/01/02,143,13,0.842571596,25595,143,10,3
10254,2014/03/31,2008/10/19,80,29,0.6883933990000001,31327,80,14,15
10255,2014/03/31,2010/05/20,9,19,0.629952384,34232,9,12,7
10256,2014/03/31,2006/01/21,8,22,0.709991769,30372,8,9,13
10257,2014/03/31,2006/11/14,46,21,0.74307695,29019,46,17,4
10258,2014/03/31,2005/03/17,426,33,0.8278274720000001,26048,426,33,0
10259,2014/03/31,2008/03/10,5,16,0.8364878179999999,25776,5,11,5
10260,2014/03/31,2008/10/09,19,22,0.621487472,34683,19,11,11
10261,2014/03/31,2011/05/19,7,19,0.597238494,36089,7,15,4
10262,2014/03/31,2011/04/19,208,13,1.345672098,16017,208,9,4
10263,2014/03/31,2007/01/27,1,15,0.7159202790000001,30105,1,2,13
10264,2014/03/31,2013/03/13,10,30,0.6196759629999999,34780,10,3,27
10265,2014/03/31,2011/02/10,83,21,1.326272386,16249,83,12,9
10266,2014/03/31,2010/05/01,5,14,0.662857143,32508,5,4,10
10267,2014/03/31,2012/08/09,27,17,0.786079247,27408,27,5,12
10268,2014/03/31,2012/11/30,32,31,0.637824324,33778,32,7,24
10269,2014/03/31,2007/06/09,77,19,0.774517903,27816,77,12,7
10270,2014/03/31,2008/08/23,46,22,0.7570260390000001,28457,46,7,15
10271,2014/03/31,2009/01/17,105,19,0.704354238,30584,105,11,8
10272,2014/03/31,2012/11/15,94,11,0.7409090909999999,29073,94,1,10
10273,2014/03/31,2011/01/13,3,13,0.737136648,29221,3,10,3
10274,2014/03/31,2007/09/04,169,10,1.001153721,21513,169,8,2
10275,2014/03/31,2007/04/24,30,18,0.6881341470000001,31294,30,8,10
10276,2014/03/31,2008/04/29,76,21,0.7834994909999999,27484,76,12,9
10277,2014/03/31,2006/05/21,5,25,0.7067831940000001,30465,5,6,19
10278,2014/03/31,2008/10/24,18,18,0.889604611,24204,18,10,8
10279,2014/03/31,2011/03/07,20,32,0.763274132,28209,20,6,26
10280,2014/03/31,2005/11/09,40,25,0.6280932379999999,34278,40,17,8
10281,2014/03/31,2012/01/27,243,16,0.680155747,31654,243,9,7
10282,2014/03/31,2011/06/08,65,21,0.669920339,32136,65,12,9
10283,2014/03/31,2006/01/15,2,3,0.586666667,36696,2,0,3
10284,2014/03/31,2012/10/22,9,20,0.7391111340000001,29127,9,7,13
10285,2014/03/31,2008/09/24,57,17,0.7103801479999999,30304,57,4,13
10286,2014/03/31,2009/09/24,184,4,0.782630067,27505,184,2,2
10287,2014/03/31,2012/02/23,27,23,0.843578791,25517,27,13,10
10288,2014/03/31,2007/09/23,8,21,0.760463908,28303,8,7,14
10289,2014/03/31,2009/03/19,12,23,0.628972208,34219,12,11,12
10290,2014/03/31,2006/04/06,16,13,0.797590245,26982,16,3,10
10291,2014/03/31,2009/05/02,11,10,0.948390992,22691,11,2,8
10292,2014/03/31,2011/09/07,336,10,1.461902174,14720,336,6,4
10293,2014/03/31,2011/10/23,226,15,0.747432958,28788,226,10,5
10294,2014/03/31,2008/01/28,36,26,0.8294752870000001,25938,36,14,12
10295,2014/03/31,2013/01/24,3,36,0.811902785,26498,3,0,36
10296,2014/03/31,2007/11/23,41,21,0.5881979,36574,41,8,13
10297,2014/03/31,2007/06/04,6,21,0.736430919,29212,6,13,8
10298,2014/03/31,2008/01/17,165,13,0.583687424,36855,165,9,4
10299,2014/03/31,2011/07/07,141,16,0.704716289,30524,141,10,6
10300,2014/03/31,2011/03/24,15,20,0.7710040509999999,27897,15,4,16
10301,2014/03/31,2011/01/13,3,25,0.6079120379999999,35379,3,14,11
10302,2014/03/31,2010/05/01,6,21,0.666774454,32255,6,5,16
10303,2014/03/31,2012/05/31,311,10,0.66415004,32378,311,8,2
10304,2014/03/31,2006/02/21,47,10,0.7463572940000001,28811,47,7,3
10305,2014/03/31,2011/07/20,5,13,0.765838558,28072,5,11,2
10306,2014/03/31,2008/08/09,20,18,0.627111558,34278,20,9,9
10307,2014/03/31,2011/11/25,11,18,0.7678023079999999,27993,11,10,8
10308,2014/03/31,2005/06/18,135,29,0.71166341,30197,135,19,10
10309,2014/03/31,2005/06/23,3,37,0.687296191,31267,3,14,23
10310,2014/03/31,2011/12/18,14,20,0.872167878,24637,14,11,9
10311,2014/03/31,2012/03/31,25,14,0.657833262,32662,25,8,6
10312,2014/03/31,2011/10/31,29,10,1.4278223019999998,15048,29,4,6
10313,2014/03/31,2007/01/22,57,24,0.676795716,31745,57,12,12
10314,2014/03/31,2010/04/15,34,23,0.556109127,38634,34,15,8
10315,2014/03/31,2010/07/19,33,17,0.7062672190000001,30417,33,8,9
10316,2014/03/31,2012/05/31,11,24,0.7053058409999999,30457,11,10,14
10317,2014/03/31,2008/08/23,177,23,0.6149577589999999,34919,177,12,11
10318,2014/03/31,2012/12/10,19,21,0.665956206,32242,19,7,14
10319,2014/03/31,2011/11/03,93,18,0.7113965740000001,30181,93,8,10
10320,2014/03/31,2012/07/12,8,21,0.6867583740000001,31259,8,9,12
10321,2014/03/31,2011/06/07,417,12,1.0314992790000002,20810,417,12,0
10322,2014/03/31,2005/01/01,60,25,0.761240558,28197,60,16,9
10323,2014/03/31,2009/01/14,23,23,0.8027750770000001,26738,23,7,16
10324,2014/03/31,2010/12/20,3,21,0.697637327,30766,3,9,12
10325,2014/03/31,2013/03/15,14,16,0.642708652,33393,14,0,16
10326,2014/03/31,2007/04/18,296,29,0.620264451,34600,296,26,3
10327,2014/03/31,2012/09/21,11,21,0.6930877559999999,30961,11,3,18
10328,2014/03/31,2007/11/05,14,15,0.593896424,36128,14,5,10
10329,2014/03/31,2006/10/09,149,18,0.738596805,29048,149,11,7
10330,2014/03/31,2008/03/07,190,6,1.427847158,15022,190,3,3
10331,2014/03/31,2010/03/27,18,21,0.854000557,25114,18,8,13
10332,2014/03/31,2006/01/22,104,14,0.916894561,23388,104,4,10
10333,2014/03/31,2008/01/20,65,18,0.667439066,32125,65,6,12
10334,2014/03/31,2005/09/25,61,15,0.764124461,28057,61,5,10
10335,2014/03/31,2011/11/25,68,13,0.683023545,31387,68,5,8
10336,2014/03/31,2008/12/20,8,16,0.735767435,29136,8,4,12
10337,2014/03/31,2007/10/25,4,23,0.650382573,32961,4,11,12
10338,2014/03/31,2012/10/23,60,20,0.7092208440000001,30225,60,12,8
10339,2014/03/31,2012/10/26,72,10,0.6455498000000001,33203,72,2,8
10340,2014/03/31,2012/12/14,4,19,0.581221086,36877,4,1,18
10341,2014/03/31,2006/03/15,21,19,0.733875706,29205,21,6,13
10342,2014/03/31,2008/01/16,105,13,0.681802768,31435,105,7,6
10343,2014/03/31,2012/08/09,30,20,0.690962022,31018,30,2,18
10344,2014/03/31,2013/03/22,74,28,0.750413895,28558,74,0,28
10345,2014/03/31,2008/04/26,7,20,0.596413403,35931,7,10,10
10346,2014/03/31,2008/08/31,109,20,0.6667272329999999,32141,109,12,8
10347,2014/03/31,2008/11/18,39,19,0.727737137,29445,39,3,16
10348,2014/03/31,2007/06/02,5,30,0.6149746,34843,5,0,30
10349,2014/03/31,2011/08/18,12,20,0.726169802,29505,12,13,7
10350,2014/03/31,2010/09/09,69,17,1.063756703,20140,69,6,11
10351,2014/03/31,2012/03/24,68,18,0.8751711740000001,24478,68,6,12
10352,2014/03/31,2010/11/12,121,21,0.609052548,35168,121,10,11
10353,2014/03/31,2011/08/17,267,15,0.7848717479999999,27290,267,12,3
10354,2014/03/31,2011/08/10,8,23,0.762238078,28100,8,13,10
10355,2014/03/31,2009/08/28,33,20,0.706510753,30316,33,12,8
10356,2014/03/31,2008/10/17,39,22,0.6410342760000001,33405,39,14,8
10357,2014/03/31,2012/08/03,28,36,0.782188813,27371,28,15,21
10358,2014/03/31,2010/10/29,4,33,0.607146909,35260,4,15,18
10359,2014/03/31,2010/12/27,108,7,0.667417927,32075,108,1,6
10360,2014/03/31,2011/02/08,378,18,0.790121064,27093,378,18,0
10361,2014/03/31,2012/07/29,606,2,0.875,24464,606,2,0
10362,2014/03/31,2011/12/02,277,2,0.875,24464,277,1,1
10363,2014/03/31,2013/01/16,4,3,0.583333333,36696,4,1,2
10364,2014/03/31,2011/12/17,102,17,0.648796108,32993,102,5,12
10365,2014/03/31,2011/01/14,14,9,1.291109235,16579,14,2,7
10366,2014/03/31,2010/04/30,31,25,0.67998602,31474,31,12,13
10367,2014/03/31,2010/02/26,43,21,0.640304028,33418,43,12,9
10368,2014/03/31,2012/04/28,108,13,0.622494691,34373,108,0,13
10369,2014/03/31,2008/10/17,10,20,0.67265933,31805,10,8,12
10370,2014/03/31,2011/07/22,66,31,0.721527202,29649,66,23,8
10371,2014/03/31,2006/06/29,7,21,0.709069906,30169,7,8,13
10372,2014/03/31,2011/10/10,56,18,0.851608935,25116,56,8,10
10373,2014/03/31,2011/08/12,2,16,0.592554441,36094,2,10,6
10374,2014/03/31,2011/06/02,20,27,0.739275838,28930,20,18,9
10375,2014/03/31,2011/12/22,10,22,0.752016668,28438,10,11,11
10376,2014/03/31,2006/11/26,8,20,0.835973417,25580,8,10,10
10377,2014/03/31,2011/02/26,31,23,0.738642487,28950,31,5,18
10378,2014/03/31,2008/10/09,75,21,0.5446827479999999,39259,75,5,16
10379,2014/03/31,2005/07/09,13,31,0.6424950420000001,33282,13,14,17
10380,2014/03/31,2012/02/16,121,20,0.7864035890000001,27191,121,9,11
10381,2014/03/31,2012/02/25,100,20,0.6524764989999999,32764,100,14,6
10382,2014/03/31,2005/10/30,23,26,0.634367618,33698,23,2,24
10383,2014/03/31,2008/04/06,130,23,0.855617595,24984,130,21,2
10384,2014/03/31,2010/12/20,8,13,1.222514155,17485,8,4,9
10385,2014/03/31,2008/06/13,203,16,1.219727802,17524,203,11,5
10386,2014/03/31,2006/10/07,25,21,0.7398812659999999,28888,25,11,10
10387,2014/03/31,2011/01/14,75,21,0.6987778720000001,30586,75,5,16
10388,2014/03/31,2007/05/11,52,28,0.7651915909999999,27924,52,13,15
10389,2014/03/31,2011/08/09,29,19,0.700385813,30507,29,4,15
10390,2014/03/31,2008/05/10,2,12,0.68375164,31245,2,3,9
10391,2014/03/31,2011/08/29,121,21,0.590902351,36150,121,13,8
10392,2014/03/31,2009/12/08,37,17,1.002840509,21299,37,10,7
10393,2014/03/31,2008/04/23,13,32,0.750101847,28474,13,13,19
10394,2014/03/31,2012/01/18,19,20,0.712434118,29978,19,6,14
10395,2014/03/31,2010/02/16,3,15,0.858861543,24867,3,0,15
10396,2014/03/31,2006/06/19,13,22,0.543189032,39316,13,16,6
10397,2014/03/31,2011/05/09,27,17,0.7360470809999999,29014,27,0,17
10398,2014/03/31,2012/12/10,2,23,0.6325764979999999,33759,2,10,13
10399,2014/03/31,2008/08/01,71,21,0.7537534859999999,28331,71,2,19
10400,2014/03/31,2012/06/15,18,36,0.688010053,31036,18,22,14
10401,2014/03/31,2007/06/01,1,27,0.8280993759999999,25781,1,16,11
10402,2014/03/31,2010/11/26,125,21,0.710535548,30044,125,10,11
10403,2014/03/31,2008/04/17,136,21,0.65374108,32651,136,13,8
10404,2014/03/31,2008/06/16,20,43,0.75690922,28200,20,14,29
10405,2014/03/31,2010/07/20,56,4,0.568141021,37569,56,0,4
10406,2014/03/31,2011/12/02,14,32,0.669689069,31872,14,17,15
10407,2014/03/31,2012/04/23,140,13,0.86339644,24720,140,8,5
10408,2014/03/31,2008/03/07,151,16,1.053978962,20249,151,6,10
10409,2014/03/31,2011/04/12,5,23,0.7761811240000001,27495,5,14,9
10410,2014/03/31,2012/08/03,384,8,0.744831076,28652,384,8,0
10411,2014/03/31,2011/10/15,91,23,0.820105304,26020,91,10,13
10412,2014/03/31,2013/02/25,30,18,0.86561965,24651,30,3,15
10413,2014/03/31,2011/01/13,6,18,0.755259265,28253,6,5,13
10414,2014/03/31,2006/06/01,10,18,0.6784721290000001,31449,10,12,6
10415,2014/03/31,2008/05/19,146,15,0.60200158,35442,146,6,9
10416,2014/03/31,2009/07/05,38,20,0.660823242,32287,38,9,11
10417,2014/03/31,2008/12/02,11,19,0.92070735,23171,11,11,8
10418,2014/03/31,2013/02/12,7,62,0.823096423,25917,7,4,58
10419,2014/03/31,2008/05/28,60,7,0.718639334,29684,60,0,7
10420,2014/03/31,2008/06/23,134,4,0.7024259890000001,30367,134,2,2
10421,2014/03/31,2006/05/17,157,14,1.108205341,19246,157,9,5
10422,2014/03/31,2012/05/01,2,28,0.686486948,31067,2,8,20
10423,2014/03/31,2007/05/24,72,21,0.792971958,26888,72,8,13
10424,2014/03/31,2010/01/16,41,24,0.681729496,31275,41,16,8
10425,2014/03/31,2010/02/09,242,8,0.825,25840,242,6,2
10426,2014/03/31,2013/01/19,20,11,0.680272202,31337,20,0,11
10427,2014/03/31,2012/10/19,4,28,0.7787969459999999,27372,4,10,18
10428,2014/03/31,2011/06/30,2,25,0.747364583,28523,2,11,14
10429,2014/03/31,2006/06/29,6,30,0.598015991,35645,6,0,30
10430,2014/03/31,2011/04/11,44,19,0.753801726,28274,44,11,8
10431,2014/03/31,2006/06/19,10,13,0.76570941,27833,10,3,10
10432,2014/03/31,2007/03/11,127,20,0.580069976,36727,127,12,8
10433,2014/03/31,2007/05/18,2,18,0.688377496,30946,2,7,11
10434,2014/03/31,2008/03/19,67,22,0.553713966,38471,67,11,11
10435,2014/03/31,2013/03/05,28,11,0.648930356,32824,28,1,10
10436,2014/03/31,2011/03/07,15,13,0.681521774,31253,15,3,10
10437,2014/03/31,2009/07/23,6,19,0.6002012,35487,6,6,13
10438,2014/03/31,2012/12/12,4,19,0.683245628,31165,4,4,15
10439,2014/03/31,2005/11/30,35,25,0.757064429,28124,35,12,13
10440,2014/03/31,2009/04/15,17,28,0.72516808,29361,17,12,16
10441,2014/03/31,2010/01/30,12,17,0.7575659140000001,28105,12,5,12
10442,2014/03/31,2011/12/04,3,38,0.800817593,26578,3,16,22
10443,2014/03/31,2011/09/16,49,21,0.46797423,45479,49,14,7
10444,2014/03/31,2011/06/23,84,14,0.927571703,22942,84,6,8
10445,2014/03/31,2007/07/29,170,4,0.7,30398,170,2,2
10446,2014/03/31,2010/05/24,21,33,0.590683768,36021,21,15,18
10447,2014/03/31,2007/10/08,58,13,0.7789357109999999,27314,58,8,5
10448,2014/03/31,2011/10/27,13,17,0.681584748,31210,13,4,13
10449,2014/03/31,2007/05/01,9,27,0.86878247,24484,9,15,12
10450,2014/03/31,2007/08/16,26,24,0.717096285,29662,26,7,17
10451,2014/03/31,2013/01/04,6,14,0.654285714,32508,6,2,12
10452,2014/03/31,2011/10/09,79,22,0.59257404,35893,79,6,16
10453,2014/03/31,2012/03/16,110,21,0.829567829,25638,110,16,5
10454,2014/03/31,2008/03/15,148,20,0.819298482,25958,148,9,11
10455,2014/03/31,2011/09/14,11,28,0.771438987,27568,11,13,15
10456,2014/03/31,2006/05/25,56,17,0.77041407,27604,56,4,13
10457,2014/03/31,2010/08/26,98,17,0.698126457,30461,98,3,14
10458,2014/03/31,2008/07/16,50,15,0.783472974,27141,50,11,4
10459,2014/03/31,2007/03/30,94,13,0.963967542,22059,94,6,7
10460,2014/03/31,2008/10/09,13,39,0.81272974,26160,13,18,21
10461,2014/03/31,2012/09/29,57,12,0.681990248,31172,57,6,6
10462,2014/03/31,2009/10/27,23,11,0.742242903,28637,23,2,9
10463,2014/03/31,2012/07/02,145,15,0.815260433,26072,145,9,6
10464,2014/03/31,2007/09/18,104,31,0.86270233,24638,104,25,6
10465,2014/03/31,2008/05/22,99,22,0.632549702,33600,99,17,5
10466,2014/03/31,2010/03/12,20,12,0.7112697029999999,29881,20,6,6
10467,2014/03/31,2010/03/24,92,25,0.608162594,34946,92,11,14
10468,2014/03/31,2011/01/01,1,17,1.447846971,14677,1,9,8
10469,2014/03/31,2011/01/01,39,16,0.627316152,33873,39,4,12
10470,2014/03/31,2011/11/30,26,17,0.725563258,29285,26,7,10
10471,2014/03/31,2006/12/01,31,26,0.71335426,29786,31,15,11
10472,2014/03/31,2012/06/16,16,18,0.762577438,27861,16,3,15
10473,2014/03/31,2012/07/15,10,23,0.7666799,27707,10,5,18
10474,2014/03/31,2012/02/19,19,24,0.783987155,27092,19,16,8
10475,2014/03/31,2011/08/17,60,16,0.767190898,27685,60,8,8
10476,2014/03/31,2009/05/12,31,26,0.865725583,24532,31,19,7
10477,2014/03/31,2011/06/03,137,22,0.6759598920000001,31415,137,12,10
10478,2014/03/31,2011/08/24,48,19,0.673529468,31526,48,11,8
10479,2014/03/31,2012/03/02,314,24,0.658054669,32267,314,23,1
10480,2014/03/31,2009/01/05,152,24,0.681545697,31151,152,14,10
10481,2014/03/31,2005/07/21,97,25,0.651779442,32572,97,10,15
10482,2014/03/31,2012/06/01,115,9,0.750117314,28300,115,8,1
10483,2014/03/31,2011/01/04,24,22,0.689752721,30775,24,14,8
10484,2014/03/31,2011/05/24,238,15,0.751929999,28228,238,10,5
10485,2014/03/31,2011/08/06,72,22,0.600596508,35339,72,7,15
10486,2014/03/31,2012/01/27,6,24,0.612194179,34669,6,10,14
10487,2014/03/31,2009/04/25,3,37,0.677776252,31312,3,13,24
10488,2014/03/31,2011/10/29,4,7,0.709046108,29930,4,4,3
10489,2014/03/31,2010/04/30,330,10,0.805256366,26349,330,8,2
10490,2014/03/31,2010/03/08,52,26,0.961696736,22060,52,8,18
10491,2014/03/31,2009/12/21,170,17,0.851338336,24919,170,8,9
10492,2014/03/31,2007/02/09,26,21,0.8201020640000001,25866,26,11,10
10493,2014/03/31,2006/10/25,80,29,0.703863538,30133,80,14,15
10494,2014/03/31,2012/03/24,18,22,0.533793416,39732,18,6,16
10495,2014/03/31,2005/10/20,5,29,0.543780929,39001,5,6,23
10496,2014/03/31,2009/10/27,29,13,0.616886672,34378,29,9,4
10497,2014/03/31,2012/07/09,156,8,0.863367804,24562,156,5,3
10498,2014/03/31,2008/10/26,164,18,0.727624211,29144,164,11,7
10499,2014/03/31,2006/09/01,24,18,0.8332887959999999,25447,24,7,11
10500,2014/03/31,2012/12/12,52,14,0.606447489,34964,52,1,13
10501,2014/03/31,2009/09/25,67,15,1.100353399,19270,67,5,10
10502,2014/03/31,2010/08/26,33,35,0.545301288,38883,33,21,14
10503,2014/03/31,2011/12/19,473,19,0.830749941,25522,473,19,0
10504,2014/03/31,2013/01/26,33,9,0.767405785,27623,33,0,9
10505,2014/03/31,2008/10/18,94,17,0.641058856,33064,94,6,11
10506,2014/03/31,2009/07/09,23,29,0.604471102,35054,23,15,14
10507,2014/03/31,2012/07/12,109,8,0.82,25840,109,4,4
10508,2014/03/31,2005/04/01,64,27,0.7407572370000001,28604,64,19,8
10509,2014/03/31,2006/08/22,2,35,0.720866193,29393,2,22,13
10510,2014/03/31,2013/03/28,5,29,0.5999716829999999,35315,5,0,29
10511,2014/03/31,2008/06/13,93,18,0.938842609,22568,93,11,7
10512,2014/03/31,2005/08/10,10,21,0.598491003,35401,10,9,12
10513,2014/03/31,2009/08/08,7,20,0.690870317,30667,7,10,10
10514,2014/03/31,2008/01/21,68,14,0.741791729,28559,68,7,7
10515,2014/03/31,2008/03/25,4,21,0.829789626,25526,4,7,14
10516,2014/03/31,2011/08/07,108,18,0.642852373,32948,108,14,4
10517,2014/03/31,2005/03/10,18,25,0.560668449,37774,18,14,11
10518,2014/03/31,2007/04/16,1,20,1.006782505,21035,1,9,11
10519,2014/03/31,2008/04/22,18,14,0.745191963,28417,18,1,13
10520,2014/03/31,2008/10/19,31,23,0.812875624,26050,31,11,12
10521,2014/03/31,2011/01/14,137,21,0.664807849,31850,137,12,9
10522,2014/03/31,2012/06/11,49,9,0.873295389,24246,49,5,4
10523,2014/03/31,2009/11/07,12,16,0.888272361,23836,12,8,8
10524,2014/03/31,2009/10/01,22,13,0.986768585,21455,22,5,8
10525,2014/03/31,2012/04/18,129,13,0.5316927020000001,39818,129,4,9
10526,2014/03/31,2008/10/30,13,29,0.838550151,25244,13,13,16
10527,2014/03/31,2011/03/01,126,10,0.7164282809999999,29546,126,4,6
10528,2014/03/31,2005/11/04,65,20,0.673753382,31417,65,15,5
10529,2014/03/31,2012/11/17,16,14,0.7685714290000001,27538,16,4,10
10530,2014/03/31,2010/07/27,58,11,0.6979471709999999,30324,58,3,8
10531,2014/03/31,2006/05/23,15,26,0.620630773,34101,15,20,6
10532,2014/03/31,2008/10/18,696,4,0.808098511,26190,696,4,0
10533,2014/03/31,2012/01/20,76,18,0.6763700859999999,31290,76,5,13
10534,2014/03/31,2010/09/13,16,19,0.877536388,24115,16,16,3
10535,2014/03/31,2009/09/28,105,3,0.576666667,36696,105,2,1
10536,2014/03/31,2011/12/02,100,10,1.206966119,17532,100,2,8
10537,2014/03/31,2013/02/26,11,21,0.7013898829999999,30168,11,0,21
10538,2014/03/31,2011/08/28,102,22,0.754218293,28054,102,10,12
10539,2014/03/31,2010/03/11,242,22,0.7037729509999999,30064,242,13,9
10540,2014/03/31,2011/10/12,206,18,0.694549752,30461,206,12,6
10541,2014/03/31,2010/07/20,244,8,0.81875,25840,244,6,2
10542,2014/03/31,2004/11/26,100,22,0.7468323509999999,28327,100,18,4
10543,2014/03/31,2009/11/25,23,12,1.435494401,14735,23,5,7
10544,2014/03/31,2010/06/19,30,33,0.778768364,27159,30,18,15
10545,2014/03/31,2008/01/31,3,26,0.710029206,29788,3,9,17
10546,2014/03/31,2009/10/14,27,19,0.657753725,32151,27,10,9
10547,2014/03/31,2008/08/08,321,20,0.8193489629999999,25805,321,19,1
10548,2014/03/31,2006/08/08,4,19,0.615271505,34364,4,3,16
10549,2014/03/31,2012/03/16,12,20,0.667191908,31687,12,11,9
10550,2014/03/31,2009/11/11,5,25,0.667148222,31689,5,9,16
10551,2014/03/31,2005/02/24,2,18,0.697981115,30289,2,4,14
10552,2014/03/31,2012/02/27,208,27,0.651787322,32434,208,21,6
10553,2014/03/31,2012/09/27,32,22,0.682205332,30984,32,6,16
10554,2014/03/31,2008/09/05,126,22,0.791462757,26703,126,17,5
10555,2014/03/31,2009/09/27,386,15,1.109978992,19040,386,15,0
10556,2014/03/31,2012/02/08,323,16,0.726223452,29098,323,12,4
10557,2014/03/31,2011/03/11,251,13,0.973424544,21708,251,9,4
10558,2014/03/31,2012/12/01,13,21,0.580891522,36376,13,5,16
10559,2014/03/31,2006/06/02,23,15,0.558915695,37803,23,9,6
10560,2014/03/31,2007/06/26,5,30,0.73091966,28902,5,9,21
10561,2014/03/31,2010/05/17,18,27,0.7135416309999999,29605,18,10,17
10562,2014/03/31,2005/01/27,2,23,0.6757901140000001,31255,2,11,12
10563,2014/03/31,2012/06/19,170,24,0.748076582,28231,170,11,13
10564,2014/03/31,2008/03/20,2,18,0.650284843,32474,2,8,10
10565,2014/03/31,2008/09/30,14,33,0.907829564,23258,14,13,20
10566,2014/03/31,2013/01/11,77,21,0.634678651,33266,77,6,15
10567,2014/03/31,2010/04/20,56,43,0.737209302,28638,56,29,14
10568,2014/03/31,2011/08/25,505,11,0.720632211,29294,505,11,0
10569,2014/03/31,2013/03/13,75,19,0.7943606529999999,26574,75,1,18
10570,2014/03/31,2012/05/08,21,12,0.753239597,28022,21,8,4
10571,2014/03/31,2007/01/05,14,30,0.8456739320000001,24958,14,22,8
10572,2014/03/31,2012/03/19,84,28,0.7089258,29771,84,13,15
10573,2014/03/31,2006/01/26,84,18,0.653537609,32293,84,8,10
10574,2014/03/31,2011/08/10,36,33,0.7615429579999999,27713,36,27,6
10575,2014/03/31,2010/11/14,16,32,0.7855760709999999,26863,16,9,23
10576,2014/03/31,2013/03/01,212,3,0.816628483,25840,212,0,3
10577,2014/03/31,2011/12/20,3,16,0.81807746,25794,3,2,14
10578,2014/03/31,2006/06/08,8,16,0.834575802,25283,8,4,12
10579,2014/03/31,2010/07/01,43,27,0.697486198,30249,43,13,14
10580,2014/03/31,2009/09/27,28,17,0.501291258,42083,28,9,8
10581,2014/03/31,2007/08/22,164,19,0.745509613,28296,164,18,1
10582,2014/03/31,2011/06/29,22,15,0.5438857810000001,38785,22,7,8
10583,2014/03/31,2007/04/13,2,15,0.6944638329999999,30373,2,4,11
10584,2014/03/31,2010/02/10,24,22,0.8830306459999999,23886,24,15,7
10585,2014/03/31,2011/12/02,82,18,0.979577818,21531,82,13,5
10586,2014/03/31,2010/04/21,76,28,0.7153323840000001,29484,76,7,21
10587,2014/03/31,2011/02/24,43,31,0.807825238,26104,43,14,17
10588,2014/03/31,2009/02/17,86,12,0.889477348,23706,86,10,2
10589,2014/03/31,2010/12/25,3,18,0.5916295779999999,35635,3,8,10
10590,2014/03/31,2012/08/02,13,31,0.650224237,32421,13,13,18
10591,2014/03/31,2008/01/20,11,23,0.64234145,32813,11,10,13
10592,2014/03/31,2008/12/18,20,31,0.706848125,29814,20,14,17
10593,2014/03/31,2011/12/10,117,23,0.512143968,41148,117,9,14
10594,2014/03/31,2011/07/06,401,18,0.8863433709999999,23776,401,18,0
10595,2014/03/31,2007/05/14,62,20,0.8375267279999999,25161,62,9,11
10596,2014/03/31,2009/02/01,123,13,0.6909674029999999,30494,123,3,10
10597,2014/03/31,2007/07/13,7,14,0.765,27538,7,2,12
10598,2014/03/31,2012/02/08,107,25,0.716215279,29413,107,19,6
10599,2014/03/31,2011/02/27,28,38,0.781068303,26968,28,32,6
10600,2014/03/31,2010/06/20,36,24,0.7975297240000001,26410,36,19,5
10601,2014/03/31,2010/09/10,7,25,0.6730589290000001,31292,7,14,11
10602,2014/03/31,2011/05/15,1,34,0.676026192,31154,1,17,17
10603,2014/03/31,2013/02/20,27,28,0.787855807,26728,27,2,26
10604,2014/03/31,2010/09/30,2,23,0.564654886,37292,2,14,9
10605,2014/03/31,2011/04/28,8,17,0.8111282740000001,25960,8,6,11
10606,2014/03/31,2005/09/09,23,16,0.5950850670000001,35384,23,7,9
10607,2014/03/31,2011/12/10,195,25,0.883655251,23826,195,18,7
10608,2014/03/31,2007/05/10,93,7,0.987390958,21322,93,3,4
10609,2014/03/31,2010/09/16,6,12,1.010949385,20824,6,4,8
10610,2014/03/31,2007/08/31,76,18,0.742193505,28361,76,3,15
10611,2014/03/31,2010/07/24,41,23,0.810514884,25967,41,3,20
10612,2014/03/31,2007/04/25,40,23,0.7945292209999999,26488,40,10,13
10613,2014/03/31,2012/12/03,3,14,0.776375844,27107,3,1,13
10614,2014/03/31,2011/02/26,17,19,0.678195881,31029,17,8,11
10615,2014/03/31,2012/04/26,22,16,0.687691352,30598,22,3,13
10616,2014/03/31,2008/11/09,4,13,0.91002422,23121,4,4,9
10617,2014/03/31,2011/09/19,144,17,0.685524747,30691,144,10,7
10618,2014/03/31,2008/05/12,19,19,0.6936432579999999,30330,19,9,10
10619,2014/03/31,2006/04/12,10,21,0.8831614959999999,23821,10,13,8
10620,2014/03/31,2012/10/25,64,17,0.726175435,28968,64,3,14
10621,2014/03/31,2009/04/30,23,15,0.663421534,31708,23,7,8
10622,2014/03/31,2011/10/27,67,26,0.741833892,28355,67,20,6
10623,2014/03/31,2005/08/11,163,22,0.819460723,25664,163,7,15
10624,2014/03/31,2011/02/28,17,26,0.6345300620000001,33132,17,10,16
10625,2014/03/31,2007/12/26,43,14,0.6943016609999999,30279,43,9,5
10626,2014/03/31,2010/01/14,72,17,0.755107759,27840,72,10,7
10627,2014/03/31,2010/03/20,32,18,0.784916545,26781,32,8,10
10628,2014/03/31,2010/11/17,169,19,0.873563147,24063,169,16,3
10629,2014/03/31,2011/08/17,108,10,0.810951113,25917,108,6,4
10630,2014/03/31,2008/04/27,21,16,0.807431228,26028,21,6,10
10631,2014/03/31,2006/04/07,67,18,0.87912727,23902,67,7,11
10632,2014/03/31,2006/12/02,142,16,0.648735604,32387,142,11,5
10633,2014/03/31,2007/09/10,4,29,0.515199725,40781,4,13,16
10634,2014/03/31,2012/11/04,13,10,1.16567854,18024,13,4,6
10635,2014/03/31,2012/11/30,479,4,1.09174505,19243,479,4,0
10636,2014/03/31,2010/12/10,36,21,0.809454013,25953,36,9,12
10637,2014/03/31,2012/04/16,151,11,0.683636364,30723,151,6,5
10638,2014/03/31,2008/08/06,97,13,1.43909826,14594,97,8,5
10639,2014/03/31,2007/11/05,157,6,0.648323094,32393,157,0,6
10640,2014/03/31,2012/08/07,18,16,0.770433315,27255,18,4,12
10641,2014/03/31,2009/01/12,21,38,0.5676098829999999,36994,21,18,20
10642,2014/03/31,2010/11/20,20,29,0.84631091,24811,20,15,14
10643,2014/03/31,2010/12/13,158,4,0.826698169,25395,158,2,2
10644,2014/03/31,2006/12/20,13,22,0.691335046,30366,13,13,9
10645,2014/03/31,2011/01/14,9,13,0.897901198,23380,9,7,6
10646,2014/03/31,2013/03/03,21,23,0.6600562839999999,31803,21,2,21
10647,2014/03/31,2012/01/11,262,14,0.849208706,24719,262,13,1
10648,2014/03/31,2007/12/13,34,24,0.6439499360000001,32598,34,11,13
10649,2014/03/31,2012/12/09,92,14,0.645714286,32508,92,4,10
10650,2014/03/31,2010/08/29,1,33,0.554208997,37857,1,12,21
10651,2014/03/31,2011/09/30,132,18,0.612667504,34238,132,11,7
10652,2014/03/31,2009/02/07,56,24,0.7884386390000001,26605,56,11,13
10653,2014/03/31,2007/10/22,46,31,0.7502536040000001,27957,46,18,13
10654,2014/03/31,2006/09/12,2,22,0.862876538,24307,2,0,22
10655,2014/03/31,2011/09/20,91,19,0.680879784,30803,91,15,4
10656,2014/03/31,2008/05/23,4,19,0.653341849,32099,4,13,6
10657,2014/03/31,2012/09/29,23,19,0.735905534,28497,23,9,10
10658,2014/03/31,2010/06/13,122,31,0.619143195,33870,122,13,18
10659,2014/03/31,2008/01/09,22,23,0.79014395,26537,22,9,14
10660,2014/03/31,2008/01/08,6,28,0.905399896,23156,6,7,21
10661,2014/03/31,2009/06/07,21,23,0.747257139,28051,21,6,17
10662,2014/03/31,2007/07/24,2,17,0.7452156440000001,28125,2,8,9
10663,2014/03/31,2009/11/04,343,20,0.6816832009999999,30745,343,17,3
10664,2014/03/31,2006/05/08,231,18,0.8855187859999999,23661,231,16,2
10665,2014/03/31,2008/02/21,131,14,0.620195126,33773,131,2,12
10666,2014/03/31,2009/03/18,34,17,0.7575549770000001,27648,34,8,9
10667,2014/03/31,2012/02/24,5,24,0.8041918509999999,26041,5,9,15
10668,2014/03/31,2008/08/13,109,33,0.865952519,24178,109,7,26
10669,2014/03/31,2011/06/01,21,21,0.737720226,28380,21,14,7
10670,2014/03/31,2008/01/19,42,17,0.71845082,29138,42,11,6
10671,2014/03/31,2007/02/20,84,17,0.8036521040000001,26048,84,10,7
10672,2014/03/31,2007/04/21,71,20,0.735711624,28449,71,5,15
10673,2014/03/31,2012/04/23,335,7,1.05,19932,335,5,2
10674,2014/03/31,2010/11/11,97,14,0.7324053340000001,28574,97,9,5
10675,2014/03/31,2010/06/09,193,18,0.754100032,27751,193,15,3
10676,2014/03/31,2010/03/11,124,25,0.861896445,24277,124,18,7
10677,2014/03/31,2010/09/23,19,33,0.723764702,28908,19,8,25
10678,2014/03/31,2010/06/23,131,10,0.527596964,39654,131,8,2
10679,2014/03/31,2006/04/07,65,19,0.745181663,28074,65,12,7
10680,2014/03/31,2010/12/13,214,33,0.7885411090000001,26527,214,26,7
10681,2014/03/31,2008/10/01,35,21,0.629180604,33244,35,11,10
10682,2014/03/31,2009/08/01,46,14,0.7523041509999999,27802,46,7,7
10683,2014/03/31,2011/01/05,52,13,0.7321496829999999,28567,52,3,10
10684,2014/03/31,2005/10/09,73,13,0.761607735,27461,73,7,6
10685,2014/03/31,2009/03/02,26,35,0.907809177,23037,26,24,11
10686,2014/03/31,2009/01/01,30,24,0.676661705,30905,30,13,11
10687,2014/03/31,2012/06/26,1,23,0.799162622,26165,1,4,19
10688,2014/03/31,2011/05/17,40,25,0.798412632,26188,40,14,11
10689,2014/03/31,2010/08/12,72,24,0.736900818,28372,72,13,11
10690,2014/03/31,2007/04/10,1,21,0.71581002,29203,1,9,12
10691,2014/03/31,2009/07/23,43,35,0.727988228,28711,43,23,12
10692,2014/03/31,2009/09/19,89,15,0.742937935,28132,89,9,6
10693,2014/03/31,2009/03/14,13,32,0.655736522,31866,13,11,21
10694,2014/03/31,2008/11/17,196,14,1.014715652,20591,196,8,6
10695,2014/03/31,2012/02/09,81,28,0.8588520209999999,24321,81,12,16
10696,2014/03/31,2010/02/25,75,25,0.577436486,36173,75,8,17
10697,2014/03/31,2008/12/17,169,18,0.6877927420000001,30368,169,11,7
10698,2014/03/31,2012/10/30,87,15,0.45924978,45480,87,5,10
10699,2014/03/31,2012/02/27,506,14,0.749581898,27864,506,14,0
10700,2014/03/31,2010/12/05,28,7,1.418798831,14719,28,1,6
10701,2014/03/31,2009/10/09,17,22,0.648845114,32185,17,12,10
10702,2014/03/31,2005/01/29,13,17,0.586013189,35635,13,2,15
10703,2014/03/31,2010/09/13,6,21,0.926116113,22547,6,1,20
10704,2014/03/31,2009/04/07,188,2,1.03,20272,188,0,2
10705,2014/03/31,2011/04/24,29,26,0.6837099259999999,30537,29,15,11
10706,2014/03/31,2008/09/05,22,16,0.717809105,29084,22,6,10
10707,2014/03/31,2011/10/21,358,36,0.8481230959999999,24615,358,34,2
10708,2014/03/31,2011/03/23,5,25,0.7909821159999999,26392,5,10,15
10709,2014/03/31,2011/05/09,20,28,0.6420468739999999,32513,20,12,16
10710,2014/03/31,2012/06/22,278,23,0.829486171,25164,278,17,6
10711,2014/03/31,2010/04/22,50,10,0.6126812660000001,34066,50,0,10
10712,2014/03/31,2008/02/25,405,7,0.79002347,26417,405,7,0
10713,2014/03/31,2010/09/06,37,27,0.7435974909999999,28064,37,16,11
10714,2014/03/31,2012/07/21,15,27,0.650540903,32076,15,12,15
10715,2014/03/31,2007/01/05,61,17,0.6942764929999999,30055,61,6,11
10716,2014/03/31,2005/06/04,157,14,0.93022247,22430,157,10,4
10717,2014/03/31,2005/11/05,75,23,0.767801207,27174,75,8,15
10718,2014/03/31,2006/09/03,8,39,0.437883348,47646,8,28,11
10719,2014/03/31,2007/05/08,82,24,0.6914370940000001,30172,82,2,22
10720,2014/03/31,2008/01/28,11,25,0.677465415,30794,11,14,11
10721,2014/03/31,2006/03/07,64,13,0.7064821020000001,29529,64,1,12
10722,2014/03/31,2012/04/06,123,18,0.7151134809999999,29168,123,14,4
10723,2014/03/31,2012/04/02,34,16,0.667052578,31268,34,9,7
10724,2014/03/31,2011/07/04,9,13,0.929296026,22444,9,8,5
10725,2014/03/31,2012/07/12,15,5,1.18,17675,15,4,1
10726,2014/03/31,2007/12/03,109,24,0.8603894870000001,24237,109,14,10
10727,2014/03/31,2012/03/12,37,25,0.649551741,32102,37,15,10
10728,2014/03/31,2011/03/08,198,22,1.07387238,19417,198,9,13
10729,2014/03/31,2006/04/07,29,24,0.74693512,27913,29,19,5
10730,2014/03/31,2011/06/12,102,16,0.715398236,29141,102,3,13
10731,2014/03/31,2011/12/16,177,17,0.832072723,25054,177,14,3
10732,2014/03/31,2008/04/21,108,15,0.6971465840000001,29901,108,8,7
10733,2014/03/31,2012/03/12,543,7,0.864666224,24103,543,7,0
10734,2014/03/31,2012/03/24,102,4,0.768022557,27131,102,1,3
10735,2014/03/31,2009/02/22,205,21,0.639427993,32587,205,16,5
10736,2014/03/31,2008/02/06,108,15,0.7992247790000001,26070,108,11,4
10737,2014/03/31,2009/12/22,167,11,0.8257004720000001,25233,167,8,3
10738,2014/03/31,2011/12/14,82,25,0.7861769809999999,26500,82,10,15
10739,2014/03/31,2008/11/05,45,39,0.714087404,29175,45,21,18
10740,2014/03/31,2012/08/22,6,22,0.669043933,31138,6,8,14
10741,2014/03/31,2011/07/26,34,30,0.6909459370000001,30150,34,13,17
10742,2014/03/31,2012/07/02,13,33,0.788869618,26407,13,11,22
10743,2014/03/31,2008/04/20,95,31,0.540683175,38526,95,27,4
10744,2014/03/31,2010/06/01,48,16,0.812614988,25633,48,8,8
10745,2014/03/31,2011/11/22,31,20,0.837326633,24875,31,8,12
10746,2014/03/31,2010/12/15,93,21,0.802858409,25941,93,11,10
10747,2014/03/31,2005/08/27,19,19,0.8157254209999999,25530,19,9,10
10748,2014/03/31,2008/08/06,69,23,0.696012834,29921,69,4,19
10749,2014/03/31,2008/08/09,25,20,0.450261832,46251,25,5,15
10750,2014/03/31,2012/05/15,20,21,0.724457936,28742,20,12,9
10751,2014/03/31,2011/11/03,124,18,0.8004290159999999,26013,124,8,10
10752,2014/03/31,2012/09/16,5,21,0.648061815,32128,5,12,9
10753,2014/03/31,2012/03/08,258,16,1.432749295,14531,258,13,3
10754,2014/03/31,2010/12/20,10,32,0.904549444,23016,10,11,21
10755,2014/03/31,2010/08/05,134,21,0.589121834,35335,134,9,12
10756,2014/03/31,2012/03/28,4,17,0.6120196410000001,34011,4,4,13
10757,2014/03/31,2008/04/10,71,16,0.742569655,28031,71,1,15
10758,2014/03/31,2011/02/14,11,23,0.65072065,31985,11,9,14
10759,2014/03/31,2007/09/09,7,16,0.8489686679999999,24512,7,10,6
10760,2014/03/31,2007/02/09,73,27,0.7429179020000001,28003,73,11,16
10761,2014/03/31,2011/10/19,204,19,0.6906942229999999,30120,204,8,11
10762,2014/03/31,2009/03/26,36,20,0.708589093,29357,36,10,10
10763,2014/03/31,2009/09/01,269,19,0.766821868,27126,269,16,3
10764,2014/03/31,2012/01/12,4,33,0.662236763,31407,4,15,18
10765,2014/03/31,2012/09/09,9,32,0.476695473,43625,9,14,18
10766,2014/03/31,2005/09/24,648,2,0.85,24464,648,2,0
10767,2014/03/31,2012/11/11,233,2,0.85,24464,233,1,1
10768,2014/03/31,2008/12/24,79,2,0.85,24464,79,0,2
10769,2014/03/31,2008/04/22,161,2,0.85,24464,161,0,2
10770,2014/03/31,2008/10/27,70,14,0.728435157,28546,70,7,7
10771,2014/03/31,2012/12/21,153,2,1.03,20188,153,0,2
10772,2014/03/31,2011/04/05,338,2,1.03,20188,338,1,1
10773,2014/03/31,2011/11/28,303,2,1.03,20188,303,1,1
10774,2014/03/31,2012/03/20,520,2,1.03,20188,520,2,0
10775,2014/03/31,2012/02/26,22,27,0.79957968,26004,22,15,12
10776,2014/03/31,2011/06/27,6,25,0.6907488620000001,30099,6,13,12
10777,2014/03/31,2006/08/01,4,17,0.7191850009999999,28908,4,6,11
10778,2014/03/31,2010/08/17,16,19,0.823690321,25239,16,9,10
10779,2014/03/31,2006/07/26,8,17,0.602128849,34521,8,9,8
10780,2014/03/31,2012/04/23,84,21,0.67870657,30624,84,11,10
10781,2014/03/31,2007/05/31,60,5,0.6818528970000001,30482,60,2,3
10782,2014/03/31,2008/02/06,35,13,0.6848728000000001,30346,35,3,10
10783,2014/03/31,2011/11/27,22,27,0.609458065,34100,22,14,13
10784,2014/03/31,2012/08/14,23,4,0.803981739,25848,23,0,4
10785,2014/03/31,2010/07/29,4,55,0.948454587,21910,4,18,37
10786,2014/03/31,2010/09/03,26,34,0.7441302009999999,27926,26,13,21
10787,2014/03/31,2005/07/29,12,30,0.8442723059999999,24612,12,12,18
10788,2014/03/31,2007/09/13,71,20,0.971906633,21378,71,11,9
10789,2014/03/31,2009/01/15,99,16,0.8039658709999999,25843,99,7,9
10790,2014/03/31,2010/02/02,146,11,0.7541663940000001,27549,146,5,6
10791,2014/03/31,2007/04/07,174,21,0.863510683,24058,174,8,13
10792,2014/03/31,2012/01/01,431,24,0.808586665,25691,431,24,0
10793,2014/03/31,2007/09/14,320,27,0.754686819,27524,320,24,3
10794,2014/03/31,2012/02/12,61,17,0.836993593,24817,61,11,6
10795,2014/03/31,2010/04/20,354,3,0.8,25961,354,2,1
10796,2014/03/31,2006/11/14,49,15,0.8605424559999999,24131,49,10,5
10797,2014/03/31,2007/07/10,19,18,0.680386997,30517,19,7,11
10798,2014/03/31,2011/09/08,22,21,0.706190476,29400,22,19,2
10799,2014/03/31,2012/03/15,84,20,0.604309291,34356,84,10,10
10800,2014/03/31,2005/05/12,36,24,0.606345396,34239,36,11,13
10801,2014/03/31,2009/07/17,253,23,0.782875731,26515,253,21,2
10802,2014/03/31,2009/07/03,37,25,0.7707403829999999,26932,37,9,16
10803,2014/03/31,2009/04/26,31,23,0.596545956,34794,31,14,9
10804,2014/03/31,2005/09/30,21,24,0.717941197,28910,21,10,14
10805,2014/03/31,2007/09/20,24,17,0.785035367,26437,24,7,10
10806,2014/03/31,2006/12/15,7,23,0.66319752,31293,7,8,15
10807,2014/03/31,2012/09/02,265,15,0.892976764,23240,265,8,7
10808,2014/03/31,2006/09/14,351,12,0.7562030759999999,27438,351,10,2
10809,2014/03/31,2011/03/11,306,14,0.745667565,27825,306,13,1
10810,2014/03/31,2010/07/12,290,4,0.7408295540000001,28003,290,3,1
10811,2014/03/31,2012/02/04,12,27,0.626033135,33137,12,9,18
10812,2014/03/31,2005/07/22,59,28,0.622947748,33300,59,12,16
10813,2014/03/31,2006/01/02,38,21,0.899956616,23050,38,13,8
10814,2014/03/31,2004/12/29,76,15,0.893242045,23223,76,11,4
10815,2014/03/31,2008/08/09,1,28,0.6903647620000001,30047,1,10,18
10816,2014/03/31,2010/01/06,25,4,0.6823623259999999,30398,25,2,2
10817,2014/03/31,2006/12/02,1,30,0.904555405,22931,1,0,30
10818,2014/03/31,2012/12/03,2,16,0.7636536340000001,27162,2,7,9
10819,2014/03/31,2012/04/29,6,25,0.6694651220000001,30979,6,17,8
10820,2014/03/31,2012/02/22,21,23,0.602470223,34422,21,5,18
10821,2014/03/31,2009/04/13,51,28,0.719289902,28827,51,11,17
10822,2014/03/31,2012/03/10,152,17,0.697646109,29721,152,7,10
10823,2014/03/31,2012/06/06,8,22,0.844823764,24541,8,9,13
10824,2014/03/31,2009/12/01,39,29,0.77827915,26638,39,10,19
10825,2014/03/31,2012/01/05,68,17,0.831377927,24936,68,9,8
10826,2014/03/31,2010/02/10,101,13,0.557205214,37205,101,12,1
10827,2014/03/31,2010/03/26,95,24,0.8298851079999999,24980,95,7,17
10828,2014/03/31,2006/12/07,317,14,0.5764574179999999,35954,317,12,2
10829,2014/03/31,2006/09/05,383,9,1.367625709,15154,383,9,0
10830,2014/03/31,2007/03/06,287,15,0.718425085,28846,287,13,2
10831,2014/03/31,2008/09/26,37,26,0.8050827509999999,25740,37,16,10
10832,2014/03/31,2007/04/26,4,21,0.807920842,25645,4,4,17
10833,2014/03/31,2012/02/19,24,15,0.72984283,28377,24,5,10
10834,2014/03/31,2005/05/25,65,15,0.783622295,26428,65,7,8
10835,2014/03/31,2009/10/09,26,26,0.746355642,27747,26,14,12
10836,2014/03/31,2005/05/19,9,32,0.906512259,22840,9,1,31
10837,2014/03/31,2007/06/17,15,4,0.6825,30336,15,0,4
10838,2014/03/31,2012/07/27,7,21,0.944821559,21912,7,10,11
10839,2014/03/31,2010/12/07,104,19,0.7128389409999999,29039,104,11,8
10840,2014/03/31,2009/12/13,32,15,0.83639743,24749,32,4,11
10841,2014/03/31,2011/12/22,339,10,0.730771403,28325,339,7,3
10842,2014/03/31,2010/08/20,71,19,0.811266855,25512,71,13,6
10843,2014/03/31,2008/01/28,19,22,0.599091304,34544,19,8,14
10844,2014/03/31,2008/11/21,22,21,0.6888245279999999,30039,22,12,9
10845,2014/03/31,2006/07/21,39,21,0.690388068,29969,39,13,8
10846,2014/03/31,2011/09/15,31,12,1.178790451,17552,31,4,8
10847,2014/03/31,2005/11/12,3,15,0.7697842020000001,26877,3,3,12
10848,2014/03/31,2011/07/25,248,23,0.602642389,34325,248,16,7
10849,2014/03/31,2007/10/27,97,21,0.5903613120000001,35039,97,7,14
10850,2014/03/31,2006/12/04,21,23,0.782413571,26438,21,17,6
10851,2014/03/31,2006/12/11,120,14,0.566874229,36487,120,4,10
10852,2014/03/31,2011/11/08,173,4,0.680001315,30416,173,2,2
10853,2014/03/31,2012/07/08,47,36,0.695154611,29752,47,16,20
10854,2014/03/31,2005/10/08,4,24,0.603433123,34272,4,9,15
10855,2014/03/31,2011/04/07,8,33,0.7122177059999999,29030,8,7,26
10856,2014/03/31,2011/12/12,192,10,1.328276903,15565,192,4,6
10857,2014/03/31,2007/05/29,51,20,0.911613899,22678,51,15,5
10858,2014/03/31,2005/09/01,3,28,0.749054676,27599,3,16,12
10859,2014/03/31,2012/01/18,12,28,0.783869488,26373,12,0,28
10860,2014/03/31,2011/12/07,120,17,0.687481543,30070,120,10,7
10861,2014/03/31,2009/04/17,9,21,0.78003019,26499,9,9,12
10862,2014/03/31,2011/08/09,14,28,0.6933557,29806,14,11,17
10863,2014/03/31,2006/06/26,34,12,0.8776400390000001,23547,34,10,2
10864,2014/03/31,2006/10/02,24,13,0.760280343,27181,24,6,7
10865,2014/03/31,2012/07/31,45,17,0.704924945,29312,45,5,12
10866,2014/03/31,2006/07/13,20,17,0.664030916,31117,20,8,9
10867,2014/03/31,2006/04/27,13,22,0.730876517,28271,13,18,4
10868,2014/03/31,2010/12/18,234,11,1.132461218,18243,234,8,3
10869,2014/03/31,2004/11/13,31,26,0.689860721,29940,31,12,14
10870,2014/03/31,2012/08/20,107,13,0.7801121809999999,26475,107,3,10
10871,2014/03/31,2006/12/13,5,30,0.541987718,38104,5,11,19
10872,2014/03/31,2006/10/25,103,18,0.649651038,31780,103,11,7
10873,2014/03/31,2006/04/02,190,22,0.8452827479999999,24421,190,15,7
10874,2014/03/31,2013/03/26,23,9,0.66577681,31005,23,1,8
10875,2014/03/31,2006/08/15,118,18,0.710822658,29040,118,11,7
10876,2014/03/31,2008/03/17,16,25,0.715500867,28850,16,12,13
10877,2014/03/31,2012/10/30,79,19,0.652429195,31636,79,8,11
10878,2014/03/31,2008/07/13,206,4,0.807419405,25560,206,2,2
10879,2014/03/31,2010/06/07,5,17,0.792891288,26023,5,6,11
10880,2014/03/31,2010/01/10,12,33,0.7300502459999999,28261,12,18,15
10881,2014/03/31,2007/03/08,26,17,0.813404826,25364,26,10,7
10882,2014/03/31,2010/10/06,290,28,0.860135918,23985,290,26,2
10883,2014/03/31,2012/07/23,81,28,0.720548007,28631,81,12,16
10884,2014/03/31,2011/04/11,375,16,0.713191467,28924,375,16,0
10885,2014/03/31,2012/01/12,25,20,0.7885,26160,25,10,10
10886,2014/03/31,2012/05/20,22,29,0.944973656,21827,22,18,11
10887,2014/03/31,2009/09/16,69,28,0.665238679,31004,69,21,7
10888,2014/03/31,2008/11/03,39,17,1.028024525,20061,39,15,2
10889,2014/03/31,2010/12/29,8,25,0.7338977859999999,28098,8,13,12
10890,2014/03/31,2008/08/01,56,38,0.615542122,33498,56,16,22
10891,2014/03/31,2012/08/30,162,11,0.708632458,29096,162,4,7
10892,2014/03/31,2012/03/13,33,17,0.7583715879999999,27186,33,12,5
10893,2014/03/31,2012/07/15,137,19,0.621061464,33190,137,3,16
10894,2014/03/31,2009/07/17,34,23,0.764519013,26955,34,5,18
10895,2014/03/31,2012/02/20,228,19,0.6255172410000001,32944,228,17,2
10896,2014/03/31,2009/11/01,71,17,0.634657631,32465,71,8,9
10897,2014/03/31,2011/04/15,9,14,0.751507589,27408,9,8,6
10898,2014/03/31,2009/02/26,102,22,0.748381904,27520,102,10,12
10899,2014/03/31,2009/11/30,125,12,0.564403793,36489,125,6,6
10900,2014/03/31,2005/08/22,149,10,1.26524421,16277,149,5,5
10901,2014/03/31,2005/01/18,43,14,1.014773802,20292,43,8,6
10902,2014/03/31,2004/11/30,1,14,0.796159616,25862,1,5,9
10903,2014/03/31,2007/09/13,63,18,0.7264882509999999,28342,63,12,6
10904,2014/03/31,2006/06/04,25,27,0.653920983,31487,25,14,13
10905,2014/03/31,2011/08/19,136,18,0.659933652,31199,136,12,6
10906,2014/03/31,2007/02/20,8,48,0.821781095,25052,8,31,17
10907,2014/03/31,2006/09/01,19,34,0.6371758439999999,32307,19,19,15
10908,2014/03/31,2008/02/13,45,21,0.607047981,33909,45,11,10
10909,2014/03/31,2007/07/22,157,12,0.7600642590000001,27078,157,8,4
10910,2014/03/31,2012/08/13,19,25,0.648882618,31717,19,9,16
10911,2014/03/31,2006/03/30,107,11,0.675926692,30447,107,2,9
10912,2014/03/31,2012/09/21,46,10,0.75904242,27110,46,1,9
10913,2014/03/31,2011/08/02,100,15,0.715328513,28766,100,6,9
10914,2014/03/31,2008/10/05,148,11,1.453848654,14153,148,8,3
10915,2014/03/31,2008/08/30,77,27,0.786200757,26171,77,17,10
10916,2014/03/31,2006/07/11,33,13,1.151104957,17874,33,4,9
10917,2014/03/31,2010/04/13,4,31,0.626779991,32826,4,14,17
10918,2014/03/31,2008/11/02,11,19,0.6951787890000001,29588,11,13,6
10919,2014/03/31,2011/05/09,115,17,0.751620318,27365,115,8,9
10920,2014/03/31,2010/02/15,24,23,0.826743307,24878,24,8,15
10921,2014/03/31,2012/07/22,561,4,0.76144391,27010,561,4,0
10922,2014/03/31,2010/08/25,65,19,0.694691775,29605,65,10,9
10923,2014/03/31,2006/11/07,4,22,0.7325130009999999,28074,4,10,12
10924,2014/03/31,2008/04/09,97,16,0.536572554,38323,97,7,9
10925,2014/03/31,2006/01/18,383,8,1.5,13708,383,8,0
10926,2014/03/31,2005/10/25,12,40,0.711030225,28916,12,22,18
10927,2014/03/31,2012/10/20,29,11,1.071546881,19187,29,7,4
10928,2014/03/31,2009/03/01,253,12,0.665694211,30884,253,5,7
10929,2014/03/31,2006/04/04,26,17,0.7439816890000001,27634,26,10,7
10930,2014/03/31,2011/11/24,2,18,0.529383257,38833,2,10,8
10931,2014/03/31,2005/11/19,18,24,0.701234947,29313,18,8,16
10932,2014/03/31,2011/08/01,1,34,0.64671082,31783,1,0,34
10933,2014/03/31,2010/09/04,66,18,0.664463339,30932,66,3,15
10934,2014/03/31,2007/03/16,5,29,0.610681008,33656,5,11,18
10935,2014/03/31,2007/11/20,2,29,0.8270707070000001,24849,2,15,14
10936,2014/03/31,2011/12/06,3,27,0.8216150959999999,25014,3,15,12
10937,2014/03/31,2009/11/03,5,43,0.648695707,31680,5,9,34
10938,2014/03/31,2009/01/06,203,3,0.56,36696,203,1,2
10939,2014/03/31,2006/03/08,118,3,0.56,36696,118,2,1
10940,2014/03/31,2012/08/04,8,19,0.758062565,27108,8,5,14
10941,2014/03/31,2007/09/15,10,24,0.639249984,32146,10,10,14
10942,2014/03/31,2008/04/21,26,16,0.7702803909999999,26677,26,7,9
10943,2014/03/31,2005/10/07,2,27,0.636575792,32279,2,2,25
10944,2014/03/31,2010/09/10,26,18,0.772093417,26612,26,10,8
10945,2014/03/31,2012/11/18,42,15,0.730264439,28135,42,3,12
10946,2014/03/31,2012/08/25,1,30,0.764409718,26877,1,10,20
10947,2014/03/31,2007/12/26,60,19,0.6740222459999999,30478,60,3,16
10948,2014/03/31,2010/11/15,26,29,0.805211511,25507,26,19,10
10949,2014/03/31,2008/10/23,17,16,1.052182489,19519,17,0,16
10950,2014/03/31,2012/09/15,11,33,0.623548093,32936,11,10,23
10951,2014/03/31,2008/01/15,22,24,0.705960811,29090,22,14,10
10952,2014/03/31,2005/11/27,94,9,1.005935342,20415,94,4,5
10953,2014/03/31,2010/12/08,63,17,0.863026266,23795,63,12,5
10954,2014/03/31,2011/08/19,25,24,0.918131092,22366,25,18,6
10955,2014/03/31,2012/05/12,100,17,0.680595313,30169,100,7,10
10956,2014/03/31,2013/01/18,37,5,0.70270064,29219,37,2,3
10957,2014/03/31,2008/07/10,122,22,0.810452428,25330,122,13,9
10958,2014/03/31,2007/04/03,172,6,0.7294023590000001,28144,172,2,4
10959,2014/03/31,2007/08/23,163,20,0.670975028,30594,163,16,4
10960,2014/03/31,2011/07/09,50,21,0.7919310159999999,25919,50,10,11
10961,2014/03/31,2011/11/29,50,18,0.803455335,25546,50,8,10
10962,2014/03/31,2011/12/01,49,26,0.853059435,24060,49,14,12
10963,2014/03/31,2008/05/15,65,23,0.7043543179999999,29132,65,15,8
10964,2014/03/31,2007/08/12,316,4,0.675,30398,316,0,4
10965,2014/03/31,2007/08/23,115,10,0.860653523,23840,115,6,4
10966,2014/03/31,2011/04/14,35,28,0.654265761,31359,35,17,11
10967,2014/03/31,2012/11/30,479,4,1.066190303,19243,479,4,0
10968,2014/03/31,2009/09/20,6,17,0.663492659,30922,6,1,16
10969,2014/03/31,2011/05/30,27,17,0.788808444,26008,27,8,9
10970,2014/03/31,2006/06/20,136,16,0.670342777,30603,136,10,6
10971,2014/03/31,2013/03/17,60,21,0.695627331,29490,60,6,15
10972,2014/03/31,2013/01/22,29,19,0.698910962,29347,29,3,16
10973,2014/03/31,2012/04/13,23,24,0.637367129,32174,23,16,8
10974,2014/03/31,2008/04/24,14,26,0.718038728,28558,14,17,9
10975,2014/03/31,2006/06/14,4,14,1.195859917,17147,4,9,5
10976,2014/03/31,2006/05/05,161,14,0.53468605,38350,161,11,3
10977,2014/03/31,2007/07/16,100,18,0.622531803,32937,100,7,11
10978,2014/03/31,2009/08/06,30,19,0.711748655,28805,30,9,10
10979,2014/03/31,2012/12/27,24,17,0.734065454,27928,24,3,14
10980,2014/03/31,2011/08/22,60,19,0.8199676029999999,25002,60,11,8
10981,2014/03/31,2012/07/08,249,28,0.799679357,25636,249,19,9
10982,2014/03/31,2005/08/18,38,18,0.7444157159999999,27538,38,10,8
10983,2014/03/31,2011/03/18,2,20,0.622245394,32943,2,6,14
10984,2014/03/31,2012/09/06,78,7,0.767970624,26688,78,3,4
10985,2014/03/31,2005/09/24,109,20,0.776139221,26404,109,11,9
10986,2014/03/31,2005/04/25,42,22,0.791459138,25892,42,5,17
10987,2014/03/31,2006/07/28,41,13,0.618397875,33131,41,9,4
10988,2014/03/31,2010/03/12,21,18,0.764265304,26807,21,9,9
10989,2014/03/31,2011/02/25,13,34,0.878554765,23318,13,20,14
10990,2014/03/31,2013/02/14,20,25,0.719355643,28478,20,3,22
10991,2014/03/31,2005/11/06,37,28,0.692334888,29586,37,12,16
10992,2014/03/31,2008/03/21,11,29,0.8064260679999999,25395,11,4,25
10993,2014/03/31,2011/01/08,334,20,1.2784006490000002,16019,334,18,2
10994,2014/03/31,2005/11/27,4,25,0.843987389,24264,4,13,12
10995,2014/03/31,2012/08/21,136,8,0.7925,25840,136,6,2
10996,2014/03/31,2010/10/28,65,19,0.667777669,30666,65,9,10
10997,2014/03/31,2008/05/20,147,11,1.029704743,19881,147,5,6
10998,2014/03/31,2007/08/21,8,13,0.549648727,37236,8,3,10
10999,2014/03/31,2011/11/30,35,26,0.677189888,30223,35,4,22
11000,2014/03/31,2011/08/19,18,29,0.763730875,26798,18,23,6
11001,2014/03/31,2005/05/27,83,17,0.756942708,27037,83,9,8
11002,2014/03/31,2012/10/08,4,11,0.973741733,21017,4,0,11
11003,2014/03/31,2012/09/07,5,29,0.623206955,32838,5,7,22
11004,2014/03/31,2008/07/06,80,25,0.66155465,30933,80,22,3
11005,2014/03/31,2005/12/05,170,21,0.784170914,26095,170,12,9
11006,2014/03/31,2007/04/19,48,16,0.7744307770000001,26422,48,4,12
11007,2014/03/31,2008/08/11,1,20,0.595346543,34368,1,12,8
11008,2014/03/31,2006/10/15,204,35,0.59197992,34562,204,21,14
11009,2014/03/31,2012/02/27,77,23,0.534089224,38308,77,12,11
11010,2014/03/31,2011/04/01,130,11,0.6856998259999999,29836,130,7,4
11011,2014/03/31,2012/08/13,21,14,0.703906685,29063,21,4,10
11012,2014/03/31,2011/08/04,38,25,0.73061395,27999,38,13,12
11013,2014/03/31,2010/09/14,17,32,0.576277045,35496,17,17,15
11014,2014/03/31,2009/08/26,28,23,0.684329352,29889,28,16,7
11015,2014/03/31,2010/10/05,31,24,0.84068777,24325,31,15,9
11016,2014/03/31,2010/02/06,20,20,0.766954989,26660,20,13,7
11017,2014/03/31,2007/11/01,2,17,0.6820775929999999,29977,2,8,9
11018,2014/03/31,2012/03/09,291,10,0.88435486,23119,291,9,1
11019,2014/03/31,2012/10/11,57,17,0.767589638,26635,57,6,11
11020,2014/03/31,2007/08/10,65,13,0.822423267,24859,65,8,5
11021,2014/03/31,2013/03/24,35,18,0.646575351,31612,35,4,14
11022,2014/03/31,2010/11/05,70,29,0.878585307,23263,70,18,11
11023,2014/03/31,2012/08/11,270,3,0.8020938809999999,25479,270,2,1
11024,2014/03/31,2007/04/26,9,25,0.561678256,36383,9,10,15
11025,2014/03/31,2012/09/12,220,12,0.7333333329999999,27864,220,8,4
11026,2014/03/31,2012/07/11,615,4,0.75,27244,615,4,0
11027,2014/03/31,2011/01/10,93,11,0.704447662,29004,93,4,7
11028,2014/03/31,2009/03/18,253,17,0.774525362,26378,253,14,3
11029,2014/03/31,2010/07/04,43,11,0.731686484,27922,43,3,8
11030,2014/03/31,2007/09/07,8,24,0.904848283,22575,8,7,17
11031,2014/03/31,2012/11/30,64,5,0.718535195,28427,64,2,3
11032,2014/03/31,2012/04/12,16,28,0.658820114,31003,16,8,20
11033,2014/03/31,2010/04/22,1,25,0.613305006,33301,1,14,11
11034,2014/03/31,2010/11/11,1,15,0.8246929129999999,24765,1,1,14
11035,2014/03/31,2008/03/09,42,26,0.634705535,32177,42,19,7
11036,2014/03/31,2011/03/05,19,28,0.8093610529999999,25229,19,11,17
11037,2014/03/31,2006/03/21,94,22,0.581845518,35085,94,10,12
11038,2014/03/31,2012/11/29,11,13,0.8258918959999999,24717,11,3,10
11039,2014/03/31,2012/11/05,76,28,0.589486528,34627,76,7,21
11040,2014/03/31,2010/02/03,7,27,0.888659758,22966,7,10,17
11041,2014/03/31,2011/08/01,11,21,0.691277482,29519,11,9,12
11042,2014/03/31,2009/02/17,112,26,0.648857297,31443,112,11,15
11043,2014/03/31,2005/07/25,126,17,0.8813387770000001,23148,126,11,6
11044,2014/03/31,2012/12/31,83,26,0.5635261460000001,36201,83,4,22
11045,2014/03/31,2008/06/05,258,19,0.752168142,27120,258,17,2
11046,2014/03/31,2011/10/28,269,20,0.5687639760000001,35865,269,16,4
11047,2014/03/31,2012/01/01,36,31,0.890661543,22901,36,14,17
11048,2014/03/31,2010/06/17,4,35,0.6955290709999999,29325,4,17,18
11049,2014/03/31,2005/05/08,18,26,0.620396714,32870,18,20,6
11050,2014/03/31,2006/03/07,58,14,0.947557983,21515,58,7,7
11051,2014/03/31,2007/02/22,16,12,0.698982034,29166,16,7,5
11052,2014/03/31,2009/05/17,187,18,0.771507342,26424,187,10,8
11053,2014/03/31,2012/03/01,165,17,0.902181013,22595,165,13,4
11054,2014/03/31,2010/09/26,17,11,0.794016828,25672,17,6,5
11055,2014/03/31,2011/06/11,301,15,0.698358577,29182,301,13,2
11056,2014/03/31,2006/04/15,206,14,0.617262042,33010,206,5,9
11057,2014/03/31,2009/08/22,17,25,0.82335529,24746,17,7,18
11058,2014/03/31,2010/09/14,38,20,0.622167155,32748,38,13,7
11059,2014/03/31,2006/10/11,225,13,0.778927247,26157,225,7,6
11060,2014/03/31,2009/06/03,48,15,0.7569321940000001,26915,48,0,15
11061,2014/03/31,2010/05/20,85,32,0.872730583,23343,85,23,9
11062,2014/03/31,2012/05/04,497,11,0.740019616,27529,497,11,0
11063,2014/03/31,2005/12/01,12,22,0.6653408239999999,30617,12,2,20
11064,2014/03/31,2011/04/08,59,12,0.934286763,21802,59,5,7
11065,2014/03/31,2007/03/19,42,16,0.769519834,26470,42,11,5
11066,2014/03/31,2012/08/12,261,17,0.72755269,27994,261,8,9
11067,2014/03/31,2011/09/19,151,30,0.687846601,29609,151,20,10
11068,2014/03/31,2011/09/13,13,13,0.8114211720000001,25099,13,5,8
11069,2014/03/31,2010/10/19,22,18,0.7394444440000001,27540,22,6,12
11070,2014/03/31,2011/08/08,222,17,0.599278651,33978,222,12,5
11071,2014/03/31,2011/03/04,10,13,0.568116524,35838,10,5,8
11072,2014/03/31,2008/04/02,116,14,0.673967755,30206,116,6,8
11073,2014/03/31,2008/03/21,66,11,0.6521120579999999,31216,66,3,8
11074,2014/03/31,2008/04/24,4,28,0.612393201,33240,4,15,13
11075,2014/03/31,2006/03/10,2,24,0.688513107,29565,2,16,8
11076,2014/03/31,2012/10/15,56,22,0.7942311440000001,25629,56,3,19
11077,2014/03/31,2009/10/10,98,22,0.610334633,33350,98,10,12
11078,2014/03/31,2007/08/05,9,24,0.671248227,30323,9,14,10
11079,2014/03/31,2009/03/11,129,16,0.767113833,26530,129,6,10
11080,2014/03/31,2007/11/24,4,21,0.617077926,32980,4,8,13
11081,2014/03/31,2012/11/19,309,10,0.77,26430,309,8,2
11082,2014/03/31,2009/10/20,30,11,1.222708972,16641,30,6,5
11083,2014/03/31,2009/02/10,26,12,0.917419966,22178,26,4,8
11084,2014/03/31,2012/03/02,280,14,0.764084422,26628,280,10,4
11085,2014/03/31,2010/12/05,56,26,0.805108429,25270,56,13,13
11086,2014/03/31,2007/06/22,185,19,0.927747173,21928,185,18,1
11087,2014/03/31,2012/02/27,26,13,1.104600348,18416,26,7,6
11088,2014/03/31,2009/10/01,232,20,0.67691939,30046,232,18,2
11089,2014/03/31,2012/02/17,123,24,0.8851220790000001,22977,123,18,6
11090,2014/03/31,2011/02/20,5,27,0.6423956789999999,31657,5,8,19
11091,2014/03/31,2010/06/04,69,37,0.850261739,23917,69,17,20
11092,2014/03/31,2005/12/02,44,17,0.8521670440000001,23862,44,11,6
11093,2014/03/31,2013/02/16,3,29,0.64308011,31619,3,3,26
11094,2014/03/31,2008/09/23,292,14,0.647350675,31408,292,11,3
11095,2014/03/31,2012/01/08,36,28,0.7713821759999999,26357,36,2,26
11096,2014/03/31,2011/03/07,30,20,0.754401855,26950,30,8,12
11097,2014/03/31,2011/11/20,4,43,0.533023256,38141,4,20,23
11098,2014/03/31,2008/04/14,39,21,0.712601136,28526,39,6,15
11099,2014/03/31,2005/11/03,34,17,0.779154017,26088,34,9,8
11100,2014/03/31,2011/08/31,81,9,1.126381776,18042,81,3,6
11101,2014/03/31,2006/11/25,77,28,0.787920285,25792,77,8,20
11102,2014/03/31,2008/03/08,7,27,1.007779321,20165,7,11,16
11103,2014/03/31,2005/05/12,5,19,0.7120189920000001,28539,5,12,7
11104,2014/03/31,2005/10/17,11,29,0.84390405,24075,11,20,9
11105,2014/03/31,2011/01/14,102,20,0.710675108,28588,102,15,5
11106,2014/03/31,2012/11/06,32,8,0.78625,25840,32,6,2
11107,2014/03/31,2009/02/17,27,18,0.735511586,27620,27,11,7
11108,2014/03/31,2012/03/21,45,35,0.705551542,28792,45,16,19
11109,2014/03/31,2008/07/24,16,33,0.850876252,23863,16,27,6
11110,2014/03/31,2010/09/12,5,17,0.796180934,25501,5,10,7
11111,2014/03/31,2011/10/03,24,22,0.6672342170000001,30429,24,3,19
11112,2014/03/31,2006/12/01,138,11,0.8018160990000001,25318,138,8,3
11113,2014/03/31,2008/10/30,18,30,0.764574216,26551,18,0,30
11114,2014/03/31,2013/01/31,28,12,1.038491763,19546,28,3,9
11115,2014/03/31,2010/05/08,73,13,0.834917729,24310,73,1,12
11116,2014/03/31,2013/01/01,21,20,0.714902258,28391,21,0,20
11117,2014/03/31,2005/09/09,35,16,0.777528542,26102,35,6,10
11118,2014/03/31,2009/09/15,15,14,0.902465199,22485,15,9,5
11119,2014/03/31,2012/03/15,98,20,0.773539124,26224,98,12,8
11120,2014/03/31,2011/09/28,20,21,0.582963644,34795,20,12,9
11121,2014/03/31,2008/05/24,5,24,0.716221751,28320,5,6,18
11122,2014/03/31,2005/10/11,14,17,0.913742398,22197,14,6,11
11123,2014/03/31,2013/01/21,71,19,0.768952457,26376,71,2,17
11124,2014/03/31,2009/05/02,42,19,0.687607745,29491,42,12,7
11125,2014/03/31,2007/12/23,26,19,0.706126685,28717,26,10,9
11126,2014/03/31,2008/06/15,75,29,0.648704113,31245,75,15,14
11127,2014/03/31,2012/03/01,49,27,0.80691536,25118,49,12,15
11128,2014/03/31,2010/06/04,12,29,0.772317189,26243,12,23,6
11129,2014/03/31,2009/01/01,174,15,0.779558795,25997,174,10,5
11130,2014/03/31,2010/08/02,25,27,0.7968027209999999,25431,25,16,11
11131,2014/03/31,2010/01/27,22,28,0.451488703,44878,22,11,17
11132,2014/03/31,2008/07/08,99,25,0.687415688,29474,99,12,13
11133,2014/03/31,2010/08/04,15,24,0.566131575,35782,15,12,12
11134,2014/03/31,2012/05/01,15,24,0.7116892109999999,28463,15,5,19
11135,2014/03/31,2012/10/27,42,23,0.7762844,26090,42,7,16
11136,2014/03/31,2009/12/23,2,43,0.658059265,30777,2,25,18
11137,2014/03/31,2012/06/08,66,5,0.792102175,25564,66,4,1
11138,2014/03/31,2007/02/01,37,32,0.868759653,23308,37,17,15
11139,2014/03/31,2011/10/17,18,29,0.769584569,26310,18,1,28
11140,2014/03/31,2012/08/09,107,11,0.957810578,21138,107,6,5
11141,2014/03/31,2009/12/03,16,17,0.6546015070000001,30929,16,9,8
11142,2014/03/31,2012/05/13,84,22,0.88506929,22875,84,13,9
11143,2014/03/31,2010/10/15,28,10,1.4409074730000002,14050,28,3,7
11144,2014/03/31,2012/09/05,26,21,0.641759353,31540,26,5,16
11145,2014/03/31,2010/04/22,3,15,0.7651631440000001,26449,3,7,8
11146,2014/03/31,2007/10/30,51,23,0.640192691,31605,51,7,16
11147,2014/03/31,2012/03/22,132,20,0.729941548,27715,132,10,10
11148,2014/03/31,2009/10/11,19,19,0.6375390000000001,31731,19,12,7
11149,2014/03/31,2011/04/28,106,16,0.4731195620000001,42756,106,6,10
11150,2014/03/31,2008/11/14,64,18,0.620735876,32587,64,9,9
11151,2014/03/31,2010/07/25,108,15,0.668846968,30242,108,9,6
11152,2014/03/31,2007/07/10,264,17,0.7756246640000001,26078,264,13,4
11153,2014/03/31,2010/09/26,67,26,0.655986898,30834,67,18,8
11154,2014/03/31,2011/10/24,107,9,0.847006954,23872,107,5,4
11155,2014/03/31,2012/01/10,18,15,0.7408941659999999,27288,18,9,6
11156,2014/03/31,2012/06/24,22,28,0.8116593059999999,24908,22,14,14
11157,2014/03/31,2005/01/23,140,16,0.695021661,29084,140,8,8
11158,2014/03/31,2013/01/01,31,27,0.843654007,23960,31,0,27
11159,2014/03/31,2008/03/07,67,19,0.666384466,30333,67,8,11
11160,2014/03/31,2006/08/07,23,20,0.7773178709999999,25998,23,12,8
11161,2014/03/31,2009/10/30,28,14,0.740408148,27294,28,7,7
11162,2014/03/31,2013/01/15,13,19,0.799975058,25259,13,2,17
11163,2014/03/31,2009/07/13,108,13,0.650601133,31058,108,4,9
11164,2014/03/31,2005/08/02,36,16,0.790811932,25544,36,4,12
11165,2014/03/31,2008/08/03,1,15,0.671759228,30070,1,2,13
11166,2014/03/31,2011/08/18,128,19,0.645060518,31313,128,12,7
11167,2014/03/31,2008/08/12,66,18,0.79901341,25279,66,12,6
11168,2014/03/31,2012/05/17,28,14,0.8765885309999999,23037,28,9,5
11169,2014/03/31,2008/10/10,12,28,0.708293932,28510,12,14,14
11170,2014/03/31,2010/01/01,135,14,0.572031954,35301,135,9,5
11171,2014/03/31,2006/07/12,87,15,0.7869097070000001,25661,87,8,7
11172,2014/03/31,2006/09/22,5,20,0.6845984070000001,29495,5,7,13
11173,2014/03/31,2011/07/29,213,27,0.539681644,37411,213,24,3
11174,2014/03/31,2008/12/05,145,24,0.8162915940000001,24733,145,19,5
11175,2014/03/31,2009/09/24,16,26,0.8106341109999999,24901,16,12,14
11176,2014/03/31,2009/10/19,518,2,0.825,24464,518,2,0
11177,2014/03/31,2011/12/07,19,18,0.6868304059999999,29376,19,12,6
11178,2014/03/31,2007/09/01,2,17,0.617975436,32649,2,11,6
11179,2014/03/31,2007/08/31,12,15,0.86050627,23446,12,3,12
11180,2014/03/31,2008/08/05,46,17,0.627617433,32146,46,11,6
11181,2014/03/31,2007/03/05,154,17,0.843062103,23928,154,14,3
11182,2014/03/31,2011/09/24,21,25,0.879610605,22933,21,11,14
11183,2014/03/31,2010/11/23,36,22,0.740169156,27253,36,12,10
11184,2014/03/31,2008/09/15,30,11,0.993145249,20310,30,3,8
11185,2014/03/31,2011/04/21,28,18,0.879379115,22935,28,7,11
11186,2014/03/31,2006/09/23,13,24,0.6836072129999999,29502,13,12,12
11187,2014/03/31,2008/04/20,32,29,0.71298957,28285,32,19,10
11188,2014/03/31,2008/10/25,61,26,0.832616433,24220,61,14,12
11189,2014/03/31,2013/01/10,1,19,0.701277387,28754,1,1,18
11190,2014/03/31,2007/06/04,3,25,0.815211256,24733,3,19,6
11191,2014/03/31,2012/01/15,56,16,1.024865043,19673,56,9,7
11192,2014/03/31,2008/05/24,4,23,0.71196165,28318,4,12,11
11193,2014/03/31,2010/06/29,107,13,0.8791478779999999,22931,107,6,7
11194,2014/03/31,2011/01/09,116,20,0.7561657909999999,26660,116,16,4
11195,2014/03/31,2010/03/19,31,17,0.70531437,28581,31,7,10
11196,2014/03/31,2010/07/20,199,9,0.7948655259999999,25358,199,6,3
11197,2014/03/31,2009/04/29,9,16,0.8498144870000001,23718,9,12,4
11198,2014/03/31,2011/09/24,4,20,0.64705278,31148,4,13,7
11199,2014/03/31,2006/09/20,6,26,0.558064463,36114,6,8,18
11200,2014/03/31,2012/05/12,24,15,0.67730322,29754,24,8,7
11201,2014/03/31,2011/12/20,7,24,0.7423038390000001,27146,7,12,12
11202,2014/03/31,2011/06/15,43,14,0.845253818,23836,43,6,8
11203,2014/03/31,2005/11/09,1,27,0.733549867,27463,1,12,15
11204,2014/03/31,2010/05/28,8,20,0.804196111,25047,8,12,8
11205,2014/03/31,2013/02/15,101,24,0.874701233,23028,101,1,23
11206,2014/03/31,2004/12/26,5,27,0.5929375920000001,33970,5,13,14
11207,2014/03/31,2008/07/05,5,17,0.7866131609999999,25605,5,6,11
11208,2014/03/31,2012/12/25,37,18,1.153374184,17462,37,3,15
11209,2014/03/31,2012/06/01,36,17,0.565572592,35610,36,7,10
11210,2014/03/31,2011/05/24,35,33,0.847739518,23756,35,17,16
11211,2014/03/31,2010/12/15,4,28,0.635205047,31700,4,13,15
11212,2014/03/31,2006/06/19,79,21,0.782711759,25725,79,10,11
11213,2014/03/31,2007/02/28,13,20,0.890045973,22622,13,18,2
11214,2014/03/31,2005/07/12,10,21,0.558492953,36044,10,9,12
11215,2014/03/31,2005/11/20,1,22,0.826027493,24370,1,10,12
11216,2014/03/31,2005/04/22,38,25,0.653091823,30820,38,16,9
11217,2014/03/31,2013/01/26,19,20,0.7868809640000001,25572,19,1,19
11218,2014/03/31,2012/10/21,185,12,0.620954482,32405,185,5,7
11219,2014/03/31,2009/10/10,16,17,0.523334547,38449,16,9,8
11220,2014/03/31,2010/11/22,49,10,1.185784418,16968,49,3,7
11221,2014/03/31,2005/03/20,20,23,0.833339962,24138,20,15,8
11222,2014/03/31,2005/11/05,159,17,0.79227185,25389,159,11,6
11223,2014/03/31,2012/03/01,164,20,0.647253596,31077,164,14,6
11224,2014/03/31,2012/01/19,110,22,0.659705805,30490,110,15,7
11225,2014/03/31,2006/03/23,6,20,0.598446706,33606,6,11,9
11226,2014/03/31,2006/04/04,34,9,0.638189001,31513,34,2,7
11227,2014/03/31,2012/10/29,216,16,0.645508298,31153,216,12,4
11228,2014/03/31,2010/09/06,72,21,0.6740640920000001,29832,72,11,10
11229,2014/03/31,2012/10/31,109,12,0.553132066,36353,109,1,11
11230,2014/03/31,2011/10/23,22,22,0.744960913,26991,22,13,9
11231,2014/03/31,2009/04/12,111,10,0.7846776209999999,25622,111,1,9
11232,2014/03/31,2011/01/29,147,12,0.69771735,28813,147,9,3
11233,2014/03/31,2005/08/30,38,16,0.684955022,29348,38,2,14
11234,2014/03/31,2012/07/01,11,23,0.549173725,36598,11,8,15
11235,2014/03/31,2008/06/12,90,15,0.740339277,27146,90,9,6
11236,2014/03/31,2012/06/12,12,25,0.8007574609999999,25097,12,14,11
11237,2014/03/31,2012/06/27,3,29,0.715450272,28083,3,16,13
11238,2014/03/31,2007/09/10,88,12,0.829921927,24208,88,8,4
11239,2014/03/31,2012/10/31,3,25,0.744218189,26995,3,10,15
11240,2014/03/31,2007/11/10,43,14,1.10949409,18106,43,9,5
11241,2014/03/31,2012/03/29,563,10,0.76,26430,563,10,0
11242,2014/03/31,2009/12/16,35,13,0.7318678040000001,27444,35,5,8
11243,2014/03/31,2010/04/14,50,15,0.7584501509999999,26480,50,7,8
11244,2014/03/31,2009/08/12,29,26,0.597304524,33623,29,11,15
11245,2014/03/31,2010/11/05,29,17,0.7743464179999999,25934,29,2,15
11246,2014/03/31,2005/01/05,35,19,0.603449043,33273,35,8,11
11247,2014/03/31,2007/12/15,18,14,1.014962338,19781,18,5,9
11248,2014/03/31,2012/01/23,376,31,0.951459716,21100,376,31,0
11249,2014/03/31,2010/10/24,119,9,1.4419997130000002,13922,119,3,6
11250,2014/03/31,2012/05/16,11,17,0.690288505,29081,11,13,4
11251,2014/03/31,2007/11/21,8,25,0.679232253,29554,8,10,15
11252,2014/03/31,2011/11/14,62,24,0.679730123,29532,62,6,18
11253,2014/03/31,2011/04/18,185,20,0.7426641759999999,27029,185,10,10
11254,2014/03/31,2012/06/20,142,17,0.70355265,28528,142,6,11
11255,2014/03/31,2012/01/22,44,14,0.7621428570000001,26334,44,6,8
11256,2014/03/31,2008/10/16,5,32,0.512406812,39168,5,13,19
11257,2014/03/31,2008/07/23,25,30,0.5656631910000001,35480,25,18,12
11258,2014/03/31,2012/01/03,34,3,0.66,30408,34,2,1
11259,2014/03/31,2009/04/28,19,23,0.525849887,38158,19,1,22
11260,2014/03/31,2005/03/02,39,9,1.035875581,19370,39,3,6
11261,2014/03/31,2012/12/04,29,24,0.675525323,29696,29,7,17
11262,2014/03/31,2011/03/16,118,21,0.498390856,40245,118,13,8
11263,2014/03/31,2012/03/19,80,11,0.844432,23750,80,7,4
11264,2014/03/31,2006/09/02,179,12,0.991004101,20237,179,7,5
11265,2014/03/31,2012/10/25,2,24,0.7477328659999999,26818,2,4,20
11266,2014/03/31,2012/03/31,31,24,0.7453355140000001,26899,31,8,16
11267,2014/03/31,2007/12/17,2,26,0.795003371,25215,2,13,13
11268,2014/03/31,2007/07/17,62,25,0.855072952,23440,62,15,10
11269,2014/03/31,2009/02/03,37,24,0.8971074309999999,22340,37,20,4
11270,2014/03/31,2013/03/20,7,24,0.663340064,30212,7,2,22
11271,2014/03/31,2006/07/18,9,25,0.7946072409999999,25219,9,5,20
11272,2014/03/31,2012/08/18,3,12,0.719166667,27864,3,7,5
11273,2014/03/31,2013/02/25,26,17,0.631819616,31699,26,5,12
11274,2014/03/31,2005/07/31,143,16,0.620430944,32278,143,9,7
11275,2014/03/31,2007/03/20,73,26,0.6003411679999999,33356,73,12,14
11276,2014/03/31,2008/12/16,149,15,0.857558991,23351,149,5,10
11277,2014/03/31,2005/01/04,6,24,0.659505978,30363,6,9,15
11278,2014/03/31,2009/09/16,111,15,0.627537999,31909,111,9,6
11279,2014/03/31,2010/07/01,41,9,1.185457936,16891,41,7,2
11280,2014/03/31,2011/02/05,23,22,0.7621374190000001,26270,23,8,14
11281,2014/03/31,2010/04/12,64,12,1.087561254,18407,64,4,8
11282,2014/03/31,2012/02/05,57,22,0.727478286,27517,57,7,15
11283,2014/03/31,2008/11/18,6,20,0.769805415,26004,6,9,11
11284,2014/03/31,2013/01/16,12,26,0.7450912,26864,12,4,22
11285,2014/03/31,2010/09/28,22,15,0.637766164,31381,22,11,4
11286,2014/03/31,2007/06/07,109,21,0.672238495,29770,109,15,6
11287,2014/03/31,2006/12/11,30,16,0.7161090040000001,27944,30,12,4
11288,2014/03/31,2006/09/18,36,24,0.853549034,23443,36,13,11
11289,2014/03/31,2009/08/13,19,18,0.8364443979999999,23920,19,1,17
11290,2014/03/31,2012/05/29,170,21,0.66829441,29931,170,12,9
11291,2014/03/31,2006/10/13,81,24,0.816123307,24508,81,15,9
11292,2014/03/31,2011/12/16,150,16,1.088276181,18372,150,8,8
11293,2014/03/31,2010/07/22,88,26,0.8028866309999999,24901,88,20,6
11294,2014/03/31,2013/03/21,64,12,0.440016069,45430,64,1,11
11295,2014/03/31,2012/07/28,111,19,0.8859371540000001,22563,111,8,11
11296,2014/03/31,2006/12/04,32,20,0.8704485479999999,22963,32,11,9
11297,2014/03/31,2008/10/23,26,16,0.73361681,27245,26,8,8
11298,2014/03/31,2005/02/09,254,19,0.804210526,24852,254,13,6
11299,2014/03/31,2011/12/26,28,34,0.65766421,30388,28,19,15
11300,2014/03/31,2010/11/04,39,32,0.8034959190000001,24869,39,22,10
11301,2014/03/31,2011/11/17,4,25,0.789776285,25300,4,4,21
11302,2014/03/31,2006/11/05,10,18,0.625923814,31922,10,12,6
11303,2014/03/31,2006/01/02,46,24,0.940809436,21237,46,16,8
11304,2014/03/31,2006/09/08,119,18,0.6942299670000001,28778,119,10,8
11305,2014/03/31,2004/12/08,6,15,0.806855285,24759,6,7,8
11306,2014/03/31,2011/11/07,74,16,0.8667708059999999,23046,74,7,9
11307,2014/03/31,2008/09/22,13,20,0.7968233140000001,25067,13,10,10
11308,2014/03/31,2013/03/24,156,4,0.8204781859999999,24342,156,2,2
11309,2014/03/31,2012/06/13,53,12,1.402778675,14237,53,2,10
11310,2014/03/31,2009/01/16,12,22,0.6873110290000001,29052,12,13,9
11311,2014/03/31,2010/06/14,30,17,0.788079018,25336,30,4,13
11312,2014/03/31,2011/02/26,43,29,0.782150133,25524,43,16,13
11313,2014/03/31,2011/03/25,46,22,0.793287105,25165,46,12,10
11314,2014/03/31,2012/12/14,68,11,0.6598704129999999,30250,68,5,6
11315,2014/03/31,2011/11/17,272,21,0.621569458,32113,272,15,6
11316,2014/03/31,2012/05/11,20,27,0.6954613559999999,28698,20,14,13
11317,2014/03/31,2006/09/14,2,23,0.7341614240000001,27183,2,4,19
11318,2014/03/31,2007/09/12,24,20,0.84745731,23542,24,10,10
11319,2014/03/31,2008/04/09,156,24,0.672077213,29684,156,12,12
11320,2014/03/31,2011/10/11,14,22,0.7728750190000001,25812,14,12,10
11321,2014/03/31,2012/07/18,391,38,0.7845033029999999,25428,391,38,0
11322,2014/03/31,2011/04/30,20,19,0.688558854,28970,20,8,11
11323,2014/03/31,2012/04/17,11,20,0.778963565,25607,11,8,12
11324,2014/03/31,2011/11/19,31,10,0.655784456,30416,31,6,4
11325,2014/03/31,2010/04/15,8,38,0.608962411,32749,8,14,24
11326,2014/03/31,2012/08/20,19,14,0.6859124990000001,29074,19,1,13
11327,2014/03/31,2004/12/12,16,15,0.614303891,32459,16,2,13
11328,2014/03/31,2006/04/25,23,22,0.707780065,28172,23,9,13
11329,2014/03/31,2012/01/25,95,15,0.678994075,29366,95,10,5
11330,2014/03/31,2010/04/28,42,15,0.7393729370000001,26967,42,6,9
11331,2014/03/31,2012/10/06,20,14,0.736968286,27054,20,1,13
11332,2014/03/31,2012/08/30,39,14,0.8839089179999999,22551,39,10,4
11333,2014/03/31,2004/11/11,77,15,0.7812418170000001,25511,77,4,11
11334,2014/03/31,2012/05/23,95,17,0.7724998059999999,25798,95,11,6
11335,2014/03/31,2008/03/12,8,23,0.701959562,28389,8,13,10
11336,2014/03/31,2008/12/22,166,19,0.646089424,30842,166,8,11
11337,2014/03/31,2008/09/09,44,21,0.7105998570000001,28040,44,13,8
11338,2014/03/31,2007/09/24,37,27,0.8245966640000001,24161,37,8,19
11339,2014/03/31,2006/02/19,61,33,0.939453954,21207,61,17,16
11340,2014/03/31,2011/08/29,5,22,0.692272727,28776,5,12,10
11341,2014/03/31,2007/02/28,88,29,0.7442176640000001,26766,88,16,13
11342,2014/03/31,2012/10/24,153,6,0.986082178,20200,153,3,3
11343,2014/03/31,2007/11/15,72,14,0.7332723390000001,27161,72,6,8
11344,2014/03/31,2011/09/05,34,23,0.7511075070000001,26510,34,18,5
11345,2014/03/31,2008/05/11,59,16,0.764011971,26062,59,7,9
11346,2014/03/31,2012/05/25,8,14,0.688673815,28910,8,6,8
11347,2014/03/31,2008/02/18,27,18,0.719141774,27685,27,8,10
11348,2014/03/31,2011/04/27,202,9,1.487312864,13386,202,7,2
11349,2014/03/31,2013/01/17,4,30,1.092659715,18220,4,5,25
11350,2014/03/31,2011/01/13,24,20,0.8473412229999999,23492,24,11,9
11351,2014/03/31,2005/08/24,105,17,0.746999925,26646,105,7,10
11352,2014/03/31,2010/10/10,4,16,1.207533823,16483,4,6,10
11353,2014/03/31,2008/09/10,143,22,0.733801939,27123,143,10,12
11354,2014/03/31,2009/01/25,2,26,0.6739075520000001,29530,2,3,23
11355,2014/03/31,2012/08/14,24,30,0.740485636,26872,24,11,19
11356,2014/03/31,2010/10/24,5,20,0.699573503,28441,5,9,11
11357,2014/03/31,2006/03/24,344,23,0.558649256,35610,344,19,4
11358,2014/03/31,2010/08/07,155,28,0.8091522940000001,24584,155,16,12
11359,2014/03/31,2010/06/04,148,31,0.618900159,32141,148,16,15
11360,2014/03/31,2006/03/05,9,19,0.6380504229999999,31176,9,7,12
11361,2014/03/31,2005/02/01,14,24,0.65072854,30568,14,12,12
11362,2014/03/31,2012/08/10,30,13,0.878169375,22648,30,5,8
11363,2014/03/31,2012/08/12,172,16,0.816997905,24343,172,11,5
11364,2014/03/31,2007/10/09,297,4,0.956457943,20793,297,2,2
11365,2014/03/31,2010/02/28,137,20,0.7170732059999999,27730,137,10,10
11366,2014/03/31,2012/08/29,74,15,0.815537143,24379,74,4,11
11367,2014/03/31,2010/11/05,332,9,1.171608322,16968,332,7,2
11368,2014/03/31,2010/11/07,64,21,0.7610420729999999,26121,64,12,9
11369,2014/03/31,2012/12/30,27,11,0.858666523,23150,27,3,8
11370,2014/03/31,2010/02/11,106,22,0.766914885,25918,106,11,11
11371,2014/03/31,2008/01/07,8,16,0.839081353,23687,8,9,7
11372,2014/03/31,2005/09/16,19,4,1.053529817,18865,19,0,4
11373,2014/03/31,2007/03/14,4,25,0.559191942,35542,4,10,15
11374,2014/03/31,2012/07/01,1,26,0.776598937,25592,1,0,26
11375,2014/03/31,2007/08/26,105,20,0.7521207990000001,26424,105,17,3
11376,2014/03/31,2011/05/25,69,6,0.906666667,21918,69,3,3
11377,2014/03/31,2007/05/19,122,17,0.77161606,25754,122,11,6
11378,2014/03/31,2012/03/29,2,31,0.6777079709999999,29319,2,7,24
11379,2014/03/31,2006/03/01,74,16,0.643806514,30855,74,9,7
11380,2014/03/31,2009/03/02,4,15,0.7053575740000001,28162,4,8,7
11381,2014/03/31,2011/12/05,41,6,0.6407428789999999,31001,41,2,4
11382,2014/03/31,2011/08/26,2,15,0.847279474,23444,2,1,14
11383,2014/03/31,2013/02/12,3,18,0.642972291,30892,3,0,18
11384,2014/03/31,2012/10/08,29,10,0.597194227,33260,29,2,8
11385,2014/03/31,2012/01/28,4,32,0.714990279,27776,4,11,21
11386,2014/03/31,2010/12/22,163,18,0.900044869,22064,163,9,9
11387,2014/03/31,2005/05/15,60,19,0.692949613,28658,60,9,10
11388,2014/03/31,2007/02/04,10,10,1.369922047,14496,10,2,8
11389,2014/03/31,2009/08/10,1,17,0.838512795,23682,1,9,8
11390,2014/03/31,2011/07/19,3,21,0.779382212,25478,3,11,10
11391,2014/03/31,2007/03/20,94,20,0.8293734070000001,23939,94,9,11
11392,2014/03/31,2007/04/12,11,26,0.669862344,29639,11,11,15
11393,2014/03/31,2012/09/04,114,10,0.82540454,24052,114,4,6
11394,2014/03/31,2012/12/17,44,14,0.638112886,31111,44,6,8
11395,2014/03/31,2007/07/19,27,19,0.7866911040000001,25235,27,4,15
11396,2014/03/31,2009/10/18,13,13,0.6813461470000001,29135,13,6,7
11397,2014/03/31,2006/06/07,99,16,0.600271243,33070,99,9,7
11398,2014/03/31,2010/10/25,343,14,0.776605375,25561,343,11,3
11399,2014/03/31,2007/10/09,222,9,1.3772427669999998,14413,222,6,3
11400,2014/03/31,2011/07/10,19,23,0.683190845,29055,19,14,9
11401,2014/03/31,2006/12/01,4,23,0.476375876,41668,4,13,10
11402,2014/03/31,2010/05/01,73,26,0.799031687,24837,73,15,11
11403,2014/03/31,2011/12/22,9,18,0.8784237779999999,22592,9,13,5
11404,2014/03/31,2009/04/22,18,24,0.705284501,28137,18,15,9
11405,2014/03/31,2011/11/26,7,18,0.832211038,23844,7,9,9
11406,2014/03/31,2008/01/13,175,26,0.7627568709999999,26015,175,17,9
11407,2014/03/31,2011/07/12,236,21,0.628467849,31570,236,19,2
11408,2014/03/31,2011/01/25,10,25,0.7620045320000001,26036,10,10,15
11409,2014/03/31,2010/01/12,9,21,0.6236300770000001,31812,9,6,15
11410,2014/03/31,2006/03/23,37,11,1.397046271,14199,37,1,10
11411,2014/03/31,2012/12/03,49,12,1.438062201,13794,49,3,9
11412,2014/03/31,2011/11/17,101,20,0.570589978,34764,101,12,8
11413,2014/03/31,2013/01/30,375,4,0.7389344259999999,26840,375,4,0
11414,2014/03/31,2012/06/21,295,10,0.71,27930,295,7,3
11415,2014/03/31,2012/05/29,90,18,0.7069859890000001,28049,90,13,5
11416,2014/03/31,2006/04/27,156,19,0.678755434,29215,156,13,6
11417,2014/03/31,2006/08/20,4,29,0.7868944440000001,25200,4,8,21
11418,2014/03/31,2005/06/16,7,23,0.623664161,31789,7,2,21
11419,2014/03/31,2011/07/22,74,15,0.67514457,29363,74,10,5
11420,2014/03/31,2006/10/23,31,16,0.765934155,25879,31,10,6
11421,2014/03/31,2004/11/16,4,25,0.80189538,24718,4,13,12
11422,2014/03/31,2006/06/09,114,12,0.8374994720000001,23667,114,7,5
11423,2014/03/31,2011/07/18,75,18,0.67950972,29167,75,12,6
11424,2014/03/31,2012/08/01,26,9,0.761111111,26037,26,5,4
11425,2014/03/31,2010/06/28,9,14,0.922564711,21480,9,9,5
11426,2014/03/31,2013/03/09,3,7,0.735404884,26946,3,1,6
11427,2014/03/31,2011/04/29,346,21,0.7214285709999999,27468,346,18,3
11428,2014/03/31,2007/08/12,15,17,0.867524735,22842,15,8,9
11429,2014/03/31,2006/10/06,132,2,0.81,24464,132,1,1
11430,2014/03/31,2010/06/27,241,2,0.81,24464,241,0,2
11431,2014/03/31,2012/03/12,32,16,0.832490442,23803,32,8,8
11432,2014/03/31,2007/04/20,70,15,0.7468230990000001,26529,70,6,9
11433,2014/03/31,2009/04/16,135,22,0.693248539,28579,135,12,10
11434,2014/03/31,2013/03/01,2,23,0.792990834,24983,2,0,23
11435,2014/03/31,2012/06/07,156,27,0.685497716,28892,156,19,8
11436,2014/03/31,2012/12/28,11,15,0.746901116,26516,11,1,14
11437,2014/03/31,2012/05/13,47,13,0.805280387,24591,47,9,4
11438,2014/03/31,2012/08/16,342,5,0.710890716,27854,342,3,2
11439,2014/03/31,2008/11/22,20,28,0.6982055709999999,28360,20,15,13
11440,2014/03/31,2008/04/22,7,13,0.8051258490000001,24593,7,6,7
11441,2014/03/31,2007/12/06,10,12,0.57043135,34705,10,9,3
11442,2014/03/31,2010/09/07,63,18,0.6906101729999999,28664,63,14,4
11443,2014/03/31,2006/05/13,5,22,0.656101223,30171,5,2,20
11444,2014/03/31,2011/01/16,12,25,0.618362489,32012,12,1,24
11445,2014/03/31,2012/03/12,37,29,0.6039890760000001,32772,37,12,17
11446,2014/03/31,2012/11/01,10,25,0.624130613,31712,10,7,18
11447,2014/03/31,2008/11/23,13,20,0.642536766,30803,13,7,13
11448,2014/03/31,2005/01/11,14,16,0.851301561,23249,14,12,4
11449,2014/03/31,2008/09/26,21,21,0.843749147,23456,21,12,9
11450,2014/03/31,2009/11/21,2,22,0.727084436,27216,2,14,8
11451,2014/03/31,2007/10/09,71,26,0.7752127240000001,25526,71,16,10
11452,2014/03/31,2012/07/26,68,30,0.756295673,26164,68,14,16
11453,2014/03/31,2008/07/26,129,24,0.6339103,31215,129,12,12
11454,2014/03/31,2006/06/24,111,18,0.6993803679999999,28291,111,11,7
11455,2014/03/31,2007/06/13,22,40,0.767769887,25770,22,14,26
11456,2014/03/31,2011/04/05,10,15,0.64078413,30875,10,6,9
11457,2014/03/31,2010/12/27,195,22,0.6928545909999999,28554,195,16,6
11458,2014/03/31,2010/11/07,137,15,0.774145043,25551,137,4,11
11459,2014/03/31,2006/04/25,71,22,0.7068566629999999,27983,71,14,8
11460,2014/03/31,2005/03/23,159,24,0.612049449,32316,159,15,9
11461,2014/03/31,2004/12/10,15,8,1.444979544,13688,15,4,4
11462,2014/03/31,2008/07/25,59,51,0.949529982,20829,59,27,24
11463,2014/03/31,2008/09/21,47,27,0.7531077429999999,26257,47,17,10
11464,2014/03/31,2012/07/20,27,29,0.793300971,24926,27,10,19
11465,2014/03/31,2012/04/07,254,15,0.802994924,24625,254,10,5
11466,2014/03/31,2012/08/22,29,13,0.940419501,21025,29,2,11
11467,2014/03/31,2012/11/24,9,19,0.774922986,25515,9,3,16
11468,2014/03/31,2010/12/29,57,21,0.615987289,32098,57,8,13
11469,2014/03/31,2011/04/06,43,19,0.719383983,27483,43,10,9
11470,2014/03/31,2012/09/02,444,5,0.822305869,24043,444,5,0
11471,2014/03/31,2007/04/15,5,33,0.6664976570000001,29663,5,18,15
11472,2014/03/31,2007/04/19,59,19,0.758700875,26056,59,12,7
11473,2014/03/31,2007/12/27,97,7,1.4357142859999998,13769,97,2,5
11474,2014/03/31,2007/04/09,26,21,0.655914853,30136,26,9,12
11475,2014/03/31,2011/06/13,21,19,0.635484504,31104,21,5,14
11476,2014/03/31,2008/06/21,8,18,0.7235167290000001,27318,8,8,10
11477,2014/03/31,2011/03/21,431,19,0.6786337259999999,29123,431,19,0
11478,2014/03/31,2010/01/01,37,9,0.7610533,25966,37,3,6
11479,2014/03/31,2010/08/18,135,5,0.747590799,26432,135,3,2
11480,2014/03/31,2010/03/03,112,17,0.72292865,27330,112,8,9
11481,2014/03/31,2005/08/29,153,14,0.8724507640000001,22646,153,13,1
11482,2014/03/31,2008/06/30,261,3,0.77,25659,261,0,3
11483,2014/03/31,2007/12/03,13,37,0.60625886,32589,13,21,16
11484,2014/03/31,2011/04/14,116,12,0.813270624,24292,116,7,5
11485,2014/03/31,2008/09/16,28,18,0.481688286,41012,28,6,12
11486,2014/03/31,2011/12/15,32,24,0.72604499,27206,32,15,9
11487,2014/03/31,2010/07/28,195,19,0.807080047,24473,195,16,3
11488,2014/03/31,2007/02/22,46,22,0.7881003109999999,25062,46,14,8
11489,2014/03/31,2010/10/21,11,17,0.6770363009999999,29173,11,8,9
11490,2014/03/31,2011/07/12,95,17,0.500412254,39466,95,3,14
11491,2014/03/31,2005/12/02,80,14,0.972011322,20315,80,7,7
11492,2014/03/31,2006/06/24,16,15,0.834357067,23665,16,2,13
11493,2014/03/31,2010/01/02,249,11,1.445872574,13655,249,7,4
11494,2014/03/31,2007/09/27,180,15,0.706788744,27933,180,12,3
11495,2014/03/31,2010/10/15,101,12,0.786588437,25097,101,6,6
11496,2014/03/31,2007/02/27,8,29,0.692441069,28508,8,15,14
11497,2014/03/31,2012/11/02,11,15,0.798976767,24706,11,4,11
11498,2014/03/31,2013/03/30,19,12,0.579331709,34072,19,1,11
11499,2014/03/31,2009/09/06,15,16,0.919535967,21464,15,8,8
11500,2014/03/31,2012/11/01,49,13,0.873111396,22604,49,3,10
11501,2014/03/31,2005/04/29,66,14,0.80826712,24416,66,8,6
11502,2014/03/31,2012/05/29,5,17,0.90457875,21816,5,7,10
11503,2014/03/31,2008/10/30,32,12,1.157414663,17050,32,8,4
11504,2014/03/31,2008/03/18,1,34,0.755464012,26120,1,9,25
11505,2014/03/31,2011/02/03,15,17,0.814916577,24214,15,6,11
11506,2014/03/31,2010/06/23,84,17,0.8103942670000001,24349,84,4,13
11507,2014/03/31,2013/03/01,26,8,0.665208172,29663,26,0,8
11508,2014/03/31,2010/01/24,174,15,0.679578784,29035,174,10,5
11509,2014/03/31,2007/01/12,100,20,0.7930013659999999,24882,100,12,8
11510,2014/03/31,2012/03/03,326,12,0.778413037,25344,326,10,2
11511,2014/03/31,2012/03/14,19,32,0.6952560529999999,28373,19,16,16
11512,2014/03/31,2008/11/09,101,23,0.632444772,31189,101,12,11
11513,2014/03/31,2010/10/28,251,13,0.73396331,26874,251,12,1
11514,2014/03/31,2010/03/09,102,17,0.6726119429999999,29323,102,4,13
11515,2014/03/31,2010/03/17,42,21,0.717819188,27476,42,4,17
11516,2014/03/31,2012/07/23,45,21,0.857709203,22992,45,10,11
11517,2014/03/31,2012/02/22,154,23,0.86686184,22749,154,15,8
11518,2014/03/31,2011/09/01,59,14,0.75264313,26200,59,8,6
11519,2014/03/31,2012/04/17,24,23,0.8254412259999999,23888,24,16,7
11520,2014/03/31,2011/12/13,4,24,0.7248623209999999,27201,4,18,6
11521,2014/03/31,2005/02/03,41,15,0.7554407479999999,26092,41,8,7
11522,2014/03/31,2010/01/10,156,20,0.734532648,26832,156,12,8
11523,2014/03/31,2012/06/13,11,44,0.833284699,23646,11,20,24
11524,2014/03/31,2008/05/07,84,19,0.697607195,28243,84,11,8
11525,2014/03/31,2011/11/02,50,12,0.688496243,28615,50,8,4
11526,2014/03/31,2012/02/22,33,23,0.65419824,30115,33,12,11
11527,2014/03/31,2005/10/12,100,13,1.125726124,17497,100,11,2
11528,2014/03/31,2011/05/07,27,3,0.863340931,22814,27,1,2
11529,2014/03/31,2010/04/05,3,12,0.586671333,33572,3,2,10
11530,2014/03/31,2008/11/18,22,17,0.7412979000000001,26566,22,10,7
11531,2014/03/31,2008/08/21,198,14,0.8062278909999999,24424,198,4,10
11532,2014/03/31,2006/04/02,51,10,0.7744245590000001,25424,51,6,4
11533,2014/03/31,2011/01/14,117,16,0.6811555090000001,28905,117,8,8
11534,2014/03/31,2005/11/13,14,17,0.782655138,25155,14,5,12
11535,2014/03/31,2008/06/12,23,21,0.8496961590000001,23170,23,14,7
11536,2014/03/31,2008/06/12,108,29,0.666150983,29553,108,18,11
11537,2014/03/31,2011/08/15,113,14,1.104104779,17828,113,13,1
11538,2014/03/31,2011/08/09,100,20,0.679864603,28952,100,12,8
11539,2014/03/31,2010/04/03,92,14,0.693224625,28394,92,8,6
11540,2014/03/31,2012/06/02,482,3,0.65,30282,482,3,0
11541,2014/03/31,2009/12/11,10,27,0.523076248,37614,10,11,16
11542,2014/03/31,2008/05/22,52,13,0.906089159,21714,52,6,7
11543,2014/03/31,2012/01/24,47,23,0.624418103,31509,47,15,8
11544,2014/03/31,2012/07/22,17,11,1.027048966,19156,17,4,7
11545,2014/03/31,2010/10/24,78,30,0.465040658,42304,78,17,13
11546,2014/03/31,2011/07/20,8,20,0.893482605,22018,8,10,10
11547,2014/03/31,2008/01/28,7,27,0.6158142879999999,31942,7,13,14
11548,2014/03/31,2008/01/15,22,18,0.612549594,32111,22,12,6
11549,2014/03/31,2012/03/30,200,4,0.8491797259999999,23163,200,3,1
11550,2014/03/31,2011/04/14,169,21,0.8352552670000001,23544,169,15,6
11551,2014/03/31,2012/06/13,18,27,0.810096807,24275,18,16,11
11552,2014/03/31,2012/11/09,25,23,0.85329905,23043,25,6,17
11553,2014/03/31,2007/05/05,49,11,1.003925854,19583,49,2,9
11554,2014/03/31,2005/11/20,6,16,1.393965114,14103,6,11,5
11555,2014/03/31,2009/01/15,80,18,0.711044387,27643,80,9,9
11556,2014/03/31,2007/02/17,130,19,0.725285609,27100,130,9,10
11557,2014/03/31,2007/05/30,189,16,0.876433604,22426,189,14,2
11558,2014/03/31,2005/05/24,29,17,0.765665978,25669,29,12,5
11559,2014/03/31,2008/11/01,12,18,0.764930137,25693,12,8,10
11560,2014/03/31,2009/09/28,196,13,0.715799308,27455,196,8,5
11561,2014/03/31,2012/01/19,110,16,0.800682068,24543,110,4,12
11562,2014/03/31,2010/01/06,100,4,1.065931109,18435,100,0,4
11563,2014/03/31,2011/03/28,23,17,0.708192732,27738,23,9,8
11564,2014/03/31,2012/06/13,349,15,0.739945376,26545,349,14,1
11565,2014/03/31,2010/05/26,4,30,0.7248189840000001,27097,4,15,15
11566,2014/03/31,2005/04/13,16,25,0.835886534,23496,16,14,11
11567,2014/03/31,2007/02/05,50,18,0.660831146,29718,50,10,8
11568,2014/03/31,2007/10/12,22,20,1.069060373,18369,22,0,20
11569,2014/03/31,2006/09/16,5,21,0.642512107,30560,5,14,7
11570,2014/03/31,2004/12/02,36,12,0.561876145,34944,36,6,6
11571,2014/03/31,2011/09/22,1,30,0.7362365909999999,26662,1,9,21
11572,2014/03/31,2011/03/18,49,12,0.835786493,23484,49,3,9
11573,2014/03/31,2011/03/22,44,17,0.808814803,24266,44,12,5
11574,2014/03/31,2007/11/01,67,11,0.705401675,27821,67,5,6
11575,2014/03/31,2007/09/11,124,22,0.759941135,25822,124,6,16
11576,2014/03/31,2011/09/24,66,21,0.716906693,27372,66,12,9
11577,2014/03/31,2006/09/29,47,22,0.634333279,30935,47,7,15
11578,2014/03/31,2007/01/21,64,24,0.784981197,24996,64,16,8
11579,2014/03/31,2010/05/11,34,18,0.834968722,23499,34,8,10
11580,2014/03/31,2010/07/21,4,16,0.66100246,29677,4,4,12
11581,2014/03/31,2009/11/24,37,8,1.321874116,14839,37,3,5
11582,2014/03/31,2007/03/27,136,19,0.6004380429999999,32668,136,11,8
11583,2014/03/31,2012/08/16,28,10,0.795668154,24650,28,4,6
11584,2014/03/31,2010/10/22,1,39,0.8730426459999999,22464,1,18,21
11585,2014/03/31,2009/04/05,7,15,0.721961124,27163,7,0,15
11586,2014/03/31,2011/11/04,34,17,0.682453887,28734,34,2,15
11587,2014/03/31,2010/03/23,24,22,0.693950097,28255,24,12,10
11588,2014/03/31,2007/11/09,44,11,0.6683083320000001,29332,44,9,2
11589,2014/03/31,2011/04/19,112,19,0.74656663,26257,112,16,3
11590,2014/03/31,2011/04/26,60,24,0.699870751,28008,60,13,11
11591,2014/03/31,2005/12/14,30,25,0.7278778309999999,26930,30,9,16
11592,2014/03/31,2010/09/26,139,17,0.7572401670000001,25882,139,9,8
11593,2014/03/31,2006/10/04,6,24,0.6420091729999999,30525,6,7,17
11594,2014/03/31,2011/11/02,56,13,0.815125614,24042,56,5,8
11595,2014/03/31,2010/04/29,135,21,0.7310830070000001,26805,135,15,6
11596,2014/03/31,2006/10/02,38,8,0.7717307390000001,25388,38,2,6
11597,2014/03/31,2008/01/21,18,19,0.828333827,23653,18,9,10
11598,2014/03/31,2005/05/11,46,8,0.588320971,33299,46,4,4
11599,2014/03/31,2010/02/12,164,5,1.202879774,16286,164,4,1
11600,2014/03/31,2012/07/27,5,7,0.8338632779999999,23493,5,3,4
11601,2014/03/31,2009/07/02,82,26,0.743145675,26360,82,15,11
11602,2014/03/31,2012/04/24,47,19,0.6316954779999999,31006,47,11,8
11603,2014/03/31,2013/01/11,66,24,0.727254596,26925,66,8,16
11604,2014/03/31,2008/04/26,12,29,0.660151382,29660,12,20,9
11605,2014/03/31,2007/09/02,1,23,0.58678535,33366,1,14,9
11606,2014/03/31,2007/05/09,169,18,0.923908919,21190,169,9,9
11607,2014/03/31,2010/10/11,26,14,0.750414734,26089,26,4,10
11608,2014/03/31,2007/11/08,27,17,0.7373344629999999,26550,27,5,12
11609,2014/03/31,2007/03/29,99,22,0.7166951009999999,27314,99,8,14
11610,2014/03/31,2012/12/08,23,14,0.8213347040000001,23833,23,0,14
11611,2014/03/31,2010/10/29,185,20,0.683442966,28641,185,11,9
11612,2014/03/31,2008/08/30,3,28,0.626433235,31244,3,10,18
11613,2014/03/31,2007/02/21,282,12,1.405849016,13922,282,11,1
11614,2014/03/31,2011/03/19,190,13,0.838205491,23349,190,11,2
11615,2014/03/31,2008/09/10,581,2,0.8,24464,581,2,0
11616,2014/03/31,2010/06/01,258,2,0.8,24464,258,1,1
11617,2014/03/31,2012/07/29,605,2,0.8,24464,605,2,0
11618,2014/03/31,2012/08/01,240,4,0.718367347,27244,240,2,2
11619,2014/03/31,2007/06/21,611,2,0.8,24464,611,2,0
11620,2014/03/31,2012/04/12,469,2,0.8,24464,469,2,0
11621,2014/03/31,2011/06/25,217,16,0.597206286,32770,217,8,8
11622,2014/03/31,2006/09/25,8,15,0.6175497,31690,8,7,8
11623,2014/03/31,2012/09/11,94,8,0.774003322,25284,94,4,4
11624,2014/03/31,2010/04/04,163,21,0.840796992,23275,163,18,3
11625,2014/03/31,2006/04/05,203,11,0.677946506,28863,203,2,9
11626,2014/03/31,2006/02/04,6,12,0.462283757,42325,6,8,4
11627,2014/03/31,2007/12/25,1,20,0.823328143,23761,1,6,14
11628,2014/03/31,2008/04/10,157,13,0.7126121959999999,27452,157,6,7
11629,2014/03/31,2011/03/16,123,22,0.748043827,26148,123,9,13
11630,2014/03/31,2009/11/06,12,27,0.658656048,29696,12,14,13
11631,2014/03/31,2010/08/29,186,8,1.127143845,17352,186,3,5
11632,2014/03/31,2012/03/03,7,24,0.678514831,28825,7,12,12
11633,2014/03/31,2005/06/06,33,23,0.71147779,27487,33,5,18
11634,2014/03/31,2011/06/15,308,9,1.4829377419999998,13187,308,8,1
11635,2014/03/31,2007/10/22,15,26,0.641273735,30493,15,9,17
11636,2014/03/31,2005/08/14,89,20,0.648810393,30136,89,17,3
11637,2014/03/31,2006/08/15,17,26,0.641727884,30465,17,10,16
11638,2014/03/31,2012/05/22,29,8,0.78486531,24909,29,5,3
11639,2014/03/31,2007/09/26,162,22,0.88683012,22045,162,19,3
11640,2014/03/31,2008/05/04,50,27,0.695499022,28105,50,16,11
11641,2014/03/31,2009/02/22,197,11,1.093798198,17869,197,6,5
11642,2014/03/31,2007/03/12,204,19,0.618551174,31598,204,14,5
11643,2014/03/31,2012/05/25,349,14,0.788321904,24790,349,12,2
11644,2014/03/31,2007/05/12,12,19,0.797339345,24509,12,4,15
11645,2014/03/31,2011/03/27,148,29,0.702776379,27806,148,23,6
11646,2014/03/31,2009/12/20,4,21,0.7947421509999999,24588,4,0,21
11647,2014/03/31,2011/03/10,148,16,0.659541987,29628,148,5,11
11648,2014/03/31,2004/11/03,98,22,0.851798605,22940,98,14,8
11649,2014/03/31,2005/08/14,343,7,1.486504374,13145,343,6,1
11650,2014/03/31,2010/10/24,25,13,0.768122027,25437,25,1,12
11651,2014/03/31,2013/03/22,19,21,0.668259457,29238,19,0,21
11652,2014/03/31,2012/07/30,61,14,0.8578273470000001,22774,61,6,8
11653,2014/03/31,2011/05/09,36,10,0.975912179,20018,36,4,6
11654,2014/03/31,2010/03/04,100,21,0.663374881,29444,100,18,3
11655,2014/03/31,2005/03/20,12,22,0.6336497529999999,30824,12,13,9
11656,2014/03/31,2011/06/25,494,19,0.670480604,29130,494,19,0
11657,2014/03/31,2011/03/02,75,25,0.543871794,35911,75,14,11
11658,2014/03/31,2012/06/24,250,20,0.749285605,26064,250,16,4
11659,2014/03/31,2012/07/27,83,6,0.724876944,26939,83,2,4
11660,2014/03/31,2011/12/27,6,20,0.569610291,34282,6,5,15
11661,2014/03/31,2011/03/24,63,19,0.81872741,23849,63,5,14
11662,2014/03/31,2012/10/02,23,26,0.6641036020000001,29401,23,21,5
11663,2014/03/31,2005/02/28,22,30,0.483746438,40361,22,19,11
11664,2014/03/31,2008/12/27,74,27,0.74751407,26119,74,15,12
11665,2014/03/31,2012/10/22,264,6,0.63808811,30598,264,4,2
11666,2014/03/31,2008/05/25,34,14,1.48665626,13132,34,11,3
11667,2014/03/31,2009/03/30,20,19,0.90520332,21567,20,7,12
11668,2014/03/31,2010/05/12,137,20,0.737208187,26481,137,7,13
11669,2014/03/31,2010/12/07,167,13,0.750467074,26013,167,7,6
11670,2014/03/31,2013/01/14,16,26,0.688989799,28331,16,7,19
11671,2014/03/31,2006/08/09,12,27,0.782627717,24938,12,13,14
11672,2014/03/31,2007/01/18,50,10,0.7159679309999999,27254,50,4,6
11673,2014/03/31,2009/03/07,487,6,0.7069234109999999,27602,487,6,0
11674,2014/03/31,2010/02/19,23,20,0.663143013,29424,23,12,8
11675,2014/03/31,2012/01/18,128,19,0.95635624,20402,128,7,12
11676,2014/03/31,2006/08/13,18,23,0.914700422,21330,18,7,16
11677,2014/03/31,2009/02/17,5,21,0.790876475,24667,5,8,13
11678,2014/03/31,2013/01/09,130,10,0.738,26430,130,4,6
11679,2014/03/31,2007/03/18,57,31,0.71246822,27376,57,16,15
11680,2014/03/31,2012/05/30,48,15,0.954104784,20442,48,10,5
11681,2014/03/31,2006/12/20,33,18,0.761423831,25614,33,8,10
11682,2014/03/31,2012/09/05,243,15,0.825653978,23617,243,9,6
11683,2014/03/31,2007/10/25,47,25,0.669720076,29115,47,9,16
11684,2014/03/31,2011/01/05,1,20,0.732589044,26616,1,3,17
11685,2014/03/31,2010/06/03,19,10,0.61862882,31513,19,5,5
11686,2014/03/31,2010/05/27,31,20,0.630992814,30892,31,2,18
11687,2014/03/31,2010/04/10,145,9,0.671183155,29041,145,7,2
11688,2014/03/31,2008/04/26,166,14,0.949966855,20516,166,11,3
11689,2014/03/31,2006/09/21,72,26,0.885743114,22002,72,17,9
11690,2014/03/31,2008/05/10,43,30,0.8758973440000001,22249,43,22,8
11691,2014/03/31,2007/04/01,5,29,0.784453345,24842,5,15,14
11692,2014/03/31,2009/03/24,79,20,0.635904047,30640,79,10,10
11693,2014/03/31,2011/04/23,163,13,0.8585529209999999,22694,163,6,7
11694,2014/03/31,2012/02/08,6,22,0.706278185,27586,6,9,13
11695,2014/03/31,2012/06/02,40,22,0.8010591229999999,24322,40,9,13
11696,2014/03/31,2011/03/28,7,34,0.667349204,29195,7,23,11
11697,2014/03/31,2007/07/27,40,32,0.4489177170000001,43399,40,16,16
11698,2014/03/31,2008/12/16,302,15,0.8133934540000001,23952,302,11,4
11699,2014/03/31,2008/05/18,7,13,0.7572352,25727,7,4,9
11700,2014/03/31,2008/08/07,83,18,0.6837900170000001,28488,83,9,9
11701,2014/03/31,2012/04/19,145,17,0.810577147,24032,145,5,12
11702,2014/03/31,2012/02/14,33,30,0.6640452729999999,29333,33,21,9
11703,2014/03/31,2009/12/01,159,20,0.818800286,23789,159,12,8
11704,2014/03/31,2012/08/02,81,15,0.7307804290000001,26652,81,4,11
11705,2014/03/31,2012/04/24,42,12,0.743764895,26184,42,9,3
11706,2014/03/31,2010/03/01,13,25,0.606581218,32105,13,15,10
11707,2014/03/31,2012/11/12,114,22,0.514668059,37838,114,11,11
11708,2014/03/31,2010/08/14,1,47,0.714255319,27260,1,31,16
11709,2014/03/31,2005/09/09,6,14,0.804285714,24206,6,7,7
11710,2014/03/31,2010/11/25,111,18,0.7670974859999999,25378,111,10,8
11711,2014/03/31,2009/11/27,110,25,0.789413625,24660,110,11,14
11712,2014/03/31,2011/11/22,10,22,0.8013622890000001,24290,10,9,13
11713,2014/03/31,2005/01/11,96,15,0.677606698,28726,96,12,3
11714,2014/03/31,2005/01/29,11,20,0.7483458940000001,26008,11,9,11
11715,2014/03/31,2007/04/25,57,16,0.7352024779999999,26472,57,7,9
11716,2014/03/31,2012/05/08,173,16,0.60627644,32101,173,8,8
11717,2014/03/31,2010/06/02,3,17,0.7482352940000001,26010,3,8,9
11718,2014/03/31,2009/09/28,233,8,1.481757405,13133,233,3,5
11719,2014/03/31,2012/10/09,28,12,0.698333333,27864,28,7,5
11720,2014/03/31,2011/03/01,83,26,0.8289983809999999,23472,83,14,12
11721,2014/03/31,2012/11/28,2,19,0.7100788259999999,27402,2,4,15
11722,2014/03/31,2010/03/02,22,7,0.834419093,23317,22,4,3
11723,2014/03/31,2012/11/27,20,22,0.643981926,30209,20,7,15
11724,2014/03/31,2011/01/11,160,16,0.618125,31472,160,9,7
11725,2014/03/31,2009/09/03,374,10,0.728059735,26718,374,10,0
11726,2014/03/31,2011/05/15,15,27,0.703120278,27661,15,7,20
11727,2014/03/31,2011/12/29,87,24,0.610388563,31861,87,15,9
11728,2014/03/31,2011/06/18,33,17,0.782681425,24845,33,11,6
11729,2014/03/31,2010/12/24,12,31,0.634051657,30664,12,7,24
11730,2014/03/31,2012/02/09,338,7,0.7857142859999999,24745,338,6,1
11731,2014/03/31,2011/02/01,74,18,0.7245552120000001,26833,74,8,10
11732,2014/03/31,2009/10/24,44,17,0.7103737940000001,27368,44,12,5
11733,2014/03/31,2011/08/25,39,13,0.821787783,23655,39,10,3
11734,2014/03/31,2012/11/28,27,13,0.7751788629999999,25075,27,8,5
11735,2014/03/31,2008/06/13,33,24,0.674457785,28817,33,14,10
11736,2014/03/31,2011/11/20,14,25,0.677851911,28672,14,15,10
11737,2014/03/31,2009/09/07,8,17,0.779721565,24925,8,3,14
11738,2014/03/31,2006/10/04,312,26,0.7105111140000001,27352,312,24,2
11739,2014/03/31,2009/09/16,13,21,0.756203354,25699,13,5,16
11740,2014/03/31,2008/09/25,88,6,0.7268938429999999,26734,88,4,2
11741,2014/03/31,2012/03/26,250,19,0.7180714659999999,27062,250,15,4
11742,2014/03/31,2005/08/29,20,29,0.582278026,33371,20,20,9
11743,2014/03/31,2011/05/26,64,16,0.7208038729999999,26957,64,15,1
11744,2014/03/31,2009/07/29,21,19,0.7554080320000001,25721,21,8,11
11745,2014/03/31,2008/11/07,58,16,0.7474931709999999,25993,58,6,10
11746,2014/03/31,2011/09/09,21,15,0.923757607,21032,21,10,5
11747,2014/03/31,2009/02/06,159,18,0.749355859,25926,159,10,8
11748,2014/03/31,2007/06/19,104,10,0.688162528,28229,104,6,4
11749,2014/03/31,2006/12/08,376,28,0.713785184,27214,376,28,0
11750,2014/03/31,2007/08/07,83,4,0.5975,32508,83,0,4
11751,2014/03/31,2008/07/29,60,22,0.576471671,33693,60,12,10
11752,2014/03/31,2008/06/01,438,23,0.661283239,29371,438,23,0
11753,2014/03/31,2006/07/04,69,24,0.7622775620000001,25479,69,9,15
11754,2014/03/31,2007/10/24,9,20,0.680997195,28520,9,7,13
11755,2014/03/31,2012/01/21,7,23,0.682574772,28453,7,14,9
11756,2014/03/31,2012/04/18,91,26,0.8459318640000001,22954,91,19,7
11757,2014/03/31,2006/09/24,92,30,0.677158302,28673,92,12,18
11758,2014/03/31,2009/08/04,3,24,0.71255138,27248,3,10,14
11759,2014/03/31,2007/09/19,17,15,0.715561125,27133,17,3,12
11760,2014/03/31,2012/06/01,212,23,0.851540857,22799,212,16,7
11761,2014/03/31,2006/07/23,94,12,0.6913845059999999,28075,94,6,6
11762,2014/03/31,2008/10/25,81,24,0.649035645,29906,81,16,8
11763,2014/03/31,2012/09/14,101,12,0.680715112,28513,101,4,8
11764,2014/03/31,2011/09/01,231,11,0.803653567,24149,231,10,1
11765,2014/03/31,2012/07/05,13,19,0.8076922759999999,24028,13,7,12
11766,2014/03/31,2007/02/12,2,22,0.7692341840000001,25228,2,7,15
11767,2014/03/31,2007/06/10,78,26,0.566670755,34245,78,8,18
11768,2014/03/31,2011/01/19,63,23,0.672384005,28859,63,10,13
11769,2014/03/31,2009/05/27,39,37,0.7079838709999999,27404,39,5,32
11770,2014/03/31,2008/02/22,73,28,0.525336438,36931,73,13,15
11771,2014/03/31,2006/02/01,22,15,0.623550191,31111,22,3,12
11772,2014/03/31,2010/08/17,149,12,0.786666667,24660,149,9,3
11773,2014/03/31,2010/08/06,21,32,0.8782759090000001,22087,21,22,10
11774,2014/03/31,2006/04/08,146,16,0.670273315,28941,146,10,6
11775,2014/03/31,2006/12/19,41,24,0.7037862840000001,27560,41,11,13
11776,2014/03/31,2012/05/22,23,31,0.7334849059999999,26434,23,21,10
11777,2014/03/31,2008/03/09,123,24,0.804075979,24112,123,13,11
11778,2014/03/31,2006/09/02,11,15,0.696555168,27833,11,9,6
11779,2014/03/31,2005/08/14,156,12,0.779600273,24867,156,6,6
11780,2014/03/31,2006/10/01,16,12,0.785816848,24668,16,8,4
11781,2014/03/31,2012/08/17,3,9,0.760139619,25498,3,3,6
11782,2014/03/31,2010/12/27,508,7,0.65198641,29727,508,7,0
11783,2014/03/31,2008/03/21,8,21,0.802074745,24162,8,11,10
11784,2014/03/31,2010/10/20,122,14,0.783233903,24741,122,7,7
11785,2014/03/31,2013/01/27,66,17,0.632480251,30634,66,6,11
11786,2014/03/31,2007/05/17,94,20,0.795125174,24366,94,12,8
11787,2014/03/31,2007/10/12,130,20,0.627009095,30897,130,10,10
11788,2014/03/31,2011/07/25,134,18,0.672943649,28784,134,12,6
11789,2014/03/31,2007/07/30,46,17,0.610353924,31730,46,10,7
11790,2014/03/31,2011/08/15,9,27,0.7543737090000001,25667,9,14,13
11791,2014/03/31,2008/07/17,33,19,0.760816928,25449,33,7,12
11792,2014/03/31,2007/04/29,8,18,0.588185795,32918,8,10,8
11793,2014/03/31,2011/10/12,6,22,0.69547832,27837,6,12,10
11794,2014/03/31,2012/08/12,30,18,0.548071457,35322,30,6,12
11795,2014/03/31,2009/01/28,15,24,0.805165745,24043,15,15,9
11796,2014/03/31,2009/05/02,234,25,0.8367934640000001,23134,234,16,9
11797,2014/03/31,2005/12/20,15,25,0.850792423,22753,15,0,25
11798,2014/03/31,2007/07/14,103,18,1.027833059,18833,103,15,3
11799,2014/03/31,2007/08/30,21,16,0.693655617,27905,21,9,7
11800,2014/03/31,2011/10/20,66,18,0.66388222,29156,66,9,9
11801,2014/03/31,2005/10/26,2,29,0.609537696,31754,2,19,10
11802,2014/03/31,2007/08/10,11,20,0.823645572,23497,11,10,10
11803,2014/03/31,2012/06/09,16,24,0.619876037,31219,16,4,20
11804,2014/03/31,2005/08/10,30,10,1.395930174,13863,30,7,3
11805,2014/03/31,2012/03/18,1,26,0.717551913,26968,1,15,11
11806,2014/03/31,2011/01/06,58,18,0.6917654000000001,27971,58,5,13
11807,2014/03/31,2012/08/08,4,27,0.8260297129999999,23424,4,13,14
11808,2014/03/31,2012/03/24,85,19,0.693730236,27891,85,9,10
11809,2014/03/31,2010/04/02,14,11,0.693766718,27889,14,5,6
11810,2014/03/31,2012/02/06,40,6,0.6588440839999999,29362,40,0,6
11811,2014/03/31,2009/09/27,334,10,0.745468208,25950,334,7,3
11812,2014/03/31,2005/03/30,7,21,0.644899817,29995,7,14,7
11813,2014/03/31,2004/12/02,489,4,0.815326898,23723,489,4,0
11814,2014/03/31,2009/07/06,9,21,0.7084743590000001,27300,9,13,8
11815,2014/03/31,2012/05/29,431,26,0.713271742,27114,431,26,0
11816,2014/03/31,2011/08/03,4,25,0.806186843,23988,4,13,12
11817,2014/03/31,2011/08/20,4,24,0.68076395,28405,4,13,11
11818,2014/03/31,2008/11/07,35,18,0.653589224,29583,35,7,11
11819,2014/03/31,2010/02/19,157,21,0.706708213,27359,157,16,5
11820,2014/03/31,2012/11/29,68,14,0.791501146,24428,68,5,9
11821,2014/03/31,2005/10/26,30,17,0.712179903,27148,30,8,9
11822,2014/03/31,2007/06/14,22,17,0.626040864,30883,22,9,8
11823,2014/03/31,2006/11/01,67,20,0.623132414,31024,67,5,15
11824,2014/03/31,2011/11/14,4,20,0.7915120370000001,24424,4,10,10
11825,2014/03/31,2012/07/01,552,4,0.707991503,27304,552,4,0
11826,2014/03/31,2010/10/10,35,15,0.698972736,27656,35,10,5
11827,2014/03/31,2010/01/18,24,14,0.7031059940000001,27492,24,5,9
11828,2014/03/31,2006/09/28,23,22,0.681772134,28350,23,15,7
11829,2014/03/31,2011/10/11,79,18,1.176127913,16433,79,12,6
11830,2014/03/31,2009/01/13,105,12,0.6855130709999999,28193,105,5,7
11831,2014/03/31,2010/09/12,669,2,0.79,24464,669,2,0
11832,2014/03/31,2007/07/04,122,7,1.335255631,14474,122,4,3
11833,2014/03/31,2011/08/25,125,22,0.841481885,22964,125,12,10
11834,2014/03/31,2007/01/20,32,28,0.618664148,31231,32,19,9
11835,2014/03/31,2010/11/28,39,26,0.630531366,30638,39,10,16
11836,2014/03/31,2010/02/22,65,19,0.8948357809999999,21587,65,13,6
11837,2014/03/31,2008/04/12,4,14,0.77886953,24795,4,4,10
11838,2014/03/31,2011/01/05,1,31,0.663098002,29122,1,13,18
11839,2014/03/31,2008/11/24,9,29,0.885253748,21813,9,6,23
11840,2014/03/31,2010/10/26,15,53,0.6281132079999999,30740,15,25,28
11841,2014/03/31,2011/07/20,23,16,0.807784286,23902,23,10,6
11842,2014/03/31,2009/01/07,14,30,0.631575228,30567,14,14,16
11843,2014/03/31,2007/04/22,7,27,0.7735328770000001,24957,7,11,16
11844,2014/03/31,2009/11/18,23,21,0.723521739,26680,23,9,12
11845,2014/03/31,2008/12/04,1,14,0.7076916590000001,27275,1,2,12
11846,2014/03/31,2012/04/24,344,10,0.92,20980,344,9,1
11847,2014/03/31,2008/08/14,429,16,0.6192290420000001,31169,429,16,0
11848,2014/03/31,2010/04/16,10,24,0.7500567429999999,25730,10,9,15
11849,2014/03/31,2010/11/23,44,16,0.821921373,23478,44,6,10
11850,2014/03/31,2007/07/02,7,17,0.684268085,28200,7,9,8
11851,2014/03/31,2007/11/13,75,24,0.741388718,26024,75,11,13
11852,2014/03/31,2012/12/20,105,19,0.827718478,23309,105,4,15
11853,2014/03/31,2006/07/08,22,10,0.59529684,32408,22,5,5
11854,2014/03/31,2011/03/15,462,5,0.7772218190000001,24822,462,5,0
11855,2014/03/31,2012/02/26,322,21,0.8416183079999999,22919,322,19,2
11856,2014/03/31,2010/05/12,30,21,0.612394666,31495,30,9,12
11857,2014/03/31,2008/05/01,69,18,0.8407650390000001,22940,69,10,8
11858,2014/03/31,2005/06/28,29,14,0.746689895,25830,29,0,14
11859,2014/03/31,2011/09/05,33,55,0.985272356,19570,33,43,12
11860,2014/03/31,2011/05/23,10,14,0.87804527,21957,10,4,10
11861,2014/03/31,2010/09/18,23,14,0.736305859,26182,23,9,5
11862,2014/03/31,2012/04/12,158,17,0.699223794,27570,158,15,2
11863,2014/03/31,2006/04/05,26,14,1.054085739,18288,26,10,4
11864,2014/03/31,2012/03/26,62,14,0.881212855,21874,62,10,4
11865,2014/03/31,2011/02/03,41,24,0.713453879,27016,41,11,13
11866,2014/03/31,2008/03/29,3,40,0.738449868,26101,3,16,24
11867,2014/03/31,2007/03/12,2,24,0.741980366,25975,2,17,7
11868,2014/03/31,2012/07/20,27,19,0.752652216,25605,27,9,10
11869,2014/03/31,2008/08/20,84,13,0.82104725,23471,84,7,6
11870,2014/03/31,2010/09/04,88,14,0.747236725,25781,88,6,8
11871,2014/03/31,2012/05/10,2,23,0.712093083,27051,2,9,14
11872,2014/03/31,2013/01/09,13,17,0.6928846359999999,27799,13,0,17
11873,2014/03/31,2010/07/26,221,17,0.736,26170,221,9,8
11874,2014/03/31,2008/11/15,36,18,0.7277051529999999,26468,36,0,18
11875,2014/03/31,2012/11/04,311,5,0.925480538,20810,311,1,4
11876,2014/03/31,2012/05/23,450,3,0.750549515,25659,450,3,0
11877,2014/03/31,2010/09/13,2,34,0.641039212,30042,2,15,19
11878,2014/03/31,2011/07/21,172,24,0.682620516,28212,172,18,6
11879,2014/03/31,2012/02/27,22,14,0.735657855,26176,22,6,8
11880,2014/03/31,2008/01/20,222,9,1.047234066,18388,222,4,5
11881,2014/03/31,2007/04/27,104,25,0.75962323,25347,104,13,12
11882,2014/03/31,2004/11/30,37,15,0.748045227,25737,37,9,6
11883,2014/03/31,2010/08/05,142,19,0.631346166,30494,142,12,7
11884,2014/03/31,2005/02/06,19,43,0.78636995,24479,19,23,20
11885,2014/03/31,2006/11/14,159,20,0.721728664,26668,159,15,5
11886,2014/03/31,2008/03/12,119,18,0.707612604,27197,119,11,7
11887,2014/03/31,2008/05/30,159,16,0.8895673479999999,21634,159,9,7
11888,2014/03/31,2008/01/09,9,22,0.636474071,30236,9,9,13
11889,2014/03/31,2011/11/28,152,31,0.821050858,23438,152,23,8
11890,2014/03/31,2011/08/02,114,14,0.57162216,33665,114,8,6
11891,2014/03/31,2006/03/30,274,22,0.725559913,26522,274,16,6
11892,2014/03/31,2007/06/06,26,16,0.686626106,28024,26,8,8
11893,2014/03/31,2010/05/26,1,21,0.736286687,26133,1,5,16
11894,2014/03/31,2011/08/26,78,21,0.6232945670000001,30869,78,8,13
11895,2014/03/31,2009/09/08,72,28,0.665737172,28901,72,15,13
11896,2014/03/31,2011/08/02,237,20,0.702312101,27395,237,13,7
11897,2014/03/31,2010/11/20,23,31,0.671560776,28646,23,20,11
11898,2014/03/31,2010/10/22,67,28,0.73647266,26116,67,13,15
11899,2014/03/31,2010/10/02,546,4,0.7580731629999999,25368,546,4,0
11900,2014/03/31,2009/10/04,153,17,0.731833822,26273,153,5,12
11901,2014/03/31,2012/02/22,36,20,0.603021483,31885,36,11,9
11902,2014/03/31,2008/05/23,242,11,1.4606130819999998,13163,242,9,2
11903,2014/03/31,2006/11/28,69,28,0.6953142859999999,27650,69,14,14
11904,2014/03/31,2012/01/03,24,9,0.758018139,25360,24,0,9
11905,2014/03/31,2012/12/10,187,11,0.774126933,24832,187,6,5
11906,2014/03/31,2011/12/03,176,19,0.888119773,21641,176,17,2
11907,2014/03/31,2013/03/10,1,17,0.731445916,26274,1,1,16
11908,2014/03/31,2008/09/03,8,23,0.697936808,27535,8,12,11
11909,2014/03/31,2009/12/10,14,18,0.604958761,31766,14,6,12
11910,2014/03/31,2012/02/16,73,31,0.610627264,31470,73,12,19
11911,2014/03/31,2010/11/22,106,20,0.679071312,28298,106,14,6
11912,2014/03/31,2011/07/19,8,20,0.835675828,22994,8,13,7
11913,2014/03/31,2012/05/30,202,11,0.66408772,28933,202,4,7
11914,2014/03/31,2010/06/16,179,21,0.396374758,48474,179,12,9
11915,2014/03/31,2008/03/11,156,17,0.7706979540000001,24930,156,7,10
11916,2014/03/31,2008/01/22,11,19,0.752757013,25524,11,13,6
11917,2014/03/31,2007/11/01,44,21,0.852892085,22527,44,10,11
11918,2014/03/31,2007/11/19,13,31,0.637750705,30125,13,4,27
11919,2014/03/31,2006/11/17,123,20,0.743420788,25842,123,11,9
11920,2014/03/31,2010/07/09,35,16,0.844039366,22761,35,4,12
11921,2014/03/31,2006/06/28,31,12,0.701830471,27370,31,9,3
11922,2014/03/31,2008/09/07,4,24,0.7267496590000001,26428,4,12,12
11923,2014/03/31,2010/12/04,233,19,0.726298131,26438,233,9,10
11924,2014/03/31,2012/04/30,49,17,0.5409988729999999,35490,49,2,15
11925,2014/03/31,2012/08/21,41,24,0.612272539,31357,41,10,14
11926,2014/03/31,2006/07/18,140,17,0.61973595,30979,140,10,7
11927,2014/03/31,2008/03/10,16,36,0.8728857870000001,21994,16,12,24
11928,2014/03/31,2013/03/23,16,10,0.626817084,30626,16,1,9
11929,2014/03/31,2012/07/24,14,18,0.646074109,29713,14,3,15
11930,2014/03/31,2005/10/26,11,24,0.7726612190000001,24842,11,11,13
11931,2014/03/31,2006/01/07,5,15,0.636969868,30134,5,5,10
11932,2014/03/31,2008/03/12,26,19,0.79707309,24080,26,7,12
11933,2014/03/31,2007/09/08,22,17,0.617088705,31103,22,2,15
11934,2014/03/31,2006/03/27,177,3,0.75085759,25560,177,1,2
11935,2014/03/31,2008/01/06,15,24,0.8502082129999999,22573,15,15,9
11936,2014/03/31,2008/02/08,138,10,0.789639566,24304,138,5,5
11937,2014/03/31,2007/06/04,37,37,0.5271689970000001,36397,37,25,12
11938,2014/03/31,2009/10/18,65,17,0.7831108929999999,24501,65,11,6
11939,2014/03/31,2011/11/26,13,21,0.516749899,37125,13,11,10
11940,2014/03/31,2011/12/08,368,7,0.964285714,19894,368,7,0
11941,2014/03/31,2013/03/22,6,12,0.604893879,31709,6,2,10
11942,2014/03/31,2010/12/08,106,28,0.6438991470000001,29786,106,19,9
11943,2014/03/31,2010/12/31,65,16,0.76328597,25125,65,13,3
11944,2014/03/31,2012/05/02,21,18,0.825243362,23237,21,11,7
11945,2014/03/31,2006/07/05,27,19,0.7767312129999999,24685,27,7,12
11946,2014/03/31,2005/07/15,22,28,0.7505128000000001,25546,22,12,16
11947,2014/03/31,2011/11/03,69,18,0.7287930509999999,26306,69,5,13
11948,2014/03/31,2011/07/28,197,15,0.517863086,37016,197,9,6
11949,2014/03/31,2012/09/04,155,12,1.061644883,18056,155,2,10
11950,2014/03/31,2012/12/06,114,18,0.353298127,54252,114,10,8
11951,2014/03/31,2006/03/29,65,11,0.641019132,29898,65,9,2
11952,2014/03/31,2009/12/10,99,21,0.623941644,30708,99,10,11
11953,2014/03/31,2009/06/08,9,10,0.6859999999999999,27930,9,7,3
11954,2014/03/31,2007/08/18,64,13,0.781964329,24502,64,0,13
11955,2014/03/31,2011/08/19,103,14,0.682037663,28091,103,6,8
11956,2014/03/31,2012/01/11,4,21,0.843727045,22707,4,7,14
11957,2014/03/31,2012/10/08,37,11,0.6238134160000001,30710,37,4,7
11958,2014/03/31,2011/09/16,109,16,0.926039934,20684,109,7,9
11959,2014/03/31,2011/11/29,5,21,0.931559339,20560,5,16,5
11960,2014/03/31,2013/03/03,76,15,0.8110609459999999,23611,76,3,12
11961,2014/03/31,2008/04/10,18,26,0.62540695,30618,18,0,26
11962,2014/03/31,2011/07/20,27,20,1.0406265959999998,18401,27,3,17
11963,2014/03/31,2008/01/03,3,20,0.583642239,32804,3,14,6
11964,2014/03/31,2010/01/14,132,15,0.650201746,29443,132,11,4
11965,2014/03/31,2012/08/30,15,25,0.573023827,33408,15,7,18
11966,2014/03/31,2009/01/07,40,24,0.7987782179999999,23965,40,15,9
11967,2014/03/31,2008/02/01,70,18,0.608308651,31466,70,5,13
11968,2014/03/31,2011/03/18,197,15,0.73043465,26205,197,7,8
11969,2014/03/31,2008/02/08,65,7,0.716892909,26697,65,6,1
11970,2014/03/31,2012/05/23,75,7,1.471610274,13004,75,4,3
11971,2014/03/31,2010/02/03,126,23,0.662278249,28895,126,18,5
11972,2014/03/31,2010/10/11,32,16,0.617841206,30971,32,8,8
11973,2014/03/31,2011/11/08,6,21,0.681514051,28077,6,0,21
11974,2014/03/31,2012/05/15,157,19,0.735700004,26007,157,6,13
11975,2014/03/31,2008/01/01,80,19,0.688342508,27795,80,10,9
11976,2014/03/31,2013/01/10,46,15,0.749468364,25525,46,4,11
11977,2014/03/31,2006/07/23,67,19,0.707969727,27021,67,13,6
11978,2014/03/31,2012/06/23,422,5,0.779868727,24529,422,5,0
11979,2014/03/31,2012/02/26,25,14,0.760871485,25141,25,7,7
11980,2014/03/31,2011/08/11,1,36,0.6981638020000001,27399,1,22,14
11981,2014/03/31,2012/03/28,32,20,0.6009644989999999,31830,32,4,16
11982,2014/03/31,2010/11/19,7,23,0.58751367,32554,7,9,14
11983,2014/03/31,2009/04/22,43,16,0.669473887,28568,43,6,10
11984,2014/03/31,2011/11/11,183,8,0.901263962,21219,183,6,2
11985,2014/03/31,2010/10/20,201,10,1.0587426640000002,18062,201,6,4
11986,2014/03/31,2012/04/21,497,16,0.66931504,28571,497,16,0
11987,2014/03/31,2012/12/29,9,16,0.595562615,32109,9,3,13
11988,2014/03/31,2009/11/21,285,12,1.153241662,16581,285,6,6
11989,2014/03/31,2008/09/11,51,13,0.6794371,28140,51,5,8
11990,2014/03/31,2009/04/04,11,17,0.6350079710000001,30108,11,11,6
11991,2014/03/31,2012/02/17,43,33,0.8958230640000001,21341,43,15,18
11992,2014/03/31,2012/11/10,6,19,0.74156484,25779,6,7,12
11993,2014/03/31,2010/07/20,327,20,0.6394507079999999,29893,327,18,2
11994,2014/03/31,2012/06/15,21,12,0.8054384929999999,23729,21,4,8
11995,2014/03/31,2013/02/24,90,19,0.811628727,23546,90,5,14
11996,2014/03/31,2008/12/08,89,13,0.8013884929999999,23846,89,11,2
11997,2014/03/31,2007/08/26,130,20,0.6400756989999999,29855,130,15,5
11998,2014/03/31,2011/09/14,11,15,0.935009544,20431,11,8,7
11999,2014/03/31,2011/08/21,87,13,0.848179114,22522,87,6,7
12000,2014/03/31,2011/12/30,219,16,0.733889892,26029,219,12,4
12001,2014/03/31,2006/03/10,40,15,0.845883343,22579,40,9,6
12002,2014/03/31,2010/08/05,38,25,0.485331368,39352,38,13,12
12003,2014/03/31,2010/05/30,125,22,0.574158374,33263,125,11,11
12004,2014/03/31,2007/09/08,99,18,0.595591317,32064,99,8,10
12005,2014/03/31,2011/06/14,2,31,0.901355076,21187,2,19,12
12006,2014/03/31,2010/04/11,21,13,0.520321508,36702,21,8,5
12007,2014/03/31,2012/01/14,5,24,0.748765098,25500,5,12,12
12008,2014/03/31,2012/10/28,163,16,0.776168137,24599,163,4,12
12009,2014/03/31,2012/08/15,24,23,0.68027366,28064,24,8,15
12010,2014/03/31,2012/09/20,3,24,0.606289262,31487,3,3,21
12011,2014/03/31,2009/06/23,38,18,0.937531434,20360,38,12,6
12012,2014/03/31,2005/01/02,4,24,0.5504115239999999,34676,4,9,15
12013,2014/03/31,2006/12/10,149,17,0.8320446420000001,22938,149,2,15
12014,2014/03/31,2011/02/24,18,19,0.560054292,34075,18,7,12
12015,2014/03/31,2011/04/11,194,20,0.687025743,27775,194,15,5
12016,2014/03/31,2009/08/23,75,15,0.581167118,32833,75,10,5
12017,2014/03/31,2008/01/05,14,14,0.652554974,29241,14,8,6
12018,2014/03/31,2005/11/09,19,16,0.872657215,21865,19,11,5
12019,2014/03/31,2008/01/09,76,23,0.540347201,35311,76,12,11
12020,2014/03/31,2007/05/17,21,12,0.995071972,19174,21,4,8
12021,2014/03/31,2007/01/12,8,45,0.794447637,24015,8,15,30
12022,2014/03/31,2006/03/09,31,31,0.494220507,38602,31,16,15
12023,2014/03/31,2006/02/19,2,18,0.661881051,28819,2,5,13
12024,2014/03/31,2009/01/18,6,18,0.6572503270000001,29018,6,8,10
12025,2014/03/31,2010/05/20,314,14,1.5,12714,314,10,4
12026,2014/03/31,2012/09/05,44,25,0.7336838659999999,25989,44,10,15
12027,2014/03/31,2011/11/20,129,29,0.91732849,20786,129,15,14
12028,2014/03/31,2011/12/19,91,16,0.820553069,23234,91,10,6
12029,2014/03/31,2005/07/25,27,18,0.5554005710000001,34326,27,15,3
12030,2014/03/31,2008/03/10,18,19,0.775440937,24584,18,11,8
12031,2014/03/31,2010/10/10,17,20,0.858558818,22204,17,18,2
12032,2014/03/31,2010/04/05,244,14,0.900719652,21163,244,9,5
12033,2014/03/31,2012/09/24,438,5,0.700943257,27193,438,5,0
12034,2014/03/31,2011/08/24,105,23,0.514969871,37007,105,12,11
12035,2014/03/31,2007/09/20,21,31,0.6866002520000001,27755,21,9,22
12036,2014/03/31,2012/05/18,675,4,1.071698538,17780,675,4,0
12037,2014/03/31,2006/02/02,153,16,0.709250354,26866,153,5,11
12038,2014/03/31,2005/04/30,168,13,0.819482603,23251,168,11,2
12039,2014/03/31,2012/10/27,42,20,0.585254216,32551,42,8,12
12040,2014/03/31,2007/10/14,4,31,0.775610342,24560,4,14,17
12041,2014/03/31,2004/12/29,75,19,0.72567651,26245,75,13,6
12042,2014/03/31,2009/11/21,45,17,0.689530413,27620,45,11,6
12043,2014/03/31,2006/04/03,19,24,0.8246700159999999,23092,19,3,21
12044,2014/03/31,2012/04/04,56,11,1.291498813,14745,56,0,11
12045,2014/03/31,2012/07/07,130,19,0.608210419,31309,130,13,6
12046,2014/03/31,2008/07/02,14,30,0.803587103,23696,14,15,15
12047,2014/03/31,2007/02/03,5,12,0.765341078,24877,5,0,12
12048,2014/03/31,2010/10/23,400,12,0.8,23796,400,12,0
12049,2014/03/31,2008/05/10,12,51,0.770751539,24696,12,24,27
12050,2014/03/31,2012/03/27,152,14,0.768843559,24757,152,10,4
12051,2014/03/31,2012/03/02,370,15,0.72504952,26252,370,15,0
12052,2014/03/31,2011/01/27,13,15,0.7796452709999999,24413,13,1,14
12053,2014/03/31,2012/04/18,139,16,0.808619195,23537,139,11,5
12054,2014/03/31,2008/02/20,36,18,0.6035684610000001,31529,36,13,5
12055,2014/03/31,2007/10/11,38,24,0.631291468,30144,38,14,10
12056,2014/03/31,2011/11/27,119,17,0.621202664,30632,119,6,11
12057,2014/03/31,2012/04/22,144,24,0.835553945,22773,144,11,13
12058,2014/03/31,2012/10/12,1,23,0.635458371,29943,1,0,23
12059,2014/03/31,2010/06/07,24,20,0.711904138,26726,24,11,9
12060,2014/03/31,2010/03/25,49,13,0.787628333,24156,49,4,9
12061,2014/03/31,2012/07/30,81,8,0.73625,25840,81,1,7
12062,2014/03/31,2012/10/23,84,25,0.610799461,31146,84,14,11
12063,2014/03/31,2012/09/22,104,11,0.642981039,29587,104,5,6
12064,2014/03/31,2012/08/14,1,19,0.706176405,26938,1,11,8
12065,2014/03/31,2010/06/12,114,26,0.776427755,24500,114,8,18
12066,2014/03/31,2010/02/11,58,13,0.709115005,26825,58,3,10
12067,2014/03/31,2010/02/26,13,15,0.7925821909999999,23999,13,11,4
12068,2014/03/31,2012/11/09,113,29,0.546697422,34791,113,10,19
12069,2014/03/31,2005/01/01,94,17,0.916762423,20747,94,0,17
12070,2014/03/31,2010/03/17,56,20,0.7479788409999999,25426,56,9,11
12071,2014/03/31,2011/12/21,15,14,0.868744175,21890,15,4,10
12072,2014/03/31,2010/04/01,56,14,0.8246400690000001,23060,56,9,5
12073,2014/03/31,2012/05/07,84,17,0.6972803959999999,27265,84,14,3
12074,2014/03/31,2005/01/23,158,21,0.71760607,26492,158,10,11
12075,2014/03/31,2009/08/31,34,25,0.679533121,27973,34,8,17
12076,2014/03/31,2008/05/09,334,3,1.026329374,18520,334,2,1
12077,2014/03/31,2006/05/16,36,18,0.6692454489999999,28401,36,5,13
12078,2014/03/31,2010/04/17,347,3,1.032699267,18405,347,1,2
12079,2014/03/31,2010/10/20,77,17,0.6176820829999999,30769,77,11,6
12080,2014/03/31,2012/11/04,39,14,0.690179038,27536,39,5,9
12081,2014/03/31,2012/10/15,86,9,0.7988888890000001,23787,86,3,6
12082,2014/03/31,2010/07/16,78,21,0.601964076,31567,78,12,9
12083,2014/03/31,2011/10/21,18,19,0.658995665,28835,18,7,12
12084,2014/03/31,2008/04/28,13,20,0.679606209,27959,13,7,13
12085,2014/03/31,2009/12/17,21,20,0.7160636890000001,26535,21,11,9
12086,2014/03/31,2009/03/23,11,29,0.874797422,21720,11,17,12
12087,2014/03/31,2009/01/24,77,24,0.666956323,28482,77,11,13
12088,2014/03/31,2010/07/27,16,15,0.7562091890000001,25116,16,5,10
12089,2014/03/31,2012/07/23,16,19,0.794251119,23909,16,4,15
12090,2014/03/31,2012/01/06,16,23,0.8088848190000001,23476,16,13,10
12091,2014/03/31,2009/07/31,27,20,0.6406200870000001,29641,27,6,14
12092,2014/03/31,2007/06/06,4,25,0.78695126,24128,4,10,15
12093,2014/03/31,2009/02/25,12,11,1.3853163080000002,13705,12,2,9
12094,2014/03/31,2012/04/07,3,33,0.7673167870000001,24739,3,18,15
12095,2014/03/31,2012/10/09,330,17,0.658957892,28807,330,15,2
12096,2014/03/31,2011/12/18,39,20,0.7397451190000001,25659,39,12,8
12097,2014/03/31,2011/08/02,182,15,0.772953777,24555,182,11,4
12098,2014/03/31,2007/02/01,78,24,0.844935227,22463,78,18,6
12099,2014/03/31,2012/04/17,48,14,0.79940567,23741,48,2,12
12100,2014/03/31,2007/03/25,3,31,0.7531770729999999,25193,3,16,15
12101,2014/03/31,2009/08/12,1,33,0.663570229,28592,1,11,22
12102,2014/03/31,2008/08/02,247,11,1.053047677,18017,247,6,5
12103,2014/03/31,2008/02/25,9,23,0.787279555,24099,9,13,10
12104,2014/03/31,2012/02/25,9,23,0.655240891,28955,9,14,9
12105,2014/03/31,2007/08/20,9,17,0.692614362,27391,9,6,11
12106,2014/03/31,2005/10/28,95,15,0.8537563570000001,22221,95,7,8
12107,2014/03/31,2005/07/01,16,19,0.8058066429999999,23542,16,14,5
12108,2014/03/31,2006/01/14,11,25,0.802750127,23628,11,0,25
12109,2014/03/31,2005/11/15,15,17,0.652885959,29051,15,8,9
12110,2014/03/31,2013/01/19,82,13,0.588731336,32215,82,3,10
12111,2014/03/31,2011/03/23,71,13,0.8452948259999999,22437,71,10,3
12112,2014/03/31,2012/01/07,48,25,0.644543755,29425,48,9,16
12113,2014/03/31,2006/12/19,137,17,0.7652855009999999,24781,137,8,9
12114,2014/03/31,2007/07/20,96,19,1.025394723,18494,96,10,9
12115,2014/03/31,2006/02/18,15,26,0.726460313,26104,15,12,14
12116,2014/03/31,2010/03/01,39,26,0.657968495,28821,39,9,17
12117,2014/03/31,2011/07/28,4,26,0.539970669,35117,4,14,12
12118,2014/03/31,2011/11/30,6,9,0.72550794,26135,6,5,4
12119,2014/03/31,2011/08/21,23,30,0.77153001,24575,23,16,14
12120,2014/03/31,2009/09/05,10,18,0.656859518,28865,10,7,11
12121,2014/03/31,2013/01/03,444,2,0.775,24464,444,2,0
12122,2014/03/31,2011/04/01,580,2,0.775,24464,580,2,0
12123,2014/03/31,2013/03/15,26,10,0.521724366,36338,26,1,9
12124,2014/03/31,2013/01/05,3,5,0.562726949,33686,3,2,3
12125,2014/03/31,2007/07/22,76,15,0.940540836,20154,76,7,8
12126,2014/03/31,2010/11/28,37,30,0.795849358,23818,37,21,9
12127,2014/03/31,2010/03/01,28,20,0.654043544,28982,28,12,8
12128,2014/03/31,2006/11/30,42,18,0.7884500190000001,24039,42,13,5
12129,2014/03/31,2006/01/08,1,28,0.747769273,25346,1,8,20
12130,2014/03/31,2011/11/18,48,13,0.779967893,24294,48,10,3
12131,2014/03/31,2007/07/01,144,11,0.8982351270000001,21095,144,8,3
12132,2014/03/31,2007/08/10,17,18,0.543373677,34867,17,9,9
12133,2014/03/31,2009/12/09,116,20,0.826891149,22912,116,10,10
12134,2014/03/31,2012/12/21,25,19,0.697622625,27156,25,3,16
12135,2014/03/31,2007/12/07,136,15,0.7775954359999999,24362,136,6,9
12136,2014/03/31,2010/05/27,8,6,0.720087809,26307,8,0,6
12137,2014/03/31,2010/03/02,32,22,0.626861908,30219,32,10,12
12138,2014/03/31,2010/10/13,43,23,0.7869828409999999,24069,43,13,10
12139,2014/03/31,2011/10/23,17,32,0.62095413,30499,17,12,20
12140,2014/03/31,2006/12/26,39,30,0.693138611,27321,39,17,13
12141,2014/03/31,2007/09/04,44,12,0.6061646070000001,31238,44,5,7
12142,2014/03/31,2011/06/25,2,34,0.639156456,29625,2,18,16
12143,2014/03/31,2011/07/05,108,17,0.725549764,26093,108,4,13
12144,2014/03/31,2011/05/09,12,23,0.8173961479999999,23158,12,12,11
12145,2014/03/31,2012/03/27,1,14,1.033571429,18312,1,8,6
12146,2014/03/31,2005/06/02,60,15,0.75701092,25001,60,0,15
12147,2014/03/31,2009/11/01,36,19,0.65585944,28856,36,1,18
12148,2014/03/31,2011/12/18,370,18,0.8679249609999999,21802,370,18,0
12149,2014/03/31,2012/07/13,18,19,0.697142225,27140,18,9,10
12150,2014/03/31,2012/01/09,329,7,1.2435228390000002,15215,329,6,1
12151,2014/03/31,2011/11/12,48,11,1.219774998,15511,48,8,3
12152,2014/03/31,2007/01/28,17,21,0.640126882,29555,17,13,8
12153,2014/03/31,2010/11/01,191,15,0.6888348809999999,27465,191,6,9
12154,2014/03/31,2011/01/15,68,30,0.613045366,30860,68,19,11
12155,2014/03/31,2012/02/07,188,16,0.871845792,21698,188,7,9
12156,2014/03/31,2010/04/24,52,24,0.594951087,31791,52,9,15
12157,2014/03/31,2010/06/25,113,22,0.491669959,38468,113,15,7
12158,2014/03/31,2010/07/06,32,9,0.6938773109999999,27256,32,0,9
12159,2014/03/31,2009/08/18,88,18,0.7355096640000001,25713,88,13,5
12160,2014/03/31,2012/12/02,106,14,0.7630349000000001,24785,106,6,8
12161,2014/03/31,2009/02/07,34,19,0.691985803,27329,34,10,9
12162,2014/03/31,2005/09/09,2,11,0.665184495,28429,2,2,9
12163,2014/03/31,2008/08/15,5,26,0.7421289790000001,25477,5,11,15
12164,2014/03/31,2010/07/23,5,22,0.652008002,28994,5,8,14
12165,2014/03/31,2007/03/14,69,17,0.817760426,23116,69,8,9
12166,2014/03/31,2008/01/17,42,22,0.495555818,38142,42,8,14
12167,2014/03/31,2009/07/30,33,13,0.934386988,20228,33,9,4
12168,2014/03/31,2012/07/27,2,20,0.7703522070000001,24531,2,4,16
12169,2014/03/31,2011/06/12,36,21,0.619987861,30480,36,10,11
12170,2014/03/31,2013/01/08,25,19,1.253707537,15072,25,4,15
12171,2014/03/31,2011/05/19,164,18,0.746808948,25302,164,16,2
12172,2014/03/31,2012/10/10,190,9,1.3860922830000002,13632,190,4,5
12173,2014/03/31,2006/03/25,18,9,1.195947075,15796,18,4,5
12174,2014/03/31,2012/07/06,23,22,0.670774885,28159,23,16,6
12175,2014/03/31,2005/08/26,2,12,1.016614275,18578,2,6,6
12176,2014/03/31,2013/01/18,71,16,0.716513772,26358,71,3,13
12177,2014/03/31,2006/04/23,31,9,0.709505598,26618,31,2,7
12178,2014/03/31,2012/05/04,44,18,0.736298405,25643,44,12,6
12179,2014/03/31,2012/11/07,6,30,0.8510371870000001,22185,6,10,20
12180,2014/03/31,2009/11/19,164,25,0.8664749620000001,21787,164,19,6
12181,2014/03/31,2011/03/15,16,17,0.860251105,21943,16,6,11
12182,2014/03/31,2009/04/15,102,14,0.731333695,25808,102,8,6
12183,2014/03/31,2012/04/27,87,15,0.7268745190000001,25964,87,9,6
12184,2014/03/31,2012/08/25,125,4,0.73257774,25759,125,1,3
12185,2014/03/31,2012/08/25,3,17,0.652218651,28932,3,10,7
12186,2014/03/31,2010/08/05,463,3,0.792575713,23807,463,3,0
12187,2014/03/31,2007/09/19,5,16,0.7131829009999999,26457,5,4,12
12188,2014/03/31,2005/03/22,43,14,0.708645258,26625,43,6,8
12189,2014/03/31,2009/02/03,67,20,0.7732319670000001,24400,67,7,13
12190,2014/03/31,2009/08/28,8,57,0.593392256,31793,8,19,38
12191,2014/03/31,2008/03/07,5,17,0.883721192,21348,5,8,9
12192,2014/03/31,2011/09/01,35,23,0.807212785,23371,35,10,13
12193,2014/03/31,2012/11/25,3,30,0.7872585759999999,23962,3,7,23
12194,2014/03/31,2010/02/02,30,24,0.7233583859999999,26078,30,13,11
12195,2014/03/31,2008/05/04,68,20,0.736080306,25627,68,9,11
12196,2014/03/31,2007/09/14,7,27,0.656591131,28728,7,6,21
12197,2014/03/31,2009/11/09,259,15,0.69556035,27117,259,11,4
12198,2014/03/31,2010/07/22,32,15,0.59318718,31793,32,6,9
12199,2014/03/31,2011/05/19,66,24,0.630995516,29884,66,9,15
12200,2014/03/31,2005/08/10,13,28,0.769003916,24516,13,18,10
12201,2014/03/31,2013/02/13,14,18,0.733654512,25697,14,2,16
12202,2014/03/31,2008/03/03,4,27,0.567014858,33248,4,15,12
12203,2014/03/31,2005/12/13,46,9,0.8203019890000001,22981,46,4,5
12204,2014/03/31,2008/06/14,205,17,0.626935382,30069,205,12,5
12205,2014/03/31,2008/01/20,5,18,0.999748077,18855,5,10,8
12206,2014/03/31,2010/10/19,130,10,0.926051584,20355,130,4,6
12207,2014/03/31,2008/08/30,45,13,0.631840579,29833,45,6,7
12208,2014/03/31,2006/03/10,3,19,0.5815504,32411,3,13,6
12209,2014/03/31,2012/09/26,15,19,0.736011091,25606,15,2,17
12210,2014/03/31,2005/09/24,61,19,0.995157356,18938,61,9,10
12211,2014/03/31,2006/11/23,47,26,0.78418234,24032,47,19,7
12212,2014/03/31,2012/10/11,13,26,0.6836108390000001,27567,13,13,13
12213,2014/03/31,2006/07/23,1,26,0.714747402,26366,1,11,15
12214,2014/03/31,2008/04/12,118,18,0.658924788,28599,118,15,3
12215,2014/03/31,2005/10/11,521,12,0.954416532,19744,521,12,0
12216,2014/03/31,2005/12/01,117,11,0.941830634,20004,117,5,6
12217,2014/03/31,2008/12/05,101,28,0.72192321,26097,101,18,10
12218,2014/03/31,2010/04/01,32,14,0.741371399,25412,32,2,12
12219,2014/03/31,2013/01/21,9,12,0.678829274,27752,9,0,12
12220,2014/03/31,2008/02/27,42,19,0.663384393,28398,42,12,7
12221,2014/03/31,2011/08/31,210,2,0.77,24464,210,0,2
12222,2014/03/31,2011/09/18,24,30,0.743367407,25337,24,23,7
12223,2014/03/31,2004/12/16,69,16,0.564146049,33386,69,11,5
12224,2014/03/31,2009/11/01,49,19,0.717627358,26245,49,12,7
12225,2014/03/31,2012/04/08,32,31,0.8209905820000001,22936,32,14,17
12226,2014/03/31,2008/07/26,88,20,0.5005,37620,88,10,10
12227,2014/03/31,2012/01/10,80,19,0.647163584,29086,80,12,7
12228,2014/03/31,2012/05/29,67,14,0.7189416390000001,26182,67,1,13
12229,2014/03/31,2005/10/06,4,17,0.754726544,24940,4,8,9
12230,2014/03/31,2007/09/11,290,6,1.007531717,18681,290,5,1
12231,2014/03/31,2011/10/29,43,22,0.74165189,25377,43,13,9
12232,2014/03/31,2011/07/30,154,15,0.667443081,28198,154,4,11
12233,2014/03/31,2011/04/29,28,15,0.704797948,26701,28,5,10
12234,2014/03/31,2010/04/13,103,14,0.694180658,27101,103,7,7
12235,2014/03/31,2012/04/11,4,29,0.906306914,20755,4,18,11
12236,2014/03/31,2011/05/08,63,14,0.98857293,19025,63,3,11
12237,2014/03/31,2009/01/06,191,16,0.985536341,19083,191,10,6
12238,2014/03/31,2010/07/29,32,13,0.68017903,27649,32,7,6
12239,2014/03/31,2011/12/22,60,13,0.8191044129999999,22957,60,6,7
12240,2014/03/31,2007/09/02,3,26,0.902126271,20844,3,14,12
12241,2014/03/31,2010/10/15,137,13,0.70212128,26781,137,7,6
12242,2014/03/31,2012/05/15,22,14,0.725777752,25908,22,3,11
12243,2014/03/31,2010/05/23,13,12,0.863905532,21764,13,4,8
12244,2014/03/31,2005/07/27,77,28,0.739597561,25420,77,14,14
12245,2014/03/31,2012/03/23,76,17,0.664367666,28292,76,11,6
12246,2014/03/31,2006/05/21,32,27,0.7246443029999999,25935,32,15,12
12247,2014/03/31,2007/02/05,14,22,0.643016389,29227,14,9,13
12248,2014/03/31,2011/12/28,74,9,0.654270942,28722,74,8,1
12249,2014/03/31,2009/06/18,44,25,0.6193819429999999,30337,44,9,16
12250,2014/03/31,2005/03/18,76,23,0.755657175,24864,76,18,5
12251,2014/03/31,2012/05/25,73,20,0.557840855,33680,73,9,11
12252,2014/03/31,2011/07/20,3,16,0.663703678,28307,3,3,13
12253,2014/03/31,2012/10/22,69,17,0.8158968120000001,23026,69,4,13
12254,2014/03/31,2007/06/09,32,20,0.765617002,24538,32,12,8
12255,2014/03/31,2012/10/31,123,8,1.453384651,12926,123,0,8
12256,2014/03/31,2006/04/01,7,22,0.7113465109999999,26409,7,4,18
12257,2014/03/31,2009/06/22,2,15,0.7331097059999999,25623,2,5,10
12258,2014/03/31,2011/06/23,216,13,0.577523982,32524,216,7,6
12259,2014/03/31,2010/03/25,82,22,0.484044275,38803,82,10,12
12260,2014/03/31,2008/03/26,140,12,0.730543389,25709,140,6,6
12261,2014/03/31,2009/07/26,9,15,0.656859282,28589,9,6,9
12262,2014/03/31,2011/12/24,47,19,0.797943139,23531,47,4,15
12263,2014/03/31,2005/11/11,12,17,0.793198141,23670,12,3,14
12264,2014/03/31,2011/03/16,174,7,1.19592687,15698,174,1,6
12265,2014/03/31,2012/05/16,2,19,0.658238429,28520,2,1,18
12266,2014/03/31,2010/03/15,5,20,0.70718564,26546,5,3,17
12267,2014/03/31,2007/06/10,130,23,0.6922501659999999,27118,130,18,5
12268,2014/03/31,2009/08/07,151,18,0.71730243,26168,151,9,9
12269,2014/03/31,2012/07/09,138,18,0.729798981,25719,138,3,15
12270,2014/03/31,2007/04/28,66,24,0.743055028,25260,66,10,14
12271,2014/03/31,2006/04/26,9,22,0.591148625,31751,9,7,15
12272,2014/03/31,2004/11/01,11,17,1.291281998,14532,11,3,14
12273,2014/03/31,2009/04/14,6,15,0.956267455,19622,6,11,4
12274,2014/03/31,2004/12/29,8,18,0.7137131990000001,26290,8,9,9
12275,2014/03/31,2011/12/29,38,11,0.734545455,25542,38,9,2
12276,2014/03/31,2007/09/20,569,7,0.748776691,25055,569,7,0
12277,2014/03/31,2006/11/08,173,14,1.219394865,15385,173,6,8
12278,2014/03/31,2012/02/10,70,30,0.6490609970000001,28903,70,13,17
12279,2014/03/31,2009/01/25,15,21,0.825614823,22722,15,10,11
12280,2014/03/31,2006/08/09,63,20,0.823066427,22792,63,11,9
12281,2014/03/31,2012/07/28,45,5,0.70214283,26717,45,0,5
12282,2014/03/31,2008/07/06,16,18,0.714093193,26268,16,12,6
12283,2014/03/31,2009/10/22,13,25,0.801801779,23388,13,14,11
12284,2014/03/31,2010/10/30,369,20,0.838658318,22360,369,20,0
12285,2014/03/31,2012/03/01,114,19,0.718677372,26092,114,8,11
12286,2014/03/31,2006/03/29,648,4,0.77433303,24214,648,4,0
12287,2014/03/31,2012/12/25,23,16,0.630470426,29739,23,3,13
12288,2014/03/31,2011/06/12,240,12,0.6982738070000001,26851,240,9,3
12289,2014/03/31,2007/03/06,15,26,0.754728071,24841,15,7,19
12290,2014/03/31,2008/10/31,107,11,1.3845613,13540,107,5,6
12291,2014/03/31,2009/09/10,30,26,0.678935608,27612,30,5,21
12292,2014/03/31,2006/05/17,36,27,0.6741803340000001,27804,36,15,12
12293,2014/03/31,2012/01/01,42,16,0.924349541,20278,42,6,10
12294,2014/03/31,2005/05/08,34,20,0.8554349609999999,21910,34,6,14
12295,2014/03/31,2011/07/07,30,24,0.775533165,24167,30,9,15
12296,2014/03/31,2011/04/02,44,15,0.68441908,27379,44,9,6
12297,2014/03/31,2009/04/27,37,22,0.55189967,33948,37,8,14
12298,2014/03/31,2012/04/06,165,6,0.8833333329999999,21210,165,3,3
12299,2014/03/31,2009/10/29,105,21,0.688925905,27195,105,11,10
12300,2014/03/31,2011/09/09,33,18,0.7826745209999999,23937,33,11,7
12301,2014/03/31,2009/12/15,416,7,0.828571429,22610,416,7,0
12302,2014/03/31,2009/12/12,5,13,0.724070896,25869,5,9,4
12303,2014/03/31,2007/01/12,19,21,0.59151854,31662,19,13,8
12304,2014/03/31,2011/06/20,95,33,0.7298659340000001,25659,95,21,12
12305,2014/03/31,2010/01/07,32,28,0.823365283,22744,32,8,20
12306,2014/03/31,2008/03/22,41,13,1.082435401,17299,41,6,7
12307,2014/03/31,2007/10/29,20,23,0.592595347,31595,20,9,14
12308,2014/03/31,2012/08/01,211,6,0.68382629,27379,211,3,3
12309,2014/03/31,2013/03/28,25,22,0.800338563,23393,25,1,21
12310,2014/03/31,2007/11/15,11,16,0.7384007890000001,25350,11,7,9
12311,2014/03/31,2005/04/19,109,24,0.638201841,29330,109,9,15
12312,2014/03/31,2007/09/08,8,18,0.633807782,29529,8,0,18
12313,2014/03/31,2008/06/09,209,19,0.724462295,25832,209,9,10
12314,2014/03/31,2010/12/08,4,27,0.54469424,34357,4,5,22
12315,2014/03/31,2007/05/16,62,43,0.71011991,26353,62,24,19
12316,2014/03/31,2007/02/06,112,23,0.709971925,26358,112,10,13
12317,2014/03/31,2010/10/26,68,25,0.727464137,25723,68,4,21
12318,2014/03/31,2010/02/15,214,14,0.815311805,22947,214,10,4
12319,2014/03/31,2008/05/07,25,17,0.821131844,22777,25,9,8
12320,2014/03/31,2007/07/19,125,20,0.707659389,26429,125,9,11
12321,2014/03/31,2013/02/15,51,8,1.05,17812,51,2,6
12322,2014/03/31,2012/06/11,164,14,0.912929806,20486,164,9,5
12323,2014/03/31,2007/03/20,26,26,0.653165578,28633,26,9,17
12324,2014/03/31,2008/07/11,44,26,0.685454346,27281,44,7,19
12325,2014/03/31,2012/03/29,19,16,0.819404496,22821,19,7,9
12326,2014/03/31,2009/11/01,8,11,0.6675217760000001,28012,8,5,6
12327,2014/03/31,2012/01/22,49,9,0.695218442,26895,49,3,6
12328,2014/03/31,2005/09/09,74,24,0.656864922,28465,74,10,14
12329,2014/03/31,2007/09/25,30,13,0.735888049,25404,30,11,2
12330,2014/03/31,2012/05/09,15,18,0.6351202770000001,29432,15,11,7
12331,2014/03/31,2007/05/15,354,18,0.7916899620000001,23610,354,17,1
12332,2014/03/31,2011/04/18,9,5,0.735026347,25430,9,3,2
12333,2014/03/31,2005/03/21,12,40,0.7186446999999999,26009,12,14,26
12334,2014/03/31,2012/08/12,35,14,0.631262116,29609,35,2,12
12335,2014/03/31,2007/10/01,10,36,0.613655349,30454,10,18,18
12336,2014/03/31,2011/11/06,128,19,0.696559693,26829,128,13,6
12337,2014/03/31,2012/06/26,81,13,0.69902783,26734,81,10,3
12338,2014/03/31,2008/07/13,16,22,0.498926416,37454,16,13,9
12339,2014/03/31,2007/08/09,46,27,0.563514369,33161,46,17,10
12340,2014/03/31,2012/11/01,13,16,0.719271335,25979,13,9,7
12341,2014/03/31,2007/03/06,149,20,0.7192539840000001,25978,149,14,6
12342,2014/03/31,2013/02/01,318,17,0.7791383409999999,23977,318,8,9
12343,2014/03/31,2008/07/18,93,5,0.87062031,21457,93,1,4
12344,2014/03/31,2009/06/05,60,26,0.779594775,23962,60,18,8
12345,2014/03/31,2011/06/23,34,22,0.7302333759999999,25581,34,6,16
12346,2014/03/31,2012/05/03,269,13,0.7163419870000001,26077,269,8,5
12347,2014/03/31,2006/02/15,36,22,0.8112299140000001,23026,36,12,10
12348,2014/03/31,2009/07/01,4,15,0.868697209,21500,4,0,15
12349,2014/03/31,2005/03/15,35,18,0.893196078,20910,35,12,6
12350,2014/03/31,2008/07/04,30,17,0.660449851,28276,30,10,7
12351,2014/03/31,2010/06/22,129,22,0.747941436,24964,129,12,10
12352,2014/03/31,2004/12/03,318,6,0.85,21966,318,4,2
12353,2014/03/31,2005/03/03,101,15,0.72664137,25695,101,13,2
12354,2014/03/31,2012/09/10,1,48,0.7846932,23794,1,7,41
12355,2014/03/31,2012/04/11,44,4,0.7847593629999999,23791,44,2,2
12356,2014/03/31,2005/02/13,8,23,0.6870344070000001,27175,8,13,10
12357,2014/03/31,2012/04/12,14,12,0.745712174,25036,14,5,7
12358,2014/03/31,2009/01/10,104,18,1.135864566,16436,104,9,9
12359,2014/03/31,2012/04/14,37,14,0.6276751070000001,29739,37,10,4
12360,2014/03/31,2005/10/01,8,25,0.810051643,23043,8,11,14
12361,2014/03/31,2009/09/18,70,20,0.7357812990000001,25368,70,19,1
12362,2014/03/31,2006/05/05,249,14,0.7743301659999999,24103,249,8,6
12363,2014/03/31,2012/07/02,31,17,0.512580539,36411,31,5,12
12364,2014/03/31,2009/03/17,60,18,0.7309273909999999,25534,60,13,5
12365,2014/03/31,2013/02/07,3,13,0.609964049,30597,3,1,12
12366,2014/03/31,2011/01/14,17,39,0.649933134,28714,17,17,22
12367,2014/03/31,2011/03/02,23,14,0.682997475,27323,23,5,9
12368,2014/03/31,2012/09/11,330,5,0.725431504,25724,330,4,1
12369,2014/03/31,2010/09/19,317,14,0.644547496,28950,317,10,4
12370,2014/03/31,2010/12/22,56,36,0.648769038,28758,56,10,26
12371,2014/03/31,2005/07/02,217,16,0.689990384,27039,217,10,6
12372,2014/03/31,2009/04/18,46,10,0.696804871,26772,46,4,6
12373,2014/03/31,2011/03/23,76,19,0.902124099,20677,76,8,11
12374,2014/03/31,2012/04/05,3,25,0.684211723,27262,3,5,20
12375,2014/03/31,2011/10/27,61,12,0.655815344,28442,61,9,3
12376,2014/03/31,2010/06/21,27,33,0.7118125259999999,26201,27,13,20
12377,2014/03/31,2010/03/08,17,18,0.668384298,27895,17,10,8
12378,2014/03/31,2008/12/14,8,16,0.7626264979999999,24447,8,6,10
12379,2014/03/31,2012/09/21,15,10,0.7187731340000001,25936,15,6,4
12380,2014/03/31,2012/06/22,20,22,0.7676229309999999,24282,20,3,19
12381,2014/03/31,2011/12/18,24,20,0.756753289,24628,24,8,12
12382,2014/03/31,2010/06/02,33,12,1.325351301,14062,33,6,6
12383,2014/03/31,2011/07/01,105,14,0.706843662,26366,105,7,7
12384,2014/03/31,2013/01/23,13,14,0.719496545,25901,13,6,8
12385,2014/03/31,2013/01/26,23,28,0.7109847009999999,26211,23,4,24
12386,2014/03/31,2006/11/10,45,25,0.736029464,25319,45,11,14
12387,2014/03/31,2012/09/03,25,18,0.68781543,27090,25,7,11
12388,2014/03/31,2007/05/02,29,12,0.785804125,23709,29,0,12
12389,2014/03/31,2011/04/11,1,18,0.765215641,24346,1,6,12
12390,2014/03/31,2013/03/28,20,12,0.805869706,23117,20,2,10
12391,2014/03/31,2010/12/04,14,27,0.592049717,31458,14,17,10
12392,2014/03/31,2011/09/01,131,23,0.7664722829999999,24299,131,19,4
12393,2014/03/31,2012/07/06,40,24,0.860039254,21654,40,12,12
12394,2014/03/31,2012/03/14,75,13,0.655879763,28394,75,7,6
12395,2014/03/31,2012/08/22,71,27,0.8075619059999999,23059,71,11,16
12396,2014/03/31,2012/04/30,691,3,0.704534448,26431,691,3,0
12397,2014/03/31,2011/05/19,82,15,0.7702966,24174,82,8,7
12398,2014/03/31,2007/04/08,112,21,0.855431407,21766,112,7,14
12399,2014/03/31,2012/08/17,1,16,0.683768041,27229,1,3,13
12400,2014/03/31,2009/03/04,29,13,0.656764654,28337,29,4,9
12401,2014/03/31,2008/12/12,57,13,0.753859336,24683,57,7,6
12402,2014/03/31,2010/09/14,320,7,0.8882374559999999,20947,320,5,2
12403,2014/03/31,2011/02/25,58,9,0.9001751579999999,20667,58,1,8
12404,2014/03/31,2008/08/29,12,33,0.712176493,26120,12,15,18
12405,2014/03/31,2008/01/15,104,7,1.422991891,13072,104,0,7
12406,2014/03/31,2007/11/28,152,18,0.761280183,24434,152,12,6
12407,2014/03/31,2007/03/16,342,20,0.596693936,31170,342,17,3
12408,2014/03/31,2012/11/04,4,15,0.814225112,22842,4,6,9
12409,2014/03/31,2012/08/02,53,22,0.579842557,32075,53,10,12
12410,2014/03/31,2010/06/05,11,34,0.8375213909999999,22206,11,22,12
12411,2014/03/31,2005/03/27,116,20,0.678994048,27387,116,13,7
12412,2014/03/31,2009/04/28,9,27,0.6333730710000001,29359,9,4,23
12413,2014/03/31,2007/08/01,17,16,0.5343712279999999,34798,17,10,6
12414,2014/03/31,2005/10/10,11,24,0.705472929,26357,11,9,15
12415,2014/03/31,2011/08/26,286,2,0.76,24464,286,1,1
12416,2014/03/31,2012/03/09,203,2,0.76,24464,203,0,2
12417,2014/03/31,2012/12/21,70,2,0.76,24464,70,0,2
12418,2014/03/31,2008/09/17,28,21,0.864644003,21503,28,13,8
12419,2014/03/31,2010/01/13,134,21,0.6466554210000001,28751,134,15,6
12420,2014/03/31,2007/10/16,70,12,0.68551049,27121,70,9,3
12421,2014/03/31,2012/02/08,107,16,0.7799618220000001,23836,107,3,13
12422,2014/03/31,2010/05/28,79,11,0.696427421,26695,79,7,4
12423,2014/03/31,2007/12/23,185,28,0.722638495,25723,185,17,11
12424,2014/03/31,2009/04/16,85,17,0.7560016270000001,24585,85,12,5
12425,2014/03/31,2009/09/09,9,25,0.776488135,23936,9,16,9
12426,2014/03/31,2011/11/12,65,15,0.7720722179999999,24066,65,3,12
12427,2014/03/31,2011/05/23,13,18,0.815688823,22778,13,3,15
12428,2014/03/31,2012/04/16,11,28,0.916461303,20273,11,16,12
12429,2014/03/31,2009/09/16,3,19,0.7545442729999999,24620,3,4,15
12430,2014/03/31,2011/06/02,20,23,0.812619423,22860,20,16,7
12431,2014/03/31,2009/06/04,22,21,0.694157543,26761,22,12,9
12432,2014/03/31,2005/12/31,23,21,0.6286497,29549,23,11,10
12433,2014/03/31,2011/03/23,68,16,0.75122113,24723,68,10,6
12434,2014/03/31,2010/10/17,36,16,0.770481663,24104,36,7,9
12435,2014/03/31,2011/03/02,81,18,0.806438683,23028,81,8,10
12436,2014/03/31,2010/03/29,20,21,0.709499885,26174,20,8,13
12437,2014/03/31,2012/08/20,1,14,0.6865795309999999,27046,1,6,8
12438,2014/03/31,2007/05/22,101,23,0.8695012879999999,21355,101,15,8
12439,2014/03/31,2011/12/03,45,30,0.7542846120000001,24616,45,25,5
12440,2014/03/31,2012/05/28,187,16,0.63728265,29135,187,14,2
12441,2014/03/31,2012/02/20,18,16,0.7111149840000001,26108,18,4,12
12442,2014/03/31,2012/06/04,56,17,0.663094728,27996,56,3,14
12443,2014/03/31,2012/11/17,40,21,0.7837223440000001,23684,40,2,19
12444,2014/03/31,2009/08/01,164,16,0.750431055,24730,164,13,3
12445,2014/03/31,2012/11/26,343,6,0.73924033,25103,343,4,2
12446,2014/03/31,2008/11/07,1,20,0.749451109,24759,1,8,12
12447,2014/03/31,2010/03/06,35,30,0.585565549,31686,35,11,19
12448,2014/03/31,2013/01/10,16,11,0.726363636,25542,16,4,7
12449,2014/03/31,2009/02/25,34,23,0.7101645999999999,26124,34,14,9
12450,2014/03/31,2007/09/30,62,19,0.7235954440000001,25638,62,8,11
12451,2014/03/31,2006/05/25,4,12,0.837535892,22150,4,6,6
12452,2014/03/31,2011/03/03,36,21,0.6343902610000001,29242,36,13,8
12453,2014/03/31,2005/01/26,5,18,0.668951677,27730,5,11,7
12454,2014/03/31,2008/11/26,20,35,0.443428571,41825,20,15,20
12455,2014/03/31,2007/11/18,32,21,0.659730345,28110,32,11,10
12456,2014/03/31,2012/03/20,39,18,0.680177897,27263,39,9,9
12457,2014/03/31,2011/01/14,7,21,0.729940947,25401,7,14,7
12458,2014/03/31,2012/02/15,99,25,0.7621174,24327,99,18,7
12459,2014/03/31,2011/10/28,20,22,0.6924022409999999,26775,20,5,17
12460,2014/03/31,2011/09/15,48,11,0.76563788,24213,48,2,9
12461,2014/03/31,2012/11/29,20,23,0.8135843759999999,22785,20,6,17
12462,2014/03/31,2013/03/01,125,10,1.402013311,13222,125,0,10
12463,2014/03/31,2008/01/29,61,14,0.852911567,21734,61,10,4
12464,2014/03/31,2010/11/07,74,14,0.832884615,22256,74,7,7
12465,2014/03/31,2011/12/13,77,13,0.888172017,20870,77,7,6
12466,2014/03/31,2007/07/09,1,17,0.70059684,26456,1,9,8
12467,2014/03/31,2011/06/07,129,15,0.66224247,27987,129,6,9
12468,2014/03/31,2009/09/12,153,14,0.6716484229999999,27590,153,12,2
12469,2014/03/31,2009/12/02,165,42,0.679761905,27258,165,35,7
12470,2014/03/31,2010/10/07,3,28,0.5711503960000001,32441,3,10,18
12471,2014/03/31,2012/02/13,53,18,0.829391647,22339,53,14,4
12472,2014/03/31,2009/02/19,85,14,0.8532703909999999,21713,85,8,6
12473,2014/03/31,2011/04/11,48,11,0.7501449570000001,24697,48,4,7
12474,2014/03/31,2009/09/08,114,23,0.669977217,27652,114,16,7
12475,2014/03/31,2013/03/31,39,17,0.686772196,26975,39,0,17
12476,2014/03/31,2010/03/09,66,18,0.7351623140000001,25198,66,8,10
12477,2014/03/31,2006/11/14,14,14,0.684520158,27061,14,10,4
12478,2014/03/31,2007/08/22,39,12,0.826830782,22403,39,4,8
12479,2014/03/31,2012/07/08,135,17,0.711596865,26026,135,6,11
12480,2014/03/31,2012/06/19,27,13,0.747000524,24791,27,9,4
12481,2014/03/31,2010/05/24,11,31,0.69865024,26501,11,15,16
12482,2014/03/31,2011/09/09,59,18,0.527074969,35121,59,12,6
12483,2014/03/31,2007/06/05,29,17,0.664963359,27838,29,9,8
12484,2014/03/31,2008/09/11,95,20,0.7679927809999999,24103,95,12,8
12485,2014/03/31,2009/02/18,144,22,0.831183655,22270,144,14,8
12486,2014/03/31,2009/12/18,89,16,0.7311981040000001,25315,89,11,5
12487,2014/03/31,2009/07/23,44,11,0.547778698,33791,44,5,6
12488,2014/03/31,2011/01/13,304,16,0.703977865,26293,304,12,4
12489,2014/03/31,2011/04/21,18,24,0.7179057409999999,25780,18,9,15
12490,2014/03/31,2011/05/01,18,26,0.764231087,24216,18,12,14
12491,2014/03/31,2004/11/13,26,18,0.669275976,27651,26,6,12
12492,2014/03/31,2012/11/16,76,17,0.7909437109999999,23397,76,3,14
12493,2014/03/31,2012/04/07,46,19,0.72746511,25437,46,7,12
12494,2014/03/31,2011/12/30,95,24,0.75772368,24421,95,12,12
12495,2014/03/31,2008/10/17,65,15,0.734036737,25206,65,7,8
12496,2014/03/31,2010/04/27,22,33,0.773032215,23933,22,20,13
12497,2014/03/31,2012/11/29,39,8,0.72125,25648,39,3,5
12498,2014/03/31,2012/09/26,48,11,0.8078880009999999,22893,48,5,6
12499,2014/03/31,2010/01/27,75,17,0.701016564,26383,75,4,13
12500,2014/03/31,2009/12/29,109,23,0.567353212,32598,109,5,18
12501,2014/03/31,2007/05/09,108,14,0.7739902059999999,23891,108,9,5
12502,2014/03/31,2013/01/15,52,15,0.761845,24271,52,4,11
12503,2014/03/31,2012/05/24,152,13,0.593647542,31147,152,9,4
12504,2014/03/31,2011/12/23,49,13,0.645486315,28644,49,9,4
12505,2014/03/31,2011/12/02,64,20,0.6239325729999999,29632,64,16,4
12506,2014/03/31,2011/09/21,30,16,0.627677474,29455,30,8,8
12507,2014/03/31,2006/06/13,78,19,0.630560027,29320,78,8,11
12508,2014/03/31,2010/06/17,18,24,0.57990872,31880,18,12,12
12509,2014/03/31,2008/11/06,32,27,0.660640009,27984,32,12,15
12510,2014/03/31,2012/03/28,95,15,0.628002446,29436,95,3,12
12511,2014/03/31,2008/01/16,208,19,0.612270469,30192,208,11,8
12512,2014/03/31,2012/12/22,130,28,0.7882567909999999,23451,130,8,20
12513,2014/03/31,2008/03/13,72,19,0.806066196,22932,72,14,5
12514,2014/03/31,2006/01/13,7,10,0.609062572,30349,7,3,7
12515,2014/03/31,2010/11/25,5,25,0.598583134,30878,5,9,16
12516,2014/03/31,2012/06/29,354,27,0.498156434,37102,354,24,3
12517,2014/03/31,2012/01/22,15,21,0.63997299,28878,15,11,10
12518,2014/03/31,2012/04/11,300,15,0.7583904459999999,24367,300,11,4
12519,2014/03/31,2011/09/12,36,23,0.730910493,25283,36,12,11
12520,2014/03/31,2010/05/10,211,10,1.412530959,13082,211,7,3
12521,2014/03/31,2006/03/20,23,24,0.6824530809999999,27068,23,11,13
12522,2014/03/31,2009/09/29,111,22,0.76471891,24156,111,10,12
12523,2014/03/31,2012/03/20,688,4,0.610654545,30250,688,4,0
12524,2014/03/31,2005/10/30,9,29,0.813161648,22716,9,15,14
12525,2014/03/31,2008/03/12,6,23,0.69702049,26501,6,6,17
12526,2014/03/31,2012/08/01,44,21,0.716781792,25769,44,10,11
12527,2014/03/31,2010/03/04,26,16,1.051627947,17562,26,6,10
12528,2014/03/31,2011/06/10,67,19,0.645172751,28625,67,13,6
12529,2014/03/31,2012/09/18,64,15,0.802877576,23002,64,8,7
12530,2014/03/31,2012/04/06,5,14,0.962508469,19187,5,4,10
12531,2014/03/31,2008/03/03,138,18,0.8337632079999999,22146,138,8,10
12532,2014/03/31,2007/03/15,112,21,0.7945965490000001,23237,112,14,7
12533,2014/03/31,2008/04/19,23,19,0.540993026,34128,23,4,15
12534,2014/03/31,2006/11/30,13,16,0.642070944,28755,13,9,7
12535,2014/03/31,2009/03/25,13,30,0.7710090209999999,23944,13,17,13
12536,2014/03/31,2011/05/27,69,19,0.738056611,25013,69,12,7
12537,2014/03/31,2007/07/13,10,18,0.691793344,26682,10,8,10
12538,2014/03/31,2010/03/19,4,25,0.604508892,30533,4,9,16
12539,2014/03/31,2007/09/02,64,9,0.692103131,26665,64,2,7
12540,2014/03/31,2011/04/01,55,35,0.742056541,24867,55,30,5
12541,2014/03/31,2012/11/26,49,13,0.745371627,24756,49,2,11
12542,2014/03/31,2011/03/14,17,25,0.646155489,28555,17,13,12
12543,2014/03/31,2011/09/11,9,22,0.844486405,21846,9,5,17
12544,2014/03/31,2013/01/08,101,11,1.133875469,16269,101,3,8
12545,2014/03/31,2007/08/22,77,16,0.587282858,31408,77,4,12
12546,2014/03/31,2006/11/10,70,18,0.633483204,29114,70,4,14
12547,2014/03/31,2007/11/01,33,20,0.6335400210000001,29110,33,10,10
12548,2014/03/31,2013/03/01,192,4,0.71279983,25873,192,2,2
12549,2014/03/31,2007/01/03,13,20,0.808515125,22810,13,13,7
12550,2014/03/31,2005/04/23,123,26,0.50963661,36187,123,13,13
12551,2014/03/31,2011/12/29,175,8,0.66267886,27829,175,4,4
12552,2014/03/31,2012/10/29,35,15,0.648607203,28432,35,3,12
12553,2014/03/31,2013/02/08,16,25,0.8294732340000001,22230,16,3,22
12554,2014/03/31,2008/04/01,49,6,1.470964499,12535,49,3,3
12555,2014/03/31,2012/10/25,177,20,0.909961504,20262,177,8,12
12556,2014/03/31,2011/02/25,321,19,0.754507878,24435,321,13,6
12557,2014/03/31,2010/12/05,67,28,0.6360561,28984,67,10,18
12558,2014/03/31,2010/11/19,3,20,0.7014207440000001,26282,3,2,18
12559,2014/03/31,2012/04/24,58,12,0.7986084390000001,23082,58,4,8
12560,2014/03/31,2010/03/19,3,9,0.6083028079999999,30303,3,5,4
12561,2014/03/31,2010/02/17,120,24,0.853604705,21594,120,20,4
12562,2014/03/31,2012/07/18,25,19,0.8991005320000001,20501,25,6,13
12563,2014/03/31,2007/06/10,11,13,0.8302225120000001,22201,11,4,9
12564,2014/03/31,2009/09/30,122,21,0.70411331,26176,122,11,10
12565,2014/03/31,2012/04/04,22,27,0.7691656929999999,23960,22,7,20
12566,2014/03/31,2008/12/15,68,16,0.781450621,23583,68,12,4
12567,2014/03/31,2013/01/31,6,14,0.671457255,27442,6,5,9
12568,2014/03/31,2012/04/10,30,25,0.771919145,23870,30,9,16
12569,2014/03/31,2011/06/10,11,21,0.655407463,28113,11,3,18
12570,2014/03/31,2008/09/19,164,13,1.246695988,14779,164,9,4
12571,2014/03/31,2006/04/16,4,18,0.705369094,26118,4,7,11
12572,2014/03/31,2008/10/08,24,15,0.7654236090000001,24067,24,7,8
12573,2014/03/31,2006/11/07,298,22,0.821082876,22431,298,20,2
12574,2014/03/31,2010/10/08,96,17,0.6220664029999999,29607,96,11,6
12575,2014/03/31,2007/09/03,44,17,0.639446913,28802,44,9,8
12576,2014/03/31,2006/09/14,33,19,0.884893811,20812,33,12,7
12577,2014/03/31,2012/09/29,21,22,0.738055389,24951,21,7,15
12578,2014/03/31,2008/08/17,77,13,0.634678086,29014,77,6,7
12579,2014/03/31,2008/09/11,6,15,0.848358979,21706,6,11,4
12580,2014/03/31,2011/02/15,45,29,0.677502484,27179,45,12,17
12581,2014/03/31,2011/06/13,12,26,0.7786923790000001,23646,12,7,19
12582,2014/03/31,2011/12/10,6,22,0.7027694659999999,26200,6,10,12
12583,2014/03/31,2008/04/30,5,16,0.729458335,25237,5,8,8
12584,2014/03/31,2005/04/13,213,12,0.844257739,21805,213,9,3
12585,2014/03/31,2006/01/04,85,8,0.59,31200,85,3,5
12586,2014/03/31,2010/03/22,110,18,0.645913892,28499,110,12,6
12587,2014/03/31,2009/11/06,93,23,0.767248666,23992,93,14,9
12588,2014/03/31,2006/10/24,108,19,0.7366015690000001,24988,108,0,19
12589,2014/03/31,2012/11/02,119,17,0.654337825,28127,119,7,10
12590,2014/03/31,2013/02/16,14,19,0.646625325,28462,14,5,14
12591,2014/03/31,2012/09/27,3,33,0.715025061,25737,3,8,25
12592,2014/03/31,2009/12/20,55,14,0.790185503,23288,55,12,2
12593,2014/03/31,2007/03/07,263,11,0.782843955,23506,263,7,4
12594,2014/03/31,2007/11/27,240,3,0.806665498,22810,240,2,1
12595,2014/03/31,2005/06/07,30,37,0.598547217,30741,30,22,15
12596,2014/03/31,2013/01/25,50,10,0.8164283809999999,22536,50,2,8
12597,2014/03/31,2008/03/11,26,17,0.998238837,18431,26,7,10
12598,2014/03/31,2012/07/10,24,12,0.704359662,26119,24,7,5
12599,2014/03/31,2010/09/23,40,19,0.768408388,23938,40,8,11
12600,2014/03/31,2010/09/06,7,11,0.6669202320000001,27580,7,1,10
12601,2014/03/31,2011/11/24,231,12,0.5476630339999999,33582,231,11,1
12602,2014/03/31,2012/04/11,112,14,0.69220679,26568,112,8,6
12603,2014/03/31,2009/08/02,8,12,0.66,27864,8,2,10
12604,2014/03/31,2004/12/13,3,21,0.558121965,32944,3,12,9
12605,2014/03/31,2007/03/31,2,16,0.744331808,24701,2,3,13
12606,2014/03/31,2009/04/22,7,23,0.7453709559999999,24666,7,13,10
12607,2014/03/31,2012/06/20,103,23,0.820507007,22406,103,11,12
12608,2014/03/31,2007/04/22,124,19,0.625668244,29383,124,7,12
12609,2014/03/31,2011/10/27,32,17,0.66836242,27504,32,7,10
12610,2014/03/31,2011/10/10,99,7,0.748197322,24569,99,5,2
12611,2014/03/31,2013/01/04,22,23,0.74700829,24608,22,7,16
12612,2014/03/31,2011/03/23,3,18,0.905358321,20303,3,10,8
12613,2014/03/31,2006/07/28,48,17,0.622347205,29533,48,6,11
12614,2014/03/31,2008/06/15,120,10,1.116766314,16458,120,4,6
12615,2014/03/31,2009/06/28,123,16,0.859488403,21384,123,9,7
12616,2014/03/31,2006/06/24,5,19,0.616913265,29792,5,4,15
12617,2014/03/31,2012/01/30,40,3,0.806657596,22783,40,2,1
12618,2014/03/31,2011/08/08,109,14,0.699138672,26285,109,10,4
12619,2014/03/31,2012/08/28,99,9,0.886171875,20736,99,4,5
12620,2014/03/31,2005/07/27,158,17,0.905582771,20291,158,15,2
12621,2014/03/31,2006/10/23,30,16,0.851785648,21572,30,5,11
12622,2014/03/31,2008/05/09,216,16,0.64967718,28282,216,14,2
12623,2014/03/31,2012/06/14,99,21,0.597767872,30733,99,14,7
12624,2014/03/31,2010/01/16,45,17,0.671090046,27375,45,5,12
12625,2014/03/31,2007/03/10,23,19,0.76074706,24148,23,12,7
12626,2014/03/31,2011/04/03,285,22,0.6805520359999999,26991,285,19,3
12627,2014/03/31,2011/03/20,13,28,0.6673293370000001,27525,13,11,17
12628,2014/03/31,2011/01/24,22,9,0.8771835290000001,20934,22,0,9
12629,2014/03/31,2009/11/28,25,23,0.606793232,30261,25,9,14
12630,2014/03/31,2012/10/13,11,13,0.77646228,23648,11,9,4
12631,2014/03/31,2011/08/02,58,11,0.78099362,23510,58,3,8
12632,2014/03/31,2011/08/16,124,24,0.8011930009999999,22917,124,14,10
12633,2014/03/31,2007/06/15,177,16,0.956874805,19186,177,7,9
12634,2014/03/31,2004/12/30,176,32,0.627399433,29259,176,17,15
12635,2014/03/31,2007/05/10,16,18,0.661374527,27755,16,5,13
12636,2014/03/31,2004/12/09,15,10,1.431477813,12823,15,6,4
12637,2014/03/31,2012/10/17,34,15,0.7267285609999999,25258,34,4,11
12638,2014/03/31,2012/12/22,31,17,0.651105357,28190,31,5,12
12639,2014/03/31,2011/01/14,29,20,0.828294972,22158,29,3,17
12640,2014/03/31,2012/04/17,40,3,0.806666667,22752,40,2,1
12641,2014/03/31,2012/03/15,10,10,0.548692039,33449,10,6,4
12642,2014/03/31,2012/06/06,43,8,0.576880855,31810,43,6,2
12643,2014/03/31,2011/03/09,84,26,0.5913661410000001,31029,84,15,11
12644,2014/03/31,2010/06/01,557,2,0.75,24464,557,2,0
12645,2014/03/31,2010/07/29,182,2,0.75,24464,182,1,1
12646,2014/03/31,2010/05/04,331,2,0.75,24464,331,0,2
12647,2014/03/31,2013/02/14,245,2,0.75,24464,245,0,2
12648,2014/03/31,2011/06/14,405,2,0.75,24464,405,2,0
12649,2014/03/31,2011/11/14,444,2,0.75,24464,444,2,0
12650,2014/03/31,2011/01/06,532,2,0.75,24464,532,2,0
12651,2014/03/31,2011/10/27,672,2,0.75,24464,672,2,0
12652,2014/03/31,2011/12/21,653,2,0.75,24464,653,2,0
12653,2014/03/31,2009/11/14,592,2,0.75,24464,592,2,0
12654,2014/03/31,2008/07/29,583,2,0.75,24464,583,2,0
12655,2014/03/31,2012/06/09,653,2,0.75,24464,653,2,0
12656,2014/03/31,2012/10/27,270,2,0.75,24464,270,0,2
12657,2014/03/31,2008/07/11,40,27,0.918856113,19967,40,15,12
12658,2014/03/31,2006/11/01,33,17,0.702449652,26118,33,12,5
12659,2014/03/31,2011/01/16,430,3,0.861867807,21287,430,3,0
12660,2014/03/31,2011/09/28,12,19,0.889616877,20620,12,7,12
12661,2014/03/31,2008/05/18,119,10,0.699836328,26211,119,6,4
12662,2014/03/31,2009/07/29,15,11,0.820315323,22358,15,4,7
12663,2014/03/31,2012/07/28,48,23,0.741950322,24719,48,14,9
12664,2014/03/31,2006/08/23,41,19,0.680971743,26931,41,4,15
12665,2014/03/31,2010/11/15,18,11,1.345474688,13630,18,5,6
12666,2014/03/31,2013/02/03,36,16,0.55318552,33150,36,4,12
12667,2014/03/31,2005/11/03,69,14,0.8139990229999999,22528,69,10,4
12668,2014/03/31,2011/04/13,349,11,0.6293255529999999,29135,349,10,1
12669,2014/03/31,2007/02/10,23,23,0.701143917,26147,23,3,20
12670,2014/03/31,2012/02/19,119,19,0.783440171,23400,119,12,7
12671,2014/03/31,2012/05/14,27,21,0.648356382,28273,27,10,11
12672,2014/03/31,2011/10/20,430,10,1.285191418,14262,430,10,0
12673,2014/03/31,2006/11/30,138,18,0.903664826,20282,138,11,7
12674,2014/03/31,2012/09/21,88,18,0.740493333,24750,88,12,6
12675,2014/03/31,2012/05/18,7,16,0.575945504,31819,7,6,10
12676,2014/03/31,2009/06/21,149,19,0.542430736,33784,149,10,9
12677,2014/03/31,2006/09/01,137,16,0.620396127,29536,137,8,8
12678,2014/03/31,2010/10/22,78,10,1.216350418,15062,78,4,6
12679,2014/03/31,2013/02/15,7,22,0.780282818,23478,7,2,20
12680,2014/03/31,2009/11/11,114,16,0.8735797409999999,20968,114,13,3
12681,2014/03/31,2009/11/28,427,18,0.8941753729999999,20482,427,18,0
12682,2014/03/31,2009/04/26,63,12,1.438988685,12726,63,0,12
12683,2014/03/31,2008/02/17,501,8,1.5,12208,501,8,0
12684,2014/03/31,2012/06/09,213,23,0.637314399,28731,213,18,5
12685,2014/03/31,2009/11/18,76,13,0.799717393,22894,76,8,5
12686,2014/03/31,2007/12/18,20,9,0.5822222220000001,31446,20,1,8
12687,2014/03/31,2007/03/26,20,24,0.553998427,33048,20,14,10
12688,2014/03/31,2006/01/27,25,15,0.763324578,23985,25,6,9
12689,2014/03/31,2012/06/14,120,13,0.953202458,19204,120,6,7
12690,2014/03/31,2011/04/04,1,14,0.7952037540000001,23018,1,2,12
12691,2014/03/31,2008/05/10,73,8,0.787479563,23242,73,4,4
12692,2014/03/31,2005/09/09,67,29,0.7060330990000001,25922,67,20,9
12693,2014/03/31,2010/02/11,4,12,0.561359509,32600,4,5,7
12694,2014/03/31,2011/04/24,166,18,0.663267488,27590,166,6,12
12695,2014/03/31,2005/10/20,142,12,0.76846548,23812,142,4,8
12696,2014/03/31,2012/12/14,12,13,0.606153846,30186,12,2,11
12697,2014/03/31,2010/02/23,11,17,0.798236115,22921,11,7,10
12698,2014/03/31,2012/12/19,2,26,0.567351774,32248,2,7,19
12699,2014/03/31,2009/03/16,8,5,0.74633434,24514,8,3,2
12700,2014/03/31,2012/02/25,282,26,0.677059477,27019,282,16,10
12701,2014/03/31,2007/12/01,116,11,0.7208524140000001,25375,116,7,4
12702,2014/03/31,2007/03/22,27,17,0.641330949,28521,27,8,9
12703,2014/03/31,2012/09/07,153,19,0.727138939,25155,153,11,8
12704,2014/03/31,2012/07/18,10,36,0.7795204809999999,23461,10,16,20
12705,2014/03/31,2009/12/07,158,5,0.697890318,26203,158,0,5
12706,2014/03/31,2010/11/24,123,27,0.643516101,28415,123,20,7
12707,2014/03/31,2011/06/14,11,19,0.654292206,27946,11,7,12
12708,2014/03/31,2006/03/05,101,14,0.908672399,20119,101,7,7
12709,2014/03/31,2012/11/29,4,26,0.665306642,27475,4,6,20
12710,2014/03/31,2010/11/15,9,19,0.6846569029999999,26698,9,13,6
12711,2014/03/31,2012/07/02,46,5,0.7773936709999999,23512,46,4,1
12712,2014/03/31,2008/09/08,1,15,0.736093995,24831,1,2,13
12713,2014/03/31,2009/03/09,36,25,0.78199846,23373,36,17,8
12714,2014/03/31,2009/11/06,42,20,0.658864095,27740,42,9,11
12715,2014/03/31,2013/03/26,59,15,0.622200926,29374,59,0,15
12716,2014/03/31,2010/07/13,107,16,0.7943992870000001,23006,107,10,6
12717,2014/03/31,2009/09/01,5,24,0.824148365,22175,5,17,7
12718,2014/03/31,2012/10/22,37,25,0.675487341,27055,37,7,18
12719,2014/03/31,2012/10/30,22,17,0.783092943,23337,22,4,13
12720,2014/03/31,2007/10/23,103,18,0.656728246,27823,103,13,5
12721,2014/03/31,2005/09/18,319,18,0.767426915,23808,319,17,1
12722,2014/03/31,2010/10/01,9,36,0.857380103,21310,9,19,17
12723,2014/03/31,2011/04/02,121,14,0.721129707,25334,121,6,8
12724,2014/03/31,2009/04/02,2,24,0.6961272009999999,26242,2,0,24
12725,2014/03/31,2008/08/01,72,14,0.6633798160000001,27537,72,11,3
12726,2014/03/31,2011/08/20,171,15,0.876172295,20848,171,11,4
12727,2014/03/31,2010/01/17,46,12,0.63724802,28663,46,6,6
12728,2014/03/31,2006/12/05,4,11,0.818471295,22313,4,4,7
12729,2014/03/31,2008/03/17,123,22,0.7165611140000001,25485,123,12,10
12730,2014/03/31,2010/12/10,131,17,0.772134038,23650,131,12,5
12731,2014/03/31,2011/06/05,88,20,0.849362761,21499,88,13,7
12732,2014/03/31,2012/09/05,177,4,0.904309986,20188,177,2,2
12733,2014/03/31,2013/03/23,2,15,0.7599333859999999,24019,2,2,13
12734,2014/03/31,2011/01/14,3,19,0.7213286440000001,25304,3,7,12
12735,2014/03/31,2007/08/29,39,12,0.94206359,19374,39,0,12
12736,2014/03/31,2013/02/28,17,9,0.602086041,30311,17,2,7
12737,2014/03/31,2012/05/14,566,7,0.807142857,22610,566,7,0
12738,2014/03/31,2012/01/01,46,25,0.6088564089999999,29967,46,10,15
12739,2014/03/31,2005/10/16,27,25,0.528595724,34516,27,19,6
12740,2014/03/31,2009/03/11,217,12,1.186863166,15369,217,6,6
12741,2014/03/31,2007/08/25,16,15,0.62783661,29047,16,8,7
12742,2014/03/31,2006/02/26,83,19,0.796219001,22904,83,11,8
12743,2014/03/31,2012/03/05,92,21,0.624478236,29199,92,13,8
12744,2014/03/31,2008/04/03,96,8,1.365806862,13348,96,2,6
12745,2014/03/31,2004/12/18,68,19,0.638106405,28570,68,6,13
12746,2014/03/31,2009/09/27,29,19,0.935525505,19486,29,11,8
12747,2014/03/31,2005/05/21,5,16,0.8640950890000001,21096,5,6,10
12748,2014/03/31,2010/07/16,95,23,0.86672531,21031,95,12,11
12749,2014/03/31,2010/02/20,3,14,0.698146545,26108,3,6,8
12750,2014/03/31,2009/09/18,5,14,1.130807793,16118,5,7,7
12751,2014/03/31,2013/02/27,23,13,0.851073547,21415,23,1,12
12752,2014/03/31,2006/12/04,90,2,0.745,24464,90,0,2
12753,2014/03/31,2008/07/23,14,21,0.74204316,24560,14,12,9
12754,2014/03/31,2012/03/24,8,30,0.601848354,30281,8,10,20
12755,2014/03/31,2007/08/08,30,15,0.819842548,22229,30,5,10
12756,2014/03/31,2010/01/16,43,12,0.652543684,27928,43,3,9
12757,2014/03/31,2011/06/15,9,15,0.58016586,31412,9,3,12
12758,2014/03/31,2011/09/06,5,19,0.899510365,20260,5,10,9
12759,2014/03/31,2012/04/20,285,16,0.59519548,30617,285,15,1
12760,2014/03/31,2005/10/10,2,23,0.7024752320000001,25941,2,14,9
12761,2014/03/31,2011/01/27,2,22,0.7558953829999999,24107,2,7,15
12762,2014/03/31,2007/11/07,77,13,0.7485359840000001,24344,77,8,5
12763,2014/03/31,2008/01/25,82,29,0.80610096,22603,82,23,6
12764,2014/03/31,2012/03/27,51,23,0.7574650759999999,24052,51,11,12
12765,2014/03/31,2008/01/21,60,28,0.734406014,24807,60,12,16
12766,2014/03/31,2012/09/13,26,17,0.8367142790000001,21773,26,8,9
12767,2014/03/31,2008/05/30,100,20,0.848786693,21462,100,11,9
12768,2014/03/31,2006/11/13,59,24,0.8159175809999999,22325,59,13,11
12769,2014/03/31,2005/08/25,36,21,0.689975758,26400,36,13,8
12770,2014/03/31,2007/08/18,12,18,0.720413305,25284,12,4,14
12771,2014/03/31,2011/08/08,242,6,0.852910189,21356,242,3,3
12772,2014/03/31,2010/08/25,6,25,0.662676005,27485,6,9,16
12773,2014/03/31,2012/11/06,18,17,0.583729607,31199,18,6,11
12774,2014/03/31,2010/12/24,273,4,0.94635192,19243,273,1,3
12775,2014/03/31,2004/12/24,381,3,0.992274412,18352,381,3,0
12776,2014/03/31,2009/07/29,4,13,0.747783573,24350,4,5,8
12777,2014/03/31,2008/10/29,7,27,0.64563648,28202,7,17,10
12778,2014/03/31,2011/04/20,336,17,0.6848875259999999,26584,336,15,2
12779,2014/03/31,2009/06/20,109,36,0.731003814,24905,109,14,22
12780,2014/03/31,2010/07/30,162,3,0.8,22752,162,2,1
12781,2014/03/31,2006/07/28,2,25,0.548601314,33174,2,9,16
12782,2014/03/31,2012/07/15,168,13,0.744971141,24429,168,10,3
12783,2014/03/31,2012/02/24,20,22,0.7865179809999999,23136,20,8,14
12784,2014/03/31,2008/02/08,6,26,0.774792642,23486,6,18,8
12785,2014/03/31,2006/07/04,125,31,0.609437615,29855,125,22,9
12786,2014/03/31,2011/11/26,13,20,0.515051669,35321,13,10,10
12787,2014/03/31,2011/08/15,30,24,0.568392963,32003,30,14,10
12788,2014/03/31,2007/08/30,6,21,0.7736265040000001,23513,6,11,10
12789,2014/03/31,2011/09/01,161,29,0.580873411,31314,161,16,13
12790,2014/03/31,2007/06/17,6,17,0.7530607770000001,24154,6,10,7
12791,2014/03/31,2004/11/22,270,17,0.7618245790000001,23874,270,16,1
12792,2014/03/31,2008/12/13,17,27,0.697745339,26066,17,15,12
12793,2014/03/31,2009/09/06,15,19,0.6618863739999999,27476,15,11,8
12794,2014/03/31,2009/04/29,49,18,0.8025879340000001,22659,49,7,11
12795,2014/03/31,2005/12/06,10,15,0.66200466,27466,10,4,11
12796,2014/03/31,2012/07/25,77,20,0.7389409090000001,24606,77,1,19
12797,2014/03/31,2005/08/20,24,16,0.7148956,25431,24,11,5
12798,2014/03/31,2010/01/30,298,8,1.346205109,13505,298,0,8
12799,2014/03/31,2012/03/20,96,20,0.643442223,28255,96,14,6
12800,2014/03/31,2007/04/19,83,18,0.627798156,28953,83,14,4
12801,2014/03/31,2010/04/11,70,30,0.688939848,26383,70,20,10
12802,2014/03/31,2011/10/22,56,18,0.600347481,30275,56,10,8
12803,2014/03/31,2012/12/01,76,3,0.7966625759999999,22814,76,1,2
12804,2014/03/31,2012/11/10,19,17,0.789860495,23010,19,2,15
12805,2014/03/31,2009/09/26,3,25,0.65538345,27722,3,11,14
12806,2014/03/31,2010/02/02,176,6,1.485,12234,176,5,1
12807,2014/03/31,2008/10/30,402,12,0.741580945,24498,402,12,0
12808,2014/03/31,2013/02/28,39,25,0.639059631,28425,39,1,24
12809,2014/03/31,2009/11/25,19,21,0.823521625,22058,19,18,3
12810,2014/03/31,2007/12/22,50,16,0.642160107,28281,50,8,8
12811,2014/03/31,2011/06/18,12,31,0.602208847,30156,12,14,17
12812,2014/03/31,2011/01/26,109,26,0.8870258390000001,20473,109,20,6
12813,2014/03/31,2010/07/03,11,19,0.57613769,31520,11,13,6
12814,2014/03/31,2008/11/15,78,14,0.742142303,24469,78,9,5
12815,2014/03/31,2006/08/15,17,11,0.790344287,22975,17,4,7
12816,2014/03/31,2008/12/10,13,22,0.706451387,25703,13,13,9
12817,2014/03/31,2005/11/02,80,14,0.850639464,21346,80,6,8
12818,2014/03/31,2012/10/25,75,15,0.6153333329999999,29505,75,6,9
12819,2014/03/31,2011/08/07,35,25,0.716063343,25354,35,18,7
12820,2014/03/31,2010/03/10,31,19,0.65727885,27617,31,5,14
12821,2014/03/31,2010/08/20,85,22,0.763161768,23781,85,13,9
12822,2014/03/31,2009/10/18,20,22,0.667728761,27179,20,9,13
12823,2014/03/31,2005/01/17,28,16,0.6818387440000001,26616,28,3,13
12824,2014/03/31,2012/04/28,234,16,0.851482194,21313,234,10,6
12825,2014/03/31,2009/11/04,39,24,0.548859485,33064,39,18,6
12826,2014/03/31,2011/11/02,282,20,0.703314213,25801,282,15,5
12827,2014/03/31,2011/05/25,67,25,0.615724466,29470,67,14,11
12828,2014/03/31,2007/04/29,6,26,0.652014086,27829,6,6,20
12829,2014/03/31,2007/06/06,45,26,0.6952331509999999,26099,45,16,10
12830,2014/03/31,2010/12/09,32,15,0.663989827,27327,32,4,11
12831,2014/03/31,2005/02/08,196,7,1.374287662,13203,196,5,2
12832,2014/03/31,2007/06/16,66,21,0.727905083,24927,66,8,13
12833,2014/03/31,2012/01/18,389,12,0.7625,23796,389,12,0
12834,2014/03/31,2010/07/04,2,13,0.8922557170000001,20335,2,5,8
12835,2014/03/31,2008/12/09,71,16,0.71984923,25204,71,8,8
12836,2014/03/31,2005/04/30,4,22,0.5806539270000001,31242,4,8,14
12837,2014/03/31,2006/11/02,130,12,0.690582861,26267,130,6,6
12838,2014/03/31,2006/10/17,139,19,0.7713604079999999,23515,139,4,15
12839,2014/03/31,2007/06/22,71,21,0.6104981820000001,29708,71,9,12
12840,2014/03/31,2004/12/22,102,18,0.732927056,24745,102,5,13
12841,2014/03/31,2008/11/15,102,15,0.8024273259999999,22601,102,5,10
12842,2014/03/31,2009/11/24,25,19,0.6741873,26898,25,2,17
12843,2014/03/31,2006/12/04,42,22,0.936434289,19365,42,11,11
12844,2014/03/31,2011/10/13,109,16,0.816991665,22195,109,7,9
12845,2014/03/31,2005/06/10,107,10,0.663478961,27330,107,3,7
12846,2014/03/31,2009/04/29,2,14,0.788793718,22988,2,0,14
12847,2014/03/31,2012/06/08,35,30,0.5349235760000001,33890,35,14,16
12848,2014/03/31,2006/02/21,18,11,0.611445775,29645,18,2,9
12849,2014/03/31,2010/01/19,97,17,0.8500140690000001,21324,97,16,1
12850,2014/03/31,2011/10/21,27,18,0.723123878,25065,27,10,8
12851,2014/03/31,2013/01/03,18,12,0.7616666670000001,23796,18,0,12
12852,2014/03/31,2010/03/31,37,21,0.5836823289999999,31051,37,13,8
12853,2014/03/31,2008/01/31,69,19,0.849162723,21343,69,10,9
12854,2014/03/31,2005/04/25,96,14,0.676712845,26780,96,8,6
12855,2014/03/31,2012/06/07,34,10,0.767119936,23621,34,0,10
12856,2014/03/31,2012/11/07,75,11,1.310292905,13827,75,3,8
12857,2014/03/31,2009/12/07,156,8,0.693272477,26127,156,5,3
12858,2014/03/31,2005/08/19,180,12,0.769027683,23552,180,4,8
12859,2014/03/31,2009/10/20,10,11,0.982903348,18427,10,4,7
12860,2014/03/31,2012/12/28,47,20,0.80080352,22613,47,4,16
12861,2014/03/31,2012/05/13,49,7,0.69129419,26194,49,4,3
12862,2014/03/31,2009/10/15,24,10,0.752886782,24051,24,5,5
12863,2014/03/31,2011/04/15,29,17,0.570515552,31733,29,8,9
12864,2014/03/31,2010/06/19,1,16,0.6036078420000001,29993,1,7,9
12865,2014/03/31,2013/03/01,354,2,0.74,24464,354,1,1
12866,2014/03/31,2013/02/17,221,2,0.74,24464,221,0,2
12867,2014/03/31,2012/12/12,35,9,0.740920476,24433,35,0,9
12868,2014/03/31,2012/08/21,5,16,0.6548531329999999,27644,5,2,14
12869,2014/03/31,2011/01/24,115,11,1.357621869,13334,115,6,5
12870,2014/03/31,2011/07/01,14,15,0.77433955,23378,14,4,11
12871,2014/03/31,2011/01/30,46,19,0.752644601,24049,46,11,8
12872,2014/03/31,2012/07/18,14,20,0.781285881,23167,14,6,14
12873,2014/03/31,2011/08/01,79,3,0.7933374240000001,22814,79,1,2
12874,2014/03/31,2012/12/29,86,3,0.7933198909999999,22814,86,1,2
12875,2014/03/31,2006/03/30,183,9,0.613840388,29484,183,8,1
12876,2014/03/31,2012/12/28,28,23,0.6140145220000001,29473,28,6,17
12877,2014/03/31,2008/04/22,33,32,0.488460563,37046,33,12,20
12878,2014/03/31,2007/10/28,200,7,0.940476611,19240,200,4,3
12879,2014/03/31,2008/03/10,25,18,0.710593803,25463,25,9,9
12880,2014/03/31,2009/11/30,28,20,0.5971992079999999,30295,28,4,16
12881,2014/03/31,2013/03/07,195,12,0.8019115170000001,22558,195,1,11
12882,2014/03/31,2010/07/03,81,13,1.330791584,13593,81,5,8
12883,2014/03/31,2011/04/17,15,20,0.643686964,28099,15,18,2
12884,2014/03/31,2009/03/09,65,25,0.5703024,31713,65,10,15
12885,2014/03/31,2004/11/20,20,35,0.938112258,19277,20,15,20
12886,2014/03/31,2012/01/25,8,33,0.754213556,23975,8,16,17
12887,2014/03/31,2011/07/26,12,20,0.861541907,20987,12,14,6
12888,2014/03/31,2012/03/12,30,26,0.6429586429999999,28121,30,10,16
12889,2014/03/31,2010/12/05,13,21,0.717222817,25209,13,9,12
12890,2014/03/31,2005/10/22,101,10,0.718844135,25150,101,3,7
12891,2014/03/31,2010/04/13,218,14,0.790014421,22884,218,11,3
12892,2014/03/31,2008/03/31,78,32,0.7962634890000001,22703,78,16,16
12893,2014/03/31,2007/11/01,400,15,0.8196191340000001,22055,400,15,0
12894,2014/03/31,2008/05/12,16,12,0.8612153990000001,20989,16,2,10
12895,2014/03/31,2011/09/07,62,19,0.7869292059999999,22968,62,12,7
12896,2014/03/31,2006/04/25,77,3,0.793301585,22783,77,0,3
12897,2014/03/31,2012/03/14,170,14,0.64753834,27908,170,9,5
12898,2014/03/31,2010/10/27,305,14,0.794002812,22759,305,8,6
12899,2014/03/31,2010/03/13,98,9,1.098950313,16443,98,1,8
12900,2014/03/31,2005/01/04,229,22,0.6118209520000001,29534,229,11,11
12901,2014/03/31,2010/09/15,11,33,0.613020865,29475,11,12,21
12902,2014/03/31,2009/11/12,19,22,0.736904723,24518,19,13,9
12903,2014/03/31,2006/10/26,58,17,0.7348602809999999,24585,58,6,11
12904,2014/03/31,2005/09/09,4,16,0.974080983,18547,4,8,8
12905,2014/03/31,2010/01/08,29,17,0.8712080440000001,20736,29,13,4
12906,2014/03/31,2008/07/20,138,9,0.63958925,28241,138,7,2
12907,2014/03/31,2011/02/23,28,18,0.7094107479999999,25456,28,7,11
12908,2014/03/31,2007/08/05,136,20,0.733326565,24623,136,11,9
12909,2014/03/31,2007/12/10,38,28,0.62836854,28735,38,14,14
12910,2014/03/31,2010/04/21,18,16,0.84393166,21393,18,6,10
12911,2014/03/31,2011/03/24,21,13,0.951270025,18976,21,3,10
12912,2014/03/31,2008/09/08,132,25,0.5607879689999999,32184,132,18,7
12913,2014/03/31,2006/06/17,7,18,0.7690092890000001,23468,7,8,10
12914,2014/03/31,2007/08/06,14,24,0.8422720690000001,21421,14,12,12
12915,2014/03/31,2012/05/06,40,11,0.651207899,27701,40,5,6
12916,2014/03/31,2010/08/03,123,15,0.7974041820000001,22621,123,9,6
12917,2014/03/31,2011/08/16,27,27,0.627027497,28767,27,6,21
12918,2014/03/31,2012/01/15,30,18,0.67425314,26752,30,6,12
12919,2014/03/31,2013/01/20,98,17,0.68672467,26263,98,6,11
12920,2014/03/31,2011/01/28,432,6,1.5,12022,432,6,0
12921,2014/03/31,2006/03/09,108,12,0.7041666670000001,25608,108,6,6
12922,2014/03/31,2011/10/09,48,13,0.655275133,27514,48,4,9
12923,2014/03/31,2012/08/11,20,21,0.618241366,29159,20,3,18
12924,2014/03/31,2010/10/12,82,13,0.650356086,27718,82,7,6
12925,2014/03/31,2011/05/24,3,22,0.7595701640000001,23730,3,13,9
12926,2014/03/31,2010/11/22,68,18,0.825832455,21821,68,8,10
12927,2014/03/31,2005/08/28,18,21,0.76705036,23491,18,7,14
12928,2014/03/31,2005/05/03,8,22,0.590501081,30514,8,9,13
12929,2014/03/31,2007/10/16,46,17,0.8194342109999999,21987,46,13,4
12930,2014/03/31,2009/09/10,8,20,0.819052555,21996,8,11,9
12931,2014/03/31,2012/03/15,14,15,0.6597183870000001,27307,14,7,8
12932,2014/03/31,2007/04/01,18,18,0.6923430829999999,26017,18,12,6
12933,2014/03/31,2011/09/10,122,13,0.649230769,27742,122,7,6
12934,2014/03/31,2011/09/11,3,17,0.7817011759999999,23037,3,6,11
12935,2014/03/31,2008/08/19,102,16,0.8751183359999999,20577,102,9,7
12936,2014/03/31,2011/12/07,60,25,0.636003815,28312,60,13,12
12937,2014/03/31,2007/12/25,138,14,0.946419448,19025,138,11,3
12938,2014/03/31,2012/06/13,327,14,0.6841534309999999,26318,327,11,3
12939,2014/03/31,2011/08/02,43,11,0.93845773,19186,43,7,4
12940,2014/03/31,2012/06/19,102,21,0.967847121,18603,102,15,6
12941,2014/03/31,2011/11/15,23,26,0.774278158,23253,23,18,8
12942,2014/03/31,2005/06/22,27,25,0.765,23534,27,16,9
12943,2014/03/31,2012/04/05,130,15,0.942737603,19097,130,13,2
12944,2014/03/31,2005/12/14,2,17,0.6658786760000001,27035,2,9,8
12945,2014/03/31,2012/11/29,10,8,0.676730574,26601,10,3,5
12946,2014/03/31,2006/09/25,24,13,0.795681889,22621,24,9,4
12947,2014/03/31,2010/06/06,36,24,0.916604696,19633,36,11,13
12948,2014/03/31,2012/05/09,160,8,0.848479819,21208,160,5,3
12949,2014/03/31,2009/12/11,10,27,0.8721555990000001,20630,10,11,16
12950,2014/03/31,2012/09/04,63,8,0.752701561,23901,63,3,5
12951,2014/03/31,2005/07/08,15,24,0.5197053389999999,34616,15,12,12
12952,2014/03/31,2006/04/13,301,20,0.758828988,23706,301,17,3
12953,2014/03/31,2010/11/30,31,10,1.197643651,15019,31,1,9
12954,2014/03/31,2008/06/22,105,12,0.723181489,24872,105,6,6
12955,2014/03/31,2007/07/21,32,20,0.680782711,26421,32,13,7
12956,2014/03/31,2012/10/27,6,23,0.859002722,20937,6,9,14
12957,2014/03/31,2012/08/10,44,21,0.7405674520000001,24284,44,7,14
12958,2014/03/31,2011/11/17,120,9,1.4255029730000002,12615,120,6,3
12959,2014/03/31,2013/03/01,1,11,0.922491664,19493,1,1,10
12960,2014/03/31,2010/09/03,368,19,0.833384316,21576,368,19,0
12961,2014/03/31,2011/03/11,77,2,0.735,24464,77,1,1
12962,2014/03/31,2012/09/30,60,2,0.735,24464,60,1,1
12963,2014/03/31,2012/10/25,8,32,0.505339236,35580,8,15,17
12964,2014/03/31,2009/06/18,370,8,1.177995807,15263,370,8,0
12965,2014/03/31,2013/01/24,40,16,0.801753924,22424,40,3,13
12966,2014/03/31,2011/12/15,77,16,0.44023876,40836,77,7,9
12967,2014/03/31,2011/05/12,10,21,0.6820962970000001,26356,10,11,10
12968,2014/03/31,2008/04/09,16,14,0.659195423,27269,16,8,6
12969,2014/03/31,2006/06/06,138,19,0.6822001670000001,26348,138,10,9
12970,2014/03/31,2011/12/27,39,3,0.79,22752,39,1,2
12971,2014/03/31,2011/06/14,23,28,0.8619705540000001,20852,23,17,11
12972,2014/03/31,2011/11/12,414,16,0.705319441,25482,414,16,0
12973,2014/03/31,2010/01/08,49,21,0.885939657,20284,49,8,13
12974,2014/03/31,2008/06/21,83,10,0.917618877,19579,83,7,3
12975,2014/03/31,2006/12/13,11,26,0.646980439,27759,11,14,12
12976,2014/03/31,2005/03/31,58,7,0.874683421,20532,58,4,3
12977,2014/03/31,2010/11/30,206,5,0.8039613179999999,22336,206,0,5
12978,2014/03/31,2013/02/15,3,16,0.593579929,30252,3,0,16
12979,2014/03/31,2010/06/01,9,15,0.868036258,20685,9,8,7
12980,2014/03/31,2010/02/03,117,22,0.6033349020000001,29758,117,7,15
12981,2014/03/31,2007/06/03,73,17,0.764873259,23473,73,9,8
12982,2014/03/31,2012/12/14,6,23,0.636991555,28184,6,6,17
12983,2014/03/31,2011/08/27,36,18,0.660539138,27173,36,9,9
12984,2014/03/31,2005/03/17,14,22,1.069408295,16782,14,11,11
12985,2014/03/31,2011/10/27,247,9,0.7544444440000001,23787,247,5,4
12986,2014/03/31,2009/05/26,23,17,0.679095175,26425,23,7,10
12987,2014/03/31,2005/04/06,52,9,1.295376895,13850,52,6,3
12988,2014/03/31,2009/08/22,12,21,0.6072471229999999,29540,12,19,2
12989,2014/03/31,2008/02/05,22,24,0.561874706,31925,22,16,8
12990,2014/03/31,2012/11/28,103,12,0.762052263,23535,103,3,9
12991,2014/03/31,2005/02/12,4,19,0.780730953,22970,4,9,10
12992,2014/03/31,2011/03/09,21,20,0.6255009420000001,28666,21,7,13
12993,2014/03/31,2006/05/24,148,14,0.6769106770000001,26488,148,9,5
12994,2014/03/31,2011/01/28,67,23,0.708778907,25297,67,13,10
12995,2014/03/31,2010/06/07,79,5,0.623799534,28743,79,3,2
12996,2014/03/31,2008/04/19,32,17,0.801470273,22370,32,7,10
12997,2014/03/31,2012/03/14,12,7,0.689993073,25984,12,0,7
12998,2014/03/31,2010/12/30,20,23,0.65341971,27438,20,9,14
12999,2014/03/31,2012/04/07,41,21,0.662413819,27065,41,14,7
13000,2014/03/31,2009/10/08,9,27,0.6745476779999999,26574,9,16,11
13001,2014/03/31,2011/01/11,9,54,0.751859402,23841,9,33,21
13002,2014/03/31,2012/07/28,16,33,0.6664064239999999,26898,16,15,18
13003,2014/03/31,2012/08/04,74,23,0.642965421,27878,74,7,16
13004,2014/03/31,2011/09/27,316,22,0.7827721,22896,316,21,1
13005,2014/03/31,2009/12/14,245,31,0.7139854990000001,25101,245,28,3
13006,2014/03/31,2008/09/21,10,22,0.63889487,28051,10,3,19
13007,2014/03/31,2011/09/07,63,13,0.784411082,22847,63,6,7
13008,2014/03/31,2012/06/16,2,11,0.523900079,34207,2,8,3
13009,2014/03/31,2010/11/07,132,26,0.472824274,37900,132,13,13
13010,2014/03/31,2007/11/12,117,10,1.326511215,13509,117,7,3
13011,2014/03/31,2006/09/26,74,20,0.620942925,28857,74,16,4
13012,2014/03/31,2006/11/18,134,14,0.917869474,19521,134,7,7
13013,2014/03/31,2011/04/25,2,22,0.616349845,29070,2,9,13
13014,2014/03/31,2013/01/21,34,16,0.604363636,29645,34,6,10
13015,2014/03/31,2011/08/30,1,7,0.7859122609999999,22795,1,1,6
13016,2014/03/31,2009/03/11,22,16,0.7349134390000001,24376,22,11,5
13017,2014/03/31,2013/03/29,8,18,0.561197018,31921,8,2,16
13018,2014/03/31,2012/02/20,34,20,0.844796453,21199,34,11,9
13019,2014/03/31,2008/01/15,260,13,1.106133416,16190,260,11,2
13020,2014/03/31,2007/06/05,101,16,0.678231329,26404,101,7,9
13021,2014/03/31,2007/05/05,23,12,0.618508514,28951,23,9,3
13022,2014/03/31,2012/06/09,379,30,0.7798314390000001,22959,379,30,0
13023,2014/03/31,2009/09/18,26,20,0.822284021,21773,26,17,3
13024,2014/03/31,2009/08/31,18,15,0.5946515179999999,30102,18,5,10
13025,2014/03/31,2007/01/08,78,6,0.924059161,19371,78,5,1
13026,2014/03/31,2007/11/01,135,8,0.639561939,27987,135,2,6
13027,2014/03/31,2011/05/12,454,17,0.794815259,22518,454,17,0
13028,2014/03/31,2008/05/22,19,14,0.9564472,18712,19,7,7
13029,2014/03/31,2011/11/16,65,14,0.8752191140000001,20446,65,10,4
13030,2014/03/31,2006/04/09,108,12,0.6952783929999999,25737,108,7,5
13031,2014/03/31,2010/06/28,4,18,0.946655733,18901,4,5,13
13032,2014/03/31,2010/04/20,5,15,0.8199738759999999,21819,5,4,11
13033,2014/03/31,2013/01/26,40,17,0.672282429,26612,40,5,12
13034,2014/03/31,2012/11/12,11,15,0.6959531590000001,25704,11,2,13
13035,2014/03/31,2006/11/27,32,19,0.80961528,22094,32,2,17
13036,2014/03/31,2006/11/21,51,40,0.706356277,25323,51,19,21
13037,2014/03/31,2010/10/24,10,23,0.798682683,22394,10,10,13
13038,2014/03/31,2008/08/21,115,14,0.731727693,24443,115,6,8
13039,2014/03/31,2007/10/26,20,15,0.865921855,20654,20,11,4
13040,2014/03/31,2011/10/25,135,6,1.4768199830000002,12110,135,5,1
13041,2014/03/31,2010/01/20,17,22,0.6785602059999999,26351,17,13,9
13042,2014/03/31,2007/11/01,103,7,0.987655767,18104,103,2,5
13043,2014/03/31,2008/03/01,185,3,0.7333333329999999,24381,185,1,2
13044,2014/03/31,2013/03/12,329,4,0.55,32508,329,2,2
13045,2014/03/31,2011/06/28,88,7,0.864167633,20688,88,4,3
13046,2014/03/31,2004/12/06,291,6,0.7662957570000001,23330,291,3,3
13047,2014/03/31,2008/03/10,11,29,0.5845007520000001,30586,11,15,14
13048,2014/03/31,2012/10/11,5,17,0.6851902959999999,26091,5,2,15
13049,2014/03/31,2011/01/03,156,22,0.643591128,27774,156,11,11
13050,2014/03/31,2013/02/04,143,13,0.655384615,27274,143,4,9
13051,2014/03/31,2009/03/26,173,8,0.938905347,19038,173,6,2
13052,2014/03/31,2012/11/30,22,22,0.633799915,28198,22,5,17
13053,2014/03/31,2009/09/14,1,20,0.517988116,34500,1,3,17
13054,2014/03/31,2011/10/30,113,14,0.779546327,22924,113,9,5
13055,2014/03/31,2007/11/28,34,21,0.797696634,22402,34,5,16
13056,2014/03/31,2013/01/12,188,26,0.64120887,27869,188,4,22
13057,2014/03/31,2004/11/18,236,20,0.523694391,34122,236,17,3
13058,2014/03/31,2005/06/30,84,18,0.842820017,21202,84,6,12
13059,2014/03/31,2012/02/28,8,9,0.970965112,18402,8,4,5
13060,2014/03/31,2008/09/23,315,11,0.903811523,19769,315,6,5
13061,2014/03/31,2011/08/31,31,17,0.706106873,25301,31,10,7
13062,2014/03/31,2011/12/18,25,10,0.773513162,23096,25,7,3
13063,2014/03/31,2007/04/11,24,13,0.764396046,23371,24,1,12
13064,2014/03/31,2011/05/27,37,13,0.578182083,30898,37,8,5
13065,2014/03/31,2008/12/25,56,3,0.693763107,25750,56,0,3
13066,2014/03/31,2011/10/20,12,23,0.74831134,23871,12,8,15
13067,2014/03/31,2012/04/16,235,19,0.719879081,24810,235,13,6
13068,2014/03/31,2010/10/17,95,18,0.697055265,25622,95,10,8
13069,2014/03/31,2010/09/08,38,22,0.693330615,25755,38,13,9
13070,2014/03/31,2005/12/01,71,13,0.740256198,24122,71,9,4
13071,2014/03/31,2008/11/29,23,22,0.633631525,28181,23,7,15
13072,2014/03/31,2005/11/27,39,18,0.60632721,29449,39,12,6
13073,2014/03/31,2006/03/28,137,10,0.7151415870000001,24967,137,2,8
13074,2014/03/31,2007/05/05,7,19,0.660592132,27021,7,7,12
13075,2014/03/31,2013/01/13,211,3,0.783356011,22783,211,2,1
13076,2014/03/31,2007/07/10,157,4,0.7434688779999999,24002,157,1,3
13077,2014/03/31,2005/07/27,29,21,0.710107446,25129,29,12,9
13078,2014/03/31,2008/09/03,2,16,0.753980139,23665,2,7,9
13079,2014/03/31,2010/10/01,52,16,0.7159469540000001,24922,52,7,9
13080,2014/03/31,2011/09/08,39,20,0.7626426709999999,23393,39,12,8
13081,2014/03/31,2012/04/30,19,19,0.708484728,25177,19,6,13
13082,2014/03/31,2011/08/13,47,21,0.749978977,23784,47,13,8
13083,2014/03/31,2008/04/11,427,7,1.350586854,13206,427,7,0
13084,2014/03/31,2011/11/22,118,13,0.774875304,23016,118,10,3
13085,2014/03/31,2009/01/22,36,25,0.782196491,22800,36,13,12
13086,2014/03/31,2012/01/06,42,9,0.748660201,23817,42,8,1
13087,2014/03/31,2008/10/08,135,19,0.893972122,19944,135,6,13
13088,2014/03/31,2008/08/08,33,16,0.806941389,22095,33,4,12
13089,2014/03/31,2008/04/10,8,27,0.8607367,20714,8,12,15
13090,2014/03/31,2011/08/20,6,24,0.699989792,25470,6,9,15
13091,2014/03/31,2010/09/17,1,17,0.727460013,24508,1,9,8
13092,2014/03/31,2007/07/28,66,19,0.91009393,19589,66,10,9
13093,2014/03/31,2010/04/21,145,12,1.105973816,16117,145,7,5
13094,2014/03/31,2011/10/19,51,17,0.888577625,20058,51,6,11
13095,2014/03/31,2012/11/20,28,14,0.659737914,27014,28,1,13
13096,2014/03/31,2010/07/24,57,18,0.6814401529999999,26150,57,12,6
13097,2014/03/31,2012/05/10,195,15,0.822342517,21669,195,13,2
13098,2014/03/31,2007/01/29,10,20,0.7570130420000001,23539,10,0,20
13099,2014/03/31,2011/03/18,293,11,0.602424017,29579,293,5,6
13100,2014/03/31,2013/03/14,8,15,0.661483461,26937,8,1,14
13101,2014/03/31,2012/07/28,186,10,0.645635033,27597,186,7,3
13102,2014/03/31,2007/07/01,12,16,0.667711941,26682,12,0,16
13103,2014/03/31,2006/03/10,265,23,0.626554829,28434,265,16,7
13104,2014/03/31,2007/01/31,1,23,0.788900846,22581,1,13,10
13105,2014/03/31,2010/11/23,31,18,0.913264448,19501,31,9,9
13106,2014/03/31,2010/03/05,89,21,0.736904585,24168,89,11,10
13107,2014/03/31,2011/09/12,102,18,0.573965256,31027,102,6,12
13108,2014/03/31,2013/01/03,5,16,0.777012392,22918,5,1,15
13109,2014/03/31,2013/03/19,10,8,0.61,29192,10,0,8
13110,2014/03/31,2012/02/19,39,22,0.675912317,26345,39,13,9
13111,2014/03/31,2005/07/18,218,15,0.6272903089999999,28387,218,11,4
13112,2014/03/31,2008/11/22,39,15,0.740212005,24056,39,6,9
13113,2014/03/31,2006/04/19,107,32,0.686740204,25928,107,15,17
13114,2014/03/31,2006/08/18,163,20,0.7062701309999999,25210,163,12,8
13115,2014/03/31,2012/10/09,4,28,0.841965856,21146,4,5,23
13116,2014/03/31,2007/06/15,30,14,0.894264617,19908,30,1,13
13117,2014/03/31,2006/12/26,80,16,0.8312448640000001,21416,80,6,10
13118,2014/03/31,2006/04/10,68,6,0.7663125270000001,23230,68,4,2
13119,2014/03/31,2012/12/01,242,6,0.68677265,25916,242,4,2
13120,2014/03/31,2004/11/30,5,8,1.42704458,12472,5,4,4
13121,2014/03/31,2010/01/03,4,13,0.74487319,23894,4,6,7
13122,2014/03/31,2013/02/11,34,14,0.6376692939999999,27910,34,3,11
13123,2014/03/31,2012/11/15,6,21,0.743122886,23949,6,2,19
13124,2014/03/31,2009/07/09,18,26,0.6779706670000001,26250,18,18,8
13125,2014/03/31,2012/12/05,43,14,0.7503293000000001,23717,43,6,8
13126,2014/03/31,2011/05/18,5,16,0.6458733210000001,27550,5,4,12
13127,2014/03/31,2012/11/02,4,22,0.761053082,23379,4,10,12
13128,2014/03/31,2011/11/04,140,15,0.623108013,28552,140,8,7
13129,2014/03/31,2012/03/26,235,12,0.825650903,21547,235,9,3
13130,2014/03/31,2011/07/22,31,24,0.709849162,25060,31,13,11
13131,2014/03/31,2007/02/08,389,14,0.98966726,17972,389,14,0
13132,2014/03/31,2010/03/06,20,26,0.749117982,23741,20,17,9
13133,2014/03/31,2008/04/08,163,11,0.987955556,18000,163,9,2
13134,2014/03/31,2012/10/14,11,18,0.618765746,28738,11,8,10
13135,2014/03/31,2005/09/01,4,14,0.6749897509999999,26344,4,6,8
13136,2014/03/31,2007/08/30,12,19,0.7036671940000001,25270,12,10,9
13137,2014/03/31,2011/09/24,348,16,0.7786048959999999,22837,348,14,2
13138,2014/03/31,2011/05/21,23,22,0.769439155,23108,23,9,13
13139,2014/03/31,2005/04/11,45,20,0.638521405,27844,45,8,12
13140,2014/03/31,2006/09/27,247,32,0.839715662,21172,247,25,7
13141,2014/03/31,2010/03/13,126,11,0.6991038140000001,25430,126,7,4
13142,2014/03/31,2008/12/13,49,23,0.690293547,25754,49,4,19
13143,2014/03/31,2010/08/28,157,20,0.83471218,21298,157,12,8
13144,2014/03/31,2013/03/21,16,17,0.82797308,21471,16,2,15
13145,2014/03/31,2005/09/01,23,19,0.715474705,24847,23,6,13
13146,2014/03/31,2005/03/02,6,22,0.617367946,28795,6,9,13
13147,2014/03/31,2010/07/06,42,11,0.626015776,28397,42,5,6
13148,2014/03/31,2008/02/10,39,23,0.727721058,24428,39,14,9
13149,2014/03/31,2011/10/29,85,5,0.700605487,25368,85,3,2
13150,2014/03/31,2011/06/15,65,12,0.7272493659999999,24438,65,5,7
13151,2014/03/31,2008/07/19,125,12,0.709348208,25054,125,5,7
13152,2014/03/31,2009/09/08,302,11,0.847163219,20978,302,10,1
13153,2014/03/31,2012/02/04,402,4,1.0831322,16407,402,4,0
13154,2014/03/31,2012/01/18,65,13,0.954325761,18621,65,6,7
13155,2014/03/31,2012/07/13,291,8,0.6854821790000001,25924,291,6,2
13156,2014/03/31,2012/01/07,86,10,0.674385699,26347,86,3,7
13157,2014/03/31,2012/06/07,107,12,1.303505503,13630,107,7,5
13158,2014/03/31,2011/01/14,34,11,0.788856673,22522,34,3,8
13159,2014/03/31,2012/04/04,77,10,0.786425568,22591,77,7,3
13160,2014/03/31,2009/11/24,24,15,0.693671756,25609,24,7,8
13161,2014/03/31,2007/05/27,9,23,0.650318129,27316,9,1,22
13162,2014/03/31,2012/10/30,19,17,0.572019321,31055,19,0,17
13163,2014/03/31,2008/08/08,61,16,0.752969227,23592,61,9,7
13164,2014/03/31,2007/04/27,49,9,0.862922173,20584,49,4,5
13165,2014/03/31,2010/09/27,428,4,0.733747831,24206,428,4,0
13166,2014/03/31,2008/08/16,36,27,0.6272604629999999,28315,36,11,16
13167,2014/03/31,2011/06/07,146,15,0.833656121,21304,146,4,11
13168,2014/03/31,2006/11/04,16,21,0.5911498000000001,30040,16,11,10
13169,2014/03/31,2011/01/13,4,20,0.8545,20780,4,2,18
13170,2014/03/31,2010/11/29,6,14,0.500453777,35480,6,5,9
13171,2014/03/31,2009/09/05,2,20,0.85149777,20851,2,3,17
13172,2014/03/31,2010/09/03,78,16,0.660090345,26897,78,11,5
13173,2014/03/31,2005/06/22,135,24,0.408580307,43446,135,14,10
13174,2014/03/31,2012/06/15,15,25,0.447472018,39668,15,13,12
13175,2014/03/31,2009/08/03,18,19,0.69405138,25574,18,4,15
13176,2014/03/31,2008/11/29,294,9,0.665339631,26676,294,7,2
13177,2014/03/31,2005/10/30,8,15,0.725824131,24450,8,8,7
13178,2014/03/31,2011/03/20,101,11,0.7409090909999999,23947,101,4,7
13179,2014/03/31,2007/11/19,121,14,0.724639765,24484,121,11,3
13180,2014/03/31,2008/08/25,46,11,1.321864243,13421,46,3,8
13181,2014/03/31,2011/05/29,151,15,0.5295877489999999,33499,151,7,8
13182,2014/03/31,2012/10/14,14,22,0.692546654,25614,14,1,21
13183,2014/03/31,2010/12/19,164,2,0.725,24464,164,1,1
13184,2014/03/31,2008/04/08,11,21,0.836253301,21208,11,10,11
13185,2014/03/31,2005/06/02,13,16,0.7375746609999999,24042,13,6,10
13186,2014/03/31,2005/05/19,2,22,0.699891055,25334,2,14,8
13187,2014/03/31,2011/04/02,3,16,0.733822117,24162,3,5,11
13188,2014/03/31,2006/11/09,5,24,0.7097405920000001,24980,5,19,5
13189,2014/03/31,2004/12/03,76,15,0.759830697,23331,76,7,8
13190,2014/03/31,2012/01/31,4,24,0.5975914379999999,29665,4,9,15
13191,2014/03/31,2009/06/17,8,17,0.595338348,29777,8,2,15
13192,2014/03/31,2012/08/08,102,21,0.705944805,25111,102,6,15
13193,2014/03/31,2007/05/21,172,19,0.71278676,24864,172,10,9
13194,2014/03/31,2008/07/06,24,13,0.759776635,23325,24,0,13
13195,2014/03/31,2005/04/17,105,11,1.281646174,13826,105,0,11
13196,2014/03/31,2011/01/11,78,23,0.547704933,32352,78,8,15
13197,2014/03/31,2008/09/13,20,16,0.58875,30096,20,9,7
13198,2014/03/31,2010/09/23,29,12,0.667530892,26544,29,6,6
13199,2014/03/31,2013/03/12,13,15,0.728353681,24327,13,0,15
13200,2014/03/31,2012/06/14,9,15,0.750917528,23596,9,5,10
13201,2014/03/31,2008/08/15,26,16,0.794675727,22296,26,5,11
13202,2014/03/31,2010/03/17,46,12,0.7520493229999999,23559,46,2,10
13203,2014/03/31,2012/12/12,9,12,0.68551037,25844,9,3,9
13204,2014/03/31,2008/06/25,92,19,0.7603193,23301,92,8,11
13205,2014/03/31,2012/06/19,62,11,0.935345301,18940,62,8,3
13206,2014/03/31,2009/07/06,4,15,0.710711047,24921,4,8,7
13207,2014/03/31,2006/11/02,27,20,0.61078077,28997,27,2,18
13208,2014/03/31,2012/10/14,84,6,0.5530742329999999,32021,84,2,4
13209,2014/03/31,2011/05/25,4,19,0.610216043,29022,4,10,9
13210,2014/03/31,2008/02/21,2,13,0.678763558,26091,2,3,10
13211,2014/03/31,2012/11/09,71,16,0.7359681640000001,24061,71,6,10
13212,2014/03/31,2007/06/03,8,24,0.746676365,23715,8,14,10
13213,2014/03/31,2011/11/27,127,15,0.62106489,28510,127,11,4
13214,2014/03/31,2011/03/18,84,19,0.7463527529999999,23722,84,17,2
13215,2014/03/31,2006/09/24,45,8,0.710439807,24920,45,3,5
13216,2014/03/31,2012/06/25,109,21,0.809268605,21876,109,11,10
13217,2014/03/31,2011/08/19,317,6,1.5,11802,317,5,1
13218,2014/03/31,2010/01/03,12,13,0.856237969,20675,12,4,9
13219,2014/03/31,2006/11/06,25,25,0.619418454,28579,25,6,19
13220,2014/03/31,2012/07/01,172,10,1.414706305,12513,172,5,5
13221,2014/03/31,2011/05/21,38,16,0.849262547,20842,38,8,8
13222,2014/03/31,2012/01/17,136,27,0.627167458,28222,136,18,9
13223,2014/03/31,2011/05/09,7,13,0.7870619109999999,22484,7,4,9
13224,2014/03/31,2012/06/30,626,2,0.874740484,20230,626,2,0
13225,2014/03/31,2005/10/05,1,19,0.584313499,30284,1,1,18
13226,2014/03/31,2009/10/31,39,20,0.657219643,26921,39,10,10
13227,2014/03/31,2011/12/27,45,19,0.7752925190000001,22819,45,11,8
13228,2014/03/31,2012/09/20,106,16,0.728834047,24272,106,8,8
13229,2014/03/31,2007/03/06,7,13,1.146790924,15425,7,4,9
13230,2014/03/31,2010/09/15,80,8,1.294863104,13660,80,6,2
13231,2014/03/31,2013/01/20,4,16,0.641813201,27559,4,6,10
13232,2014/03/31,2012/08/25,2,27,0.774261075,22844,2,5,22
13233,2014/03/31,2005/11/01,15,13,0.977268206,18098,15,9,4
13234,2014/03/31,2011/06/14,75,14,0.793200879,22297,75,7,7
13235,2014/03/31,2007/05/31,5,30,0.6856116,25793,5,7,23
13236,2014/03/31,2006/11/06,167,23,0.622732331,28397,167,5,18
13237,2014/03/31,2012/07/15,4,18,0.7483756559999999,23628,4,3,15
13238,2014/03/31,2008/03/06,141,16,0.6550389,26992,141,9,7
13239,2014/03/31,2009/07/30,5,20,0.690167857,25617,5,9,11
13240,2014/03/31,2007/08/27,13,12,0.760297192,23251,13,3,9
13241,2014/03/31,2012/09/21,22,19,1.16687793,15147,22,2,17
13242,2014/03/31,2007/04/18,20,19,0.714115175,24745,20,9,10
13243,2014/03/31,2005/03/12,160,13,0.6885932509999999,25662,160,7,6
13244,2014/03/31,2007/03/06,11,16,0.838419529,21076,11,4,12
13245,2014/03/31,2011/11/27,69,9,0.977545228,18075,69,5,4
13246,2014/03/31,2008/11/15,27,22,0.7128906909999999,24783,27,14,8
13247,2014/03/31,2008/09/26,11,20,0.743945174,23748,11,8,12
13248,2014/03/31,2010/11/01,4,24,0.7280342870000001,24266,4,13,11
13249,2014/03/31,2007/10/11,139,16,0.607207232,29093,139,7,9
13250,2014/03/31,2010/04/05,107,23,0.70119954,25193,107,12,11
13251,2014/03/31,2010/09/15,44,19,0.963888252,18327,44,9,10
13252,2014/03/31,2010/10/24,12,22,0.650282727,27164,12,16,6
13253,2014/03/31,2011/12/02,15,30,0.797417374,22148,15,11,19
13254,2014/03/31,2012/07/03,385,22,0.80423725,21960,385,22,0
13255,2014/03/31,2008/02/08,1,24,0.678787378,26018,1,11,13
13256,2014/03/31,2009/10/13,29,23,0.8429770879999999,20950,29,14,9
13257,2014/03/31,2012/04/26,21,25,0.692893529,25481,21,15,10
13258,2014/03/31,2013/02/07,3,25,0.797770447,22130,3,2,23
13259,2014/03/31,2008/07/14,47,14,0.68953988,25602,47,0,14
13260,2014/03/31,2008/08/22,82,25,0.804039627,21955,82,16,9
13261,2014/03/31,2011/02/18,12,25,0.591614384,29838,12,10,15
13262,2014/03/31,2007/01/02,98,16,0.583805365,30231,98,4,12
13263,2014/03/31,2013/02/06,31,19,0.648237649,27225,31,3,16
13264,2014/03/31,2009/11/10,4,27,0.644592739,27378,4,7,20
13265,2014/03/31,2007/12/22,25,36,0.759481794,23234,25,6,30
13266,2014/03/31,2005/05/04,55,19,0.7333653370000001,24060,55,5,14
13267,2014/03/31,2007/03/24,2,26,0.6315667389999999,27937,2,7,19
13268,2014/03/31,2008/02/11,433,8,0.754659966,23380,433,8,0
13269,2014/03/31,2012/07/31,2,19,0.689690395,25581,2,4,15
13270,2014/03/31,2013/03/29,4,10,1.369099022,12886,4,1,9
13271,2014/03/31,2008/04/14,15,12,0.758375102,23263,15,9,3
13272,2014/03/31,2012/08/10,26,30,0.782170347,22554,26,20,10
13273,2014/03/31,2007/04/23,108,11,0.680853569,25903,108,9,2
13274,2014/03/31,2008/04/28,25,20,0.71821462,24555,25,7,13
13275,2014/03/31,2006/03/29,6,34,0.6271435679999999,28119,6,13,21
13276,2014/03/31,2009/08/28,1,29,0.8927775809999999,19751,1,5,24
13277,2014/03/31,2013/03/26,19,35,0.56270473,31334,19,0,35
13278,2014/03/31,2011/03/16,93,19,0.6304946,27962,93,10,9
13279,2014/03/31,2011/08/07,126,5,0.639049811,27584,126,1,4
13280,2014/03/31,2006/12/19,18,10,0.886392437,19886,18,4,6
13281,2014/03/31,2013/03/26,77,15,0.5311347820000001,33187,77,2,13
13282,2014/03/31,2011/12/19,3,13,0.7171496009999999,24572,3,3,10
13283,2014/03/31,2012/09/01,53,3,0.773301585,22783,53,2,1
13284,2014/03/31,2012/07/15,129,13,0.714958399,24639,129,6,7
13285,2014/03/31,2009/06/13,102,9,0.6787842470000001,25951,102,5,4
13286,2014/03/31,2011/05/30,21,15,0.7402223059999999,23796,21,4,11
13287,2014/03/31,2012/10/26,230,2,0.72,24464,230,0,2
13288,2014/03/31,2012/10/26,230,2,0.72,24464,230,0,2
13289,2014/03/31,2010/02/08,18,13,0.762919085,23086,18,10,3
13290,2014/03/31,2012/07/18,26,20,0.583288293,30195,26,10,10
13291,2014/03/31,2006/03/14,130,9,1.445295421,12186,130,1,8
13292,2014/03/31,2010/08/24,578,4,0.919733626,19146,578,4,0
13293,2014/03/31,2008/08/15,113,22,0.770746334,22845,113,14,8
13294,2014/03/31,2008/08/18,42,26,0.856252492,20563,42,12,14
13295,2014/03/31,2011/05/09,29,17,0.660471528,26658,29,6,11
13296,2014/03/31,2006/11/23,74,23,0.694671138,25345,74,13,10
13297,2014/03/31,2008/10/29,1,23,0.8054881509999999,21858,1,11,12
13298,2014/03/31,2011/10/23,127,26,0.702919029,25046,127,13,13
13299,2014/03/31,2007/02/27,46,28,0.7501355040000001,23468,46,14,14
13300,2014/03/31,2012/08/08,77,25,0.47722775,36887,77,19,6
13301,2014/03/31,2012/03/17,4,20,0.8686513690000001,20265,4,11,9
13302,2014/03/31,2010/04/22,26,9,0.8681594000000001,20276,26,6,3
13303,2014/03/31,2011/12/31,68,10,0.775202607,22704,68,8,2
13304,2014/03/31,2012/05/25,13,9,0.8170454970000001,21540,13,5,4
13305,2014/03/31,2007/06/08,3,11,1.209539487,14549,3,5,6
13306,2014/03/31,2010/09/15,228,4,0.6976466859999999,25224,228,0,4
13307,2014/03/31,2009/08/02,15,16,0.736832761,23882,15,11,5
13308,2014/03/31,2011/04/03,42,23,0.625156855,28147,42,12,11
13309,2014/03/31,2006/06/30,34,20,0.487471258,36097,34,10,10
13310,2014/03/31,2007/09/18,4,3,0.773333333,22752,4,1,2
13311,2014/03/31,2006/06/22,6,23,0.665903104,26420,6,6,17
13312,2014/03/31,2007/10/26,45,7,0.773427705,22747,45,0,7
13313,2014/03/31,2010/02/06,153,16,0.584392958,30105,153,14,2
13314,2014/03/31,2005/01/24,28,18,0.71655289,24551,28,11,7
13315,2014/03/31,2005/01/22,313,21,0.76220643,23078,313,19,2
13316,2014/03/31,2007/11/09,358,12,0.94114405,18688,358,11,1
13317,2014/03/31,2012/05/13,13,21,0.748668852,23491,13,8,13
13318,2014/03/31,2006/04/18,209,18,0.524633812,33521,209,16,2
13319,2014/03/31,2009/09/24,90,21,0.714282871,24619,90,13,8
13320,2014/03/31,2012/05/09,45,19,0.7695776809999999,22850,45,7,12
13321,2014/03/31,2009/12/26,163,17,0.629754289,27919,163,10,7
13322,2014/03/31,2008/05/26,162,11,0.8406742220000001,20913,162,4,7
13323,2014/03/31,2006/04/07,124,15,0.698263823,25176,124,9,6
13324,2014/03/31,2011/03/11,176,24,0.492185514,35717,176,17,7
13325,2014/03/31,2011/08/05,4,17,0.4824466220000001,36438,4,0,17
13326,2014/03/31,2006/03/04,34,24,0.6144134920000001,28610,34,9,15
13327,2014/03/31,2012/12/04,62,12,0.865848973,20301,62,9,3
13328,2014/03/31,2009/08/19,68,28,0.7580897129999999,23185,68,10,18
13329,2014/03/31,2012/09/01,40,8,0.8225,21368,40,5,3
13330,2014/03/31,2011/03/17,102,15,0.632626008,27776,102,10,5
13331,2014/03/31,2013/03/27,5,15,0.652153886,26942,5,0,15
13332,2014/03/31,2011/03/21,78,19,0.8283836290000001,21208,78,5,14
13333,2014/03/31,2012/05/18,77,18,0.6944896429999999,25296,77,13,5
13334,2014/03/31,2012/02/08,216,37,0.82,21423,216,27,10
13335,2014/03/31,2011/11/05,379,32,0.832390295,21102,379,32,0
13336,2014/03/31,2008/07/15,8,17,0.728897004,24098,8,4,13
13337,2014/03/31,2005/11/12,46,19,0.55810061,31468,46,12,7
13338,2014/03/31,2006/04/25,1,16,0.613683824,28617,1,7,9
13339,2014/03/31,2009/04/06,43,10,0.725288068,24213,43,8,2
13340,2014/03/31,2011/09/01,5,17,0.690233874,25441,5,11,6
13341,2014/03/31,2005/12/25,79,24,0.615720798,28517,79,10,14
13342,2014/03/31,2011/10/08,446,14,0.6329259939999999,27741,446,14,0
13343,2014/03/31,2006/11/05,3,26,0.685457953,25614,3,10,16
13344,2014/03/31,2010/04/29,43,14,0.7221987740000001,24309,43,7,7
13345,2014/03/31,2011/03/01,97,26,0.6537634529999999,26853,97,16,10
13346,2014/03/31,2007/10/07,9,32,0.80601956,21779,9,20,12
13347,2014/03/31,2012/12/10,114,8,0.851240543,20620,114,3,5
13348,2014/03/31,2012/11/11,15,11,0.8283220840000001,21187,15,4,7
13349,2014/03/31,2009/09/12,67,16,0.728134595,24102,67,6,10
13350,2014/03/31,2010/04/06,177,14,0.71865105,24419,177,8,6
13351,2014/03/31,2012/05/05,382,20,0.666870606,26315,382,20,0
13352,2014/03/31,2012/05/08,215,16,0.8445382359999999,20779,215,14,2
13353,2014/03/31,2005/07/02,5,18,0.7972541,22011,5,8,10
13354,2014/03/31,2004/11/25,65,21,0.566531607,30974,65,12,9
13355,2014/03/31,2009/03/18,97,20,0.478769986,36650,97,9,11
13356,2014/03/31,2012/02/19,39,10,0.893287685,19643,39,2,8
13357,2014/03/31,2008/12/02,185,16,0.8575251690000001,20462,185,10,6
13358,2014/03/31,2010/08/10,35,16,0.5575,31472,35,4,12
13359,2014/03/31,2007/02/22,168,8,1.468902378,11944,168,5,3
13360,2014/03/31,2006/07/02,100,19,0.984697199,17817,100,11,8
13361,2014/03/31,2006/08/02,15,17,0.782399768,22423,15,7,10
13362,2014/03/31,2009/01/07,75,14,0.671113576,26141,75,5,9
13363,2014/03/31,2011/05/11,10,31,0.558420768,31414,10,8,23
13364,2014/03/31,2008/11/21,142,12,0.8574270490000001,20459,142,7,5
13365,2014/03/31,2008/12/27,51,23,0.799615262,21937,51,8,15
13366,2014/03/31,2007/08/23,94,18,0.651809669,26911,94,7,11
13367,2014/03/31,2010/02/23,11,18,0.7775325829999999,22558,11,9,9
13368,2014/03/31,2010/05/02,16,22,0.749359566,23406,16,15,7
13369,2014/03/31,2005/09/17,10,17,0.586918315,29883,10,7,10
13370,2014/03/31,2012/02/10,86,26,0.7375089359999999,23781,86,9,17
13371,2014/03/31,2012/05/09,482,10,0.818500023,21427,482,10,0
13372,2014/03/31,2007/05/20,117,15,0.92060315,19050,117,14,1
13373,2014/03/31,2008/11/26,237,17,0.8471726740000001,20698,237,13,4
13374,2014/03/31,2010/04/30,118,21,0.759259548,23094,118,8,13
13375,2014/03/31,2008/03/05,20,14,0.679670129,25798,20,8,6
13376,2014/03/31,2013/01/24,102,16,0.767242813,22853,102,0,16
13377,2014/03/31,2012/08/11,133,8,1.438691942,12186,133,3,5
13378,2014/03/31,2009/12/03,13,28,0.82259009,21312,13,6,22
13379,2014/03/31,2011/01/13,5,13,0.740453202,23676,5,4,9
13380,2014/03/31,2009/07/11,9,19,0.6957342440000001,25196,9,0,19
13381,2014/03/31,2011/07/30,31,26,0.721921255,24281,31,15,11
13382,2014/03/31,2010/05/24,21,25,0.8971216540000001,19539,21,12,13
13383,2014/03/31,2010/06/26,5,22,0.662591291,26454,5,10,12
13384,2014/03/31,2013/01/22,14,17,0.759802757,23068,14,2,15
13385,2014/03/31,2012/08/30,81,12,0.708299248,24742,81,2,10
13386,2014/03/31,2011/06/03,154,20,0.826799717,21195,154,11,9
13387,2014/03/31,2008/12/14,1,24,0.716903126,24444,1,2,22
13388,2014/03/31,2008/03/20,104,22,0.661575549,26486,104,12,10
13389,2014/03/31,2012/12/28,31,16,1.22205747,14338,31,6,10
13390,2014/03/31,2008/09/06,13,15,0.969165837,18078,13,4,11
13391,2014/03/31,2010/07/08,111,8,0.806215545,21731,111,6,2
13392,2014/03/31,2009/09/06,129,9,0.6570192420000001,26661,129,7,2
13393,2014/03/31,2012/09/14,88,14,0.796428571,21994,88,6,8
13394,2014/03/31,2006/09/02,154,18,0.817559393,21425,154,14,4
13395,2014/03/31,2007/04/12,77,15,0.731663325,23940,77,9,6
13396,2014/03/31,2012/09/01,24,10,0.8106526270000001,21605,24,8,2
13397,2014/03/31,2010/11/09,239,14,0.6305872610000001,27773,239,9,5
13398,2014/03/31,2011/05/30,292,20,0.701103771,24978,292,17,3
13399,2014/03/31,2008/10/10,260,14,0.7667259190000001,22840,260,12,2
13400,2014/03/31,2006/01/19,6,23,0.583723248,29998,6,12,11
13401,2014/03/31,2007/11/20,108,17,0.7471448690000001,23435,108,7,10
13402,2014/03/31,2011/06/15,1,12,0.752176733,23278,1,4,8
13403,2014/03/31,2008/09/02,368,18,0.738167714,23719,368,18,0
13404,2014/03/31,2005/03/16,10,14,0.7220020620000001,24250,10,11,3
13405,2014/03/31,2008/06/07,333,8,1.309627469,13368,333,6,2
13406,2014/03/31,2013/01/03,26,12,0.692457875,25282,26,2,10
13407,2014/03/31,2011/09/01,35,26,0.922148765,18983,35,19,7
13408,2014/03/31,2012/07/21,30,23,0.778790764,22477,30,8,15
13409,2014/03/31,2012/04/06,86,20,0.688786102,25414,86,9,11
13410,2014/03/31,2006/06/03,56,13,0.7137115709999999,24526,56,8,5
13411,2014/03/31,2011/03/10,55,24,0.532910552,32846,55,12,12
13412,2014/03/31,2007/02/28,125,13,0.738416101,23701,125,6,7
13413,2014/03/31,2010/02/02,153,12,0.651792924,26850,153,6,6
13414,2014/03/31,2005/03/05,61,21,0.7076651840000001,24730,61,10,11
13415,2014/03/31,2012/08/15,223,6,0.643857616,27180,223,2,4
13416,2014/03/31,2005/04/01,84,11,0.707001091,24749,84,6,5
13417,2014/03/31,2010/01/04,188,26,0.818333801,21378,188,25,1
13418,2014/03/31,2009/02/17,24,19,0.79940499,21882,24,9,10
13419,2014/03/31,2008/08/28,5,25,0.614740819,28455,5,13,12
13420,2014/03/31,2009/11/20,112,18,0.7024815259999999,24900,112,8,10
13421,2014/03/31,2008/08/21,88,2,0.715,24464,88,0,2
13422,2014/03/31,2010/11/05,26,16,0.772417311,22645,26,12,4
13423,2014/03/31,2006/03/12,49,24,0.8240816999999999,21224,49,13,11
13424,2014/03/31,2013/01/07,18,21,0.862270262,20284,18,3,18
13425,2014/03/31,2009/01/01,1,12,0.651247766,26856,1,5,7
13426,2014/03/31,2011/01/13,511,3,0.766553432,22814,511,3,0
13427,2014/03/31,2008/11/23,310,3,0.7666725120000001,22810,310,2,1
13428,2014/03/31,2012/03/18,19,14,0.7447893320000001,23473,19,0,14
13429,2014/03/31,2005/06/30,1,14,0.742252558,23551,1,4,10
13430,2014/03/31,2006/04/16,116,16,0.8205327640000001,21304,116,10,6
13431,2014/03/31,2007/07/24,70,15,0.748130965,23365,70,12,3
13432,2014/03/31,2009/08/22,114,19,0.617821061,28289,114,15,4
13433,2014/03/31,2006/06/14,97,16,0.903229974,19350,97,7,9
13434,2014/03/31,2012/10/15,1,21,0.700608514,24946,1,4,17
13435,2014/03/31,2009/10/04,113,30,0.7614172440000001,22953,113,23,7
13436,2014/03/31,2012/09/10,26,23,0.8061754940000001,21676,26,10,13
13437,2014/03/31,2007/05/04,12,17,0.644720142,27103,12,4,13
13438,2014/03/31,2013/02/03,8,17,0.677370033,25795,8,3,14
13439,2014/03/31,2004/11/12,101,25,0.778116232,22455,101,14,11
13440,2014/03/31,2005/01/04,35,19,0.668971934,26117,35,8,11
13441,2014/03/31,2010/11/02,112,19,0.682810412,25587,112,10,9
13442,2014/03/31,2011/03/21,35,10,0.7926065059999999,22041,35,4,6
13443,2014/03/31,2006/09/22,4,17,0.908837209,19221,4,8,9
13444,2014/03/31,2012/05/23,70,10,0.8100282879999999,21564,70,4,6
13445,2014/03/31,2013/03/02,355,4,0.6822798659999999,25598,355,2,2
13446,2014/03/31,2007/10/01,18,21,0.855079567,20423,18,12,9
13447,2014/03/31,2009/08/16,24,18,0.730483581,23905,24,13,5
13448,2014/03/31,2010/01/26,49,15,0.875685272,19941,49,8,7
13449,2014/03/31,2012/05/25,43,16,0.517854135,33716,43,7,9
13450,2014/03/31,2009/08/03,50,13,0.439479196,39727,50,9,4
13451,2014/03/31,2013/03/03,6,43,0.6759975220000001,25824,6,6,37
13452,2014/03/31,2007/06/20,128,18,0.51326512,34011,128,13,5
13453,2014/03/31,2007/08/09,27,14,0.597803082,29200,27,7,7
13454,2014/03/31,2008/11/22,72,13,0.827501185,21094,72,8,5
13455,2014/03/31,2011/05/24,286,17,0.691344265,25248,286,15,2
13456,2014/03/31,2007/07/26,164,14,0.789499683,22106,164,8,6
13457,2014/03/31,2008/03/22,21,25,0.822009515,21229,21,17,8
13458,2014/03/31,2007/12/06,151,22,0.970372595,17982,151,14,8
13459,2014/03/31,2011/09/08,43,15,0.6705591639999999,26021,43,0,15
13460,2014/03/31,2006/11/30,95,15,0.90465882,19286,95,7,8
13461,2014/03/31,2006/09/23,106,19,0.788596095,22124,106,15,4
13462,2014/03/31,2012/02/15,2,15,0.838239958,20812,2,4,11
13463,2014/03/31,2012/12/01,195,24,0.8360296159999999,20867,195,2,22
13464,2014/03/31,2011/09/11,47,17,0.81764342,21336,47,7,10
13465,2014/03/31,2011/07/29,25,19,0.8649038179999999,20170,25,3,16
13466,2014/03/31,2007/12/20,200,3,0.7666666670000001,22752,200,2,1
13467,2014/03/31,2013/01/10,14,22,0.606824491,28745,14,4,18
13468,2014/03/31,2012/07/05,269,8,1.400754156,12451,269,4,4
13469,2014/03/31,2011/07/13,5,15,0.730687531,23868,5,0,15
13470,2014/03/31,2009/08/25,5,14,0.69896296,24946,5,5,9
13471,2014/03/31,2006/11/14,61,32,0.450061948,38742,61,18,14
13472,2014/03/31,2011/05/24,116,13,0.7785501229999999,22395,116,9,4
13473,2014/03/31,2011/03/15,7,16,0.616105378,28298,7,8,8
13474,2014/03/31,2010/08/31,65,18,0.6925031779999999,25176,65,7,11
13475,2014/03/31,2012/03/14,10,15,0.763323408,22838,10,2,13
13476,2014/03/31,2012/09/02,13,13,0.6626118520000001,26307,13,5,8
13477,2014/03/31,2010/10/07,118,24,0.955603618,18240,118,17,7
13478,2014/03/31,2012/03/05,36,9,0.729438748,23893,36,2,7
13479,2014/03/31,2007/05/09,99,11,1.030813273,16907,99,3,8
13480,2014/03/31,2008/02/21,12,25,0.773989163,22516,12,2,23
13481,2014/03/31,2011/09/25,13,21,0.540887985,32219,13,5,16
13482,2014/03/31,2007/05/26,16,10,0.642694549,27114,16,6,4
13483,2014/03/31,2011/06/30,354,11,0.962259775,18108,354,9,2
13484,2014/03/31,2012/12/26,9,23,0.617839994,28199,9,2,21
13485,2014/03/31,2008/07/10,119,7,1.4293157769999998,12189,119,2,5
13486,2014/03/31,2006/03/28,30,8,0.76625,22736,30,7,1
13487,2014/03/31,2012/04/16,150,20,0.70980194,24538,150,12,8
13488,2014/03/31,2010/01/04,3,6,1.231734088,14140,3,0,6
13489,2014/03/31,2007/01/18,21,20,0.776172564,22438,21,12,8
13490,2014/03/31,2013/03/01,39,19,0.722997758,24088,39,2,17
13491,2014/03/31,2011/11/15,266,15,0.658118434,26462,266,14,1
13492,2014/03/31,2013/01/17,18,27,0.664499351,26206,18,5,22
13493,2014/03/31,2006/08/05,17,25,0.6558000979999999,26553,17,11,14
13494,2014/03/31,2009/04/01,24,17,0.8745623020000001,19911,24,5,12
13495,2014/03/31,2010/09/02,193,12,0.912257557,19087,193,5,7
13496,2014/03/31,2005/04/06,27,12,0.92434995,18837,27,11,1
13497,2014/03/31,2011/10/28,27,18,0.745469767,23352,27,1,17
13498,2014/03/31,2007/06/03,189,19,0.80272895,21686,189,12,7
13499,2014/03/31,2012/01/18,122,15,0.749216564,23231,122,12,3
13500,2014/03/31,2009/07/13,13,9,0.968108138,17977,13,2,7
13501,2014/03/31,2012/09/15,24,7,0.7562718420000001,23006,24,2,5
13502,2014/03/31,2010/05/01,21,17,0.645208619,26963,21,10,7
13503,2014/03/31,2010/03/13,116,20,0.653539334,26618,116,18,2
13504,2014/03/31,2011/05/27,131,16,0.788459412,22063,131,11,5
13505,2014/03/31,2008/02/24,12,16,0.720391385,24145,12,9,7
13506,2014/03/31,2008/05/04,246,6,0.693730057,25072,246,2,4
13507,2014/03/31,2011/11/16,8,24,0.61757608,28161,8,4,20
13508,2014/03/31,2011/10/21,39,3,0.763274371,22783,39,1,2
13509,2014/03/31,2009/01/11,37,3,0.763274371,22783,37,0,3
13510,2014/03/31,2010/12/11,1,17,0.8485794459999999,20492,1,14,3
13511,2014/03/31,2012/12/22,1,14,1.112543826,15630,1,4,10
13512,2014/03/31,2011/09/14,7,19,0.5400459639999999,32199,7,3,16
13513,2014/03/31,2009/08/27,6,27,0.521590411,33331,6,11,16
13514,2014/03/31,2005/06/01,1,17,0.561899929,30938,1,6,11
13515,2014/03/31,2006/07/24,32,24,0.828471547,20982,32,11,13
13516,2014/03/31,2007/06/02,228,13,0.7160203490000001,24276,228,5,8
13517,2014/03/31,2007/02/16,1,21,0.777679091,22349,1,3,18
13518,2014/03/31,2012/02/22,101,10,1.153300597,15070,101,4,6
13519,2014/03/31,2007/02/04,78,19,0.889720999,19534,78,9,10
13520,2014/03/31,2007/05/16,132,26,0.589176415,29493,132,14,12
13521,2014/03/31,2012/05/10,103,21,0.815086312,21318,103,7,14
13522,2014/03/31,2006/09/12,137,11,1.194948766,14541,137,4,7
13523,2014/03/31,2011/02/16,110,9,1.125368223,15439,110,5,4
13524,2014/03/31,2010/03/02,116,14,0.767215402,22646,116,10,4
13525,2014/03/31,2011/12/16,376,18,0.5694444439999999,30510,376,18,0
13526,2014/03/31,2010/09/19,87,18,0.6952833359999999,24988,87,5,13
13527,2014/03/31,2011/04/02,50,21,0.697227886,24916,50,15,6
13528,2014/03/31,2007/07/05,6,22,0.793504477,21892,6,13,9
13529,2014/03/31,2012/03/30,64,19,0.74625725,23277,64,12,7
13530,2014/03/31,2011/07/06,41,22,0.6254555279999999,27770,41,9,13
13531,2014/03/31,2012/09/01,6,11,0.68,25542,6,5,6
13532,2014/03/31,2012/08/14,149,6,0.8076323129999999,21502,149,1,5
13533,2014/03/31,2005/04/01,176,14,0.597142857,29078,176,8,6
13534,2014/03/31,2012/12/30,47,17,0.7063194079999999,24583,47,7,10
13535,2014/03/31,2006/04/05,82,7,1.35882376,12778,82,0,7
13536,2014/03/31,2009/10/04,336,35,0.7036310590000001,24676,336,30,5
13537,2014/03/31,2010/03/03,58,9,1.31064241,13247,58,6,3
13538,2014/03/31,2007/05/10,26,23,0.795248958,21831,26,10,13
13539,2014/03/31,2009/08/17,115,10,1.009767347,17193,115,6,4
13540,2014/03/31,2006/12/25,75,14,0.8667309040000001,20030,75,11,3
13541,2014/03/31,2011/06/12,21,15,0.7276587720000001,23855,21,6,9
13542,2014/03/31,2007/03/16,318,11,1.331221234,13036,318,8,3
13543,2014/03/31,2006/10/04,21,21,0.786049735,22077,21,12,9
13544,2014/03/31,2009/04/14,157,17,0.633063257,27412,157,9,8
13545,2014/03/31,2012/08/23,132,20,0.667170704,26010,132,13,7
13546,2014/03/31,2012/03/03,40,16,0.832675752,20839,40,4,12
13547,2014/03/31,2011/10/17,96,20,0.719397935,24117,96,12,8
13548,2014/03/31,2010/10/13,31,14,0.63,27538,31,7,7
13549,2014/03/31,2010/08/03,81,16,0.69099534,25107,81,11,5
13550,2014/03/31,2009/10/02,166,14,0.720799053,24066,166,11,3
13551,2014/03/31,2011/04/19,419,14,0.957601855,18114,419,14,0
13552,2014/03/31,2013/03/04,21,19,0.815923609,21259,21,0,19
13553,2014/03/31,2010/07/30,8,21,0.732437819,23681,8,9,12
13554,2014/03/31,2008/10/15,6,13,0.716434797,24209,6,8,5
13555,2014/03/31,2011/11/30,6,8,0.777108164,22318,6,6,2
13556,2014/03/31,2012/06/13,16,24,0.677133877,25613,16,6,18
13557,2014/03/31,2012/05/19,56,11,0.703081945,24663,56,9,2
13558,2014/03/31,2008/03/03,1,39,0.6889034559999999,25170,1,16,23
13559,2014/03/31,2006/06/25,50,19,0.6768479190000001,25618,50,5,14
13560,2014/03/31,2010/12/30,15,26,0.7066248270000001,24538,15,10,16
13561,2014/03/31,2005/08/18,73,18,0.462812033,37464,73,8,10
13562,2014/03/31,2011/12/27,90,8,0.8736171709999999,19847,90,5,3
13563,2014/03/31,2010/09/09,48,19,0.7474353340000001,23196,48,12,7
13564,2014/03/31,2007/04/03,11,8,1.011969414,17132,11,4,4
13565,2014/03/31,2012/06/30,78,13,0.8765220690000001,19779,78,6,7
13566,2014/03/31,2006/09/05,233,19,0.816350193,21234,233,14,5
13567,2014/03/31,2006/08/23,68,23,0.6945452,24956,68,15,8
13568,2014/03/31,2013/01/30,11,29,0.8941642590000001,19384,11,9,20
13569,2014/03/31,2010/12/26,15,13,0.69550297,24912,15,5,8
13570,2014/03/31,2012/01/10,9,14,0.827386944,20941,9,0,14
13571,2014/03/31,2010/08/06,78,18,0.7025506890000001,24660,78,13,5
13572,2014/03/31,2006/10/25,17,8,0.673099188,25739,17,4,4
13573,2014/03/31,2011/03/16,279,14,0.695088268,24924,279,9,5
13574,2014/03/31,2012/12/13,126,16,0.6896317820000001,25121,126,8,8
13575,2014/03/31,2013/01/19,42,14,0.838459007,20662,42,2,12
13576,2014/03/31,2010/01/21,110,23,0.642503523,26962,110,15,8
13577,2014/03/31,2006/09/28,75,9,0.901942405,19203,75,7,2
13578,2014/03/31,2004/12/07,2,15,0.858640623,20171,2,8,7
13579,2014/03/31,2008/04/23,16,12,0.6890900409999999,25133,16,7,5
13580,2014/03/31,2010/07/14,31,14,0.6724814570000001,25751,31,11,3
13581,2014/03/31,2010/11/12,119,20,0.681271933,25418,119,10,10
13582,2014/03/31,2011/07/29,4,23,0.696647624,24857,4,11,12
13583,2014/03/31,2008/07/16,170,17,0.73328788,23614,170,5,12
13584,2014/03/31,2010/05/13,13,15,0.7046059,24575,13,8,7
13585,2014/03/31,2011/08/14,240,19,0.905953428,19110,240,15,4
13586,2014/03/31,2007/09/16,595,4,0.878047877,19717,595,4,0
13587,2014/03/31,2007/08/08,77,24,0.718977905,24078,77,21,3
13588,2014/03/31,2006/11/08,48,17,0.762019193,22717,48,7,10
13589,2014/03/31,2012/02/05,3,19,0.758295952,22828,3,6,13
13590,2014/03/31,2008/04/15,99,21,0.892036073,19405,99,17,4
13591,2014/03/31,2009/12/10,34,17,0.662017057,26147,34,7,10
13592,2014/03/31,2012/07/22,15,11,0.627209235,27591,15,4,7
13593,2014/03/31,2010/11/09,15,35,0.760255261,22761,15,20,15
13594,2014/03/31,2009/12/05,310,3,0.690502414,25059,310,0,3
13595,2014/03/31,2011/06/07,1,20,0.8284717429999999,20880,1,13,7
13596,2014/03/31,2005/07/23,82,17,0.725332718,23849,82,10,7
13597,2014/03/31,2006/05/18,354,12,0.935513791,18490,354,8,4
13598,2014/03/31,2008/06/24,145,21,0.6639015779999999,26051,145,10,11
13599,2014/03/31,2012/09/20,209,22,0.8701741059999999,19873,209,17,5
13600,2014/03/31,2007/12/28,16,12,1.12997582,15302,16,6,6
13601,2014/03/31,2010/04/08,128,12,0.651090854,26548,128,4,8
13602,2014/03/31,2011/10/18,8,14,1.014893717,17030,8,7,7
13603,2014/03/31,2008/09/26,71,14,0.6165997,28024,71,5,9
13604,2014/03/31,2012/08/06,39,17,0.699516638,24702,39,6,11
13605,2014/03/31,2011/02/28,45,15,0.458969557,37644,45,6,9
13606,2014/03/31,2012/07/20,25,13,0.724122233,23856,25,3,10
13607,2014/03/31,2010/07/26,10,19,0.695719119,24829,10,0,19
13608,2014/03/31,2005/04/01,114,13,0.84444803,20454,114,4,9
13609,2014/03/31,2005/01/23,28,18,0.6313183960000001,27359,28,7,11
13610,2014/03/31,2008/10/15,90,8,0.712638333,24235,90,0,8
13611,2014/03/31,2008/11/18,6,16,0.715558088,24136,6,3,13
13612,2014/03/31,2008/11/25,5,25,0.81389622,21218,5,8,17
13613,2014/03/31,2006/08/21,44,25,0.788829656,21891,44,17,8
13614,2014/03/31,2009/09/11,12,27,0.625110242,27621,12,11,16
13615,2014/03/31,2011/03/31,191,17,0.7261087509999999,23779,191,13,4
13616,2014/03/31,2012/12/17,35,17,0.7699032370000001,22426,35,2,15
13617,2014/03/31,2012/03/06,175,12,0.637271419,27091,175,7,5
13618,2014/03/31,2011/01/03,64,18,0.548204566,31491,64,5,13
13619,2014/03/31,2011/07/26,139,33,0.6771068840000001,25495,139,21,12
13620,2014/03/31,2005/12/21,174,16,0.654115797,26391,174,7,9
13621,2014/03/31,2012/11/19,125,10,0.724664148,23820,125,5,5
13622,2014/03/31,2005/12/19,88,11,1.225455449,14085,88,6,5
13623,2014/03/31,2011/05/12,96,3,0.7566654979999999,22810,96,2,1
13624,2014/03/31,2008/01/13,10,30,0.697719922,24736,10,12,18
13625,2014/03/31,2012/01/05,298,12,0.8240318040000001,20941,298,11,1
13626,2014/03/31,2010/09/02,20,20,0.7926863890000001,21769,20,10,10
13627,2014/03/31,2012/08/30,59,19,0.820653477,21026,59,6,13
13628,2014/03/31,2010/04/17,62,23,0.6483860779999999,26606,62,16,7
13629,2014/03/31,2007/09/23,3,13,0.78823989,21885,3,5,8
13630,2014/03/31,2010/05/16,137,14,0.774763744,22264,137,9,5
13631,2014/03/31,2012/12/12,159,10,0.682108989,25287,159,4,6
13632,2014/03/31,2010/07/06,1,12,0.7401656440000001,23303,1,0,12
13633,2014/03/31,2009/07/25,39,15,0.900363855,19156,39,9,6
13634,2014/03/31,2010/11/07,32,16,0.740166509,23302,32,8,8
13635,2014/03/31,2008/11/18,108,24,0.6765113359999999,25494,108,18,6
13636,2014/03/31,2012/10/23,70,19,0.671622011,25678,70,5,14
13637,2014/03/31,2009/03/23,84,20,0.709901618,24293,84,12,8
13638,2014/03/31,2011/02/24,101,28,0.604218843,28541,101,21,7
13639,2014/03/31,2009/08/25,8,12,0.828337977,20818,8,8,4
13640,2014/03/31,2009/09/17,6,18,0.814197554,21179,6,10,8
13641,2014/03/31,2006/08/30,5,12,1.053532107,16367,5,4,8
13642,2014/03/31,2009/03/03,11,18,0.80459356,21430,11,13,5
13643,2014/03/31,2004/11/01,94,29,0.7173327509999999,24036,94,12,17
13644,2014/03/31,2007/06/09,36,16,0.66745035,25831,36,8,8
13645,2014/03/31,2008/01/22,46,3,0.7567256290000001,22783,46,2,1
13646,2014/03/31,2012/09/27,134,16,0.7813334540000001,22063,134,4,12
13647,2014/03/31,2006/11/22,99,22,0.801114881,21518,99,11,11
13648,2014/03/31,2007/01/17,58,21,0.667281384,25833,58,14,7
13649,2014/03/31,2010/04/13,31,21,0.622305109,27695,31,8,13
13650,2014/03/31,2006/08/09,30,18,0.693514025,24849,30,11,7
13651,2014/03/31,2011/09/14,31,16,0.609731097,28263,31,6,10
13652,2014/03/31,2012/07/17,5,16,0.7474759259999999,23054,5,9,7
13653,2014/03/31,2010/04/02,199,2,0.85,20272,199,0,2
13654,2014/03/31,2012/06/28,24,22,0.587942812,29307,24,18,4
13655,2014/03/31,2012/11/07,51,4,0.653219349,26378,51,2,2
13656,2014/03/31,2005/09/19,136,19,0.4583097920000001,37593,136,13,6
13657,2014/03/31,2011/11/28,12,18,0.742570037,23202,12,9,9
13658,2014/03/31,2011/11/14,39,18,0.61888354,27838,39,10,8
13659,2014/03/31,2006/04/21,9,33,0.724846215,23767,9,16,17
13660,2014/03/31,2009/08/11,251,23,0.727936702,23666,251,19,4
13661,2014/03/31,2007/06/15,76,17,0.7383982,23330,76,16,1
13662,2014/03/31,2011/03/28,66,14,0.61124796,28182,66,6,8
13663,2014/03/31,2011/04/16,2,23,0.6219055529999999,27698,2,10,13
13664,2014/03/31,2007/02/06,73,17,0.675649837,25491,73,9,8
13665,2014/03/31,2012/12/22,204,32,0.6265625,27488,204,13,19
13666,2014/03/31,2011/06/19,102,17,0.657580374,26190,102,14,3
13667,2014/03/31,2013/01/11,28,21,0.886816005,19419,28,8,13
13668,2014/03/31,2012/10/31,33,24,0.7262529520000001,23712,33,12,12
13669,2014/03/31,2010/02/02,218,18,0.8727843670000001,19728,218,11,7
13670,2014/03/31,2012/08/31,9,17,0.626325439,27489,9,2,15
13671,2014/03/31,2010/07/14,48,18,0.749869338,22960,48,4,14
13672,2014/03/31,2011/08/29,101,10,0.915452515,18806,101,3,7
13673,2014/03/31,2007/12/09,5,14,0.72800406,23648,5,5,9
13674,2014/03/31,2008/11/07,58,3,0.7566666670000001,22752,58,1,2
13675,2014/03/31,2011/02/02,74,16,0.72009035,23907,74,13,3
13676,2014/03/31,2010/05/08,56,14,0.73552617,23405,56,2,12
13677,2014/03/31,2005/03/15,3,29,0.7027453459999999,24496,3,9,20
13678,2014/03/31,2009/11/08,147,14,0.741588403,23212,147,9,5
13679,2014/03/31,2012/07/12,99,17,0.7912490809999999,21752,99,5,12
13680,2014/03/31,2009/07/01,1,14,0.81770287,21048,1,7,7
13681,2014/03/31,2005/09/13,111,22,0.783159811,21976,111,13,9
13682,2014/03/31,2010/08/24,11,19,0.677909084,25386,11,0,19
13683,2014/03/31,2008/09/28,12,22,0.950888496,18098,12,1,21
13684,2014/03/31,2006/11/15,56,14,0.808703417,21279,56,10,4
13685,2014/03/31,2008/09/03,108,19,0.615058083,27977,108,9,10
13686,2014/03/31,2011/06/06,73,8,0.98303548,17503,73,3,5
13687,2014/03/31,2007/06/14,73,8,1.154951319,14893,73,5,3
13688,2014/03/31,2011/12/22,6,23,0.571875104,30073,6,13,10
13689,2014/03/31,2010/08/02,13,26,0.751946303,22869,13,0,26
13690,2014/03/31,2011/08/02,249,10,0.7467577190000001,23027,249,3,7
13691,2014/03/31,2005/08/01,39,21,0.690946277,24887,39,12,9
13692,2014/03/31,2012/09/08,83,14,0.7666822740000001,22425,83,5,9
13693,2014/03/31,2005/05/13,32,13,0.70714556,24313,32,10,3
13694,2014/03/31,2005/10/29,69,16,0.7528159209999999,22838,69,10,6
13695,2014/03/31,2011/01/04,9,12,0.678818512,25324,9,6,6
13696,2014/03/31,2008/02/03,33,23,0.778048792,22094,33,12,11
13697,2014/03/31,2010/12/14,41,22,0.721202853,23835,41,5,17
13698,2014/03/31,2012/08/22,6,18,0.627631185,27385,6,4,14
13699,2014/03/31,2012/03/24,49,4,1.249266555,13757,49,2,2
13700,2014/03/31,2011/09/26,1,15,0.81780908,21014,1,9,6
13701,2014/03/31,2008/03/10,30,13,0.941444615,18254,30,9,4
13702,2014/03/31,2011/07/31,19,23,0.650820709,26404,19,0,23
13703,2014/03/31,2010/07/27,99,20,0.634179187,27089,99,5,15
13704,2014/03/31,2010/10/15,177,13,0.641758509,26767,177,12,1
13705,2014/03/31,2006/04/25,15,18,0.7543434920000001,22772,15,8,10
13706,2014/03/31,2012/01/20,18,5,0.502041735,34216,18,0,5
13707,2014/03/31,2007/08/09,21,14,0.79615028,21573,21,2,12
13708,2014/03/31,2005/06/26,51,29,0.801114324,21439,51,18,11
13709,2014/03/31,2012/06/17,581,23,0.436757451,39324,581,23,0
13710,2014/03/31,2008/07/22,80,20,0.735838903,23340,80,14,6
13711,2014/03/31,2005/10/14,3,22,0.778463421,22062,3,11,11
13712,2014/03/31,2013/03/01,8,18,0.668268991,25696,8,0,18
13713,2014/03/31,2006/03/25,201,7,1.01094924,16982,201,2,5
13714,2014/03/31,2007/05/07,18,21,0.861438679,19928,18,9,12
13715,2014/03/31,2009/03/12,198,17,0.584137063,29388,198,4,13
13716,2014/03/31,2012/01/28,11,30,0.8315025429999999,20645,11,18,12
13717,2014/03/31,2005/04/16,110,15,0.676085313,25389,110,4,11
13718,2014/03/31,2013/03/16,42,12,0.8330146559999999,20606,42,2,10
13719,2014/03/31,2011/06/16,524,12,0.781648452,21960,524,12,0
13720,2014/03/31,2009/10/30,21,15,0.7647393509999999,22444,21,7,8
13721,2014/03/31,2008/07/03,45,11,1.1344843999999998,15128,45,5,6
13722,2014/03/31,2011/06/16,129,14,0.71653904,23950,129,7,7
13723,2014/03/31,2009/10/02,35,15,0.763528653,22476,35,12,3
13724,2014/03/31,2010/05/21,156,26,0.614601913,27921,156,19,7
13725,2014/03/31,2012/12/31,371,2,0.85,20188,371,2,0
13726,2014/03/31,2006/09/24,6,18,0.809414623,21200,6,4,14
13727,2014/03/31,2012/12/15,130,6,0.6753765009999999,25405,130,2,4
13728,2014/03/31,2007/07/12,49,19,0.7293143759999999,23526,49,13,6
13729,2014/03/31,2013/03/31,216,4,0.6447316999999999,26612,216,0,4
13730,2014/03/31,2011/08/18,27,19,0.8331034820000001,20593,27,6,13
13731,2014/03/31,2007/07/17,11,14,0.874944657,19605,11,2,12
13732,2014/03/31,2008/02/02,14,22,0.567701473,30215,14,18,4
13733,2014/03/31,2009/07/18,302,10,0.6309682520000001,27183,302,7,3
13734,2014/03/31,2007/04/27,19,23,0.868464226,19749,19,15,8
13735,2014/03/31,2012/08/23,41,14,0.868288361,19753,41,9,5
13736,2014/03/31,2005/02/20,1,22,0.8906992570000001,19249,1,15,7
13737,2014/03/31,2008/03/17,6,21,0.457360615,37486,6,5,16
13738,2014/03/31,2007/07/30,29,26,0.675283599,25388,29,19,7
13739,2014/03/31,2010/07/03,18,21,0.703113645,24383,18,9,12
13740,2014/03/31,2007/01/09,15,15,0.683807092,25069,15,10,5
13741,2014/03/31,2009/10/07,12,18,0.785789594,21815,12,2,16
13742,2014/03/31,2012/06/22,368,10,0.801507925,21387,368,10,0
13743,2014/03/31,2007/06/10,77,18,0.536429354,31955,77,3,15
13744,2014/03/31,2008/11/26,95,18,0.767361447,22338,95,16,2
13745,2014/03/31,2007/04/27,16,20,0.62905758,27249,16,11,9
13746,2014/03/31,2011/12/09,12,24,0.714658494,23982,12,7,17
13747,2014/03/31,2009/10/29,113,11,0.781774392,21923,113,5,6
13748,2014/03/31,2010/04/05,202,12,0.811886489,21108,202,6,6
13749,2014/03/31,2006/02/19,10,14,0.8493799559999999,20176,10,9,5
13750,2014/03/31,2012/12/26,66,10,0.738,23220,66,0,10
13751,2014/03/31,2011/01/24,24,23,0.809919652,21158,24,11,12
13752,2014/03/31,2009/02/19,78,19,0.731938405,23411,78,6,13
13753,2014/03/31,2006/05/18,16,17,0.675490892,25362,16,6,11
13754,2014/03/31,2004/11/30,14,6,1.2608861409999998,13587,14,1,5
13755,2014/03/31,2010/06/27,189,11,0.966937969,17717,189,7,4
13756,2014/03/31,2005/04/14,48,18,0.779860232,21965,48,3,15
13757,2014/03/31,2012/06/13,5,26,0.7320582959999999,23398,5,8,18
13758,2014/03/31,2011/03/20,69,19,0.6313468489999999,27130,69,16,3
13759,2014/03/31,2012/05/23,35,22,0.7775494820000001,22028,35,7,15
13760,2014/03/31,2008/03/22,3,11,0.597871056,28648,3,3,8
13761,2014/03/31,2012/07/12,618,2,0.7,24464,618,2,0
13762,2014/03/31,2011/08/19,559,2,0.7,24464,559,2,0
13763,2014/03/31,2012/06/23,632,2,0.7,24464,632,2,0
13764,2014/03/31,2008/11/07,136,15,1.100159974,15565,136,11,4
13765,2014/03/31,2011/06/14,195,13,0.635749025,26935,195,8,5
13766,2014/03/31,2008/06/26,87,18,0.8370922959999999,20456,87,10,8
13767,2014/03/31,2009/09/16,21,29,0.8384350979999999,20423,21,15,14
13768,2014/03/31,2010/06/19,178,13,0.624363331,27424,178,11,2
13769,2014/03/31,2007/05/07,171,8,1.037349573,16503,171,2,6
13770,2014/03/31,2008/04/17,37,20,0.705753216,24256,37,9,11
13771,2014/03/31,2011/08/15,26,12,0.742568863,23053,26,2,10
13772,2014/03/31,2012/02/28,9,30,0.812669958,21064,9,20,10
13773,2014/03/31,2006/07/25,25,25,0.509954716,33566,25,9,16
13774,2014/03/31,2007/12/19,4,19,0.7019084720000001,24386,4,12,7
13775,2014/03/31,2010/09/09,13,29,0.518073792,33039,13,11,18
13776,2014/03/31,2011/01/10,5,9,0.912742787,18751,5,6,3
13777,2014/03/31,2009/01/03,1,20,0.692526201,24713,1,8,12
13778,2014/03/31,2010/09/15,21,21,0.634757966,26959,21,3,18
13779,2014/03/31,2006/09/02,26,14,0.770647602,22205,26,6,8
13780,2014/03/31,2007/10/26,2,30,0.575310315,29744,2,14,16
13781,2014/03/31,2005/09/21,10,22,0.617763737,27698,10,8,14
13782,2014/03/31,2007/02/20,40,12,1.196638226,14299,40,9,3
13783,2014/03/31,2012/11/09,97,13,0.553022301,30940,97,2,11
13784,2014/03/31,2012/03/04,551,3,0.75,22814,551,3,0
13785,2014/03/31,2009/08/30,21,14,0.7598898559999999,22516,21,6,8
13786,2014/03/31,2010/01/04,18,21,0.733714568,23319,18,13,8
13787,2014/03/31,2012/05/03,80,19,0.658850035,25966,80,10,9
13788,2014/03/31,2009/07/12,128,25,0.76203118,22450,128,17,8
13789,2014/03/31,2005/03/10,19,15,0.7290159390000001,23464,19,6,9
13790,2014/03/31,2007/10/26,282,14,0.64394722,26563,282,9,5
13791,2014/03/31,2011/08/18,149,18,0.695627313,24589,149,11,7
13792,2014/03/31,2011/12/29,190,19,0.7,24434,190,10,9
13793,2014/03/31,2005/05/16,4,18,0.728773275,23469,4,12,6
13794,2014/03/31,2005/12/03,398,8,0.633441354,27001,398,8,0
13795,2014/03/31,2012/05/27,66,13,0.7438870040000001,22992,66,6,7
13796,2014/03/31,2012/09/03,34,21,0.7945523809999999,21525,34,13,8
13797,2014/03/31,2008/04/27,79,24,0.631481741,27083,79,12,12
13798,2014/03/31,2007/07/04,88,14,0.698459402,24484,88,7,7
13799,2014/03/31,2007/03/02,4,17,0.7125517729999999,23999,4,10,7
13800,2014/03/31,2012/06/15,145,8,0.819223915,20874,145,4,4
13801,2014/03/31,2010/01/07,8,23,0.82310373,20775,8,14,9
13802,2014/03/31,2007/07/29,80,15,0.653519205,26165,80,10,5
13803,2014/03/31,2007/06/30,177,7,0.562044177,30423,177,2,5
13804,2014/03/31,2012/11/02,25,12,0.761170369,22463,25,4,8
13805,2014/03/31,2005/09/09,433,23,0.754441356,22662,433,23,0
13806,2014/03/31,2010/02/28,69,24,0.555883462,30754,69,7,17
13807,2014/03/31,2008/08/15,159,12,0.840710211,20332,159,3,9
13808,2014/03/31,2010/04/08,11,18,0.748754162,22828,11,7,11
13809,2014/03/31,2006/07/08,72,15,0.681061252,25093,72,7,8
13810,2014/03/31,2006/03/31,284,24,0.7988489409999999,21389,284,19,5
13811,2014/03/31,2012/09/28,1,17,0.679040579,25161,1,8,9
13812,2014/03/31,2008/02/22,2,16,0.771969813,22129,2,0,16
13813,2014/03/31,2006/06/13,171,12,0.7204791229999999,23710,171,8,4
13814,2014/03/31,2008/05/09,57,14,0.915071517,18667,57,8,6
13815,2014/03/31,2012/10/13,26,19,0.634611898,26913,26,7,12
13816,2014/03/31,2010/10/15,36,7,0.769154245,22205,36,3,4
13817,2014/03/31,2011/10/22,212,17,0.606401151,28159,212,14,3
13818,2014/03/31,2012/01/25,71,13,0.901797824,18934,71,5,8
13819,2014/03/31,2012/05/20,198,11,0.6778743,25187,198,4,7
13820,2014/03/31,2013/02/05,12,20,0.609131909,28027,12,2,18
13821,2014/03/31,2011/11/08,26,14,0.663124199,25741,26,9,5
13822,2014/03/31,2011/09/04,15,20,0.618293063,27605,15,7,13
13823,2014/03/31,2011/05/11,353,3,0.75,22752,353,2,1
13824,2014/03/31,2009/11/20,17,19,0.699069158,24408,17,15,4
13825,2014/03/31,2012/04/17,444,16,0.7375,23136,444,16,0
13826,2014/03/31,2012/06/13,155,12,0.56162212,30380,155,3,9
13827,2014/03/31,2005/09/01,76,13,0.783183842,21785,76,9,4
13828,2014/03/31,2011/04/10,39,21,0.514614967,33153,39,17,4
13829,2014/03/31,2007/08/25,105,16,0.633515953,26923,105,4,12
13830,2014/03/31,2009/07/18,17,12,0.615191531,27724,17,5,7
13831,2014/03/31,2011/09/08,3,17,0.703721477,24235,3,8,9
13832,2014/03/31,2007/08/07,26,13,0.84091317,20281,26,6,7
13833,2014/03/31,2010/07/05,206,9,0.699125195,24394,206,4,5
13834,2014/03/31,2011/09/21,151,18,0.685330922,24885,151,7,11
13835,2014/03/31,2011/09/16,19,23,0.7730879420000001,22060,19,11,12
13836,2014/03/31,2010/09/27,66,19,0.816734362,20878,66,8,11
13837,2014/03/31,2006/10/24,80,17,0.7580088909999999,22495,80,4,13
13838,2014/03/31,2009/12/07,6,26,0.8178702990000001,20848,6,5,21
13839,2014/03/31,2012/04/27,26,21,0.6941004759999999,24563,26,13,8
13840,2014/03/31,2008/10/07,25,16,0.606962404,28088,25,12,4
13841,2014/03/31,2008/04/30,3,24,0.903813487,18862,3,0,24
13842,2014/03/31,2009/04/08,78,16,0.851602558,20018,78,7,9
13843,2014/03/31,2011/12/27,91,19,0.587156539,29028,91,6,13
13844,2014/03/31,2007/05/10,3,14,0.611403458,27874,3,6,8
13845,2014/03/31,2006/12/26,11,17,0.7066781390000001,24116,11,9,8
13846,2014/03/31,2010/08/02,145,19,0.710885997,23973,145,14,5
13847,2014/03/31,2011/09/14,13,13,0.7407172040000001,23006,13,8,5
13848,2014/03/31,2012/10/12,114,6,0.5431511170000001,31373,114,4,2
13849,2014/03/31,2008/05/12,82,22,0.7233527209999999,23554,82,14,8
13850,2014/03/31,2007/05/01,22,19,0.597658739,28506,22,4,15
13851,2014/03/31,2012/01/01,202,8,0.652244257,26120,202,3,5
13852,2014/03/31,2010/12/14,19,16,0.783937957,21727,19,7,9
13853,2014/03/31,2012/09/09,157,10,1.054241149,16156,157,6,4
13854,2014/03/31,2008/12/26,24,25,0.70528759,24149,24,9,16
13855,2014/03/31,2010/02/05,8,29,0.541736378,31439,8,2,27
13856,2014/03/31,2012/12/30,60,13,0.601283672,28325,60,0,13
13857,2014/03/31,2009/11/20,68,26,0.8629917909999999,19734,68,7,19
13858,2014/03/31,2005/09/09,1,17,0.83039208,20506,1,13,4
13859,2014/03/31,2007/02/22,8,18,0.74566674,22835,8,5,13
13860,2014/03/31,2011/09/16,31,24,0.7757761879999999,21947,31,9,15
13861,2014/03/31,2006/10/13,2,16,0.701794312,24260,2,10,6
13862,2014/03/31,2012/12/28,183,3,0.785883113,21662,183,1,2
13863,2014/03/31,2013/03/28,114,14,0.69750717,24406,114,0,14
13864,2014/03/31,2012/04/23,66,12,0.678333333,25092,66,5,7
13865,2014/03/31,2013/02/13,25,13,0.680986237,24994,25,1,12
13866,2014/03/31,2009/03/29,5,26,0.745645317,22826,5,16,10
13867,2014/03/31,2012/04/07,1,17,0.841341771,20227,1,5,12
13868,2014/03/31,2012/10/23,5,13,0.8144971999999999,20893,5,1,12
13869,2014/03/31,2012/10/26,86,8,0.656057299,25934,86,3,5
13870,2014/03/31,2012/08/14,14,29,0.6179720989999999,27526,14,10,19
13871,2014/03/31,2008/04/20,6,17,0.524414367,32435,6,8,9
13872,2014/03/31,2010/03/12,136,23,0.858762496,19806,136,10,13
13873,2014/03/31,2007/02/01,5,15,0.748223649,22732,5,7,8
13874,2014/03/31,2009/02/04,419,8,1.421164773,11968,419,8,0
13875,2014/03/31,2010/12/19,69,23,0.617214763,27556,69,20,3
13876,2014/03/31,2011/11/18,4,14,0.7363015709999999,23099,4,7,7
13877,2014/03/31,2007/06/14,5,28,0.762990445,22291,5,22,6
13878,2014/03/31,2012/05/21,406,17,1.183993595,14363,406,17,0
13879,2014/03/31,2012/12/06,139,3,0.5921533529999999,28718,139,0,3
13880,2014/03/31,2007/03/15,145,15,0.929806967,18287,145,7,8
13881,2014/03/31,2009/02/26,8,14,0.666273903,25520,8,9,5
13882,2014/03/31,2005/01/23,49,16,0.527505662,32233,49,13,3
13883,2014/03/31,2012/11/09,71,18,0.722937024,23517,71,3,15
13884,2014/03/31,2012/08/12,98,13,0.919615405,18487,98,6,7
13885,2014/03/31,2008/09/29,29,18,0.838930616,20264,29,10,8
13886,2014/03/31,2011/06/14,20,17,0.6944946479999999,24478,20,10,7
13887,2014/03/31,2008/02/26,18,17,0.743883249,22852,18,6,11
13888,2014/03/31,2012/11/23,39,17,0.56283756,30202,39,8,9
13889,2014/03/31,2012/08/25,9,19,0.5293913339999999,32103,9,10,9
13890,2014/03/31,2005/02/01,7,24,0.7333563479999999,23174,7,10,14
13891,2014/03/31,2010/12/14,8,18,0.788439588,21552,8,0,18
13892,2014/03/31,2007/03/18,22,14,0.657155896,25857,22,7,7
13893,2014/03/31,2011/12/01,148,11,0.7027158809999999,24180,148,5,6
13894,2014/03/31,2008/01/24,23,12,1.066570837,15931,23,4,8
13895,2014/03/31,2007/12/05,89,17,0.746009045,22774,89,5,12
13896,2014/03/31,2010/01/02,117,15,0.786638885,21597,117,8,7
13897,2014/03/31,2013/02/28,18,19,0.6527337360000001,26023,18,0,19
13898,2014/03/31,2008/12/04,507,15,0.962417134,17649,507,15,0
13899,2014/03/31,2011/12/21,10,28,0.7187998309999999,23630,10,16,12
13900,2014/03/31,2010/05/29,3,19,0.609256376,27877,3,13,6
13901,2014/03/31,2012/04/28,5,20,0.939313091,18081,5,8,12
13902,2014/03/31,2005/09/23,38,17,0.922288476,18414,38,5,12
13903,2014/03/31,2012/04/04,332,14,0.792857143,21420,332,12,2
13904,2014/03/31,2010/09/18,31,11,0.600139939,28298,31,1,10
13905,2014/03/31,2011/12/26,1,20,0.471044002,36044,1,5,15
13906,2014/03/31,2011/02/13,17,24,0.733009457,23157,17,9,15
13907,2014/03/31,2010/11/04,28,14,0.6939043340000001,24460,28,6,8
13908,2014/03/31,2012/02/14,75,18,0.632226485,26845,75,6,12
13909,2014/03/31,2007/10/16,247,8,1.375073732,12342,247,5,3
13910,2014/03/31,2008/02/27,50,6,0.782589125,21683,50,2,4
13911,2014/03/31,2008/05/15,106,18,0.699266463,24266,106,12,6
13912,2014/03/31,2011/07/11,152,23,0.596218591,28455,152,21,2
13913,2014/03/31,2006/10/23,10,17,0.739096414,22953,10,8,9
13914,2014/03/31,2012/05/11,13,10,1.438418419,11792,13,4,6
13915,2014/03/31,2012/07/19,21,27,0.8536767670000001,19868,21,17,10
13916,2014/03/31,2007/05/24,29,18,0.5583419479999999,30373,29,6,12
13917,2014/03/31,2011/03/18,2,27,0.744333494,22783,2,15,12
13918,2014/03/31,2011/10/01,33,18,0.6970437359999999,24328,33,12,6
13919,2014/03/31,2011/03/06,12,21,0.827386552,20494,12,6,15
13920,2014/03/31,2009/08/01,140,7,1.288374744,13161,140,5,2
13921,2014/03/31,2011/12/21,37,24,0.607585119,27902,37,13,11
13922,2014/03/31,2010/05/10,43,28,0.674617558,25128,43,15,13
13923,2014/03/31,2011/11/20,66,8,0.753838662,22487,66,0,8
13924,2014/03/31,2009/11/19,89,13,0.820355242,20662,89,3,10
13925,2014/03/31,2008/06/20,178,7,1.483274685,11424,178,4,3
13926,2014/03/31,2013/02/04,1,13,0.615673692,27520,1,2,11
13927,2014/03/31,2006/08/30,35,21,0.759540462,22305,35,10,11
13928,2014/03/31,2012/12/12,61,13,1.3675240169999998,12387,61,4,9
13929,2014/03/31,2011/08/16,6,25,0.668699668,25332,6,8,17
13930,2014/03/31,2009/12/29,22,20,0.7625105790000001,22214,22,13,7
13931,2014/03/31,2011/09/19,1,24,0.6922974740000001,24466,1,14,10
13932,2014/03/31,2009/08/24,77,14,0.642168341,26375,77,8,6
13933,2014/03/31,2006/05/04,4,19,0.563732526,30044,4,11,8
13934,2014/03/31,2012/03/10,3,23,0.650043755,26054,3,4,19
13935,2014/03/31,2013/01/12,22,22,0.842258305,20108,22,2,20
13936,2014/03/31,2012/06/16,3,18,0.536291324,31580,3,8,10
13937,2014/03/31,2007/04/03,28,24,0.873611039,19385,28,10,14
13938,2014/03/31,2012/11/06,97,11,0.531214003,31878,97,6,5
13939,2014/03/31,2012/10/16,184,10,0.905350192,18704,184,7,3
13940,2014/03/31,2009/09/06,49,15,0.61773631,27411,49,8,7
13941,2014/03/31,2008/05/29,101,20,0.667545437,25365,101,8,12
13942,2014/03/31,2007/11/22,118,17,0.805187123,21029,118,9,8
13943,2014/03/31,2010/05/14,399,9,0.666666667,25398,399,9,0
13944,2014/03/31,2011/03/05,32,13,0.783538341,21609,32,4,9
13945,2014/03/31,2009/04/19,82,13,0.73926382,22902,82,1,12
13946,2014/03/31,2012/06/15,37,10,0.78297891,21622,37,5,5
13947,2014/03/31,2009/12/27,58,19,0.862375325,19631,58,6,13
13948,2014/03/31,2012/01/11,13,20,0.676314423,25030,13,7,13
13949,2014/03/31,2012/06/01,46,19,0.744420405,22740,46,10,9
13950,2014/03/31,2010/03/02,11,25,0.695508074,24337,11,10,15
13951,2014/03/31,2009/01/08,10,16,0.65425689,25871,10,5,11
13952,2014/03/31,2011/12/15,11,19,0.747178242,22649,11,9,10
13953,2014/03/31,2012/12/30,6,21,0.845220518,20021,6,2,19
13954,2014/03/31,2009/06/05,46,11,0.98073093,17252,46,4,7
13955,2014/03/31,2006/04/07,16,11,0.592402213,28557,16,4,7
13956,2014/03/31,2008/01/30,68,11,0.771377502,21931,68,6,5
13957,2014/03/31,2009/02/09,4,14,1.154148189,14657,4,6,8
13958,2014/03/31,2006/03/10,30,13,0.464683809,36402,30,6,7
13959,2014/03/31,2012/01/16,69,14,0.763146853,22165,69,6,8
13960,2014/03/31,2006/09/21,186,4,0.6453521560000001,26210,186,0,4
13961,2014/03/31,2008/09/28,125,16,1.043317088,16210,125,10,6
13962,2014/03/31,2011/06/29,34,17,0.966156878,17504,34,9,8
13963,2014/03/31,2012/02/21,62,14,0.745988531,22670,62,7,7
13964,2014/03/31,2008/10/21,1,16,0.6440562160000001,26256,1,4,12
13965,2014/03/31,2010/01/30,9,20,0.8242600179999999,20514,9,12,8
13966,2014/03/31,2009/02/28,296,19,0.7717890079999999,21906,296,14,5
13967,2014/03/31,2011/04/03,102,14,0.59369469,28476,102,7,7
13968,2014/03/31,2012/06/13,363,12,0.848048658,19935,363,11,1
13969,2014/03/31,2012/12/18,6,24,0.618521879,27332,6,4,20
13970,2014/03/31,2012/09/28,359,15,0.650219239,25999,359,14,1
13971,2014/03/31,2006/07/10,29,18,0.579162327,29188,29,5,13
13972,2014/03/31,2007/10/28,3,12,0.906201887,18654,3,5,7
13973,2014/03/31,2005/03/01,37,13,1.009512632,16743,37,5,8
13974,2014/03/31,2011/09/06,1,30,0.6751687909999999,25031,1,14,16
13975,2014/03/31,2008/01/19,44,21,0.763892053,22122,44,14,7
13976,2014/03/31,2008/04/25,79,16,0.6640274279999999,25448,79,9,7
13977,2014/03/31,2012/10/03,4,27,0.5530029129999999,30557,4,9,18
13978,2014/03/31,2005/10/13,67,22,0.661189889,25557,67,14,8
13979,2014/03/31,2006/03/30,339,12,0.7248327040000001,23312,339,10,2
13980,2014/03/31,2006/12/08,46,23,0.6884203879999999,24544,46,11,12
13981,2014/03/31,2012/10/01,133,16,0.602089377,28061,133,9,7
13982,2014/03/31,2013/01/11,20,26,0.7039291670000001,24000,20,2,24
13983,2014/03/31,2007/09/10,73,23,0.7259520429999999,23271,73,18,5
13984,2014/03/31,2008/09/14,49,17,0.75579456,22352,49,5,12
13985,2014/03/31,2006/08/02,66,10,0.715513765,23610,66,5,5
13986,2014/03/31,2013/03/19,9,15,1.163235092,14522,9,1,14
13987,2014/03/31,2005/10/11,315,11,0.8330530209999999,20275,315,7,4
13988,2014/03/31,2008/08/19,36,14,0.670910463,25174,36,9,5
13989,2014/03/31,2012/05/13,30,15,0.708740557,23828,30,4,11
13990,2014/03/31,2012/03/29,87,20,0.671931877,25131,87,7,13
13991,2014/03/31,2008/04/27,3,14,0.7794982,21662,3,3,11
13992,2014/03/31,2011/04/26,9,19,0.6030969820000001,27995,9,10,9
13993,2014/03/31,2012/06/20,140,28,0.5402912089999999,31249,140,4,24
13994,2014/03/31,2012/08/06,59,16,0.706041736,23912,59,3,13
13995,2014/03/31,2012/09/17,105,19,0.561567375,30063,105,7,12
13996,2014/03/31,2008/08/14,34,14,0.8666175490000001,19477,34,0,14
13997,2014/03/31,2012/11/29,67,23,0.7031900179999999,24003,67,9,14
13998,2014/03/31,2012/07/06,17,21,0.7221743970000001,23372,17,8,13
13999,2014/03/31,2010/10/11,88,10,0.593983108,28415,88,3,7
14000,2014/03/31,2006/04/21,50,13,1.102438594,15308,50,0,13
14001,2014/03/31,2010/10/25,93,13,0.815850133,20685,93,11,2
14002,2014/03/31,2012/07/29,71,13,0.812339913,20770,71,10,3
14003,2014/03/31,2009/06/29,333,14,0.792722233,21284,333,12,2
14004,2014/03/31,2012/06/22,107,16,0.8187091759999999,20607,107,10,6
14005,2014/03/31,2011/04/12,9,17,0.665405459,25354,9,9,8
14006,2014/03/31,2010/10/15,15,15,0.952406142,17713,15,0,15
14007,2014/03/31,2005/10/08,15,26,0.681546325,24749,15,13,13
14008,2014/03/31,2006/04/29,192,15,0.664962548,25366,192,10,5
14009,2014/03/31,2011/03/19,34,36,0.76847002,21948,34,3,33
14010,2014/03/31,2005/10/24,228,23,0.586399291,28761,228,21,2
14011,2014/03/31,2008/01/24,4,24,0.954627271,17667,4,11,13
14012,2014/03/31,2007/06/13,70,18,0.6718600570000001,25096,70,12,6
14013,2014/03/31,2010/06/04,134,8,0.65936647,25571,134,0,8
14014,2014/03/31,2008/04/13,27,12,0.774271675,21776,27,6,6
14015,2014/03/31,2006/10/13,26,17,0.7528873209999999,22391,26,9,8
14016,2014/03/31,2006/10/23,14,23,0.670961309,25122,14,7,16
14017,2014/03/31,2012/06/15,11,20,0.7425431720000001,22700,11,13,7
14018,2014/03/31,2013/02/14,3,12,0.80383823,20968,3,4,8
14019,2014/03/31,2011/12/30,3,28,0.775813119,21725,3,13,15
14020,2014/03/31,2012/12/13,2,63,0.6609262379999999,25501,2,8,55
14021,2014/03/31,2011/01/05,7,25,0.801131762,21038,7,14,11
14022,2014/03/31,2008/01/27,383,8,1.438300051,11718,383,8,0
14023,2014/03/31,2008/02/06,216,16,0.807120073,20879,216,15,1
14024,2014/03/31,2006/11/01,9,26,0.573788735,29366,9,14,12
14025,2014/03/31,2011/06/09,117,19,0.928413136,18149,117,11,8
14026,2014/03/31,2005/07/12,113,15,0.61272519,27499,113,7,8
14027,2014/03/31,2009/10/14,6,35,0.751012749,22434,6,8,27
14028,2014/03/31,2009/10/16,22,21,0.6438428620000001,26168,22,12,9
14029,2014/03/31,2009/05/20,3,16,0.8147265340000001,20679,3,4,12
14030,2014/03/31,2006/11/01,30,23,0.7706568779999999,21861,30,7,16
14031,2014/03/31,2011/10/16,8,29,0.7288379840000001,23115,8,13,16
14032,2014/03/31,2008/03/25,190,20,0.797448168,21126,190,18,2
14033,2014/03/31,2012/06/28,2,16,0.7220045429999999,23332,2,11,5
14034,2014/03/31,2010/02/09,507,15,0.7659542540000001,21991,507,15,0
14035,2014/03/31,2010/03/01,25,16,0.8855888540000001,19020,25,10,6
14036,2014/03/31,2013/03/13,138,7,0.6012157770000001,28015,138,2,5
14037,2014/03/31,2011/03/19,68,13,0.6827617659999999,24669,68,7,6
14038,2014/03/31,2011/10/12,11,30,0.635892614,26484,11,13,17
14039,2014/03/31,2013/03/01,4,17,0.617758621,27260,4,2,15
14040,2014/03/31,2011/09/06,109,16,0.8152561740000001,20650,109,8,8
14041,2014/03/31,2012/04/11,287,21,0.85995811,19575,287,15,6
14042,2014/03/31,2010/02/11,11,20,0.8284659679999999,20319,11,10,10
14043,2014/03/31,2009/04/08,98,17,0.668654114,25173,98,10,7
14044,2014/03/31,2009/04/13,23,16,0.695767848,24191,23,10,6
14045,2014/03/31,2013/01/18,96,7,0.912095279,18451,96,2,5
14046,2014/03/31,2009/03/11,125,11,0.658232809,25566,125,9,2
14047,2014/03/31,2005/04/29,188,4,0.649216049,25920,188,0,4
14048,2014/03/31,2007/03/27,390,11,0.893891102,18825,390,11,0
14049,2014/03/31,2011/05/30,110,17,0.982493723,17127,110,8,9
14050,2014/03/31,2010/12/17,16,16,0.800933067,21006,16,12,4
14051,2014/03/31,2009/08/08,26,14,0.927706645,18135,26,9,5
14052,2014/03/31,2012/10/30,2,17,0.457130241,36801,2,4,13
14053,2014/03/31,2011/03/21,16,20,0.922229715,18240,16,7,13
14054,2014/03/31,2005/10/08,12,16,0.995148503,16902,12,3,13
14055,2014/03/31,2010/10/07,16,20,0.615865036,27311,16,5,15
14056,2014/03/31,2006/12/01,40,20,0.694621706,24214,40,10,10
14057,2014/03/31,2004/11/07,56,12,0.668168997,25172,56,3,9
14058,2014/03/31,2006/06/30,13,8,0.7030549290000001,23922,13,0,8
14059,2014/03/31,2010/10/03,7,21,0.602458893,27915,7,6,15
14060,2014/03/31,2011/03/22,37,21,0.7150267859999999,23520,37,8,13
14061,2014/03/31,2008/01/12,23,22,0.724799793,23201,23,7,15
14062,2014/03/31,2011/02/23,353,12,0.6347129429999999,26493,353,10,2
14063,2014/03/31,2011/01/24,1,20,0.858385664,19587,1,6,14
14064,2014/03/31,2011/10/31,345,10,1.486507515,11310,345,6,4
14065,2014/03/31,2011/10/17,19,19,0.680888583,24691,19,7,12
14066,2014/03/31,2011/07/04,218,14,0.443932231,37864,218,9,5
14067,2014/03/31,2007/06/10,10,19,0.565112292,29744,10,10,9
14068,2014/03/31,2006/08/09,36,16,0.77810269,21599,36,9,7
14069,2014/03/31,2009/09/25,115,19,0.700603635,23988,115,12,7
14070,2014/03/31,2013/01/02,12,22,0.663031642,25346,12,4,18
14071,2014/03/31,2012/10/21,155,17,0.620688483,27074,155,10,7
14072,2014/03/31,2011/07/01,135,11,0.480246349,34991,135,8,3
14073,2014/03/31,2007/07/09,36,14,0.8719693820000001,19270,36,6,8
14074,2014/03/31,2008/10/10,9,13,0.7676676720000001,21888,9,9,4
14075,2014/03/31,2010/06/12,8,18,0.8358995020000001,20100,8,12,6
14076,2014/03/31,2011/05/08,29,14,0.856388011,19618,29,13,1
14077,2014/03/31,2008/11/18,106,15,0.724312136,23195,106,10,5
14078,2014/03/31,2012/11/23,97,13,0.7944318340000001,21147,97,5,8
14079,2014/03/31,2011/10/27,1,15,0.733195705,22912,1,8,7
14080,2014/03/31,2011/07/26,37,28,0.8335273390000001,20154,37,20,8
14081,2014/03/31,2011/09/19,261,14,0.624569825,26896,261,11,3
14082,2014/03/31,2010/11/15,116,14,0.825962238,20338,116,5,9
14083,2014/03/31,2011/01/17,350,20,0.8077318840000001,20797,350,19,1
14084,2014/03/31,2011/07/31,25,19,0.657470841,25550,25,3,16
14085,2014/03/31,2012/07/22,57,17,0.730965145,22981,57,5,12
14086,2014/03/31,2010/12/01,40,11,0.71193897,23595,40,3,8
14087,2014/03/31,2012/10/17,11,13,0.6572264170000001,25559,11,9,4
14088,2014/03/31,2012/04/25,47,11,0.7989455409999999,21025,47,1,10
14089,2014/03/31,2006/10/17,70,14,0.790329851,21252,70,10,4
14090,2014/03/31,2010/08/23,116,7,0.7428571429999999,22610,116,2,5
14091,2014/03/31,2011/09/02,474,4,1.3,12920,474,4,0
14092,2014/03/31,2006/04/04,140,17,0.6200874989999999,27086,140,11,6
14093,2014/03/31,2009/10/19,34,18,0.58152874,28880,34,10,8
14094,2014/03/31,2009/10/26,167,10,0.859702073,19535,167,7,3
14095,2014/03/31,2008/05/30,123,21,0.981327801,17111,123,13,8
14096,2014/03/31,2013/01/12,232,6,1.001655432,16763,232,3,3
14097,2014/03/31,2006/09/18,62,19,0.63200399,26567,62,13,6
14098,2014/03/31,2012/08/17,66,10,1.174180013,14299,66,3,7
14099,2014/03/31,2006/12/06,48,14,0.8150376229999999,20599,48,9,5
14100,2014/03/31,2012/08/31,18,20,0.8025,20920,18,7,13
14101,2014/03/31,2006/03/10,2,16,0.694547975,24169,2,3,13
14102,2014/03/31,2009/08/06,42,19,0.7086044159999999,23689,42,10,9
14103,2014/03/31,2005/02/25,2,18,0.833243485,20145,2,6,12
14104,2014/03/31,2013/02/15,45,14,0.656814055,25556,45,3,11
14105,2014/03/31,2007/01/14,115,13,0.732789226,22906,115,4,9
14106,2014/03/31,2009/02/01,51,12,0.611000874,27466,51,5,7
14107,2014/03/31,2011/06/03,152,15,0.75276108,22292,152,1,14
14108,2014/03/31,2007/04/19,109,11,0.7952466709999999,21101,109,5,6
14109,2014/03/31,2011/03/28,21,24,0.603488581,27805,21,8,16
14110,2014/03/31,2011/03/18,224,24,0.8000352820000001,20974,224,19,5
14111,2014/03/31,2011/11/01,18,16,0.859929278,19513,18,7,9
14112,2014/03/31,2011/12/04,349,9,0.7473276320000001,22452,349,6,3
14113,2014/03/31,2008/04/20,114,23,0.577951147,29026,114,10,13
14114,2014/03/31,2008/12/04,8,21,0.567196429,29573,8,17,4
14115,2014/03/31,2012/07/29,23,30,0.648975857,25846,23,7,23
14116,2014/03/31,2010/02/03,2,18,0.7114094240000001,23577,2,8,10
14117,2014/03/31,2008/11/24,9,17,0.8378030870000001,20019,9,9,8
14118,2014/03/31,2012/10/05,14,28,0.481374243,34841,14,15,13
14119,2014/03/31,2009/12/29,5,14,0.715891493,23427,5,5,9
14120,2014/03/31,2013/03/22,42,5,0.897324773,18690,42,1,4
14121,2014/03/31,2006/11/15,46,15,0.6236287229999999,26891,46,12,3
14122,2014/03/31,2012/03/03,174,8,0.99724548,16816,174,7,1
14123,2014/03/31,2012/08/19,380,10,1.029922614,16282,380,10,0
14124,2014/03/31,2011/07/28,120,16,0.78800282,21280,120,13,3
14125,2014/03/31,2008/04/13,11,13,0.716445755,23403,11,6,7
14126,2014/03/31,2008/12/27,12,21,0.5939920639999999,28226,12,6,15
14127,2014/03/31,2009/10/30,34,23,0.774646735,21641,34,14,9
14128,2014/03/31,2009/06/20,34,20,0.613509132,27323,34,7,13
14129,2014/03/31,2010/10/26,269,26,0.6783722529999999,24709,269,20,6
14130,2014/03/31,2011/03/08,23,20,0.77622777,21592,23,7,13
14131,2014/03/31,2013/01/23,5,18,0.869334959,19277,5,1,17
14132,2014/03/31,2009/10/29,21,9,1.28650238,13026,21,0,9
14133,2014/03/31,2010/02/26,130,13,0.923859852,18138,130,7,6
14134,2014/03/31,2010/04/23,90,21,0.688211279,24347,90,11,10
14135,2014/03/31,2008/05/24,72,4,0.664275293,25224,72,0,4
14136,2014/03/31,2011/04/16,345,13,0.8933747470000001,18754,345,12,1
14137,2014/03/31,2007/10/22,1,21,0.610174812,27458,1,7,14
14138,2014/03/31,2007/06/14,27,14,0.768433702,21803,27,7,7
14139,2014/03/31,2008/03/24,168,13,0.655812096,25545,168,10,3
14140,2014/03/31,2008/01/01,94,15,0.72103521,23232,94,13,2
14141,2014/03/31,2009/11/21,16,27,0.5123808360000001,32686,16,7,20
14142,2014/03/31,2012/03/31,230,13,0.677160249,24724,230,9,4
14143,2014/03/31,2011/11/08,253,19,0.5509081929999999,30390,253,16,3
14144,2014/03/31,2011/05/01,200,18,0.8719191709999999,19201,200,6,12
14145,2014/03/31,2008/09/25,86,6,0.8941278909999999,18719,86,0,6
14146,2014/03/31,2009/07/13,190,15,0.765693568,21858,190,6,9
14147,2014/03/31,2013/01/14,41,15,0.642470633,26050,41,5,10
14148,2014/03/31,2012/09/18,2,42,0.7481747059999999,22369,2,15,27
14149,2014/03/31,2006/07/21,105,20,0.47411158,35293,105,15,5
14150,2014/03/31,2007/02/18,22,21,0.620988717,26944,22,9,12
14151,2014/03/31,2007/06/05,4,24,0.5071018970000001,32994,4,15,9
14152,2014/03/31,2011/11/27,297,3,0.7333391779999999,22814,297,2,1
14153,2014/03/31,2007/02/20,512,11,0.750724768,22283,512,11,0
14154,2014/03/31,2013/01/10,171,20,0.663673477,25205,171,5,15
14155,2014/03/31,2012/07/12,64,13,0.604162904,27685,64,7,6
14156,2014/03/31,2007/07/18,49,35,0.707161762,23652,49,24,11
14157,2014/03/31,2009/08/26,121,8,0.6996155940000001,23907,121,3,5
14158,2014/03/31,2009/06/26,15,21,0.7912433170000001,21137,15,10,11
14159,2014/03/31,2011/10/05,401,16,0.981121671,17046,401,16,0
14160,2014/03/31,2010/05/16,53,20,0.7957939079999999,21010,53,4,16
14161,2014/03/31,2007/02/21,49,33,0.6476582470000001,25814,49,18,15
14162,2014/03/31,2012/01/03,116,18,0.585806791,28539,116,10,8
14163,2014/03/31,2010/02/08,128,18,0.6904406540000001,24214,128,10,8
14164,2014/03/31,2011/03/29,82,14,0.700705093,23855,82,6,8
14165,2014/03/31,2009/09/04,107,20,0.7308916390000001,22868,107,10,10
14166,2014/03/31,2012/09/07,3,12,0.860805521,19416,3,3,9
14167,2014/03/31,2012/10/13,321,5,1.018780859,16405,321,4,1
14168,2014/03/31,2013/01/15,11,39,0.58063095,28782,11,9,30
14169,2014/03/31,2012/01/30,91,12,0.7379862220000001,22644,91,9,3
14170,2014/03/31,2009/08/06,1,21,0.7240383029999999,23079,1,12,9
14171,2014/03/31,2007/04/19,36,13,0.701995127,23803,36,8,5
14172,2014/03/31,2006/12/06,25,17,0.878243456,19026,25,8,9
14173,2014/03/31,2009/12/04,37,14,0.963039769,17350,37,8,6
14174,2014/03/31,2012/05/28,43,20,0.7485529320000001,22321,43,8,12
14175,2014/03/31,2007/07/20,12,23,0.5258953129999999,31771,12,8,15
14176,2014/03/31,2011/10/10,298,11,0.915933337,18241,298,3,8
14177,2014/03/31,2007/12/11,69,20,0.661919968,25240,69,16,4
14178,2014/03/31,2012/09/21,36,21,0.7517346109999999,22224,36,10,11
14179,2014/03/31,2005/06/18,159,15,0.705222053,23688,159,9,6
14180,2014/03/31,2011/11/04,124,25,0.627322468,26629,124,18,7
14181,2014/03/31,2011/06/26,235,9,1.380319782,12102,235,6,3
14182,2014/03/31,2009/11/19,26,26,0.600354087,27818,26,14,12
14183,2014/03/31,2012/09/17,12,9,0.791116638,21108,12,4,5
14184,2014/03/31,2012/12/15,127,10,0.6333027379999999,26366,127,2,8
14185,2014/03/31,2010/10/07,129,14,0.623619691,26773,129,9,5
14186,2014/03/31,2012/12/16,28,15,1.163412084,14349,28,6,9
14187,2014/03/31,2006/11/09,37,29,0.892358475,18707,37,10,19
14188,2014/03/31,2006/01/04,13,16,0.658642336,25345,13,6,10
14189,2014/03/31,2012/01/22,66,10,0.774,21565,66,6,4
14190,2014/03/31,2011/10/07,6,10,0.72614548,22986,6,0,10
14191,2014/03/31,2013/01/20,17,15,0.696241188,23973,17,3,12
14192,2014/03/31,2008/04/27,57,27,0.70258514,23755,57,9,18
14193,2014/03/31,2006/01/16,49,13,0.7783076059999999,21443,49,4,9
14194,2014/03/31,2012/10/13,254,7,0.779314403,21412,254,5,2
14195,2014/03/31,2005/07/12,167,18,0.961976362,17345,167,15,3
14196,2014/03/31,2011/03/07,232,3,0.7333333329999999,22752,232,2,1
14197,2014/03/31,2009/03/07,11,17,0.81402176,20496,11,10,7
14198,2014/03/31,2007/10/05,38,18,0.8898074559999999,18749,38,15,3
14199,2014/03/31,2010/04/05,18,16,0.597345317,27928,18,4,12
14200,2014/03/31,2010/05/17,125,13,0.834922176,19981,125,4,9
14201,2014/03/31,2006/06/17,129,18,0.8549420870000001,19512,129,12,6
14202,2014/03/31,2012/10/21,2,14,0.685202103,24344,2,5,9
14203,2014/03/31,2007/01/01,86,14,0.605714286,27538,86,7,7
14204,2014/03/31,2010/02/13,4,29,0.882723472,18895,4,21,8
14205,2014/03/31,2006/06/20,14,17,0.666615372,25019,14,2,15
14206,2014/03/31,2006/02/14,1,29,0.94499405,17647,1,19,10
14207,2014/03/31,2012/03/06,49,9,0.699901788,23826,49,7,2
14208,2014/03/31,2006/04/29,220,24,0.706654518,23596,220,18,6
14209,2014/03/31,2012/10/24,70,11,0.629988287,26467,70,4,7
14210,2014/03/31,2013/01/19,2,15,0.673531812,24755,2,4,11
14211,2014/03/31,2011/05/25,18,5,0.529759771,31470,18,3,2
14212,2014/03/31,2007/02/10,11,18,0.8279850000000001,20134,11,4,14
14213,2014/03/31,2011/11/12,1,15,0.455929329,36564,1,4,11
14214,2014/03/31,2011/08/17,10,14,0.577903349,28846,10,4,10
14215,2014/03/31,2009/11/13,58,21,0.672115958,24802,58,6,15
14216,2014/03/31,2005/12/27,6,25,0.636691749,26180,6,10,15
14217,2014/03/31,2012/12/05,27,28,0.74050291,22509,27,2,26
14218,2014/03/31,2012/10/01,17,13,0.887502929,18778,17,4,9
14219,2014/03/31,2008/02/14,197,24,0.764282438,21803,197,16,8
14220,2014/03/31,2008/03/28,101,12,0.62724648,26566,101,2,10
14221,2014/03/31,2008/03/09,30,13,0.717897027,23210,30,7,6
14222,2014/03/31,2011/01/28,5,8,0.91370805,18236,5,4,4
14223,2014/03/31,2007/11/03,33,18,0.6064733929999999,27474,33,13,5
14224,2014/03/31,2011/08/01,12,15,0.740010215,22516,12,6,9
14225,2014/03/31,2011/07/15,248,13,0.779167602,21384,248,9,4
14226,2014/03/31,2008/04/17,154,13,0.8775665000000001,18985,154,10,3
14227,2014/03/31,2006/05/19,36,12,0.565561138,29458,36,7,5
14228,2014/03/31,2009/11/30,157,18,0.697048659,23901,157,11,7
14229,2014/03/31,2008/12/26,14,18,0.8211474759999999,20288,14,0,18
14230,2014/03/31,2008/11/07,4,23,0.68174333,24436,4,12,11
14231,2014/03/31,2012/03/28,153,17,0.8032466970000001,20738,153,10,7
14232,2014/03/31,2007/09/11,164,18,0.79351896,20992,164,11,7
14233,2014/03/31,2007/06/29,125,20,0.597487356,27879,125,18,2
14234,2014/03/31,2010/11/22,310,6,0.923814542,18031,310,5,1
14235,2014/03/31,2013/02/02,74,10,0.6846988690000001,24325,74,1,9
14236,2014/03/31,2013/02/24,187,2,0.825,20188,187,0,2
14237,2014/03/31,2007/11/21,118,12,1.418441227,11740,118,9,3
14238,2014/03/31,2009/09/13,158,18,0.774276282,21507,158,6,12
14239,2014/03/31,2011/08/03,6,31,0.774376395,21504,6,9,22
14240,2014/03/31,2011/05/01,55,23,0.536601895,31032,55,12,11
14241,2014/03/31,2011/06/25,11,22,0.880029598,18920,11,12,10
14242,2014/03/31,2012/12/21,94,23,0.83166292,20019,94,2,21
14243,2014/03/31,2012/11/13,33,14,0.627976689,26511,33,7,7
14244,2014/03/31,2007/08/27,5,25,0.708816742,23486,5,9,16
14245,2014/03/31,2006/11/08,208,13,0.7917435559999999,21026,208,8,5
14246,2014/03/31,2006/06/29,1,16,0.6673627870000001,24943,1,0,16
14247,2014/03/31,2005/09/09,1,28,0.6844730459999999,24319,1,13,15
14248,2014/03/31,2006/05/20,14,16,0.7788709,21371,14,5,11
14249,2014/03/31,2009/01/23,13,13,0.8735002359999999,19053,13,0,13
14250,2014/03/31,2012/04/19,13,27,0.7365215079999999,22596,13,6,21
14251,2014/03/31,2011/09/21,179,12,0.7289875579999999,22826,179,10,2
14252,2014/03/31,2010/01/14,30,17,0.650904468,25562,30,9,8
14253,2014/03/31,2010/09/12,30,11,0.731379841,22749,30,8,3
14254,2014/03/31,2011/12/14,11,16,0.7369274729999999,22571,11,9,7
14255,2014/03/31,2006/11/01,2,16,0.788483053,21095,2,4,12
14256,2014/03/31,2011/12/18,418,9,0.818019968,20333,418,9,0
14257,2014/03/31,2004/11/12,257,13,0.707899217,23496,257,8,5
14258,2014/03/31,2008/09/09,42,23,0.634583715,26208,42,10,13
14259,2014/03/31,2012/10/19,31,13,0.673483983,24693,31,4,9
14260,2014/03/31,2012/09/28,83,9,1.231751371,13498,83,2,7
14261,2014/03/31,2007/03/29,131,15,0.8240095159999999,20177,131,8,7
14262,2014/03/31,2012/08/13,101,2,0.82,20272,101,0,2
14263,2014/03/31,2005/11/07,10,21,0.669804562,24816,10,17,4
14264,2014/03/31,2006/08/24,83,17,0.7096345000000001,23420,83,7,10
14265,2014/03/31,2011/01/14,6,16,0.7363260970000001,22570,6,11,5
14266,2014/03/31,2010/02/24,82,14,1.000179958,16615,82,10,4
14267,2014/03/31,2008/01/04,10,15,0.7246899259999999,22930,10,8,7
14268,2014/03/31,2012/04/09,21,15,0.49343351,33674,21,10,5
14269,2014/03/31,2008/07/07,31,19,0.7416642859999999,22400,31,5,14
14270,2014/03/31,2008/06/01,121,24,0.745047986,22298,121,13,11
14271,2014/03/31,2009/09/18,14,16,0.7525267259999999,22076,14,5,11
14272,2014/03/31,2013/03/10,43,20,0.807009959,20585,43,2,18
14273,2014/03/31,2010/06/05,99,6,1.420063259,11698,99,1,5
14274,2014/03/31,2009/12/17,70,12,0.6208002539999999,26754,70,6,6
14275,2014/03/31,2008/03/15,181,16,0.718922078,23100,181,14,2
14276,2014/03/31,2007/05/18,4,18,0.830683307,19991,4,12,6
14277,2014/03/31,2008/01/16,14,20,0.804755997,20635,14,9,11
14278,2014/03/31,2005/06/22,60,15,0.881788976,18832,60,7,8
14279,2014/03/31,2009/07/10,96,10,0.856157257,19395,96,5,5
14280,2014/03/31,2012/04/03,52,34,0.591085556,28087,52,26,8
14281,2014/03/31,2010/07/25,2,26,0.602680102,27540,2,5,21
14282,2014/03/31,2007/11/23,12,13,0.623498629,26619,12,6,7
14283,2014/03/31,2012/04/21,6,27,0.791719697,20963,6,8,19
14284,2014/03/31,2010/05/01,8,19,0.5532605429999999,29995,8,4,15
14285,2014/03/31,2006/09/15,230,15,0.852677012,19462,230,12,3
14286,2014/03/31,2012/05/26,81,19,0.806299806,20580,81,6,13
14287,2014/03/31,2005/09/23,18,17,0.6217690260000001,26687,18,6,11
14288,2014/03/31,2006/12/04,29,14,0.749867125,22126,29,7,7
14289,2014/03/31,2011/10/12,33,16,0.613878774,27024,33,4,12
14290,2014/03/31,2007/04/26,10,10,1.347914195,12307,10,3,7
14291,2014/03/31,2008/12/05,16,19,0.536244989,30932,16,9,10
14292,2014/03/31,2013/03/28,140,9,0.66005611,25129,140,2,7
14293,2014/03/31,2012/08/15,46,17,0.621686223,26675,46,4,13
14294,2014/03/31,2009/04/09,326,9,0.7522772640000001,22044,326,8,1
14295,2014/03/31,2010/04/26,2,22,0.624049599,26573,2,4,18
14296,2014/03/31,2010/11/29,100,8,0.6227523660000001,26628,100,3,5
14297,2014/03/31,2009/08/05,88,17,0.6619809170000001,25049,88,0,17
14298,2014/03/31,2013/02/13,4,14,0.5501058360000001,30141,4,1,13
14299,2014/03/31,2006/05/19,152,9,0.6884810859999999,24083,152,6,3
14300,2014/03/31,2006/04/28,139,15,0.512299657,32357,139,11,4
14301,2014/03/31,2007/04/14,18,18,0.8270824809999999,20041,18,8,10
14302,2014/03/31,2012/07/03,43,13,0.739131773,22425,43,9,4
14303,2014/03/31,2011/03/04,13,24,0.731188018,22668,13,10,14
14304,2014/03/31,2010/12/09,118,15,0.783147798,21164,118,9,6
14305,2014/03/31,2006/07/18,215,6,1.4362513,11540,215,2,4
14306,2014/03/31,2005/06/21,61,16,0.8084861940000001,20498,61,4,12
14307,2014/03/31,2009/01/17,312,10,0.752741562,22013,312,8,2
14308,2014/03/31,2012/04/15,172,22,0.827861104,20015,172,16,6
14309,2014/03/31,2005/03/31,5,15,0.626015793,26467,5,10,5
14310,2014/03/31,2010/07/23,103,18,0.648924095,25532,103,9,9
14311,2014/03/31,2011/09/26,160,8,0.620220891,26710,160,7,1
14312,2014/03/31,2008/05/01,12,16,0.6566049629999999,25228,12,8,8
14313,2014/03/31,2012/09/03,65,16,0.71686675,23107,65,8,8
14314,2014/03/31,2005/04/11,18,20,0.6409621120000001,25839,18,4,16
14315,2014/03/31,2009/12/05,127,16,0.791847566,20914,127,9,7
14316,2014/03/31,2011/11/14,120,15,0.6676968670000001,24801,120,6,9
14317,2014/03/31,2010/03/17,4,18,0.736524485,22483,4,6,12
14318,2014/03/31,2010/10/20,46,20,0.736573094,22478,46,12,8
14319,2014/03/31,2011/12/01,11,22,0.651541126,25410,11,5,17
14320,2014/03/31,2007/06/28,119,18,0.616661452,26847,119,12,6
14321,2014/03/31,2007/07/05,16,21,0.7866226359999999,21046,16,10,11
14322,2014/03/31,2011/04/14,160,14,0.821173115,20160,160,4,10
14323,2014/03/31,2008/11/10,122,16,0.769581145,21511,122,10,6
14324,2014/03/31,2008/05/21,11,20,0.808585942,20473,11,10,10
14325,2014/03/31,2010/12/05,84,3,0.726589562,22783,84,0,3
14326,2014/03/31,2011/10/16,13,16,0.8080175740000001,20485,13,1,15
14327,2014/03/31,2007/09/29,1,18,0.60773747,27235,1,9,9
14328,2014/03/31,2011/08/27,27,18,0.7534070740000001,21969,27,2,16
14329,2014/03/31,2005/12/27,153,10,0.7263252590000001,22788,153,5,5
14330,2014/03/31,2010/08/18,140,10,0.782231991,21156,140,4,6
14331,2014/03/31,2011/01/11,10,19,0.559611105,29571,10,9,10
14332,2014/03/31,2010/03/26,15,22,0.71676398,23087,15,0,22
14333,2014/03/31,2006/05/10,60,9,0.706101984,23435,60,6,3
14334,2014/03/31,2008/10/23,4,19,0.6468664239999999,25581,4,7,12
14335,2014/03/31,2007/03/20,31,22,0.642272727,25762,31,13,9
14336,2014/03/31,2011/11/24,85,6,0.4555818370000001,36316,85,3,3
14337,2014/03/31,2008/10/18,96,6,1.440695001,11482,96,2,4
14338,2014/03/31,2009/10/08,110,22,0.662140827,24981,110,19,3
14339,2014/03/31,2007/11/11,8,13,0.827644233,19985,8,10,3
14340,2014/03/31,2009/10/24,290,13,0.671656853,24625,290,7,6
14341,2014/03/31,2011/06/24,10,13,0.826067326,20022,10,5,8
14342,2014/03/31,2008/06/10,40,12,0.522527802,31652,40,6,6
14343,2014/03/31,2006/04/07,121,7,0.638124011,25917,121,0,7
14344,2014/03/31,2008/03/08,82,14,0.673820078,24544,82,3,11
14345,2014/03/31,2007/04/27,4,24,0.700766688,23595,4,0,24
14346,2014/03/31,2008/07/25,30,7,0.8336799109999999,19832,30,0,7
14347,2014/03/31,2012/01/25,34,16,0.8497388709999999,19454,34,9,7
14348,2014/03/31,2012/11/10,244,8,0.444817286,37162,244,7,1
14349,2014/03/31,2009/01/02,6,10,0.6294523989999999,26260,6,1,9
14350,2014/03/31,2011/03/21,5,14,0.713940912,23152,5,7,7
14351,2014/03/31,2011/07/18,52,9,1.436316475,11508,52,4,5
14352,2014/03/31,2012/03/01,32,25,0.673302782,24549,32,15,10
14353,2014/03/31,2006/05/09,119,12,0.54874805,30121,119,9,3
14354,2014/03/31,2011/09/15,58,20,0.470466255,35131,58,3,17
14355,2014/03/31,2011/03/28,58,18,0.654030075,25270,58,11,7
14356,2014/03/31,2007/02/21,162,20,0.820988525,20131,162,12,8
14357,2014/03/31,2006/12/01,222,16,0.8317362859999999,19870,222,8,8
14358,2014/03/31,2006/12/08,19,17,0.7481204159999999,22090,19,8,9
14359,2014/03/31,2011/10/02,228,11,0.7187387470000001,22993,228,7,4
14360,2014/03/31,2005/04/11,76,26,0.552839985,29891,76,18,8
14361,2014/03/31,2007/10/15,20,22,0.65762894,25128,20,12,10
14362,2014/03/31,2010/03/29,3,42,0.780212525,21174,3,20,22
14363,2014/03/31,2011/11/20,5,22,0.7308278029999999,22602,5,12,10
14364,2014/03/31,2010/10/20,204,11,0.916377961,18023,204,8,3
14365,2014/03/31,2008/12/12,45,9,0.653472618,25272,45,1,8
14366,2014/03/31,2012/10/26,230,2,0.675,24464,230,0,2
14367,2014/03/31,2010/08/20,711,2,0.675,24464,711,2,0
14368,2014/03/31,2006/12/06,683,2,0.675,24464,683,2,0
14369,2014/03/31,2011/04/04,7,2,0.675,24464,7,0,2
14370,2014/03/31,2008/02/04,12,19,0.780042043,21169,12,16,3
14371,2014/03/31,2008/11/08,66,30,0.769043782,21470,66,8,22
14372,2014/03/31,2011/04/24,30,17,0.794662848,20777,30,10,7
14373,2014/03/31,2010/06/23,82,15,0.580709437,28431,82,9,6
14374,2014/03/31,2010/03/14,107,15,0.801630493,20595,107,6,9
14375,2014/03/31,2007/10/04,5,22,0.7238090229999999,22809,5,11,11
14376,2014/03/31,2010/01/09,6,16,0.6274987639999999,26303,6,9,7
14377,2014/03/31,2010/09/19,158,19,0.701219782,23537,158,12,7
14378,2014/03/31,2007/05/22,141,20,0.6189513560000001,26663,141,11,9
14379,2014/03/31,2012/06/19,62,19,0.67609866,24407,62,9,10
14380,2014/03/31,2010/11/05,7,22,0.74458668,22162,7,9,13
14381,2014/03/31,2007/05/30,68,15,0.7260631,22726,68,13,2
14382,2014/03/31,2011/10/30,13,18,0.718004265,22979,13,6,12
14383,2014/03/31,2012/01/09,21,18,0.6405144229999999,25757,21,9,9
14384,2014/03/31,2012/12/08,8,3,1.41,11700,8,0,3
14385,2014/03/31,2007/05/17,6,15,0.670468217,24604,6,9,6
14386,2014/03/31,2010/06/02,4,10,1.13071972,14589,4,7,3
14387,2014/03/31,2011/03/19,69,21,0.734467005,22458,69,8,13
14388,2014/03/31,2012/06/15,119,17,0.771166074,21388,119,7,10
14389,2014/03/31,2005/06/01,37,20,0.87476981,18854,37,6,14
14390,2014/03/31,2010/03/31,163,19,0.62,26600,163,15,4
14391,2014/03/31,2007/02/26,65,21,0.674036457,24467,65,11,10
14392,2014/03/31,2010/05/26,35,18,0.707826759,23297,35,8,10
14393,2014/03/31,2010/05/19,13,10,0.622078618,26508,13,5,5
14394,2014/03/31,2008/12/24,85,16,0.961944461,17141,85,5,11
14395,2014/03/31,2007/03/16,119,28,0.5765,28600,119,20,8
14396,2014/03/31,2011/09/19,22,20,0.525255177,31390,22,11,9
14397,2014/03/31,2011/06/12,230,3,0.6544522070000001,25192,230,0,3
14398,2014/03/31,2007/05/08,15,17,0.7057804609999999,23358,15,6,11
14399,2014/03/31,2007/01/31,5,22,0.702176598,23477,5,13,9
14400,2014/03/31,2011/08/14,114,16,0.646609791,25494,114,7,9
14401,2014/03/31,2006/09/04,46,11,0.709608679,23229,46,4,7
14402,2014/03/31,2008/03/06,261,9,0.769414154,21422,261,8,1
14403,2014/03/31,2008/06/19,137,3,0.723369618,22783,137,2,1
14404,2014/03/31,2006/07/19,15,12,0.78281826,21052,15,0,12
14405,2014/03/31,2012/10/16,37,13,0.774697255,21272,37,1,12
14406,2014/03/31,2006/10/01,101,12,0.8451805309999999,19498,101,5,7
14407,2014/03/31,2012/04/08,19,15,0.73467386,22429,19,10,5
14408,2014/03/31,2006/04/26,37,18,0.4886731520000001,33719,37,7,11
14409,2014/03/31,2008/02/07,38,19,0.929473684,17727,38,7,12
14410,2014/03/31,2008/05/29,149,9,0.664319181,24801,149,7,2
14411,2014/03/31,2009/11/04,99,21,0.727990809,22631,99,13,8
14412,2014/03/31,2006/02/24,165,19,0.7237024999999999,22763,165,13,6
14413,2014/03/31,2010/05/26,381,6,0.85,19380,381,6,0
14414,2014/03/31,2013/02/10,102,15,0.948755904,17362,102,1,14
14415,2014/03/31,2011/08/07,503,10,0.73346767,22456,503,10,0
14416,2014/03/31,2009/11/05,243,12,1.091333157,15092,243,11,1
14417,2014/03/31,2007/02/07,82,20,0.714300893,23058,82,15,5
14418,2014/03/31,2010/05/02,110,12,0.75468634,21823,110,8,4
14419,2014/03/31,2012/06/03,147,17,0.616710733,26702,147,4,13
14420,2014/03/31,2005/10/22,16,20,0.689843325,23871,16,10,10
14421,2014/03/31,2007/10/25,21,15,0.8338367259999999,19746,21,0,15
14422,2014/03/31,2010/05/17,195,10,0.8684460390000001,18958,195,8,2
14423,2014/03/31,2007/12/01,15,24,0.822544092,20015,15,4,20
14424,2014/03/31,2010/12/05,17,15,0.597685632,27541,17,8,7
14425,2014/03/31,2009/04/14,134,17,0.649550513,25340,134,14,3
14426,2014/03/31,2010/11/01,469,13,0.807508708,20383,469,13,0
14427,2014/03/31,2010/10/07,342,13,0.7402118190000001,22236,342,12,1
14428,2014/03/31,2012/04/18,48,12,0.592607115,27774,48,5,7
14429,2014/03/31,2012/12/15,101,8,0.761825125,21604,101,1,7
14430,2014/03/31,2012/02/06,613,7,0.596823094,27574,613,7,0
14431,2014/03/31,2010/03/24,5,17,0.7703665559999999,21361,5,9,8
14432,2014/03/31,2013/01/09,32,7,1.131490064,14543,32,1,6
14433,2014/03/31,2011/07/11,35,18,0.716414421,22967,35,5,13
14434,2014/03/31,2011/03/08,74,11,0.6734323959999999,24429,74,3,8
14435,2014/03/31,2008/05/03,84,16,0.664448079,24759,84,9,7
14436,2014/03/31,2006/05/15,29,20,0.670645766,24529,29,15,5
14437,2014/03/31,2012/01/27,29,12,0.698351518,23555,29,6,6
14438,2014/03/31,2009/10/13,210,15,0.753128978,21841,210,9,6
14439,2014/03/31,2007/02/23,69,18,0.7662095309999999,21467,69,3,15
14440,2014/03/31,2010/09/01,230,26,0.7326128209999999,22447,230,20,6
14441,2014/03/31,2005/06/14,153,18,0.693760284,23703,153,8,10
14442,2014/03/31,2005/04/02,138,17,0.566745709,29014,138,13,4
14443,2014/03/31,2010/12/24,17,11,0.62623524,26254,17,4,7
14444,2014/03/31,2006/08/10,81,9,0.939285714,17500,81,4,5
14445,2014/03/31,2005/09/29,70,13,1.137450695,14451,70,6,7
14446,2014/03/31,2006/05/09,92,17,0.779839161,21077,92,6,11
14447,2014/03/31,2009/07/16,173,20,0.7128655070000001,23057,173,11,9
14448,2014/03/31,2012/09/28,75,21,0.835812653,19664,75,4,17
14449,2014/03/31,2012/10/24,33,9,0.694655085,23658,33,3,6
14450,2014/03/31,2007/04/23,98,15,0.664186742,24740,98,11,4
14451,2014/03/31,2013/03/05,20,4,0.57330449,28661,20,0,4
14452,2014/03/31,2007/11/16,13,19,0.568640501,28893,13,11,8
14453,2014/03/31,2011/07/29,222,19,0.781567956,21021,222,15,4
14454,2014/03/31,2006/05/09,3,20,0.696768748,23576,3,4,16
14455,2014/03/31,2010/12/11,67,12,0.8035856159999999,20440,67,7,5
14456,2014/03/31,2010/02/10,252,16,0.7023479859999999,23386,252,11,5
14457,2014/03/31,2008/05/14,321,32,0.6629874060000001,24774,321,20,12
14458,2014/03/31,2012/11/29,79,3,1.02387694,16041,79,1,2
14459,2014/03/31,2012/09/19,166,14,0.7471771079999999,21981,166,11,3
14460,2014/03/31,2012/09/20,136,12,0.483607185,33960,136,3,9
14461,2014/03/31,2009/12/01,346,7,1.0,16421,346,5,2
14462,2014/03/31,2008/08/05,276,2,0.81,20272,276,0,2
14463,2014/03/31,2012/08/18,42,13,0.951594992,17254,42,4,9
14464,2014/03/31,2010/11/03,47,19,0.551412737,29772,47,14,5
14465,2014/03/31,2006/09/08,15,23,0.875982391,18740,15,8,15
14466,2014/03/31,2008/01/28,28,9,0.658879701,24913,28,4,5
14467,2014/03/31,2005/02/01,39,20,0.565649252,29018,39,7,13
14468,2014/03/31,2011/09/16,71,16,0.674846828,24319,71,8,8
14469,2014/03/31,2007/03/05,2,6,1.432190418,11459,2,4,2
14470,2014/03/31,2007/01/09,6,23,0.7558993140000001,21711,6,7,16
14471,2014/03/31,2007/04/13,78,13,0.559116464,29348,78,9,4
14472,2014/03/31,2011/08/16,35,14,0.753373892,21779,35,4,10
14473,2014/03/31,2012/05/03,477,5,0.674889958,24309,477,5,0
14474,2014/03/31,2012/08/17,573,5,0.564669237,29054,573,5,0
14475,2014/03/31,2012/12/24,11,12,0.503312368,32593,11,2,10
14476,2014/03/31,2012/09/06,390,14,0.72063126,22764,390,14,0
14477,2014/03/31,2008/09/05,66,10,0.6773502929999999,24214,66,6,4
14478,2014/03/31,2008/01/05,122,8,1.351310044,12137,122,2,6
14479,2014/03/31,2007/02/01,69,20,0.7418957559999999,22102,69,10,10
14480,2014/03/31,2012/05/09,38,13,0.659359016,24868,38,7,6
14481,2014/03/31,2009/12/12,86,15,0.701274539,23381,86,8,7
14482,2014/03/31,2010/03/18,393,9,1.037333924,15806,393,9,0
14483,2014/03/31,2007/03/16,10,9,0.645555556,25398,10,3,6
14484,2014/03/31,2008/10/29,157,13,0.789681148,20762,157,5,8
14485,2014/03/31,2013/01/23,29,10,0.8060506390000001,20340,29,1,9
14486,2014/03/31,2010/02/18,4,16,0.6674180679999999,24563,4,5,11
14487,2014/03/31,2011/11/09,137,2,0.67,24464,137,0,2
14488,2014/03/31,2012/08/19,4,8,0.703019645,23314,4,3,5
14489,2014/03/31,2004/12/01,5,14,0.631027606,25973,5,7,7
14490,2014/03/31,2005/09/04,14,21,0.655280899,25009,14,10,11
14491,2014/03/31,2009/06/26,29,26,0.601860653,27227,29,15,11
14492,2014/03/31,2010/08/04,473,8,0.775,21144,473,8,0
14493,2014/03/31,2009/04/27,4,23,0.7221215459999999,22691,4,9,14
14494,2014/03/31,2010/09/07,2,15,0.7826231309999999,20933,2,7,8
14495,2014/03/31,2010/04/05,11,20,0.617514324,26528,11,9,11
14496,2014/03/31,2012/09/22,371,3,1.3,12600,371,3,0
14497,2014/03/31,2009/09/22,46,15,0.7781524059999999,21049,46,6,9
14498,2014/03/31,2010/06/29,125,22,0.742162309,22069,125,10,12
14499,2014/03/31,2006/05/03,19,15,0.7061576270000001,23194,19,13,2
14500,2014/03/31,2011/04/01,23,19,0.731440247,22392,23,7,12
14501,2014/03/31,2010/08/16,5,16,0.7221190479999999,22680,5,6,10
14502,2014/03/31,2012/12/07,7,19,0.645894463,25356,7,5,14
14503,2014/03/31,2011/12/21,34,19,0.6362764679999999,25739,34,11,8
14504,2014/03/31,2012/10/18,9,14,0.833979831,19634,9,4,10
14505,2014/03/31,2009/09/03,16,14,0.923861084,17723,16,6,8
14506,2014/03/31,2009/08/11,1,32,0.601321385,27229,1,15,17
14507,2014/03/31,2008/11/23,99,8,1.447276584,11313,99,5,3
14508,2014/03/31,2006/11/16,137,23,0.7654661490000001,21388,137,14,9
14509,2014/03/31,2005/04/11,4,20,0.603910654,27108,4,9,11
14510,2014/03/31,2012/07/23,77,16,0.7181740809999999,22794,77,10,6
14511,2014/03/31,2009/03/19,40,24,0.8683328029999999,18852,40,19,5
14512,2014/03/31,2011/08/29,102,24,0.45222477,36197,102,6,18
14513,2014/03/31,2010/10/15,265,8,1.4348233540000002,11407,265,6,2
14514,2014/03/31,2011/11/06,96,19,0.741719465,22065,96,10,9
14515,2014/03/31,2007/10/21,128,16,0.7980217479999999,20508,128,4,12
14516,2014/03/31,2012/05/24,291,15,0.5031389310000001,32527,291,10,5
14517,2014/03/31,2011/05/01,10,17,0.511764706,31977,10,9,8
14518,2014/03/31,2009/12/20,44,23,0.638532464,25628,44,16,7
14519,2014/03/31,2006/01/19,5,17,0.627799263,26064,5,5,12
14520,2014/03/31,2008/12/19,78,11,0.64766664,25264,78,0,11
14521,2014/03/31,2005/10/02,141,8,1.048280369,15608,141,3,5
14522,2014/03/31,2006/05/15,195,11,0.662604399,24689,195,10,1
14523,2014/03/31,2012/07/22,8,14,0.568887537,28756,8,1,13
14524,2014/03/31,2011/03/07,94,14,0.637072981,25678,94,3,11
14525,2014/03/31,2009/03/04,550,15,0.935077741,17494,550,15,0
14526,2014/03/31,2005/09/19,70,12,0.765948211,21356,70,4,8
14527,2014/03/31,2008/11/17,82,13,0.775707308,21087,82,5,8
14528,2014/03/31,2009/11/06,154,17,0.8528058190000001,19178,154,5,12
14529,2014/03/31,2012/06/06,18,25,0.7417143629999999,22049,18,10,15
14530,2014/03/31,2010/06/15,82,24,0.7843005129999999,20851,82,11,13
14531,2014/03/31,2008/02/21,11,11,1.33124308,12284,11,7,4
14532,2014/03/31,2012/04/18,15,16,0.700343085,23347,15,6,10
14533,2014/03/31,2005/11/25,141,20,0.636232781,25698,141,16,4
14534,2014/03/31,2009/03/25,76,17,0.660118298,24768,76,11,6
14535,2014/03/31,2006/07/31,2,21,0.651615513,25088,2,8,13
14536,2014/03/31,2008/01/09,14,25,0.638148105,25617,14,3,22
14537,2014/03/31,2012/11/17,142,15,0.766066557,21335,142,12,3
14538,2014/03/31,2007/10/11,212,13,0.695336737,23505,212,11,2
14539,2014/03/31,2008/02/22,103,14,0.936813023,17446,103,8,6
14540,2014/03/31,2012/01/17,36,16,0.549342185,29750,36,2,14
14541,2014/03/31,2007/05/03,123,20,0.6689822320000001,24426,123,13,7
14542,2014/03/31,2012/07/05,1,14,0.785141745,20812,1,7,7
14543,2014/03/31,2011/01/13,20,28,0.7915943990000001,20641,20,12,16
14544,2014/03/31,2011/08/15,256,8,0.84175237,19408,256,6,2
14545,2014/03/31,2006/09/07,49,20,0.614207459,26598,49,13,7
14546,2014/03/31,2011/09/13,140,20,0.779395486,20959,140,14,6
14547,2014/03/31,2005/07/17,464,14,0.990516039,16491,464,14,0
14548,2014/03/31,2012/10/17,160,6,0.8019609190000001,20368,160,5,1
14549,2014/03/31,2011/08/23,76,17,0.7561850090000001,21599,76,6,11
14550,2014/03/31,2011/01/16,67,12,0.713533421,22890,67,5,7
14551,2014/03/31,2010/11/01,69,29,0.590553969,27655,69,17,12
14552,2014/03/31,2007/08/27,15,20,0.47068882,34697,15,12,8
14553,2014/03/31,2012/05/27,23,18,0.60401472,27038,23,2,16
14554,2014/03/31,2012/09/03,7,27,0.810716839,20144,7,14,13
14555,2014/03/31,2011/07/15,40,4,0.648079289,25199,40,2,2
14556,2014/03/31,2011/02/19,101,13,0.8950312429999999,18244,101,4,9
14557,2014/03/31,2012/10/07,74,15,0.6903686790000001,23652,74,6,9
14558,2014/03/31,2012/10/04,71,20,0.505902838,32276,71,7,13
14559,2014/03/31,2006/05/14,606,4,0.975991392,16729,606,4,0
14560,2014/03/31,2011/07/17,216,11,0.695454545,23474,216,7,4
14561,2014/03/31,2011/04/20,103,18,0.650743443,25086,103,9,9
14562,2014/03/31,2007/11/01,9,17,0.6281806289999999,25987,9,9,8
14563,2014/03/31,2005/08/11,81,15,0.7083669659999999,23043,81,9,6
14564,2014/03/31,2012/07/02,130,17,0.6518981429999999,25035,130,12,5
14565,2014/03/31,2009/11/01,85,24,0.744776378,21912,85,14,10
14566,2014/03/31,2012/11/23,21,16,0.8412583770000001,19398,21,5,11
14567,2014/03/31,2005/03/18,148,17,0.7803897470000001,20911,148,11,6
14568,2014/03/31,2011/05/14,137,19,0.6225886079999999,26211,137,12,7
14569,2014/03/31,2005/08/24,23,28,0.8830793379999999,18478,23,10,18
14570,2014/03/31,2012/04/20,65,12,0.745888,21875,65,7,5
14571,2014/03/31,2008/03/11,28,16,0.7304329140000001,22337,28,8,8
14572,2014/03/31,2005/01/01,6,11,0.6733300320000001,24231,6,3,8
14573,2014/03/31,2007/02/01,107,17,0.720385465,22648,107,12,5
14574,2014/03/31,2011/12/05,74,32,0.485226029,33624,74,18,14
14575,2014/03/31,2008/05/13,221,11,0.80301585,20316,221,9,2
14576,2014/03/31,2011/03/12,92,14,0.7268679259999999,22442,92,6,8
14577,2014/03/31,2012/03/24,195,9,0.731556263,22297,195,2,7
14578,2014/03/31,2012/11/23,44,18,0.567298971,28752,44,3,15
14579,2014/03/31,2010/06/09,217,15,0.86337762,18892,217,13,2
14580,2014/03/31,2013/01/29,11,14,1.042450623,15645,11,2,12
14581,2014/03/31,2007/11/27,345,12,0.620873306,26268,345,11,1
14582,2014/03/31,2006/09/23,8,22,0.612366593,26629,8,11,11
14583,2014/03/31,2010/03/10,43,19,0.659925938,24709,43,9,10
14584,2014/03/31,2009/02/23,55,16,0.984291923,16566,55,10,6
14585,2014/03/31,2008/03/03,194,3,0.716666667,22752,194,2,1
14586,2014/03/31,2009/12/10,339,16,0.7586000740000001,21494,339,14,2
14587,2014/03/31,2007/09/25,112,13,0.6557110110000001,24866,112,8,5
14588,2014/03/31,2007/02/01,9,19,0.762342654,21386,9,7,12
14589,2014/03/31,2007/04/16,11,15,0.715917355,22772,11,7,8
14590,2014/03/31,2012/10/24,110,18,0.925535937,17614,110,7,11
14591,2014/03/31,2013/02/22,49,23,0.60814088,26803,49,5,18
14592,2014/03/31,2006/03/30,15,13,0.716917528,22735,15,7,6
14593,2014/03/31,2009/12/04,72,11,0.773332226,21076,72,1,10
14594,2014/03/31,2011/07/24,6,9,0.728705567,22365,6,7,2
14595,2014/03/31,2007/09/26,178,14,0.701856158,23220,178,11,3
14596,2014/03/31,2005/08/29,32,18,0.756729662,21536,32,13,5
14597,2014/03/31,2007/07/29,34,19,0.793222839,20544,34,10,9
14598,2014/03/31,2011/12/24,98,12,1.117161467,14585,98,10,2
14599,2014/03/31,2007/11/13,73,19,0.620594599,26253,73,6,13
14600,2014/03/31,2012/12/02,478,3,1.000313133,16287,478,3,0
14601,2014/03/31,2010/10/11,486,11,0.89316886,18240,486,11,0
14602,2014/03/31,2011/12/31,22,24,0.6977001159999999,23349,22,11,13
14603,2014/03/31,2007/05/22,82,15,0.6830604709999999,23846,82,9,6
14604,2014/03/31,2011/07/17,150,14,0.576331564,28260,150,10,4
14605,2014/03/31,2010/04/13,75,22,0.663392123,24551,75,13,9
14606,2014/03/31,2012/03/20,10,20,0.694696298,23444,10,6,14
14607,2014/03/31,2008/01/10,3,24,0.648912221,25097,3,13,11
14608,2014/03/31,2007/12/31,3,20,0.596013761,27324,3,9,11
14609,2014/03/31,2011/07/21,9,18,0.76578294,21266,9,6,12
14610,2014/03/31,2011/05/23,19,18,0.7636500940000001,21320,19,6,12
14611,2014/03/31,2008/03/13,71,18,0.631988665,25761,71,8,10
14612,2014/03/31,2011/07/09,1,24,0.623775768,26098,1,9,15
14613,2014/03/31,2012/05/02,279,14,0.639049974,25473,279,9,5
14614,2014/03/31,2009/04/09,6,15,0.945141397,17221,6,6,9
14615,2014/03/31,2011/07/17,2,11,0.7528582659999999,21618,2,7,4
14616,2014/03/31,2007/08/01,34,15,0.787759113,20657,34,5,10
14617,2014/03/31,2011/02/18,109,18,0.585197972,27807,109,10,8
14618,2014/03/31,2011/06/29,45,13,0.74623647,21804,45,4,9
14619,2014/03/31,2012/06/09,26,16,0.663992001,24504,26,8,8
14620,2014/03/31,2008/07/02,131,14,1.060020848,15349,131,11,3
14621,2014/03/31,2010/08/20,66,10,0.571734669,28455,66,4,6
14622,2014/03/31,2005/10/22,94,2,0.665,24464,94,1,1
14623,2014/03/31,2006/06/11,40,7,1.261353028,12897,40,6,1
14624,2014/03/31,2011/02/27,84,9,0.616915083,26367,84,4,5
14625,2014/03/31,2012/06/05,272,7,1.482787603,10970,272,6,1
14626,2014/03/31,2010/10/15,38,24,0.588581509,27635,38,14,10
14627,2014/03/31,2012/03/22,81,19,0.7152420740000001,22741,81,7,12
14628,2014/03/31,2008/11/02,7,35,0.5739835529999999,28334,7,2,33
14629,2014/03/31,2009/07/22,127,13,0.75036685,21671,127,11,2
14630,2014/03/31,2007/10/30,442,6,0.7666666670000001,21210,442,6,0
14631,2014/03/31,2009/04/15,62,21,0.787886423,20638,62,12,9
14632,2014/03/31,2011/02/14,16,10,0.525165208,30961,16,2,8
14633,2014/03/31,2008/03/04,34,18,0.586972454,27699,34,10,8
14634,2014/03/31,2009/12/10,72,13,0.647300633,25117,72,9,4
14635,2014/03/31,2012/11/03,13,17,0.540577281,30072,13,4,13
14636,2014/03/31,2009/07/23,47,25,0.568921359,28573,47,13,12
14637,2014/03/31,2009/02/21,18,14,0.751438147,21632,18,6,8
14638,2014/03/31,2010/08/02,10,20,0.640683063,25371,10,13,7
14639,2014/03/31,2012/10/03,265,5,0.7376319490000001,22035,265,2,3
14640,2014/03/31,2012/09/18,42,12,0.687991026,23624,42,8,4
14641,2014/03/31,2009/01/05,156,13,0.7042819379999999,23076,156,3,10
14642,2014/03/31,2010/12/13,10,10,0.793808128,20472,10,2,8
14643,2014/03/31,2011/04/04,131,17,0.675965555,24038,131,9,8
14644,2014/03/31,2013/01/01,19,11,0.618646765,26263,19,0,11
14645,2014/03/31,2008/06/29,11,13,0.8930061009999999,18193,11,5,8
14646,2014/03/31,2010/10/03,68,8,1.019661038,15931,68,6,2
14647,2014/03/31,2005/10/25,14,19,0.743842455,21835,14,12,7
14648,2014/03/31,2011/02/07,4,14,0.728707709,22286,4,6,8
14649,2014/03/31,2011/04/30,44,18,0.6752551040000001,24049,44,12,6
14650,2014/03/31,2011/09/20,28,19,0.688966483,23570,28,11,8
14651,2014/03/31,2013/01/19,9,28,0.5641909589999999,28781,9,6,22
14652,2014/03/31,2011/09/15,16,17,0.6404583460000001,25352,16,5,12
14653,2014/03/31,2012/06/28,3,21,0.816449082,19885,3,9,12
14654,2014/03/31,2007/03/28,144,21,0.523009343,31040,144,14,7
14655,2014/03/31,2009/06/19,46,40,0.69975,23200,46,27,13
14656,2014/03/31,2011/08/24,3,24,0.704878642,23031,3,20,4
14657,2014/03/31,2011/09/25,66,12,0.603436547,26902,66,7,5
14658,2014/03/31,2005/05/06,27,10,0.797516337,20353,27,5,5
14659,2014/03/31,2011/06/15,35,19,0.700666062,23166,35,6,13
14660,2014/03/31,2008/08/14,100,10,0.8375258,19380,100,3,7
14661,2014/03/31,2012/09/09,26,10,0.6990000000000001,23220,26,3,7
14662,2014/03/31,2005/04/06,1,13,0.741239953,21896,1,0,13
14663,2014/03/31,2005/09/09,1,11,0.632766969,25649,1,8,3
14664,2014/03/31,2013/02/05,2,13,0.700315426,23175,2,2,11
14665,2014/03/31,2006/11/23,43,14,0.807278018,20103,43,6,8
14666,2014/03/31,2012/07/03,17,13,0.709728406,22865,17,11,2
14667,2014/03/31,2011/06/24,313,14,0.718887609,22573,313,11,3
14668,2014/03/31,2011/08/17,22,19,0.582538144,27855,22,2,17
14669,2014/03/31,2006/11/03,265,15,0.770953105,21047,265,9,6
14670,2014/03/31,2010/11/04,73,27,0.672923734,24113,73,8,19
14671,2014/03/31,2009/11/03,34,13,0.8130346759999999,19956,34,3,10
14672,2014/03/31,2009/01/06,404,7,0.8246251590000001,19675,404,7,0
14673,2014/03/31,2007/07/03,6,16,0.746219125,21741,6,9,7
14674,2014/03/31,2007/04/08,166,12,0.64835185,25022,166,7,5
14675,2014/03/31,2006/07/27,16,19,0.636977146,25466,16,6,13
14676,2014/03/31,2010/08/02,44,14,0.652275305,24867,44,6,8
14677,2014/03/31,2010/04/16,31,19,0.753623734,21522,31,6,13
14678,2014/03/31,2010/08/19,506,2,0.8,20272,506,2,0
14679,2014/03/31,2011/03/21,11,24,0.65098025,24912,11,10,14
14680,2014/03/31,2010/06/22,32,25,0.6836495490000001,23718,32,1,24
14681,2014/03/31,2009/12/06,47,16,1.068974156,15168,47,4,12
14682,2014/03/31,2005/04/27,250,18,0.7038134309999999,23037,250,5,13
14683,2014/03/31,2010/12/31,442,18,0.791838429,20474,442,18,0
14684,2014/03/31,2013/01/28,32,12,0.821962176,19723,32,3,9
14685,2014/03/31,2007/11/08,117,12,0.650269164,24929,117,7,5
14686,2014/03/31,2009/04/16,3,20,0.537586893,30152,3,3,17
14687,2014/03/31,2007/08/15,10,15,0.787585403,20579,10,6,9
14688,2014/03/31,2011/09/29,195,14,0.923876853,17540,195,10,4
14689,2014/03/31,2013/03/25,70,18,0.746095405,21718,70,0,18
14690,2014/03/31,2009/10/30,174,19,0.574264044,28215,174,13,6
14691,2014/03/31,2008/07/24,3,19,0.8737259340000001,18543,3,10,9
14692,2014/03/31,2012/07/01,170,22,0.485643285,33360,170,12,10
14693,2014/03/31,2006/02/27,111,13,0.836115297,19376,111,0,13
14694,2014/03/31,2010/06/08,81,15,0.7781075890000001,20820,81,9,6
14695,2014/03/31,2007/05/19,91,15,0.631205969,25664,91,10,5
14696,2014/03/31,2012/03/22,529,11,0.703303955,23033,529,11,0
14697,2014/03/31,2009/04/18,79,13,0.779871455,20771,79,2,11
14698,2014/03/31,2011/05/01,18,21,0.784791182,20640,18,12,9
14699,2014/03/31,2012/02/28,123,10,0.777336949,20837,123,9,1
14700,2014/03/31,2006/06/12,140,16,0.7722318109999999,20974,140,10,6
14701,2014/03/31,2012/08/31,4,14,0.786046591,20605,4,6,8
14702,2014/03/31,2010/11/29,228,3,0.7098777070000001,22814,228,2,1
14703,2014/03/31,2009/07/24,3,19,0.775222595,20890,3,10,9
14704,2014/03/31,2005/06/12,17,23,0.643061986,25183,17,12,11
14705,2014/03/31,2009/06/17,34,18,0.7316251020000001,22134,34,14,4
14706,2014/03/31,2009/03/04,95,23,0.847735316,19102,95,12,11
14707,2014/03/31,2010/01/07,78,8,0.7045253220000001,22984,78,3,5
14708,2014/03/31,2010/11/07,26,15,0.8763733290000001,18477,26,12,3
14709,2014/03/31,2008/01/08,18,22,0.585943686,27631,18,9,13
14710,2014/03/31,2009/10/14,4,16,0.8324758329999999,19448,4,12,4
14711,2014/03/31,2011/12/27,40,21,0.7079050240000001,22869,40,15,6
14712,2014/03/31,2010/08/12,208,22,0.749838344,21589,208,15,7
14713,2014/03/31,2008/08/18,7,10,1.341636831,12066,7,2,8
14714,2014/03/31,2008/07/06,495,3,0.727887945,22239,495,3,0
14715,2014/03/31,2013/03/28,3,20,0.614100687,26359,3,0,20
14716,2014/03/31,2006/12/21,10,15,0.793192042,20407,10,7,8
14717,2014/03/31,2011/06/30,18,31,0.648613905,24955,18,14,17
14718,2014/03/31,2012/09/18,193,9,0.827315714,19562,193,8,1
14719,2014/03/31,2010/10/10,197,25,0.731722657,22117,197,16,9
14720,2014/03/31,2012/01/24,89,18,0.749198185,21601,89,12,6
14721,2014/03/31,2010/10/08,97,16,0.7858053709999999,20593,97,6,10
14722,2014/03/31,2010/12/27,13,21,0.620157514,26093,13,17,4
14723,2014/03/31,2010/02/13,65,21,0.917791957,17631,65,13,8
14724,2014/03/31,2007/02/26,8,12,0.579368376,27928,8,4,8
14725,2014/03/31,2012/10/23,88,13,0.7549461009999999,21429,88,3,10
14726,2014/03/31,2011/11/15,68,22,0.871301772,18567,68,20,2
14727,2014/03/31,2012/08/09,119,16,0.547865416,29528,119,11,5
14728,2014/03/31,2011/08/27,14,19,0.529616921,30542,14,13,6
14729,2014/03/31,2013/01/01,121,5,1.399747317,11556,121,0,5
14730,2014/03/31,2012/10/15,22,23,0.5482517029999999,29503,22,4,19
14731,2014/03/31,2010/11/30,49,16,0.7131305109999999,22680,49,3,13
14732,2014/03/31,2010/12/14,1,22,0.644616979,25090,1,12,10
14733,2014/03/31,2007/10/14,73,8,1.411505498,11458,73,3,5
14734,2014/03/31,2008/01/05,4,27,0.484926385,33349,4,15,12
14735,2014/03/31,2009/11/18,12,22,0.711556739,22727,12,9,13
14736,2014/03/31,2005/11/17,9,19,0.741082543,21819,9,7,12
14737,2014/03/31,2012/09/17,36,13,0.578138387,27965,36,3,10
14738,2014/03/31,2011/01/28,4,24,0.763835578,21165,4,11,13
14739,2014/03/31,2011/09/07,103,15,0.813297278,19877,103,11,4
14740,2014/03/31,2008/09/03,108,20,0.641783318,25189,108,7,13
14741,2014/03/31,2010/09/22,80,17,0.7763308040000001,20822,80,7,10
14742,2014/03/31,2008/09/15,75,19,0.6680677829999999,24195,75,8,11
14743,2014/03/31,2012/05/16,37,16,0.640351795,25242,37,7,9
14744,2014/03/31,2011/02/26,5,18,0.750496378,21536,5,7,11
14745,2014/03/31,2011/12/11,28,25,0.7185502159999999,22493,28,12,13
14746,2014/03/31,2010/02/16,100,17,0.639371786,25278,100,7,10
14747,2014/03/31,2011/11/18,128,12,0.719182538,22472,128,9,3
14748,2014/03/31,2007/06/25,113,10,1.406506527,11490,113,4,6
14749,2014/03/31,2009/01/17,65,19,0.658344808,24547,65,3,16
14750,2014/03/31,2012/03/24,13,21,0.733762713,22024,13,14,7
14751,2014/03/31,2006/11/27,4,15,0.809062782,19974,4,6,9
14752,2014/03/31,2009/11/28,4,20,0.733405192,22034,4,7,13
14753,2014/03/31,2009/04/14,2,22,0.745565655,21674,2,6,16
14754,2014/03/31,2006/08/28,27,20,0.659366686,24506,27,7,13
14755,2014/03/31,2008/09/19,50,19,0.750181075,21538,50,5,14
14756,2014/03/31,2008/12/25,103,11,0.610485547,26465,103,4,7
14757,2014/03/31,2008/03/09,88,20,0.7478964909999999,21602,88,10,10
14758,2014/03/31,2013/03/28,4,20,0.815632068,19808,4,1,19
14759,2014/03/31,2011/08/24,2,17,0.735982232,21950,2,4,13
14760,2014/03/31,2007/08/14,99,15,0.604088699,26742,99,8,7
14761,2014/03/31,2012/10/04,83,3,0.71,22752,83,1,2
14762,2014/03/31,2005/09/01,35,15,0.797512219,20255,35,0,15
14763,2014/03/31,2011/08/18,198,22,0.709588367,22763,198,13,9
14764,2014/03/31,2008/04/27,124,16,0.586743079,27526,124,10,6
14765,2014/03/31,2010/07/31,567,2,0.8,20188,567,2,0
14766,2014/03/31,2012/08/30,249,6,0.833333333,19380,249,4,2
14767,2014/03/31,2011/04/09,10,17,0.781695145,20659,10,0,17
14768,2014/03/31,2010/06/17,4,13,0.580326673,27826,4,5,8
14769,2014/03/31,2010/07/08,535,7,0.852661456,18937,535,7,0
14770,2014/03/31,2008/01/22,143,17,0.89370233,18067,143,7,10
14771,2014/03/31,2010/05/13,76,2,0.66,24464,76,1,1
14772,2014/03/31,2005/09/23,27,28,0.532693171,30310,27,14,14
14773,2014/03/31,2011/08/04,4,10,0.599294332,26939,4,0,10
14774,2014/03/31,2011/10/10,71,15,0.7751723970000001,20824,71,6,9
14775,2014/03/31,2012/03/06,75,13,0.6971289140000001,23155,75,9,4
14776,2014/03/31,2009/03/07,114,13,0.541945274,29785,114,6,7
14777,2014/03/31,2009/08/16,13,17,0.7445382840000001,21680,13,4,13
14778,2014/03/31,2006/01/15,5,21,0.587808449,27460,5,9,12
14779,2014/03/31,2011/12/01,137,20,0.8127037909999999,19861,137,9,11
14780,2014/03/31,2010/11/20,114,15,0.5958703439999999,27087,114,11,4
14781,2014/03/31,2011/08/21,70,13,0.7580806090000001,21288,70,4,9
14782,2014/03/31,2012/12/06,33,9,0.795457682,20287,33,2,7
14783,2014/03/31,2006/01/20,4,33,0.434872666,37107,4,19,14
14784,2014/03/31,2009/09/01,9,17,0.6860068029999999,23520,9,6,11
14785,2014/03/31,2007/11/09,49,15,0.89260872,18074,49,7,8
14786,2014/03/31,2013/03/07,47,14,0.68293891,23621,47,2,12
14787,2014/03/31,2012/03/24,40,18,0.713472357,22610,40,12,6
14788,2014/03/31,2007/11/11,64,7,0.5472718329999999,29474,64,1,6
14789,2014/03/31,2007/03/25,9,27,0.731257368,22054,9,10,17
14790,2014/03/31,2009/10/09,23,14,0.707343188,22798,23,3,11
14791,2014/03/31,2007/12/19,97,15,0.646572838,24939,97,3,12
14792,2014/03/31,2009/03/03,51,3,0.7066678359999999,22814,51,1,2
14793,2014/03/31,2007/04/04,31,10,0.846022775,19056,31,6,4
14794,2014/03/31,2011/10/28,155,9,1.207762212,13348,155,5,4
14795,2014/03/31,2009/11/05,37,2,0.605057243,26641,37,0,2
14796,2014/03/31,2009/12/01,33,10,0.556114887,28985,33,4,6
14797,2014/03/31,2007/12/13,19,21,0.702858451,22932,19,8,13
14798,2014/03/31,2010/08/22,103,9,0.813251249,19817,103,4,5
14799,2014/03/31,2007/09/12,121,14,0.713774028,22578,121,8,6
14800,2014/03/31,2008/04/04,73,4,0.523255399,30795,73,0,4
14801,2014/03/31,2012/02/13,18,15,0.437536185,36825,18,0,15
14802,2014/03/31,2007/06/19,2,10,1.307003326,12327,2,4,6
14803,2014/03/31,2010/12/16,472,3,0.752646578,21405,472,3,0
14804,2014/03/31,2008/11/22,110,14,0.874584351,18417,110,7,7
14805,2014/03/31,2012/12/28,28,19,0.736697768,21864,28,1,18
14806,2014/03/31,2011/04/30,48,12,0.7019712359999999,22945,48,8,4
14807,2014/03/31,2012/04/08,169,20,0.665315598,24208,169,15,5
14808,2014/03/31,2010/02/27,4,24,0.642003827,25087,4,7,17
14809,2014/03/31,2010/05/16,94,17,0.803402005,20047,94,10,7
14810,2014/03/31,2011/12/09,3,21,0.62022799,25966,3,9,12
14811,2014/03/31,2009/04/02,14,13,0.751563375,21428,14,9,4
14812,2014/03/31,2013/03/20,11,18,0.8268419159999999,19477,11,4,14
14813,2014/03/31,2013/03/27,12,19,0.597780624,26940,12,2,17
14814,2014/03/31,2012/08/15,14,28,0.6579278510000001,24477,14,9,19
14815,2014/03/31,2011/12/22,37,12,0.67383228,23897,37,1,11
14816,2014/03/31,2006/05/23,96,14,0.7247148840000001,22219,96,8,6
14817,2014/03/31,2011/04/05,169,11,0.831735537,19360,169,5,6
14818,2014/03/31,2005/09/09,63,22,0.703862732,22875,63,14,8
14819,2014/03/31,2013/01/07,136,7,0.839061865,19187,136,1,6
14820,2014/03/31,2011/01/14,561,3,0.7266350709999999,22155,561,3,0
14821,2014/03/31,2010/09/11,45,3,0.706589562,22783,45,0,3
14822,2014/03/31,2013/01/23,46,14,0.6531611620000001,24646,46,1,13
14823,2014/03/31,2009/07/02,104,17,0.710174703,22667,104,10,7
14824,2014/03/31,2009/06/26,461,20,0.7695305029999999,20916,461,20,0
14825,2014/03/31,2010/09/13,41,18,0.7059333329999999,22800,41,9,9
14826,2014/03/31,2008/10/23,154,7,0.786869072,20454,154,4,3
14827,2014/03/31,2010/02/21,14,23,0.618755142,26011,14,9,14
14828,2014/03/31,2006/07/03,11,19,0.8391292109999999,19178,11,7,12
14829,2014/03/31,2006/01/15,88,25,0.6746285740000001,23854,88,15,10
14830,2014/03/31,2005/03/30,32,29,0.704363127,22846,32,11,18
14831,2014/03/31,2008/11/01,5,12,0.869209204,18513,5,7,5
14832,2014/03/31,2009/12/17,48,19,0.682454087,23577,48,7,12
14833,2014/03/31,2008/05/18,12,20,0.7055940009999999,22803,12,13,7
14834,2014/03/31,2011/12/09,113,4,0.63363554,25391,113,2,2
14835,2014/03/31,2007/08/10,148,15,0.748166853,21504,148,13,2
14836,2014/03/31,2007/02/20,1,63,0.788075152,20412,1,34,29
14837,2014/03/31,2011/03/12,150,13,0.774685965,20762,150,8,5
14838,2014/03/31,2012/02/12,13,15,0.870343615,18480,13,9,6
14839,2014/03/31,2013/01/26,160,15,0.8611994000000001,18676,160,4,11
14840,2014/03/31,2010/01/28,46,11,1.313076106,12246,46,6,5
14841,2014/03/31,2008/03/06,18,11,1.15942237,13867,18,5,6
14842,2014/03/31,2012/11/14,30,6,1.41,11402,30,0,6
14843,2014/03/31,2005/01/01,1,19,0.715714286,22456,1,0,19
14844,2014/03/31,2012/03/07,65,17,0.627367948,25615,65,11,6
14845,2014/03/31,2008/11/18,44,10,0.608,26430,44,2,8
14846,2014/03/31,2012/12/18,111,8,0.76,21144,111,2,6
14847,2014/03/31,2006/10/12,21,11,0.92192151,17429,21,6,5
14848,2014/03/31,2011/01/15,43,32,0.8408556629999999,19108,43,10,22
14849,2014/03/31,2007/10/01,42,16,0.7633148040000001,21048,42,5,11
14850,2014/03/31,2008/04/15,110,15,0.646084543,24863,110,13,2
14851,2014/03/31,2006/04/23,19,21,0.709364813,22639,19,12,9
14852,2014/03/31,2010/11/25,76,18,0.615088862,26108,76,11,7
14853,2014/03/31,2006/01/13,23,9,0.671826094,23898,23,3,6
14854,2014/03/31,2011/03/08,35,12,0.7269010640000001,22085,35,5,7
14855,2014/03/31,2009/07/27,233,7,0.77545819,20701,233,5,2
14856,2014/03/31,2008/04/28,196,14,0.679700216,23617,196,6,8
14857,2014/03/31,2005/08/30,163,13,0.732399963,21917,163,7,6
14858,2014/03/31,2010/06/16,209,9,0.734360875,21858,209,4,5
14859,2014/03/31,2009/07/31,96,10,0.7086044770000001,22651,96,3,7
14860,2014/03/31,2012/03/10,101,15,0.661205455,24273,101,9,6
14861,2014/03/31,2010/06/08,3,10,0.703038374,22828,3,2,8
14862,2014/03/31,2011/05/13,288,6,0.7807253359999999,20556,288,5,1
14863,2014/03/31,2009/11/23,120,23,0.658020009,24389,120,14,9
14864,2014/03/31,2007/09/06,42,22,0.715681859,22424,42,12,10
14865,2014/03/31,2012/08/28,253,17,0.958908211,16734,253,10,7
14866,2014/03/31,2008/01/21,377,16,0.7348600740000001,21833,377,16,0
14867,2014/03/31,2012/08/20,4,10,0.772726747,20761,4,3,7
14868,2014/03/31,2009/06/06,24,19,0.6588799439999999,24347,24,11,8
14869,2014/03/31,2008/03/18,49,14,0.8445601009999999,18993,49,10,4
14870,2014/03/31,2011/09/15,199,24,0.621424144,25812,199,15,9
14871,2014/03/31,2011/10/25,26,10,0.6921330859999999,23173,26,5,5
14872,2014/03/31,2006/09/30,30,15,0.680980425,23551,30,6,9
14873,2014/03/31,2012/12/15,159,21,0.759140355,21125,159,11,10
14874,2014/03/31,2009/10/31,178,10,1.334067881,12021,178,5,5
14875,2014/03/31,2011/11/03,42,12,0.6728039109999999,23831,42,5,7
14876,2014/03/31,2010/07/05,34,12,0.8773203829999999,18275,34,10,2
14877,2014/03/31,2010/11/25,20,23,0.764423095,20974,20,16,7
14878,2014/03/31,2011/10/08,21,16,0.637123043,25162,21,12,4
14879,2014/03/31,2007/09/04,24,25,0.720594237,22247,24,16,9
14880,2014/03/31,2011/03/01,62,10,0.76588581,20930,62,6,4
14881,2014/03/31,2007/01/03,29,4,0.529350439,30282,29,2,2
14882,2014/03/31,2008/02/08,11,4,1.204246112,13311,11,1,3
14883,2014/03/31,2007/07/31,140,12,0.5898815,27173,140,7,5
14884,2014/03/31,2007/03/13,107,11,0.8585360759999999,18669,107,10,1
14885,2014/03/31,2011/07/24,47,22,0.516210384,31048,47,10,12
14886,2014/03/31,2010/09/12,10,24,0.900855489,17791,10,15,9
14887,2014/03/31,2011/09/14,25,22,0.862743325,18576,25,7,15
14888,2014/03/31,2009/08/03,58,22,0.750322596,21358,58,13,9
14889,2014/03/31,2009/09/17,5,23,0.796507282,20119,5,7,16
14890,2014/03/31,2012/02/11,38,20,0.768397832,20853,38,1,19
14891,2014/03/31,2011/07/19,3,19,0.6800925409999999,23557,3,6,13
14892,2014/03/31,2010/03/26,2,16,0.5709480020000001,28059,2,6,10
14893,2014/03/31,2012/06/09,32,13,0.922612602,17362,32,7,6
14894,2014/03/31,2012/04/07,8,17,0.7032567940000001,22777,8,10,7
14895,2014/03/31,2007/11/07,421,16,0.714021754,22433,421,16,0
14896,2014/03/31,2011/09/30,276,9,0.664831479,24092,276,4,5
14897,2014/03/31,2006/03/05,364,9,1.464201481,10939,364,7,2
14898,2014/03/31,2011/09/27,123,11,0.712895803,22467,123,0,11
14899,2014/03/31,2006/06/07,31,18,0.633637299,25277,31,8,10
14900,2014/03/31,2012/07/01,584,3,0.7523512,21287,584,3,0
14901,2014/03/31,2008/09/16,8,17,0.721123069,22207,8,11,6
14902,2014/03/31,2011/05/09,20,17,0.79813877,20062,20,10,7
14903,2014/03/31,2007/11/19,213,18,0.6479140529999999,24713,213,13,5
14904,2014/03/31,2009/09/09,282,21,0.704062967,22742,282,16,5
14905,2014/03/31,2005/07/11,162,14,0.739902495,21640,162,7,7
14906,2014/03/31,2006/09/18,28,19,0.778696075,20561,28,12,7
14907,2014/03/31,2008/05/08,11,21,0.6592497429999999,24285,11,7,14
14908,2014/03/31,2011/03/28,7,18,0.7018346409999999,22811,7,8,10
14909,2014/03/31,2010/10/25,48,4,0.57130652,28021,48,0,4
14910,2014/03/31,2007/06/14,80,14,0.750791671,21322,80,10,4
14911,2014/03/31,2011/07/16,81,13,0.747224478,21423,81,8,5
14912,2014/03/31,2005/09/09,11,21,0.6881822870000001,23260,11,8,13
14913,2014/03/31,2012/09/02,102,17,0.686727304,23308,102,9,8
14914,2014/03/31,2007/09/27,271,16,0.664862507,24074,271,12,4
14915,2014/03/31,2013/03/24,144,16,0.702962491,22768,144,1,15
14916,2014/03/31,2006/09/17,17,14,0.6819092459999999,23470,17,4,10
14917,2014/03/31,2009/03/30,1,16,0.636939458,25123,1,8,8
14918,2014/03/31,2009/09/16,12,18,0.498757365,32077,12,11,7
14919,2014/03/31,2009/12/22,237,4,0.589670119,27131,237,0,4
14920,2014/03/31,2006/10/01,217,10,0.7093096259999999,22553,217,7,3
14921,2014/03/31,2011/10/16,36,31,0.8204128629999999,19498,36,18,13
14922,2014/03/31,2007/01/16,34,24,0.5796057689999999,27598,34,15,9
14923,2014/03/31,2008/02/25,164,10,1.095639129,14598,164,7,3
14924,2014/03/31,2005/08/10,126,17,0.6426644429999999,24887,126,10,7
14925,2014/03/31,2006/01/26,26,14,0.55,29078,26,4,10
14926,2014/03/31,2009/09/18,67,14,0.709290815,22547,67,11,3
14927,2014/03/31,2006/08/22,6,18,0.7717575520000001,20722,6,0,18
14928,2014/03/31,2011/10/27,28,17,0.662864249,24125,28,15,2
14929,2014/03/31,2008/10/13,44,13,0.76735256,20839,44,4,9
14930,2014/03/31,2010/01/04,14,15,0.676594313,23634,14,4,11
14931,2014/03/31,2010/03/07,53,12,0.934001168,17120,53,1,11
14932,2014/03/31,2007/10/03,193,13,0.7103012259999999,22508,193,9,4
14933,2014/03/31,2010/10/24,4,17,0.871463069,18345,4,8,9
14934,2014/03/31,2008/05/19,375,11,0.905047554,17664,375,11,0
14935,2014/03/31,2011/07/11,32,18,0.7178209329999999,22271,32,2,16
14936,2014/03/31,2011/12/05,364,13,1.217405377,13131,364,12,1
14937,2014/03/31,2010/12/26,77,13,0.769602716,20766,77,6,7
14938,2014/03/31,2011/09/22,3,14,0.619599411,25787,3,6,8
14939,2014/03/31,2012/04/06,42,11,1.094612223,14596,42,7,4
14940,2014/03/31,2008/03/06,55,16,0.736171605,21701,55,8,8
14941,2014/03/31,2012/12/10,86,17,0.7448340170000001,21448,86,5,12
14942,2014/03/31,2006/04/06,4,23,0.883033553,18091,4,22,1
14943,2014/03/31,2008/06/23,96,16,0.8209132020000001,19459,96,10,6
14944,2014/03/31,2012/03/23,142,22,0.753079644,21207,142,17,5
14945,2014/03/31,2013/03/18,298,3,0.626026028,25511,298,2,1
14946,2014/03/31,2008/11/02,11,17,0.595314445,26825,11,7,10
14947,2014/03/31,2007/10/02,5,2,1.05,15208,5,0,2
14948,2014/03/31,2010/12/20,450,2,1.05,15208,450,2,0
14949,2014/03/31,2012/08/11,57,7,0.7649841909999999,20874,57,2,5
14950,2014/03/31,2007/11/06,11,3,0.759693611,21019,11,0,3
14951,2014/03/31,2007/09/28,18,19,0.755144006,21145,18,9,10
14952,2014/03/31,2012/12/18,25,15,0.652450047,24473,25,2,13
14953,2014/03/31,2011/12/01,25,17,0.671829427,23767,25,9,8
14954,2014/03/31,2008/05/18,136,22,0.7128188759999999,22399,136,17,5
14955,2014/03/31,2005/09/24,20,21,0.725639033,22002,20,10,11
14956,2014/03/31,2011/01/15,251,12,0.581871492,27438,251,10,2
14957,2014/03/31,2006/06/27,3,10,0.796382501,20047,3,4,6
14958,2014/03/31,2013/01/09,11,19,0.926292793,17234,11,2,17
14959,2014/03/31,2009/01/17,30,13,0.944175194,16907,30,6,7
14960,2014/03/31,2007/10/28,184,12,0.78500836,20334,184,8,4
14961,2014/03/31,2008/10/16,172,13,0.645011517,24747,172,5,8
14962,2014/03/31,2011/01/18,155,10,0.681113766,23434,155,5,5
14963,2014/03/31,2007/11/28,4,17,0.880782518,18121,4,9,8
14964,2014/03/31,2011/10/14,74,13,0.7233411890000001,22064,74,6,7
14965,2014/03/31,2013/02/09,231,2,1.05,15199,231,1,1
14966,2014/03/31,2011/06/14,9,18,0.7742091990000001,20612,9,13,5
14967,2014/03/31,2005/01/15,21,15,0.6831315290000001,23356,21,10,5
14968,2014/03/31,2010/05/05,39,24,0.8962979609999999,17801,39,17,7
14969,2014/03/31,2007/08/28,4,16,0.809524075,19709,4,4,12
14970,2014/03/31,2012/05/16,9,18,0.593806156,26867,9,5,13
14971,2014/03/31,2011/09/01,9,9,0.6255688460000001,25499,9,5,4
14972,2014/03/31,2005/03/30,2,21,0.51941322,30710,2,9,12
14973,2014/03/31,2006/07/18,92,23,0.686422761,23233,92,11,12
14974,2014/03/31,2009/04/07,193,11,0.561089335,28421,193,4,7
14975,2014/03/31,2012/10/18,132,23,0.64869452,24581,132,12,11
14976,2014/03/31,2013/02/15,30,14,0.727785841,21909,30,3,11
14977,2014/03/31,2009/03/04,74,11,0.7940833709999999,20079,74,5,6
14978,2014/03/31,2010/08/08,86,22,0.713815984,22335,86,8,14
14979,2014/03/31,2012/08/19,6,23,0.616269136,25868,6,4,19
14980,2014/03/31,2008/01/11,3,18,0.772467413,20637,3,9,9
14981,2014/03/31,2007/11/21,118,17,0.492510119,32365,118,7,10
14982,2014/03/31,2010/07/09,11,12,1.4385920580000002,11080,11,3,9
14983,2014/03/31,2011/08/27,6,11,0.808844963,19705,6,2,9
14984,2014/03/31,2011/09/08,1,17,0.7850546740000001,20302,1,5,12
14985,2014/03/31,2012/03/04,468,8,0.8636915409999999,18453,468,8,0
14986,2014/03/31,2011/01/31,19,33,0.8309479609999999,19178,19,19,14
14987,2014/03/31,2012/03/17,6,19,0.8040332020000001,19818,6,6,13
14988,2014/03/31,2010/09/22,6,18,0.7961586890000001,20014,6,8,10
14989,2014/03/31,2009/01/20,165,11,0.7380507690000001,21588,165,3,8
14990,2014/03/31,2005/09/16,5,20,0.7014943640000001,22712,5,4,16
14991,2014/03/31,2006/05/25,116,14,0.733292677,21727,116,10,4
14992,2014/03/31,2010/06/27,32,11,0.7579438629999999,21020,32,3,8
14993,2014/03/31,2008/04/04,84,17,0.889168388,17917,84,3,14
14994,2014/03/31,2006/08/20,123,21,0.701308387,22715,123,6,15
14995,2014/03/31,2008/02/06,17,16,0.521531661,30542,17,9,7
14996,2014/03/31,2011/09/03,154,14,0.886886414,17960,154,10,4
14997,2014/03/31,2011/08/14,11,14,0.553754129,28763,11,2,12
14998,2014/03/31,2011/08/24,46,18,0.6752895790000001,23586,46,9,9
14999,2014/03/31,2012/03/09,124,8,1.350073748,11797,124,2,6
15000,2014/03/31,2009/07/07,3,7,1.460484182,10905,3,3,4
15001,2014/03/31,2009/07/03,49,14,0.6809034159999999,23389,49,10,4
15002,2014/03/31,2009/04/17,115,19,0.567169771,28079,115,11,8
15003,2014/03/31,2009/01/21,202,19,0.8143546740000001,19556,202,10,9
15004,2014/03/31,2012/04/14,24,19,0.699735929,22759,24,12,7
15005,2014/03/31,2007/05/29,10,12,0.748626363,21272,10,2,10
15006,2014/03/31,2010/02/05,66,14,0.624047656,25516,66,6,8
15007,2014/03/31,2007/12/12,113,12,0.6930656390000001,22974,113,5,7
15008,2014/03/31,2007/10/14,109,20,0.637413828,24979,109,9,11
15009,2014/03/31,2005/07/02,3,25,0.670420246,23748,3,6,19
15010,2014/03/31,2013/03/28,26,12,0.504042425,31585,26,0,12
15011,2014/03/31,2006/01/31,20,19,0.900771842,17672,20,12,7
15012,2014/03/31,2010/04/29,39,12,0.7107367059999999,22397,39,8,4
15013,2014/03/31,2011/05/10,24,18,0.7282356440000001,21855,24,10,8
15014,2014/03/31,2008/10/08,68,12,0.7435092959999999,21406,68,8,4
15015,2014/03/31,2009/01/03,43,17,0.735125872,21649,43,9,8
15016,2014/03/31,2012/03/05,150,2,0.785,20272,150,1,1
15017,2014/03/31,2011/03/25,9,15,0.783831642,20302,9,9,6
15018,2014/03/31,2012/03/27,99,19,0.848558631,18753,99,10,9
15019,2014/03/31,2010/03/09,71,21,0.963567276,16514,71,17,4
15020,2014/03/31,2011/05/16,81,8,0.7525,21144,81,2,6
15021,2014/03/31,2010/10/18,13,30,0.6905807540000001,23039,13,13,17
15022,2014/03/31,2006/08/30,3,27,0.5962423170000001,26684,3,0,27
15023,2014/03/31,2006/01/26,2,22,0.574105738,27710,2,9,13
15024,2014/03/31,2006/01/18,12,14,0.62170868,25587,12,0,14
15025,2014/03/31,2011/03/19,304,11,0.6886838690000001,23098,304,10,1
15026,2014/03/31,2012/11/01,2,29,0.863786587,18415,2,17,12
15027,2014/03/31,2008/06/16,131,18,0.634157165,25082,131,11,7
15028,2014/03/31,2008/02/04,94,22,0.7517223609999999,21157,94,15,7
15029,2014/03/31,2010/06/04,16,21,0.962781208,16518,16,13,8
15030,2014/03/31,2012/04/23,57,10,0.897723963,17715,57,3,7
15031,2014/03/31,2011/05/30,40,16,0.6324039610000001,25146,40,9,7
15032,2014/03/31,2011/06/13,514,2,0.65,24464,514,2,0
15033,2014/03/31,2008/06/26,609,2,0.65,24464,609,2,0
15034,2014/03/31,2007/12/14,580,2,0.65,24464,580,2,0
15035,2014/03/31,2010/08/29,592,2,0.65,24464,592,2,0
15036,2014/03/31,2008/11/07,593,2,0.65,24464,593,2,0
15037,2014/03/31,2012/01/25,203,17,0.772635339,20578,203,16,1
15038,2014/03/31,2012/01/16,172,12,0.8118040240000001,19584,172,8,4
15039,2014/03/31,2007/11/05,136,13,0.7150926590000001,22232,136,11,2
15040,2014/03/31,2006/08/23,223,16,0.8861020070000001,17940,223,15,1
15041,2014/03/31,2012/07/03,81,13,0.747565369,21264,81,3,10
15042,2014/03/31,2007/12/01,102,8,0.7120134379999999,22325,102,4,4
15043,2014/03/31,2008/03/25,19,23,0.619713049,25649,19,9,14
15044,2014/03/31,2012/04/01,622,8,0.8706343120000001,18256,622,8,0
15045,2014/03/31,2009/07/21,10,27,0.503138335,31590,10,15,12
15046,2014/03/31,2013/01/17,6,21,0.791490962,20081,6,4,17
15047,2014/03/31,2012/03/01,256,9,0.70876873,22424,256,1,8
15048,2014/03/31,2010/10/19,50,13,0.691521323,22980,50,3,10
15049,2014/03/31,2013/02/04,79,13,0.718304932,22123,79,4,9
15050,2014/03/31,2011/08/28,24,18,0.573845515,27692,24,6,12
15051,2014/03/31,2010/07/01,93,13,0.8042964159999999,19756,93,8,5
15052,2014/03/31,2007/06/07,7,11,0.80435225,19753,7,5,6
15053,2014/03/31,2010/12/27,128,15,0.761734107,20858,128,10,5
15054,2014/03/31,2011/01/04,51,8,0.8382377459999999,18953,51,5,3
15055,2014/03/31,2011/12/24,88,15,0.513639509,30930,88,9,6
15056,2014/03/31,2011/06/21,8,22,0.708228266,22430,8,6,16
15057,2014/03/31,2011/07/09,186,13,0.747902072,21240,186,9,4
15058,2014/03/31,2012/02/27,150,17,0.8244018890000001,19269,150,5,12
15059,2014/03/31,2012/06/18,330,12,0.6942353920000001,22881,330,9,3
15060,2014/03/31,2008/09/06,33,18,0.702044289,22624,33,12,6
15061,2014/03/31,2012/06/15,149,14,0.876488217,18119,149,8,6
15062,2014/03/31,2013/01/19,2,15,0.754678515,21043,2,5,10
15063,2014/03/31,2012/05/17,306,8,0.554571169,28636,306,7,1
15064,2014/03/31,2011/07/09,135,16,0.783700084,20259,135,7,9
15065,2014/03/31,2011/03/18,23,23,0.640425154,24791,23,8,15
15066,2014/03/31,2012/09/11,58,11,0.7706970870000001,20600,58,1,10
15067,2014/03/31,2011/07/07,4,18,0.7263308629999999,21858,4,1,17
15068,2014/03/31,2012/09/10,112,15,0.620148449,25598,112,8,7
15069,2014/03/31,2008/03/02,12,46,0.762168235,20828,12,18,28
15070,2014/03/31,2012/03/30,3,12,0.474859852,33429,3,10,2
15071,2014/03/31,2005/11/11,56,13,0.79884807,19871,56,6,7
15072,2014/03/31,2007/11/01,168,8,0.843662166,18814,168,4,4
15073,2014/03/31,2012/12/17,60,8,0.804143697,19736,60,4,4
15074,2014/03/31,2007/12/15,26,17,0.621208361,25547,26,5,12
15075,2014/03/31,2010/07/12,109,17,0.58257232,27240,109,11,6
15076,2014/03/31,2006/09/14,26,18,0.680996996,23300,26,10,8
15077,2014/03/31,2013/01/31,227,4,0.517897245,30636,227,0,4
15078,2014/03/31,2009/09/17,89,18,0.627308316,25289,89,11,7
15079,2014/03/31,2010/06/07,50,12,0.77664741,20426,50,9,3
15080,2014/03/31,2005/10/26,44,8,0.903309983,17559,44,0,8
15081,2014/03/31,2011/12/12,236,26,0.697439314,22740,236,18,8
15082,2014/03/31,2006/04/07,262,9,0.686381736,23105,262,6,3
15083,2014/03/31,2010/02/01,68,33,0.721383405,21982,68,10,23
15084,2014/03/31,2012/09/11,37,11,0.7599554279999999,20865,37,5,6
15085,2014/03/31,2011/03/25,19,17,0.845798261,18747,19,11,6
15086,2014/03/31,2006/09/27,67,13,0.685196837,23141,67,0,13
15087,2014/03/31,2008/08/10,33,12,0.66455719,23859,33,7,5
15088,2014/03/31,2011/06/08,15,14,0.473863514,33454,15,7,7
15089,2014/03/31,2009/03/30,9,23,0.729792827,21721,9,5,18
15090,2014/03/31,2010/03/15,17,22,0.572528985,27687,17,13,9
15091,2014/03/31,2011/11/17,171,7,0.749431705,21151,171,3,4
15092,2014/03/31,2012/10/25,61,12,0.8857747970000001,17895,61,4,8
15093,2014/03/31,2006/06/10,125,9,0.64970364,24396,125,4,5
15094,2014/03/31,2010/06/21,4,20,0.5183901879999999,30575,4,11,9
15095,2014/03/31,2011/12/15,34,22,0.565182755,28043,34,9,13
15096,2014/03/31,2011/05/26,2,17,0.629642857,25172,2,8,9
15097,2014/03/31,2007/08/13,84,15,0.7488384290000001,21161,84,6,9
15098,2014/03/31,2007/03/22,450,16,0.677079862,23403,450,16,0
15099,2014/03/31,2012/03/22,1,17,0.753647087,21025,1,6,11
15100,2014/03/31,2011/08/19,221,13,0.690853281,22935,221,10,3
15101,2014/03/31,2009/09/22,108,15,0.7143685470000001,22179,108,6,9
15102,2014/03/31,2012/10/29,55,11,0.55349869,28625,55,5,6
15103,2014/03/31,2011/01/07,214,13,0.830606092,19073,214,11,2
15104,2014/03/31,2010/02/11,163,13,0.748044197,21178,163,12,1
15105,2014/03/31,2009/02/15,31,14,0.6618488339999999,23934,31,2,12
15106,2014/03/31,2008/12/12,51,17,0.723838878,21884,51,8,9
15107,2014/03/31,2013/01/05,145,14,0.8798489140000001,18003,145,4,10
15108,2014/03/31,2011/06/05,17,22,0.629158656,25174,17,8,14
15109,2014/03/31,2007/11/15,115,19,0.880693433,17983,115,12,7
15110,2014/03/31,2010/06/25,105,19,0.729224146,21718,105,13,6
15111,2014/03/31,2012/01/10,5,22,0.701714741,22569,5,2,20
15112,2014/03/31,2011/01/04,12,13,0.7209765090000001,21966,12,5,8
15113,2014/03/31,2011/12/14,46,23,0.7976240370000001,19853,46,12,11
15114,2014/03/31,2010/03/15,12,21,0.83368083,18993,12,14,7
15115,2014/03/31,2010/09/08,16,17,0.701266664,22579,16,8,9
15116,2014/03/31,2012/03/17,197,11,0.842841097,18785,197,10,1
15117,2014/03/31,2012/09/01,185,11,0.689942912,22947,185,4,7
15118,2014/03/31,2008/10/20,4,15,0.6400133410000001,24736,4,7,8
15119,2014/03/31,2006/07/19,12,24,0.605540892,26142,12,14,10
15120,2014/03/31,2011/11/18,534,11,1.0,15829,534,11,0
15121,2014/03/31,2011/12/22,123,11,0.681651593,23220,123,9,2
15122,2014/03/31,2011/07/08,156,10,0.797586937,19842,156,1,9
15123,2014/03/31,2009/07/31,29,10,0.911666763,17357,29,6,4
15124,2014/03/31,2010/03/05,102,22,0.65378796,24203,102,9,13
15125,2014/03/31,2011/08/23,311,12,0.781258023,20254,311,9,3
15126,2014/03/31,2011/11/06,559,15,0.8283033190000001,19102,559,15,0
15127,2014/03/31,2011/03/29,18,22,0.5994770939999999,26391,18,15,7
15128,2014/03/31,2008/03/13,82,11,0.8396056890000001,18843,82,6,5
15129,2014/03/31,2008/12/19,349,8,0.628870692,25157,349,6,2
15130,2014/03/31,2007/01/12,1,20,0.804875095,19655,1,0,20
15131,2014/03/31,2012/10/10,280,8,0.658772799,24014,280,6,2
15132,2014/03/31,2012/09/10,26,16,0.7424955409999999,21306,26,6,10
15133,2014/03/31,2011/11/27,304,3,0.693323398,22814,304,2,1
15134,2014/03/31,2011/05/03,22,23,0.624106297,25344,22,11,12
15135,2014/03/31,2006/08/24,5,16,0.640929573,24678,5,7,9
15136,2014/03/31,2005/02/02,10,22,0.524477864,30155,10,8,14
15137,2014/03/31,2006/06/15,15,14,0.685613563,23062,15,8,6
15138,2014/03/31,2007/06/02,12,17,0.675579388,23404,12,4,13
15139,2014/03/31,2011/02/15,108,12,0.596867024,26486,108,9,3
15140,2014/03/31,2011/12/19,106,9,0.7685793470000001,20568,106,4,5
15141,2014/03/31,2006/05/30,7,15,0.7563730320000001,20899,7,9,6
15142,2014/03/31,2006/09/17,3,15,0.638165523,24770,3,6,9
15143,2014/03/31,2012/06/01,82,8,0.7831501759999999,20183,82,4,4
15144,2014/03/31,2010/03/29,21,15,0.58828681,26868,21,5,10
15145,2014/03/31,2011/10/31,143,11,0.7353559129999999,21494,143,4,7
15146,2014/03/31,2006/07/24,51,14,0.637037201,24811,51,5,9
15147,2014/03/31,2007/10/06,77,22,0.647547425,24407,77,16,6
15148,2014/03/31,2012/01/04,66,18,0.58656584,26944,66,10,8
15149,2014/03/31,2010/07/09,213,9,0.8049029790000001,19635,213,3,6
15150,2014/03/31,2008/08/26,60,3,0.582385024,27136,60,1,2
15151,2014/03/31,2007/02/12,71,15,0.683381335,23124,71,8,7
15152,2014/03/31,2010/04/13,62,14,0.5664838320000001,27894,62,8,6
15153,2014/03/31,2011/03/13,88,14,0.7681614,20570,88,10,4
15154,2014/03/31,2006/02/22,18,10,0.668002621,23651,18,3,7
15155,2014/03/31,2006/03/01,27,18,0.654137303,24151,27,8,10
15156,2014/03/31,2005/12/08,318,5,0.912206952,17318,318,4,1
15157,2014/03/31,2005/12/11,32,24,0.855143723,18473,32,13,11
15158,2014/03/31,2012/11/01,30,13,0.745893852,21178,30,4,9
15159,2014/03/31,2012/03/28,27,16,0.7369134940000001,21432,27,11,5
15160,2014/03/31,2006/12/03,20,21,0.8082216879999999,19541,20,5,16
15161,2014/03/31,2005/10/11,11,22,0.791001202,19966,11,7,15
15162,2014/03/31,2007/12/24,37,18,0.691848688,22827,37,16,2
15163,2014/03/31,2011/04/17,27,21,0.789283822,20009,27,9,12
15164,2014/03/31,2007/12/07,23,24,0.600748631,26288,23,13,11
15165,2014/03/31,2011/07/09,10,15,0.593241172,26620,10,5,10
15166,2014/03/31,2008/05/31,1,8,0.838856308,18825,1,5,3
15167,2014/03/31,2011/02/14,12,20,0.8277467890000001,19075,12,11,9
15168,2014/03/31,2008/07/01,3,20,0.8791408209999999,17959,3,0,20
15169,2014/03/31,2009/11/10,118,15,0.611598807,25813,118,6,9
15170,2014/03/31,2010/08/21,52,14,0.837004401,18861,52,4,10
15171,2014/03/31,2009/12/04,17,18,0.721402916,21883,17,6,12
15172,2014/03/31,2010/01/05,74,17,0.6738773159999999,23426,74,9,8
15173,2014/03/31,2006/05/24,14,12,0.5927753370000001,26631,14,7,5
15174,2014/03/31,2008/04/05,51,19,0.788698476,20015,51,14,5
15175,2014/03/31,2006/08/07,107,16,0.699203136,22576,107,9,7
15176,2014/03/31,2010/11/23,8,26,0.7786956740000001,20271,8,6,20
15177,2014/03/31,2011/10/11,203,10,0.826490208,19098,203,7,3
15178,2014/03/31,2009/08/22,40,24,0.77135324,20462,40,8,16
15179,2014/03/31,2012/03/07,96,10,0.731138185,21587,96,6,4
15180,2014/03/31,2011/08/24,16,7,0.8528571429999999,18501,16,4,3
15181,2014/03/31,2007/04/14,88,23,0.6245762579999999,25263,88,16,7
15182,2014/03/31,2012/09/27,28,12,0.5915729279999999,26670,28,6,6
15183,2014/03/31,2012/06/04,1,16,0.546354066,28876,1,10,6
15184,2014/03/31,2006/02/02,228,7,1.4950616,10552,228,5,2
15185,2014/03/31,2007/11/01,177,13,0.7531183459999999,20947,177,5,8
15186,2014/03/31,2007/11/29,86,17,0.61439905,25676,86,11,6
15187,2014/03/31,2011/11/05,118,18,0.838349365,18817,118,0,18
15188,2014/03/31,2011/09/02,74,23,0.484169557,32579,74,9,14
15189,2014/03/31,2010/07/25,67,11,0.6709533329999999,23507,67,7,4
15190,2014/03/31,2012/06/13,3,14,0.630301371,25019,3,2,12
15191,2014/03/31,2008/09/30,70,17,0.7692219509999999,20500,70,9,8
15192,2014/03/31,2004/11/25,39,21,0.594826481,26510,39,9,12
15193,2014/03/31,2010/04/11,95,20,0.61510259,25636,95,2,18
15194,2014/03/31,2006/11/23,1,26,0.564158944,27947,1,5,21
15195,2014/03/31,2007/07/23,132,13,0.7845777559999999,20095,132,10,3
15196,2014/03/31,2009/11/20,29,17,0.847086826,18612,29,8,9
15197,2014/03/31,2012/09/14,1,7,1.081175502,14581,1,6,1
15198,2014/03/31,2011/03/24,432,8,0.786538941,20043,432,8,0
15199,2014/03/31,2012/05/07,510,5,0.66128403,23839,510,5,0
15200,2014/03/31,2008/02/27,25,20,0.8516651359999999,18509,25,9,11
15201,2014/03/31,2010/04/21,1,26,0.750165152,21011,1,13,13
15202,2014/03/31,2011/08/03,635,11,0.908280989,17353,635,11,0
15203,2014/03/31,2011/06/12,104,13,0.620982231,25381,104,6,7
15204,2014/03/31,2010/03/30,66,17,0.683047153,23074,66,8,9
15205,2014/03/31,2011/12/31,332,8,0.830576051,18974,332,6,2
15206,2014/03/31,2013/02/10,7,14,0.651373595,24192,7,1,13
15207,2014/03/31,2012/10/18,8,14,0.6778268159999999,23247,8,3,11
15208,2014/03/31,2012/02/13,260,15,0.940096659,16760,260,13,2
15209,2014/03/31,2010/02/10,2,23,0.522475126,30152,2,11,12
15210,2014/03/31,2006/11/03,185,5,0.840971273,18728,185,1,4
15211,2014/03/31,2012/12/08,23,10,0.6289349470000001,25041,23,4,6
15212,2014/03/31,2009/10/15,20,7,0.7690645759999999,20472,20,1,6
15213,2014/03/31,2009/12/11,98,12,0.592950813,26552,98,0,12
15214,2014/03/31,2009/02/22,134,21,0.8737690090000001,18018,134,12,9
15215,2014/03/31,2006/03/17,7,14,0.731448285,21522,7,6,8
15216,2014/03/31,2011/11/02,96,10,0.628819417,25030,96,3,7
15217,2014/03/31,2012/02/16,429,24,0.744022407,21154,429,24,0
15218,2014/03/31,2005/03/11,44,18,0.611046318,25757,44,4,14
15219,2014/03/31,2007/06/20,1,33,0.697413037,22567,1,13,20
15220,2014/03/31,2011/11/18,4,15,0.7851973259999999,20043,4,12,3
15221,2014/03/31,2004/11/08,110,15,0.653922962,24066,110,8,7
15222,2014/03/31,2010/01/19,23,14,0.563540197,27925,23,3,11
15223,2014/03/31,2007/03/01,84,9,0.830512455,18948,84,5,4
15224,2014/03/31,2006/12/15,45,14,0.6756896259999999,23288,45,8,6
15225,2014/03/31,2011/09/15,7,14,0.678302725,23196,7,7,7
15226,2014/03/31,2010/02/12,43,26,0.846037858,18596,43,17,9
15227,2014/03/31,2011/02/05,261,11,0.814773422,19309,261,10,1
15228,2014/03/31,2008/12/31,65,9,0.902380406,17434,65,4,5
15229,2014/03/31,2007/08/12,9,12,0.8265713840000001,19031,9,7,5
15230,2014/03/31,2006/11/24,305,3,0.4908387420000001,32048,305,1,2
15231,2014/03/31,2011/09/14,268,9,0.623276409,25238,268,7,2
15232,2014/03/31,2005/10/02,66,17,0.973084442,16165,66,8,9
15233,2014/03/31,2012/09/13,3,26,0.791112005,19883,3,10,16
15234,2014/03/31,2008/04/15,64,17,0.6940560459999999,22660,64,12,5
15235,2014/03/31,2010/08/30,49,16,0.577326456,27241,49,11,5
15236,2014/03/31,2007/10/29,46,16,0.8327226520000001,18886,46,11,5
15237,2014/03/31,2008/02/19,4,21,0.702751162,22376,4,8,13
15238,2014/03/31,2005/06/23,14,20,0.66019188,23817,14,14,6
15239,2014/03/31,2012/11/13,178,13,0.785851245,20006,178,8,5
15240,2014/03/31,2012/05/21,63,16,0.941038013,16705,63,10,6
15241,2014/03/31,2007/07/09,2,15,0.602081658,26109,2,4,11
15242,2014/03/31,2012/10/17,163,11,0.756297455,20783,163,4,7
15243,2014/03/31,2011/04/22,67,15,0.606154261,25930,67,6,9
15244,2014/03/31,2009/12/22,25,21,0.829004642,18958,25,12,9
15245,2014/03/31,2005/07/30,1,26,0.586341827,26803,1,11,15
15246,2014/03/31,2011/01/25,18,23,0.700853142,22423,18,5,18
15247,2014/03/31,2010/10/27,17,12,0.746894962,21040,17,2,10
15248,2014/03/31,2012/04/17,191,22,0.629211211,24975,191,18,4
15249,2014/03/31,2009/03/01,74,20,0.75889844,20707,74,13,7
15250,2014/03/31,2010/07/29,152,14,0.967739114,16237,152,10,4
15251,2014/03/31,2011/09/07,83,15,0.840279159,18699,83,4,11
15252,2014/03/31,2009/08/11,11,19,0.591788768,26549,11,13,6
15253,2014/03/31,2011/08/21,703,2,0.775,20272,703,2,0
15254,2014/03/31,2007/07/31,1,21,0.618556242,25399,1,9,12
15255,2014/03/31,2008/12/06,124,7,0.94968869,16543,124,5,2
15256,2014/03/31,2009/01/16,17,16,0.7494609040000001,20961,17,3,13
15257,2014/03/31,2013/03/30,187,7,0.574829479,27328,187,0,7
15258,2014/03/31,2009/12/08,6,12,0.641562245,24484,6,4,8
15259,2014/03/31,2004/11/25,18,15,0.574499835,27341,18,3,12
15260,2014/03/31,2008/11/13,20,15,0.673158391,23322,20,13,2
15261,2014/03/31,2012/08/22,341,26,0.502392077,31249,341,21,5
15262,2014/03/31,2006/02/15,65,18,0.577624287,27175,65,14,4
15263,2014/03/31,2006/07/18,2,25,0.54811245,28635,2,9,16
15264,2014/03/31,2013/03/06,177,4,1.00675797,15589,177,0,4
15265,2014/03/31,2011/10/16,166,14,0.61690173,25440,166,9,5
15266,2014/03/31,2008/08/18,30,6,1.246666667,12588,30,0,6
15267,2014/03/31,2005/01/01,89,17,0.729655926,21507,89,6,11
15268,2014/03/31,2006/01/12,4,21,0.738895324,21237,4,13,8
15269,2014/03/31,2010/12/07,51,14,0.702360682,22341,51,11,3
15270,2014/03/31,2006/06/04,4,32,0.590728484,26562,4,17,15
15271,2014/03/31,2007/09/05,102,25,0.6912953820000001,22696,102,8,17
15272,2014/03/31,2013/03/23,14,11,1.200979026,13064,14,1,10
15273,2014/03/31,2006/08/03,1,20,0.6158207720000001,25476,1,9,11
15274,2014/03/31,2009/01/16,49,11,0.907598496,17285,49,6,5
15275,2014/03/31,2010/11/25,78,28,0.771750873,20327,78,10,18
15276,2014/03/31,2012/12/20,25,16,0.785491237,19970,25,6,10
15277,2014/03/31,2011/10/21,199,12,0.8337392370000001,18814,199,8,4
15278,2014/03/31,2012/01/22,60,3,0.643333333,24381,60,2,1
15279,2014/03/31,2009/10/01,105,13,0.709616307,22101,105,6,7
15280,2014/03/31,2008/01/12,36,13,0.7069123279999999,22185,36,4,9
15281,2014/03/31,2008/01/15,210,12,0.8272616979999999,18957,210,9,3
15282,2014/03/31,2005/05/21,181,22,0.8087030070000001,19391,181,17,5
15283,2014/03/31,2008/06/12,75,19,0.874898733,17923,75,10,9
15284,2014/03/31,2013/03/18,6,10,0.74854831,20948,6,1,9
15285,2014/03/31,2006/11/10,9,15,0.586817501,26718,9,8,7
15286,2014/03/31,2011/09/19,5,12,0.644933975,24309,5,6,6
15287,2014/03/31,2007/07/23,132,18,0.654633566,23947,132,9,9
15288,2014/03/31,2011/12/04,236,9,0.734628614,21339,236,8,1
15289,2014/03/31,2007/09/04,32,16,0.6541555729999999,23963,32,10,6
15290,2014/03/31,2012/08/17,66,8,1.312946645,11939,66,3,5
15291,2014/03/31,2009/02/17,71,22,0.661646617,23691,71,10,12
15292,2014/03/31,2010/09/02,220,12,0.6877858240000001,22785,220,10,2
15293,2014/03/31,2012/03/13,19,23,0.695774986,22523,19,8,15
15294,2014/03/31,2009/09/18,108,22,0.7076779259999999,22144,108,11,11
15295,2014/03/31,2007/09/29,6,25,0.727514276,21539,6,14,11
15296,2014/03/31,2011/09/02,40,21,0.86226955,18171,40,8,13
15297,2014/03/31,2006/08/09,12,14,0.58022516,27003,12,6,8
15298,2014/03/31,2009/01/03,177,22,0.840307857,18645,177,19,3
15299,2014/03/31,2008/01/06,180,14,0.758710896,20650,180,11,3
15300,2014/03/31,2008/04/17,63,19,0.954597855,16412,63,11,8
15301,2014/03/31,2010/11/17,1,23,0.6521483579999999,24023,1,8,15
15302,2014/03/31,2012/02/25,108,14,0.8047924590000001,19466,108,9,5
15303,2014/03/31,2005/12/19,10,16,0.59467317,26344,10,6,10
15304,2014/03/31,2011/12/21,3,15,0.655943218,23881,3,3,12
15305,2014/03/31,2009/06/30,132,10,0.88,17800,132,2,8
15306,2014/03/31,2007/03/27,3,19,0.8540972790000001,18339,3,1,18
15307,2014/03/31,2010/07/01,50,13,0.7785317359999999,20119,50,4,9
15308,2014/03/31,2008/11/20,148,16,0.780136481,20076,148,6,10
15309,2014/03/31,2006/03/12,11,26,0.802362314,19519,11,4,22
15310,2014/03/31,2010/07/01,3,22,0.6001391070000001,26095,3,6,16
15311,2014/03/31,2011/09/02,34,18,0.6993466709999999,22393,34,4,14
15312,2014/03/31,2008/11/21,42,14,0.741466383,21120,42,6,8
15313,2014/03/31,2009/03/03,132,3,0.901289283,17374,132,0,3
15314,2014/03/31,2012/08/14,233,9,0.931122079,16817,233,2,7
15315,2014/03/31,2010/07/24,8,22,0.565273817,27701,8,13,9
15316,2014/03/31,2011/11/23,30,2,0.64,24464,30,1,1
15317,2014/03/31,2008/12/15,118,2,0.64,24464,118,0,2
15318,2014/03/31,2010/02/16,59,10,0.7953731270000001,19685,59,4,6
15319,2014/03/31,2013/01/05,25,18,0.595880495,26275,25,2,16
15320,2014/03/31,2011/04/18,47,16,0.748125,20928,47,8,8
15321,2014/03/31,2012/09/11,87,19,0.638214096,24531,87,11,8
15322,2014/03/31,2007/07/01,2,12,0.685298752,22845,2,6,6
15323,2014/03/31,2011/01/31,43,19,0.6108279679999999,25629,43,9,10
15324,2014/03/31,2008/05/25,31,19,0.70865375,22091,31,9,10
15325,2014/03/31,2013/03/22,67,10,0.544902357,28727,67,0,10
15326,2014/03/31,2012/10/21,13,11,0.8070616140000001,19395,13,2,9
15327,2014/03/31,2009/07/28,27,22,0.526352815,29738,27,16,6
15328,2014/03/31,2007/06/14,15,27,0.809596007,19332,15,6,21
15329,2014/03/31,2010/01/14,43,14,0.661472043,23661,43,4,10
15330,2014/03/31,2006/05/19,27,21,0.515395712,30363,27,13,8
15331,2014/03/31,2011/05/23,108,14,0.837360873,18688,108,6,8
15332,2014/03/31,2012/06/20,67,9,0.468057134,33430,67,7,2
15333,2014/03/31,2007/10/06,144,17,0.832018505,18806,144,8,9
15334,2014/03/31,2007/08/16,23,18,0.65750788,23795,23,6,12
15335,2014/03/31,2005/10/15,310,5,1.5,10429,310,2,3
15336,2014/03/31,2011/09/11,474,8,0.8317045940000001,18808,474,8,0
15337,2014/03/31,2008/12/30,9,15,0.609429963,25665,9,4,11
15338,2014/03/31,2012/08/30,208,18,0.959957037,16293,208,10,8
15339,2014/03/31,2007/10/05,2,7,0.5554435679999999,28158,2,0,7
15340,2014/03/31,2009/06/25,100,14,0.868825,18000,100,11,3
15341,2014/03/31,2013/03/23,12,18,0.738676019,21171,12,0,18
15342,2014/03/31,2005/11/04,106,14,0.658357964,23751,106,3,11
15343,2014/03/31,2009/03/20,33,14,0.6904954740000001,22645,33,4,10
15344,2014/03/31,2012/09/11,7,9,0.8971957309999999,17427,7,3,6
15345,2014/03/31,2005/02/25,109,13,0.549220825,28466,109,3,10
15346,2014/03/31,2012/06/07,22,10,0.934815834,16724,22,7,3
15347,2014/03/31,2011/08/01,356,23,0.7913043479999999,19757,356,22,1
15348,2014/03/31,2011/03/30,141,15,0.642715014,24324,141,8,7
15349,2014/03/31,2012/07/27,33,18,0.8521040009999999,18346,33,7,11
15350,2014/03/31,2012/10/09,95,19,0.843778809,18527,95,6,13
15351,2014/03/31,2010/08/27,144,15,0.50455505,30981,144,7,8
15352,2014/03/31,2009/04/03,86,12,0.900833333,17352,86,9,3
15353,2014/03/31,2011/01/04,62,12,0.648829853,24091,62,7,5
15354,2014/03/31,2010/09/04,1,21,0.824888912,18949,1,16,5
15355,2014/03/31,2011/10/26,90,14,0.796463694,19625,90,7,7
15356,2014/03/31,2010/10/22,104,23,0.8765191790000001,17832,104,16,7
15357,2014/03/31,2007/04/26,75,16,0.83650289,18684,75,6,10
15358,2014/03/31,2009/08/03,1,11,0.603385453,25902,1,6,5
15359,2014/03/31,2010/10/21,21,11,0.785942357,19881,21,5,6
15360,2014/03/31,2008/11/30,24,12,0.794830095,19658,24,2,10
15361,2014/03/31,2007/08/30,50,21,0.633164485,24677,50,12,9
15362,2014/03/31,2013/03/16,29,16,0.740036472,21112,29,2,14
15363,2014/03/31,2005/09/28,80,32,0.67373469,23188,80,18,14
15364,2014/03/31,2010/04/20,46,17,0.71828268,21749,46,14,3
15365,2014/03/31,2009/09/29,40,13,0.754568861,20701,40,7,6
15366,2014/03/31,2012/06/08,90,24,0.55045107,28377,90,13,11
15367,2014/03/31,2012/02/27,89,19,0.752611545,20754,89,9,10
15368,2014/03/31,2013/03/21,14,16,0.487217595,32055,14,1,15
15369,2014/03/31,2006/03/23,145,15,0.780536259,20009,145,8,7
15370,2014/03/31,2012/01/01,372,9,0.759971767,20543,372,9,0
15371,2014/03/31,2012/06/26,6,24,0.779516653,20027,6,10,14
15372,2014/03/31,2005/02/20,12,23,0.489803589,31872,12,10,13
15373,2014/03/31,2008/08/07,204,12,0.820712445,19019,204,8,4
15374,2014/03/31,2008/03/12,18,21,0.782631368,19944,18,0,21
15375,2014/03/31,2009/03/11,48,17,0.708170682,22041,48,6,11
15376,2014/03/31,2005/03/31,161,6,0.672838607,23198,161,4,2
15377,2014/03/31,2010/11/04,13,15,0.863368922,18077,13,13,2
15378,2014/03/31,2012/11/11,136,3,1.012278005,15417,136,2,1
15379,2014/03/31,2007/05/17,60,10,0.858644217,18174,60,3,7
15380,2014/03/31,2007/06/04,16,19,0.590905786,26408,16,13,6
15381,2014/03/31,2007/09/18,26,20,0.8213496159999999,18998,26,12,8
15382,2014/03/31,2007/11/13,29,17,0.7542408279999999,20687,29,0,17
15383,2014/03/31,2012/06/06,189,13,0.7044338090000001,22148,189,7,6
15384,2014/03/31,2011/01/04,186,14,0.797792892,19555,186,7,7
15385,2014/03/31,2005/12/01,174,16,0.534106269,29209,174,10,6
15386,2014/03/31,2011/08/26,218,17,0.707643803,22044,218,13,4
15387,2014/03/31,2010/10/01,144,13,0.84096075,18548,144,10,3
15388,2014/03/31,2009/11/11,289,14,1.137171916,13716,289,10,4
15389,2014/03/31,2009/07/27,3,15,0.67806,23000,3,5,10
15390,2014/03/31,2008/09/28,1,16,0.761635573,20476,1,11,5
15391,2014/03/31,2010/10/22,36,14,0.771308735,20218,36,8,6
15392,2014/03/31,2011/05/27,429,12,0.796628352,19575,429,12,0
15393,2014/03/31,2007/08/29,15,14,0.72971688,21369,15,3,11
15394,2014/03/31,2010/01/14,43,10,0.5742956060000001,27151,43,5,5
15395,2014/03/31,2013/02/04,2,22,0.577104153,27018,2,0,22
15396,2014/03/31,2008/05/30,234,11,0.6494135529999999,24009,234,7,4
15397,2014/03/31,2013/03/11,7,25,0.877700968,17764,7,3,22
15398,2014/03/31,2012/02/07,109,12,0.719428703,21670,109,2,10
15399,2014/03/31,2010/11/30,254,19,0.810666112,19231,254,16,3
15400,2014/03/31,2009/09/19,9,22,0.8061032109999999,19339,9,8,14
15401,2014/03/31,2010/10/15,35,19,0.749762409,20792,35,7,12
15402,2014/03/31,2007/12/20,32,9,0.640479517,24337,32,1,8
15403,2014/03/31,2006/08/23,23,13,1.005884859,15494,23,7,6
15404,2014/03/31,2011/01/07,191,23,0.656131436,23753,191,13,10
15405,2014/03/31,2012/05/31,424,21,0.792910201,19655,424,21,0
15406,2014/03/31,2004/12/03,308,17,0.6060472889999999,25714,308,15,2
15407,2014/03/31,2011/04/21,134,12,0.646474981,24102,134,3,9
15408,2014/03/31,2013/01/26,21,10,0.714197836,21816,21,0,10
15409,2014/03/31,2005/05/25,17,14,0.6561489220000001,23744,17,4,10
15410,2014/03/31,2012/12/17,143,12,0.749128198,20796,143,3,9
15411,2014/03/31,2012/12/11,76,27,0.6714926720000001,23200,76,4,23
15412,2014/03/31,2007/07/30,39,8,0.91445351,17036,39,4,4
15413,2014/03/31,2012/01/10,244,21,0.77017798,20227,244,14,7
15414,2014/03/31,2007/06/17,216,10,0.73,21340,216,8,2
15415,2014/03/31,2013/03/26,66,11,0.777272727,20042,66,0,11
15416,2014/03/31,2012/08/04,172,17,0.70814665,21998,172,13,4
15417,2014/03/31,2013/03/22,9,12,0.694069156,22442,9,2,10
15418,2014/03/31,2008/09/08,109,6,0.592579516,26284,109,3,3
15419,2014/03/31,2010/11/13,122,24,0.811842585,19185,122,19,5
15420,2014/03/31,2011/05/31,102,17,0.961412963,16200,102,12,5
15421,2014/03/31,2010/10/14,133,21,0.7284738070000001,21380,133,4,17
15422,2014/03/31,2009/12/29,128,15,0.646486778,24089,128,11,4
15423,2014/03/31,2012/06/08,112,13,0.667634298,23325,112,3,10
15424,2014/03/31,2012/07/11,202,12,0.813907157,19129,202,7,5
15425,2014/03/31,2005/03/23,200,11,0.858967115,18124,200,9,2
15426,2014/03/31,2006/05/20,157,11,0.738011283,21094,157,4,7
15427,2014/03/31,2012/12/06,106,12,0.6705530670000001,23216,106,4,8
15428,2014/03/31,2006/10/23,125,13,0.621832308,25034,125,5,8
15429,2014/03/31,2011/05/24,1,14,0.7341931979999999,21201,1,7,7
15430,2014/03/31,2011/01/29,5,17,0.666359005,23359,5,7,10
15431,2014/03/31,2011/08/01,51,16,0.662282784,23502,51,8,8
15432,2014/03/31,2005/09/09,3,17,0.7408901370000001,21008,3,9,8
15433,2014/03/31,2008/03/03,47,17,0.519017542,29986,47,6,11
15434,2014/03/31,2010/11/15,121,17,0.91503587,17006,121,7,10
15435,2014/03/31,2007/08/22,220,4,0.8950264609999999,17384,220,2,2
15436,2014/03/31,2005/09/09,4,11,1.307591394,11899,4,2,9
15437,2014/03/31,2012/01/09,142,17,0.500715734,31073,142,13,4
15438,2014/03/31,2010/11/17,155,14,0.577853959,26924,155,7,7
15439,2014/03/31,2011/09/30,9,26,0.921923077,16874,9,2,24
15440,2014/03/31,2008/03/11,31,18,0.77736295,20011,31,1,17
15441,2014/03/31,2012/09/15,130,21,0.5841325820000001,26625,130,11,10
15442,2014/03/31,2012/02/17,18,19,0.678644238,22917,18,17,2
15443,2014/03/31,2010/04/30,8,11,0.625900511,24847,8,9,2
15444,2014/03/31,2007/10/10,90,14,0.5707656170000001,27246,90,8,6
15445,2014/03/31,2010/02/04,2,25,0.643056693,24183,2,13,12
15446,2014/03/31,2008/05/23,249,14,0.671104782,23172,249,12,2
15447,2014/03/31,2012/09/14,179,10,0.687973278,22603,179,4,6
15448,2014/03/31,2006/07/07,2,18,0.8214121190000001,18929,2,6,12
15449,2014/03/31,2007/03/07,9,23,0.709730199,21905,9,14,9
15450,2014/03/31,2011/07/07,137,13,0.7574377590000001,20525,137,10,3
15451,2014/03/31,2007/11/03,4,14,0.758095099,20505,4,2,12
15452,2014/03/31,2012/03/12,206,19,0.8479455570000001,18331,206,13,6
15453,2014/03/31,2007/12/12,4,16,0.8137525520000001,19099,4,12,4
15454,2014/03/31,2013/01/29,31,27,0.634311837,24500,31,4,23
15455,2014/03/31,2006/05/02,14,15,0.696377487,22316,14,8,7
15456,2014/03/31,2006/09/26,23,28,0.694807959,22365,23,12,16
15457,2014/03/31,2005/11/05,23,23,0.732688608,21208,23,17,6
15458,2014/03/31,2012/11/17,61,15,0.686631021,22630,61,2,13
15459,2014/03/31,2008/02/04,48,11,0.684449828,22702,48,6,5
15460,2014/03/31,2011/11/01,22,44,0.633410398,24525,22,22,22
15461,2014/03/31,2012/06/15,173,14,0.773969907,20071,173,10,4
15462,2014/03/31,2006/05/31,12,14,0.911809697,17036,12,3,11
15463,2014/03/31,2010/07/05,184,18,0.537442738,28902,184,11,7
15464,2014/03/31,2008/08/13,85,19,0.710001828,21877,85,7,12
15465,2014/03/31,2007/05/12,93,25,0.717312275,21654,93,14,11
15466,2014/03/31,2011/07/26,88,16,0.54602053,28446,88,8,8
15467,2014/03/31,2010/07/07,33,23,0.564865976,27495,33,16,7
15468,2014/03/31,2011/07/21,40,17,0.7924302259999999,19599,40,7,10
15469,2014/03/31,2012/01/25,102,21,0.837828128,18537,102,13,8
15470,2014/03/31,2011/09/24,40,23,0.636216869,24411,40,12,11
15471,2014/03/31,2012/02/05,52,18,0.637928853,24344,52,8,10
15472,2014/03/31,2011/04/10,6,13,0.7605793909999999,20418,6,7,6
15473,2014/03/31,2010/10/21,10,17,0.867074819,17910,10,1,16
15474,2014/03/31,2010/01/07,13,23,0.81577117,19036,13,7,16
15475,2014/03/31,2011/10/25,7,20,0.689279595,22529,7,5,15
15476,2014/03/31,2008/07/23,26,8,1.320694055,11757,26,3,5
15477,2014/03/31,2011/01/15,186,12,0.647730686,23972,186,8,4
15478,2014/03/31,2013/02/01,6,18,0.754439532,20581,6,5,13
15479,2014/03/31,2007/11/25,212,16,0.669153594,23204,212,7,9
15480,2014/03/31,2011/09/29,39,27,0.648771519,23932,39,18,9
15481,2014/03/31,2006/08/14,134,12,0.8727924890000001,17787,134,8,4
15482,2014/03/31,2010/07/28,92,21,0.680968152,22796,92,20,1
15483,2014/03/31,2012/09/21,5,21,0.7000338229999999,22174,5,10,11
15484,2014/03/31,2010/11/19,269,14,0.6700276270000001,23166,269,10,4
15485,2014/03/31,2007/06/29,11,7,1.256626184,12351,11,3,4
15486,2014/03/31,2011/07/31,12,15,0.770403574,20145,12,5,10
15487,2014/03/31,2009/09/21,106,20,0.599450346,25889,106,15,5
15488,2014/03/31,2010/08/12,3,15,0.6119345429999999,25360,3,1,14
15489,2014/03/31,2007/08/09,2,5,0.611489085,25378,2,2,3
15490,2014/03/31,2013/03/18,25,22,0.763796702,20315,25,2,20
15491,2014/03/31,2006/05/20,30,24,0.5984793429999999,25923,30,6,18
15492,2014/03/31,2012/09/14,10,21,0.786321658,19729,10,12,9
15493,2014/03/31,2012/11/07,7,26,0.710968378,21820,7,6,20
15494,2014/03/31,2008/06/20,58,12,0.75622258,20514,58,7,5
15495,2014/03/31,2011/10/09,60,16,0.6916358290000001,22429,60,9,7
15496,2014/03/31,2011/07/10,184,12,0.6898634709999999,22486,184,6,6
15497,2014/03/31,2006/05/13,35,14,0.788230601,19679,35,9,5
15498,2014/03/31,2008/05/23,23,23,0.702154013,22089,23,13,10
15499,2014/03/31,2010/12/27,8,15,0.769566835,20154,8,6,9
15500,2014/03/31,2007/04/26,21,14,0.81694601,18985,21,3,11
15501,2014/03/31,2007/07/31,82,14,0.698888288,22191,82,8,6
15502,2014/03/31,2008/03/08,73,16,0.70900064,21874,73,10,6
15503,2014/03/31,2009/11/11,169,10,0.778168816,19927,169,3,7
15504,2014/03/31,2006/06/25,35,5,1.3984614,11088,35,2,3
15505,2014/03/31,2012/08/10,61,38,0.726949693,21329,61,15,23
15506,2014/03/31,2012/04/16,15,14,0.606689364,25554,15,3,11
15507,2014/03/31,2005/04/08,21,13,0.724882405,21387,21,2,11
15508,2014/03/31,2009/09/03,73,18,0.597823722,25925,73,0,18
15509,2014/03/31,2006/01/29,23,20,0.697392224,22222,23,11,9
15510,2014/03/31,2012/04/28,4,17,0.592854629,26140,4,6,11
15511,2014/03/31,2006/04/20,136,15,0.931971374,16628,136,5,10
15512,2014/03/31,2012/06/07,10,31,0.41659928,37198,10,15,16
15513,2014/03/31,2007/07/06,68,15,0.7152871120000001,21664,68,7,8
15514,2014/03/31,2007/07/17,164,6,1.224715042,12651,164,2,4
15515,2014/03/31,2011/02/23,153,10,0.8405012479999999,18434,153,6,4
15516,2014/03/31,2010/04/26,9,19,0.6607403620000001,23448,9,8,11
15517,2014/03/31,2007/03/09,126,13,0.689151246,22480,126,7,6
15518,2014/03/31,2010/12/07,24,17,1.395471579,11101,24,7,10
15519,2014/03/31,2006/02/25,22,17,0.493320271,31389,22,11,6
15520,2014/03/31,2012/02/06,49,12,0.7752854,19972,49,6,6
15521,2014/03/31,2012/08/15,11,19,0.700662956,22098,11,14,5
15522,2014/03/31,2010/06/02,21,12,0.682788411,22676,21,0,12
15523,2014/03/31,2009/09/06,126,13,0.708436513,21855,126,8,5
15524,2014/03/31,2010/07/06,111,12,0.709775363,21813,111,6,6
15525,2014/03/31,2013/01/06,6,12,0.7462424679999999,20745,6,4,8
15526,2014/03/31,2011/10/28,114,15,0.985218941,15712,114,11,4
15527,2014/03/31,2013/01/13,126,12,0.702896458,22020,126,1,11
15528,2014/03/31,2011/07/31,107,27,0.646706369,23928,107,2,25
15529,2014/03/31,2006/08/15,40,16,0.822133673,18822,40,3,13
15530,2014/03/31,2012/08/01,26,15,0.7375699509999999,20979,26,9,6
15531,2014/03/31,2008/04/19,45,14,0.725791078,21319,45,6,8
15532,2014/03/31,2007/06/18,34,8,1.067760524,14490,34,3,5
15533,2014/03/31,2008/09/17,13,20,0.623182001,24824,13,11,9
15534,2014/03/31,2010/03/18,4,15,0.66189979,23371,4,5,10
15535,2014/03/31,2011/07/25,307,17,0.622764604,24839,307,15,2
15536,2014/03/31,2013/01/26,10,19,0.693355897,22307,10,3,16
15537,2014/03/31,2010/11/24,4,17,0.556034873,27815,4,9,8
15538,2014/03/31,2012/01/30,135,13,1.430064731,10814,135,10,3
15539,2014/03/31,2006/06/04,174,7,0.835714286,18501,174,4,3
15540,2014/03/31,2008/09/01,65,10,0.7859999999999999,19670,65,6,4
15541,2014/03/31,2011/07/24,46,23,0.44501828,34737,46,13,10
15542,2014/03/31,2004/11/05,217,13,0.60170689,25690,217,8,5
15543,2014/03/31,2007/03/21,11,33,0.619459784,24953,11,21,12
15544,2014/03/31,2013/02/18,30,17,0.778384952,19857,30,0,17
15545,2014/03/31,2010/10/07,5,19,0.7180812120000001,21524,5,3,16
15546,2014/03/31,2009/06/22,35,14,0.573449095,26952,35,9,5
15547,2014/03/31,2007/02/19,21,25,0.762739882,20260,21,12,13
15548,2014/03/31,2012/11/23,62,26,0.6906932459999999,22373,62,11,15
15549,2014/03/31,2006/04/11,26,18,0.651414721,23722,26,4,14
15550,2014/03/31,2005/04/14,95,18,0.767051378,20145,95,13,5
15551,2014/03/31,2009/08/05,27,11,0.859681171,17972,27,5,6
15552,2014/03/31,2012/09/27,65,3,0.6132359479999999,25192,65,0,3
15553,2014/03/31,2011/09/19,70,17,0.837063668,18455,70,1,16
15554,2014/03/31,2006/06/19,390,21,0.592102338,26090,390,21,0
15555,2014/03/31,2008/12/09,29,16,0.579124991,26674,29,7,9
15556,2014/03/31,2007/07/17,227,13,0.750913422,20571,227,8,5
15557,2014/03/31,2011/07/11,13,26,0.8110643209999999,19045,13,14,12
15558,2014/03/31,2010/02/15,24,18,0.6774085609999999,22802,24,8,10
15559,2014/03/31,2006/06/03,39,25,0.7345175709999999,21029,39,17,8
15560,2014/03/31,2013/01/06,48,15,0.7730230229999999,19980,48,2,13
15561,2014/03/31,2005/12/08,50,22,0.828884238,18633,50,11,11
15562,2014/03/31,2012/04/04,394,8,0.763410113,20231,394,8,0
15563,2014/03/31,2008/06/27,134,12,0.808686773,19098,134,8,4
15564,2014/03/31,2010/09/27,2,11,0.7769044620000001,19877,2,5,6
15565,2014/03/31,2011/06/12,7,17,0.667840924,23121,7,9,8
15566,2014/03/31,2007/09/16,288,9,0.76764431,20113,288,7,2
15567,2014/03/31,2012/10/07,48,12,0.6524220270000001,23662,48,5,7
15568,2014/03/31,2012/01/05,75,13,0.800995745,19272,75,4,9
15569,2014/03/31,2010/11/14,245,16,0.56433298,27353,245,11,5
15570,2014/03/31,2011/08/23,418,19,0.708358956,21791,418,19,0
15571,2014/03/31,2012/03/17,256,14,0.732791967,21064,256,13,1
15572,2014/03/31,2012/02/21,261,17,0.643235123,23996,261,13,4
15573,2014/03/31,2011/12/13,104,11,0.784914815,19663,104,8,3
15574,2014/03/31,2009/02/21,68,12,0.737040787,20938,68,9,3
15575,2014/03/31,2008/03/01,46,22,0.602363871,25619,46,14,8
15576,2014/03/31,2009/09/28,79,10,0.632009256,24417,79,2,8
15577,2014/03/31,2007/09/21,43,14,0.74004508,20852,43,7,7
15578,2014/03/31,2006/05/27,77,11,0.635342968,24288,77,7,4
15579,2014/03/31,2009/02/15,61,18,0.6672890810000001,23125,61,10,8
15580,2014/03/31,2011/11/30,46,16,0.727849528,21200,46,10,6
15581,2014/03/31,2012/07/17,128,18,0.616072113,25044,128,9,9
15582,2014/03/31,2008/08/05,283,9,1.221296809,12631,283,7,2
15583,2014/03/31,2007/11/07,88,23,0.7395388079999999,20859,88,9,14
15584,2014/03/31,2010/08/27,12,12,0.647186071,23835,12,2,10
15585,2014/03/31,2012/12/26,86,13,0.707472366,21803,86,5,8
15586,2014/03/31,2011/07/17,10,13,0.803388718,19199,10,5,8
15587,2014/03/31,2010/08/21,48,10,0.788316978,19566,48,6,4
15588,2014/03/31,2009/08/02,58,18,0.940747789,16395,58,8,10
15589,2014/03/31,2012/12/23,1,20,0.6736922340000001,22894,1,1,19
15590,2014/03/31,2012/01/25,5,13,0.618665303,24927,5,4,9
15591,2014/03/31,2010/06/05,51,10,0.888258641,17360,51,5,5
15592,2014/03/31,2008/09/05,153,13,0.8486087720000001,18171,153,8,5
15593,2014/03/31,2012/01/28,56,14,0.83323949,18506,56,9,5
15594,2014/03/31,2012/06/27,60,12,0.738561165,20878,60,6,6
15595,2014/03/31,2012/03/20,13,27,0.614471188,25094,13,23,4
15596,2014/03/31,2010/10/12,233,13,0.733799553,21013,233,7,6
15597,2014/03/31,2012/05/26,37,13,0.7469481179999999,20643,37,6,7
15598,2014/03/31,2009/08/03,181,5,0.8159062290000001,18897,181,0,5
15599,2014/03/31,2010/10/12,229,12,0.7160247059999999,21533,229,8,4
15600,2014/03/31,2012/04/01,2,25,0.610692359,25247,2,8,17
15601,2014/03/31,2009/12/22,88,12,0.7465046,20650,88,5,7
15602,2014/03/31,2011/08/27,108,4,0.690998879,22305,108,1,3
15603,2014/03/31,2005/04/11,330,5,1.5,10275,330,4,1
15604,2014/03/31,2010/01/10,31,9,0.790155857,19505,31,7,2
15605,2014/03/31,2010/08/27,34,16,0.734091169,20994,34,6,10
15606,2014/03/31,2012/11/03,2,33,0.71905133,21430,2,12,21
15607,2014/03/31,2012/11/11,66,6,0.7863978770000001,19594,66,1,5
15608,2014/03/31,2005/05/26,26,19,0.551289088,27950,26,12,7
15609,2014/03/31,2013/01/19,15,19,0.641714631,24011,15,1,18
15610,2014/03/31,2010/10/10,74,18,0.7741282279999999,19902,74,5,13
15611,2014/03/31,2007/11/02,124,16,0.728221308,21156,124,8,8
15612,2014/03/31,2012/12/04,3,19,0.7778581170000001,19805,3,6,13
15613,2014/03/31,2011/06/09,4,17,0.7306184490000001,21085,4,9,8
15614,2014/03/31,2012/07/07,65,10,0.613929539,25092,65,4,6
15615,2014/03/31,2011/04/06,609,4,0.55,28003,609,4,0
15616,2014/03/31,2012/10/13,186,16,0.608464638,25310,186,9,7
15617,2014/03/31,2006/03/19,4,10,0.940105623,16379,4,4,6
15618,2014/03/31,2010/04/28,292,6,1.482950014,10383,292,3,3
15619,2014/03/31,2009/11/23,104,16,0.590090829,26093,104,5,11
15620,2014/03/31,2012/07/19,45,9,0.84138095,18299,45,3,6
15621,2014/03/31,2007/07/31,50,9,1.061578403,14502,50,4,5
15622,2014/03/31,2010/09/28,127,28,0.7004673709999999,21974,127,15,13
15623,2014/03/31,2011/01/06,5,13,0.700267552,21977,5,8,5
15624,2014/03/31,2010/04/30,49,16,0.614798258,25032,49,6,10
15625,2014/03/31,2006/04/29,9,8,0.930652516,16536,9,0,8
15626,2014/03/31,2009/09/19,72,11,0.61965327,24832,72,3,8
15627,2014/03/31,2006/02/12,6,29,0.7058154040000001,21799,6,18,11
15628,2014/03/31,2013/03/23,81,10,0.651789451,23605,81,2,8
15629,2014/03/31,2005/01/02,119,11,0.723617932,21258,119,5,6
15630,2014/03/31,2012/01/22,103,9,0.605555556,25398,103,4,5
15631,2014/03/31,2012/03/18,95,15,0.6804273959999999,22602,95,9,6
15632,2014/03/31,2011/09/29,83,13,0.647454216,23753,83,7,6
15633,2014/03/31,2012/05/04,112,16,0.782899908,19642,112,10,6
15634,2014/03/31,2010/09/26,8,12,0.775163323,19838,8,6,6
15635,2014/03/31,2012/12/12,207,13,0.7092288529999999,21682,207,8,5
15636,2014/03/31,2007/12/07,88,10,0.845050833,18197,88,4,6
15637,2014/03/31,2011/05/13,12,22,0.687582722,22364,12,9,13
15638,2014/03/31,2006/07/15,19,10,0.889390942,17289,19,2,8
15639,2014/03/31,2009/06/11,54,14,0.6833564440000001,22500,54,3,11
15640,2014/03/31,2012/08/01,11,6,0.793333333,19380,11,2,4
15641,2014/03/31,2012/09/15,497,6,0.795096721,19334,497,6,0
15642,2014/03/31,2011/03/05,2,12,0.76035119,20217,2,5,7
15643,2014/03/31,2007/03/21,70,12,0.918317701,16739,70,6,6
15644,2014/03/31,2011/09/14,59,18,0.7265714959999999,21155,59,10,8
15645,2014/03/31,2008/11/06,11,11,0.818093464,18788,11,5,6
15646,2014/03/31,2012/04/27,88,20,0.761203011,20191,88,12,8
15647,2014/03/31,2013/02/01,74,14,0.845112174,18186,74,2,12
15648,2014/03/31,2010/09/12,3,21,0.8427115209999999,18237,3,17,4
15649,2014/03/31,2010/07/24,131,24,0.86812101,17701,131,14,10
15650,2014/03/31,2012/11/05,42,16,0.7207562390000001,21316,42,7,9
15651,2014/03/31,2012/10/20,80,16,0.569739672,26966,80,8,8
15652,2014/03/31,2011/01/01,78,18,0.6473410310000001,23731,78,6,12
15653,2014/03/31,2010/08/21,93,9,0.7331782170000001,20952,93,2,7
15654,2014/03/31,2011/06/13,219,16,0.708929659,21666,219,9,7
15655,2014/03/31,2012/05/23,26,10,0.524362432,29291,26,4,6
15656,2014/03/31,2012/04/09,62,28,0.663878971,23135,62,10,18
15657,2014/03/31,2007/02/16,108,16,0.730166889,21032,108,8,8
15658,2014/03/31,2005/11/23,67,16,0.7282354059999999,21087,67,7,9
15659,2014/03/31,2011/09/24,2,17,0.637347057,24094,2,1,16
15660,2014/03/31,2008/05/20,83,16,0.67487166,22752,83,7,9
15661,2014/03/31,2012/01/24,31,18,0.7026234379999999,21853,31,11,7
15662,2014/03/31,2012/07/31,3,21,0.725755613,21155,3,5,16
15663,2014/03/31,2013/02/25,7,24,0.749226527,20492,7,0,24
15664,2014/03/31,2007/03/20,13,14,0.7848062570000001,19562,13,3,11
15665,2014/03/31,2009/05/24,71,25,0.647923103,23694,71,8,17
15666,2014/03/31,2007/11/01,55,19,0.49997948,30702,55,11,8
15667,2014/03/31,2007/07/22,24,8,0.65375,23480,24,1,7
15668,2014/03/31,2007/06/08,34,18,0.608359558,25231,34,4,14
15669,2014/03/31,2008/01/25,74,12,0.68790731,22311,74,6,6
15670,2014/03/31,2010/12/20,152,14,0.856894857,17909,152,9,5
15671,2014/03/31,2006/01/01,7,19,0.703373831,21812,7,5,14
15672,2014/03/31,2010/12/26,29,7,0.594782895,25794,29,5,2
15673,2014/03/31,2012/08/09,31,17,0.573889575,26733,31,3,14
15674,2014/03/31,2011/09/08,300,8,0.807833184,18991,300,5,3
15675,2014/03/31,2010/11/04,20,12,0.708852073,21639,20,9,3
15676,2014/03/31,2008/02/01,47,11,0.551588449,27807,47,5,6
15677,2014/03/31,2008/11/19,33,15,0.883193597,17366,33,9,6
15678,2014/03/31,2011/03/03,6,23,0.794025678,19316,6,12,11
15679,2014/03/31,2010/03/17,418,16,0.866172484,17706,418,16,0
15680,2014/03/31,2012/09/16,27,17,0.7118989929999999,21543,27,11,6
15681,2014/03/31,2009/10/03,71,19,0.79478182,19296,71,10,9
15682,2014/03/31,2010/08/20,238,17,0.96414812,15906,238,7,10
15683,2014/03/31,2008/05/05,222,17,0.7741811390000001,19808,222,11,6
15684,2014/03/31,2011/01/12,8,17,0.8566540029999999,17899,8,10,7
15685,2014/03/31,2013/01/24,259,7,0.887733773,17271,259,4,3
15686,2014/03/31,2011/07/01,16,23,0.7292142690000001,21025,16,10,13
15687,2014/03/31,2010/12/19,60,21,0.650857106,23556,60,13,8
15688,2014/03/31,2005/11/17,43,15,0.7427430840000001,20641,43,3,12
15689,2014/03/31,2011/12/06,9,13,0.703501904,21791,9,9,4
15690,2014/03/31,2011/12/16,1,10,0.957104951,16017,1,6,4
15691,2014/03/31,2005/06/24,93,19,0.583682227,26264,93,11,8
15692,2014/03/31,2009/03/10,176,13,0.829546488,18478,176,8,5
15693,2014/03/31,2008/01/30,98,9,0.665673152,23026,98,3,6
15694,2014/03/31,2005/07/12,409,21,0.711616678,21538,409,21,0
15695,2014/03/31,2008/07/20,373,10,0.781505278,19611,373,10,0
15696,2014/03/31,2012/05/12,86,15,0.676132533,22666,86,12,3
15697,2014/03/31,2008/03/13,106,17,0.899365573,17039,106,9,8
15698,2014/03/31,2010/09/22,5,16,0.670786605,22845,5,8,8
15699,2014/03/31,2008/11/18,89,26,0.8298878959999999,18465,89,17,9
15700,2014/03/31,2011/07/09,9,20,0.68684805,22310,9,5,15
15701,2014/03/31,2011/08/26,13,15,0.6458684929999999,23725,13,7,8
15702,2014/03/31,2012/02/21,88,22,0.612434053,25020,88,17,5
15703,2014/03/31,2012/01/16,5,15,0.8064307140000001,19001,5,4,11
15704,2014/03/31,2012/12/12,39,9,0.8655555559999999,17703,39,3,6
15705,2014/03/31,2009/04/19,24,16,0.7586695390000001,20196,24,7,9
15706,2014/03/31,2011/07/19,27,14,0.7247024879999999,21142,27,9,5
15707,2014/03/31,2009/06/14,20,23,0.650790044,23543,20,16,7
15708,2014/03/31,2012/04/04,254,13,0.8226723579999999,18624,254,7,6
15709,2014/03/31,2010/04/28,288,6,1.427571748,10732,288,2,4
15710,2014/03/31,2010/11/25,194,26,0.708405697,21627,194,17,9
15711,2014/03/31,2011/07/26,289,11,0.788080465,19437,289,8,3
15712,2014/03/31,2006/10/23,109,18,0.7382990309999999,20747,109,11,7
15713,2014/03/31,2011/09/09,360,12,0.670154445,22856,360,10,2
15714,2014/03/31,2011/12/26,5,12,0.648993178,23599,5,3,9
15715,2014/03/31,2008/06/01,19,12,0.676089701,22653,19,3,9
15716,2014/03/31,2009/01/04,47,6,0.7733762559999999,19803,47,1,5
15717,2014/03/31,2005/10/28,14,10,0.841925783,18190,14,6,4
15718,2014/03/31,2005/11/27,238,15,0.63162714,24245,238,7,8
15719,2014/03/31,2011/03/25,22,22,0.70095528,21847,22,13,9
15720,2014/03/31,2011/08/03,10,12,0.844919715,18123,10,6,6
15721,2014/03/31,2009/03/28,63,17,0.912560343,16779,63,10,7
15722,2014/03/31,2010/03/10,197,15,0.793070548,19306,197,12,3
15723,2014/03/31,2009/11/14,11,12,0.656658518,23316,11,8,4
15724,2014/03/31,2008/10/07,13,19,0.57805286,26485,13,13,6
15725,2014/03/31,2005/09/09,8,22,0.616423596,24835,8,11,11
15726,2014/03/31,2009/03/02,24,21,0.717040749,21350,24,6,15
15727,2014/03/31,2006/06/19,118,9,0.946962761,16166,118,7,2
15728,2014/03/31,2008/01/20,74,14,0.910298507,16817,74,6,8
15729,2014/03/31,2011/09/19,27,11,0.8018023259999999,19092,27,3,8
15730,2014/03/31,2011/12/12,79,26,0.612354588,24998,79,5,21
15731,2014/03/31,2012/07/10,24,18,0.668255915,22906,24,5,13
15732,2014/03/31,2007/04/30,268,8,1.489533865,10276,268,7,1
15733,2014/03/31,2009/06/26,48,17,0.7116869709999999,21506,48,4,13
15734,2014/03/31,2011/07/09,3,16,0.577973866,26479,3,9,7
15735,2014/03/31,2010/01/04,9,7,0.827142857,18501,9,4,3
15736,2014/03/31,2010/08/03,132,11,0.757759842,20195,132,2,9
15737,2014/03/31,2007/11/19,132,16,0.69680479,21961,132,7,9
15738,2014/03/31,2006/06/05,37,7,0.701154692,21824,37,4,3
15739,2014/03/31,2008/09/17,37,18,0.8276352229999999,18488,37,13,5
15740,2014/03/31,2009/09/28,441,8,1.5,10200,441,8,0
15741,2014/03/31,2011/11/05,161,18,0.682374114,22421,161,7,11
15742,2014/03/31,2012/06/25,202,14,0.730260645,20948,202,7,7
15743,2014/03/31,2007/03/18,180,10,0.70550738,21680,180,5,5
15744,2014/03/31,2006/04/15,32,12,0.777793033,19665,32,3,9
15745,2014/03/31,2005/07/26,25,17,0.796560417,19200,25,12,5
15746,2014/03/31,2010/01/21,14,32,0.566856211,26977,14,16,16
15747,2014/03/31,2010/05/07,186,14,0.7364035640000001,20765,186,11,3
15748,2014/03/31,2011/09/15,17,18,0.8842696040000001,17292,17,9,9
15749,2014/03/31,2011/06/19,539,13,0.578538726,26429,539,13,0
15750,2014/03/31,2011/07/15,195,2,0.625,24464,195,0,2
15751,2014/03/31,2009/12/11,685,2,0.625,24464,685,2,0
15752,2014/03/31,2009/09/10,237,2,0.625,24464,237,0,2
15753,2014/03/31,2010/02/01,178,2,0.625,24464,178,0,2
15754,2014/03/31,2010/09/13,240,2,0.625,24464,240,0,2
15755,2014/03/31,2011/05/08,174,2,0.625,24464,174,0,2
15756,2014/03/31,2013/01/22,395,2,0.625,24464,395,2,0
15757,2014/03/31,2011/07/14,215,10,0.8314132679999999,18390,215,5,5
15758,2014/03/31,2011/02/27,12,23,0.654365341,23359,12,8,15
15759,2014/03/31,2007/07/16,82,12,0.877131872,17426,82,4,8
15760,2014/03/31,2012/06/19,18,26,0.750240514,20373,18,7,19
15761,2014/03/31,2007/05/23,76,19,0.812644901,18806,76,13,6
15762,2014/03/31,2008/06/18,48,16,0.7291645590000001,20959,48,11,5
15763,2014/03/31,2007/09/21,6,14,0.75296216,20296,6,3,11
15764,2014/03/31,2009/10/05,133,7,0.6991389490000001,21857,133,2,5
15765,2014/03/31,2008/04/10,79,22,0.650722286,23481,79,8,14
15766,2014/03/31,2012/09/07,45,7,0.805879747,18960,45,4,3
15767,2014/03/31,2006/04/18,150,8,0.760425024,20093,150,2,6
15768,2014/03/31,2013/01/08,141,14,0.8297452890000001,18413,141,5,9
15769,2014/03/31,2010/05/01,41,16,0.663188488,23036,41,12,4
15770,2014/03/31,2009/12/01,30,18,0.599375785,25488,30,11,7
15771,2014/03/31,2005/11/24,199,10,0.655224534,23315,199,6,4
15772,2014/03/31,2012/09/15,64,7,1.424197278,10726,64,1,6
15773,2014/03/31,2007/01/23,66,10,0.677361653,22552,66,8,2
15774,2014/03/31,2005/10/16,73,16,0.72925765,20947,73,10,6
15775,2014/03/31,2005/05/17,4,18,0.633106349,24128,4,3,15
15776,2014/03/31,2007/04/07,55,13,0.8575918020000001,17810,55,2,11
15777,2014/03/31,2011/11/01,19,7,1.354890446,11273,19,0,7
15778,2014/03/31,2008/11/20,32,14,0.787952435,19384,32,0,14
15779,2014/03/31,2006/12/10,84,14,0.910228262,16779,84,6,8
15780,2014/03/31,2012/05/15,2,15,0.701394975,21771,2,8,7
15781,2014/03/31,2011/05/07,12,15,0.814771357,18741,12,7,8
15782,2014/03/31,2012/10/30,76,13,0.424691959,35953,76,3,10
15783,2014/03/31,2009/01/26,119,21,0.74732697,20430,119,15,6
15784,2014/03/31,2006/06/12,20,14,0.869378737,17561,20,12,2
15785,2014/03/31,2006/05/30,11,11,0.978009609,15610,11,1,10
15786,2014/03/31,2009/08/27,9,14,0.6456872779999999,23644,9,5,9
15787,2014/03/31,2007/05/21,75,8,0.927593875,16458,75,3,5
15788,2014/03/31,2010/10/18,361,6,1.262245742,12094,361,5,1
15789,2014/03/31,2012/12/03,13,10,0.793788155,19231,13,4,6
15790,2014/03/31,2008/01/28,112,15,0.831652411,18355,112,11,4
15791,2014/03/31,2006/03/22,80,19,0.769312065,19842,80,5,14
15792,2014/03/31,2007/06/16,48,14,0.8064449490000001,18928,48,6,8
15793,2014/03/31,2010/09/03,27,29,0.481442044,31705,27,14,15
15794,2014/03/31,2012/06/02,285,17,0.851975887,17916,285,10,7
15795,2014/03/31,2007/05/31,110,17,0.6612364079999999,23083,110,11,6
15796,2014/03/31,2011/01/04,7,20,0.578275679,26393,7,13,7
15797,2014/03/31,2012/11/29,50,8,1.005756837,15175,50,1,7
15798,2014/03/31,2008/10/13,366,15,0.8093170009999999,18858,366,14,1
15799,2014/03/31,2011/08/04,29,7,0.7671428570000001,19894,29,3,4
15800,2014/03/31,2005/03/08,282,9,0.499168874,30573,282,6,3
15801,2014/03/31,2010/06/06,63,14,0.596986934,25562,63,6,8
15802,2014/03/31,2008/11/18,27,15,0.853267725,17884,27,7,8
15803,2014/03/31,2012/08/08,114,19,0.7847999379999999,19444,114,10,9
15804,2014/03/31,2008/08/05,193,25,0.6690477029999999,22808,193,17,8
15805,2014/03/31,2011/07/26,12,13,0.664898475,22950,12,7,6
15806,2014/03/31,2005/11/27,165,24,0.799504873,19086,165,16,8
15807,2014/03/31,2009/01/13,30,24,0.598073607,25514,30,9,15
15808,2014/03/31,2005/05/17,188,10,1.473031181,10359,188,9,1
15809,2014/03/31,2011/08/03,13,15,0.963826038,15831,13,11,4
15810,2014/03/31,2007/07/17,24,17,0.5932913360000001,25716,24,7,10
15811,2014/03/31,2010/02/12,2,27,0.746091763,20444,2,0,27
15812,2014/03/31,2008/11/18,49,17,0.764013224,19964,49,8,9
15813,2014/03/31,2011/05/16,31,26,0.658723708,23153,31,8,18
15814,2014/03/31,2011/02/23,168,18,0.716340364,21289,168,14,4
15815,2014/03/31,2012/02/16,178,12,0.8217254009999999,18558,178,5,7
15816,2014/03/31,2013/03/26,167,11,0.699090909,21813,167,1,10
15817,2014/03/31,2007/08/16,3,12,0.59274307,25723,3,0,12
15818,2014/03/31,2010/02/19,8,17,0.779193458,19565,8,3,14
15819,2014/03/31,2011/09/01,104,16,0.689564863,22108,104,9,7
15820,2014/03/31,2011/01/10,34,15,0.564088588,27024,34,7,8
15821,2014/03/31,2012/10/16,61,16,0.710033537,21469,61,4,12
15822,2014/03/31,2011/03/29,88,20,0.708988837,21500,88,14,6
15823,2014/03/31,2012/06/16,27,14,0.666196949,22879,27,3,11
15824,2014/03/31,2012/07/26,4,18,0.61577767,24747,4,3,15
15825,2014/03/31,2012/01/07,8,19,0.7482186,20366,8,13,6
15826,2014/03/31,2011/09/24,67,20,0.6094212689999999,25003,67,12,8
15827,2014/03/31,2010/09/23,195,15,0.561435941,27139,195,13,2
15828,2014/03/31,2011/04/19,32,17,0.713078111,21367,32,11,6
15829,2014/03/31,2007/02/15,96,19,0.673810703,22610,96,8,11
15830,2014/03/31,2012/04/12,529,16,0.8909526870000001,17099,529,16,0
15831,2014/03/31,2011/03/18,7,35,0.534559045,28495,7,22,13
15832,2014/03/31,2009/10/15,26,10,0.8857757620000001,17196,26,1,9
15833,2014/03/31,2013/02/05,319,7,0.787503231,19341,319,4,3
15834,2014/03/31,2012/02/25,154,6,1.030292924,14782,154,2,4
15835,2014/03/31,2012/12/07,17,13,0.7719286329999999,19729,17,7,6
15836,2014/03/31,2011/02/15,2,17,0.600247133,25371,2,9,8
15837,2014/03/31,2008/06/08,125,15,0.581039338,26209,125,10,5
15838,2014/03/31,2006/04/14,20,16,0.723736217,21040,20,8,8
15839,2014/03/31,2011/12/22,93,16,0.7698872370000001,19776,93,12,4
15840,2014/03/31,2006/01/15,18,23,0.709621947,21452,18,13,10
15841,2014/03/31,2009/10/15,9,11,0.671524108,22669,9,5,6
15842,2014/03/31,2011/07/08,132,11,0.675364685,22540,132,2,9
15843,2014/03/31,2009/01/22,2,16,0.675195848,22543,2,6,10
15844,2014/03/31,2012/09/05,108,8,0.956111949,15918,108,3,5
15845,2014/03/31,2005/02/06,167,11,1.078728381,14108,167,6,5
15846,2014/03/31,2011/07/02,170,13,0.74153014,20521,170,4,9
15847,2014/03/31,2006/10/01,57,15,0.848990682,17923,57,7,8
15848,2014/03/31,2012/09/01,9,14,0.8363586390000001,18191,9,8,6
15849,2014/03/31,2008/02/28,169,13,0.682824828,22281,169,6,7
15850,2014/03/31,2010/09/22,15,14,0.58048653,26206,15,0,14
15851,2014/03/31,2010/05/01,5,13,0.878474821,17316,5,9,4
15852,2014/03/31,2009/11/16,249,13,1.274464181,11935,249,12,1
15853,2014/03/31,2007/11/09,169,12,1.178253796,12908,169,0,12
15854,2014/03/31,2010/11/27,19,13,0.7994979759999999,19023,19,2,11
15855,2014/03/31,2012/11/22,67,9,0.766632555,19837,67,3,6
15856,2014/03/31,2011/08/06,231,12,0.71683558,21214,231,10,2
15857,2014/03/31,2010/05/12,6,9,0.8703497020000001,17472,6,7,2
15858,2014/03/31,2008/09/11,10,39,0.648588065,23443,10,20,19
15859,2014/03/31,2007/05/18,6,13,0.721343581,21078,6,3,10
15860,2014/03/31,2005/06/03,161,20,0.62749804,24229,161,13,7
15861,2014/03/31,2010/05/17,228,13,0.781622539,19451,228,8,5
15862,2014/03/31,2011/04/22,32,14,0.677833162,22429,32,8,6
15863,2014/03/31,2010/10/24,76,13,1.105927381,13743,76,10,3
15864,2014/03/31,2009/02/27,117,27,0.7293924270000001,20837,117,12,15
15865,2014/03/31,2009/09/15,107,14,0.693643998,21910,107,9,5
15866,2014/03/31,2010/08/23,9,25,0.634204925,23960,9,12,13
15867,2014/03/31,2013/01/01,79,14,0.612801258,24796,79,2,12
15868,2014/03/31,2011/05/24,57,16,0.764514441,19874,57,7,9
15869,2014/03/31,2011/05/28,38,11,0.66007429,23018,38,8,3
15870,2014/03/31,2008/07/03,73,17,0.649506669,23392,73,11,6
15871,2014/03/31,2013/01/05,44,13,0.609494524,24927,44,4,9
15872,2014/03/31,2011/01/17,1,7,1.41941792,10703,1,1,6
15873,2014/03/31,2007/10/02,100,23,0.653913043,23230,100,17,6
15874,2014/03/31,2010/12/09,1,10,0.742359122,20461,1,4,6
15875,2014/03/31,2012/08/22,17,11,0.8036991379999999,18899,17,3,8
15876,2014/03/31,2011/12/11,32,7,0.612636228,24793,32,2,5
15877,2014/03/31,2010/02/02,78,15,0.816039327,18613,78,8,7
15878,2014/03/31,2006/03/26,20,13,0.725463794,20936,20,6,7
15879,2014/03/31,2010/10/20,215,3,0.666643989,22783,215,1,2
15880,2014/03/31,2011/04/07,47,9,0.723817853,20983,47,2,7
15881,2014/03/31,2007/12/24,13,13,0.7544955040000001,20129,13,6,7
15882,2014/03/31,2006/09/30,27,27,0.594077218,25564,27,3,24
15883,2014/03/31,2007/11/30,81,8,0.957689057,15855,81,5,3
15884,2014/03/31,2007/05/29,151,14,0.8129360109999999,18675,151,8,6
15885,2014/03/31,2009/03/13,161,11,0.815373543,18619,161,7,4
15886,2014/03/31,2010/02/18,13,20,0.880499971,17241,13,9,11
15887,2014/03/31,2005/01/01,12,16,0.6719307720000001,22592,12,5,11
15888,2014/03/31,2012/03/02,254,18,0.831870992,18247,254,14,4
15889,2014/03/31,2013/01/23,22,8,0.768926039,19740,22,2,6
15890,2014/03/31,2011/10/13,119,12,0.922523251,16451,119,3,9
15891,2014/03/31,2009/04/14,16,13,0.783677959,19364,16,0,13
15892,2014/03/31,2007/08/15,102,16,0.903392272,16797,102,5,11
15893,2014/03/31,2012/05/10,24,18,0.636796341,23829,24,9,9
15894,2014/03/31,2009/12/31,1,18,0.8768592890000001,17305,1,15,3
15895,2014/03/31,2013/03/01,43,10,0.663515393,22868,43,1,9
15896,2014/03/31,2008/01/30,27,17,0.7353681,20633,27,8,9
15897,2014/03/31,2012/04/01,515,12,0.966666667,15696,515,12,0
15898,2014/03/31,2010/01/07,59,16,0.715408336,21208,59,7,9
15899,2014/03/31,2010/04/11,1,25,0.7490269070000001,20255,1,11,14
15900,2014/03/31,2008/05/10,23,33,0.746412792,20325,23,16,17
15901,2014/03/31,2010/06/07,85,8,0.7175,21144,85,6,2
15902,2014/03/31,2010/07/01,37,9,0.826666667,18351,37,0,9
15903,2014/03/31,2007/06/04,49,11,0.836522914,18133,49,9,2
15904,2014/03/31,2012/10/23,38,17,0.701547569,21621,38,8,9
15905,2014/03/31,2005/10/17,72,9,0.62239977,24369,72,8,1
15906,2014/03/31,2009/01/14,18,13,0.672134722,22565,18,5,8
15907,2014/03/31,2010/12/10,115,13,0.615873467,24626,115,6,7
15908,2014/03/31,2010/03/01,2,20,0.844382761,17959,2,13,7
15909,2014/03/31,2012/12/20,138,11,0.8827561709999999,17176,138,2,9
15910,2014/03/31,2010/06/28,35,18,0.858208423,17666,35,2,16
15911,2014/03/31,2009/03/11,116,14,0.862672698,17574,116,5,9
15912,2014/03/31,2011/06/06,21,19,0.779413852,19449,21,7,12
15913,2014/03/31,2010/06/25,37,19,0.741904948,20431,37,15,4
15914,2014/03/31,2012/08/07,81,9,0.7993661009999999,18962,81,6,3
15915,2014/03/31,2005/09/15,251,12,0.979605612,15467,251,8,4
15916,2014/03/31,2012/07/31,18,15,0.750176264,20197,18,7,8
15917,2014/03/31,2013/01/01,49,20,0.631218232,24002,49,0,20
15918,2014/03/31,2010/03/24,30,15,0.553693848,27359,30,9,6
15919,2014/03/31,2011/07/28,446,17,0.653819759,23169,446,17,0
15920,2014/03/31,2010/11/16,130,19,0.82497413,18361,130,15,4
15921,2014/03/31,2012/06/11,50,13,0.733031652,20662,50,10,3
15922,2014/03/31,2012/02/28,43,20,0.7266062179999999,20844,43,10,10
15923,2014/03/31,2013/02/01,407,3,0.529372903,28608,407,3,0
15924,2014/03/31,2010/02/20,154,15,0.77359011,19576,154,8,7
15925,2014/03/31,2008/05/15,2,16,0.747484081,20259,2,6,10
15926,2014/03/31,2011/09/14,47,15,0.755942289,20031,47,9,6
15927,2014/03/31,2011/02/01,77,18,0.7640150370000001,19818,77,11,7
15928,2014/03/31,2010/07/11,137,15,0.797647245,18982,137,8,7
15929,2014/03/31,2013/02/02,11,19,0.702911927,21539,11,2,17
15930,2014/03/31,2013/02/19,1,41,0.592477495,25550,1,4,37
15931,2014/03/31,2012/05/17,98,12,0.565879846,26749,98,7,5
15932,2014/03/31,2012/07/27,369,12,0.799926012,18922,369,12,0
15933,2014/03/31,2006/06/26,100,13,0.626209094,24171,100,6,7
15934,2014/03/31,2011/02/01,13,15,0.823832462,18372,13,13,2
15935,2014/03/31,2012/12/15,49,13,0.728175432,20783,49,5,8
15936,2014/03/31,2005/02/23,103,29,0.8283753009999999,18268,103,28,1
15937,2014/03/31,2012/11/14,2,34,1.05118305,14395,2,6,28
15938,2014/03/31,2009/03/11,2,15,1.342254945,11273,2,2,13
15939,2014/03/31,2011/11/06,72,12,0.8530904990000001,17735,72,10,2
15940,2014/03/31,2007/01/31,104,14,0.615883167,24565,104,9,5
15941,2014/03/31,2007/01/07,109,16,0.762221383,19848,109,9,7
15942,2014/03/31,2010/03/19,7,19,0.7013682309999999,21568,7,9,10
15943,2014/03/31,2012/04/23,273,13,0.5656678629999999,26742,273,11,2
15944,2014/03/31,2007/04/14,76,24,0.532575261,28401,76,11,13
15945,2014/03/31,2012/04/21,340,3,0.965094436,15672,340,1,2
15946,2014/03/31,2007/01/04,3,27,0.7739341829999999,19539,3,13,14
15947,2014/03/31,2009/02/12,53,7,0.7054971309999999,21433,53,3,4
15948,2014/03/31,2007/05/04,63,12,0.8013875340000001,18868,63,0,12
15949,2014/03/31,2011/03/11,23,13,0.744460584,20309,23,3,10
15950,2014/03/31,2006/04/20,19,21,0.821881048,18394,19,11,10
15951,2014/03/31,2008/03/09,59,23,0.737252377,20505,59,12,11
15952,2014/03/31,2009/09/05,289,13,0.924428545,16353,289,9,4
15953,2014/03/31,2008/09/25,481,20,0.635097891,23802,481,20,0
15954,2014/03/31,2008/11/23,44,16,0.70155799,21547,44,5,11
15955,2014/03/31,2008/10/14,92,4,0.90734858,16659,92,2,2
15956,2014/03/31,2012/04/17,198,16,0.705317312,21430,198,8,8
15957,2014/03/31,2008/07/25,3,17,0.765361049,19748,3,7,10
15958,2014/03/31,2009/07/19,20,16,1.027543001,14709,20,9,7
15959,2014/03/31,2012/09/09,62,17,1.162238542,13004,62,6,11
15960,2014/03/31,2008/08/13,82,15,0.644336204,23456,82,6,9
15961,2014/03/31,2010/05/08,5,16,0.732209302,20640,5,5,11
15962,2014/03/31,2007/06/21,56,11,0.765671075,19737,56,5,6
15963,2014/03/31,2011/03/16,5,16,0.6524770089999999,23161,5,7,9
15964,2014/03/31,2009/10/22,12,22,0.74143509,20382,12,10,12
15965,2014/03/31,2012/09/27,21,31,0.8419354840000001,17949,21,9,22
15966,2014/03/31,2011/06/12,85,7,0.7472261509999999,20221,85,2,5
15967,2014/03/31,2008/08/14,137,12,1.404430191,10758,137,9,3
15968,2014/03/31,2007/06/13,219,12,0.59,25608,219,5,7
15969,2014/03/31,2006/05/12,135,17,0.7347881909999999,20561,135,8,9
15970,2014/03/31,2007/07/28,21,18,0.7930159059999999,19049,21,6,12
15971,2014/03/31,2010/07/25,437,11,0.8081032640000001,18690,437,11,0
15972,2014/03/31,2012/09/05,35,11,0.5320082429999999,28388,35,6,5
15973,2014/03/31,2010/03/22,146,16,0.84086971,17960,146,8,8
15974,2014/03/31,2011/12/14,209,12,0.748317641,20180,209,9,3
15975,2014/03/31,2008/06/01,45,27,0.724371372,20847,45,11,16
15976,2014/03/31,2011/04/11,84,21,0.7265377209999999,20784,84,18,3
15977,2014/03/31,2007/10/09,97,16,0.648481426,23285,97,10,6
15978,2014/03/31,2009/02/10,64,11,0.850069812,17762,64,9,2
15979,2014/03/31,2006/01/12,9,17,0.6693978629999999,22553,9,5,12
15980,2014/03/31,2011/05/25,47,9,1.090771065,13838,47,4,5
15981,2014/03/31,2012/11/12,105,13,0.614431462,24563,105,2,11
15982,2014/03/31,2007/11/27,11,15,0.7557918459999999,19966,11,5,10
15983,2014/03/31,2011/07/09,5,25,0.623095218,24218,5,1,24
15984,2014/03/31,2012/06/15,46,12,0.792648001,19037,46,9,3
15985,2014/03/31,2011/02/04,2,12,0.6072514689999999,24846,2,8,4
15986,2014/03/31,2010/12/30,106,18,0.52037769,28992,106,12,6
15987,2014/03/31,2011/10/05,21,14,0.7039547359999999,21430,21,7,7
15988,2014/03/31,2009/03/12,11,27,0.6783326590000001,22239,11,10,17
15989,2014/03/31,2009/06/26,11,15,0.683576834,22067,11,6,9
15990,2014/03/31,2008/09/02,2,30,0.769856071,19593,2,6,24
15991,2014/03/31,2012/04/21,43,16,0.8236394909999999,18313,43,6,10
15992,2014/03/31,2006/06/22,5,8,1.019299135,14796,5,5,3
15993,2014/03/31,2010/03/18,76,11,0.85178876,17705,76,7,4
15994,2014/03/31,2007/03/08,26,16,0.720161883,20941,26,7,9
15995,2014/03/31,2007/03/01,12,19,0.5935588620000001,25407,12,13,6
15996,2014/03/31,2012/01/22,2,17,0.64685642,23311,2,0,17
15997,2014/03/31,2011/04/15,23,15,0.881436923,17106,23,6,9
15998,2014/03/31,2008/02/26,6,19,0.6784735159999999,22221,6,5,14
15999,2014/03/31,2010/07/30,12,19,0.762558928,19770,12,8,11
16000,2014/03/31,2011/07/15,29,16,0.914950537,16477,29,7,9
16001,2014/03/31,2009/01/16,12,13,0.754694869,19975,12,11,2
16002,2014/03/31,2008/03/20,126,17,0.618455732,24374,126,6,11
16003,2014/03/31,2006/07/14,4,19,0.8341798559999999,18070,4,12,7
16004,2014/03/31,2007/11/15,196,8,1.152130245,13083,196,6,2
16005,2014/03/31,2006/01/08,106,23,0.867919618,17367,106,14,9
16006,2014/03/31,2011/10/21,45,11,0.7445628329999999,20244,45,7,4
16007,2014/03/31,2013/01/17,34,29,0.550699331,27369,34,4,25
16008,2014/03/31,2008/10/27,6,18,0.747928143,20151,6,10,8
16009,2014/03/31,2009/01/22,107,5,1.352206371,11145,107,1,4
16010,2014/03/31,2007/12/20,2,12,0.791710008,19035,2,0,12
16011,2014/03/31,2012/09/20,17,22,0.6495289000000001,23201,17,12,10
16012,2014/03/31,2009/11/03,199,12,0.827972527,18200,199,8,4
16013,2014/03/31,2010/11/19,66,8,0.924983423,16288,66,2,6
16014,2014/03/31,2010/11/20,14,18,0.620357819,24286,14,11,7
16015,2014/03/31,2011/09/23,139,15,0.5970051120000001,25233,139,8,7
16016,2014/03/31,2011/05/15,38,11,0.8779274970000001,17158,38,4,7
16017,2014/03/31,2012/12/14,117,22,0.7744306209999999,19451,117,15,7
16018,2014/03/31,2011/04/18,24,17,0.65174974,23112,24,6,11
16019,2014/03/31,2006/03/24,12,27,0.808518519,18630,12,18,9
16020,2014/03/31,2006/08/28,90,23,0.783895915,19215,90,11,12
16021,2014/03/31,2012/03/24,49,15,0.974899676,15450,49,6,9
16022,2014/03/31,2012/05/23,347,9,0.878381058,17147,347,8,1
16023,2014/03/31,2011/12/19,279,11,0.83065685,18132,279,9,2
16024,2014/03/31,2006/06/16,6,8,1.4421059180000002,10442,6,4,4
16025,2014/03/31,2008/03/14,18,8,0.65272345,23070,18,1,7
16026,2014/03/31,2012/01/06,29,10,0.725,20770,29,5,5
16027,2014/03/31,2009/08/20,55,20,0.639152729,23558,55,13,7
16028,2014/03/31,2012/06/04,70,9,1.420061309,10602,70,5,4
16029,2014/03/31,2012/06/18,30,19,0.7512750140000001,20039,30,12,7
16030,2014/03/31,2012/03/25,7,17,0.665587143,22618,7,2,15
16031,2014/03/31,2012/05/19,69,8,0.738846626,20375,69,4,4
16032,2014/03/31,2006/10/15,130,18,0.909421857,16553,130,10,8
16033,2014/03/31,2007/06/07,49,6,0.758477352,19847,49,4,2
16034,2014/03/31,2009/08/27,132,9,0.704291797,21371,132,6,3
16035,2014/03/31,2012/08/22,105,4,0.985813466,15268,105,2,2
16036,2014/03/31,2010/01/08,74,13,0.549479756,27391,74,6,7
16037,2014/03/31,2009/02/17,74,17,0.638301735,23577,74,8,9
16038,2014/03/31,2012/05/01,103,15,0.707960672,21257,103,3,12
16039,2014/03/31,2011/03/29,17,18,0.655655281,22952,17,3,15
16040,2014/03/31,2006/12/27,1,31,0.826013832,18218,1,14,17
16041,2014/03/31,2010/01/06,112,12,0.867660016,17342,112,5,7
16042,2014/03/31,2008/04/15,13,2,0.615,24464,13,0,2
16043,2014/03/31,2007/07/01,67,12,0.6779123109999999,22192,67,5,7
16044,2014/03/31,2010/12/11,6,14,0.6605558970000001,22774,6,7,7
16045,2014/03/31,2010/03/01,4,19,0.623122204,24140,4,10,9
16046,2014/03/31,2011/04/17,16,16,0.5603624779999999,26843,16,8,8
16047,2014/03/31,2012/10/15,65,16,0.6924768659999999,21721,65,7,9
16048,2014/03/31,2008/07/14,25,8,0.66625,22576,25,5,3
16049,2014/03/31,2012/10/31,141,17,0.69198408,21733,141,7,10
16050,2014/03/31,2013/02/16,191,7,0.8510697309999999,17668,191,1,6
16051,2014/03/31,2006/06/27,221,13,0.652312899,23049,221,11,2
16052,2014/03/31,2005/04/23,6,19,0.62016789,24242,6,4,15
16053,2014/03/31,2005/12/01,6,17,0.666875,22544,6,4,13
16054,2014/03/31,2011/11/03,1,10,0.6934564999999999,21678,1,4,6
16055,2014/03/31,2008/03/03,478,16,0.7944509040000001,18922,478,16,0
16056,2014/03/31,2009/02/11,57,23,0.712119202,21107,57,16,7
16057,2014/03/31,2011/04/03,308,14,0.654605636,22961,308,9,5
16058,2014/03/31,2008/02/27,207,11,0.811812682,18514,207,6,5
16059,2014/03/31,2011/04/09,443,5,1.3900295969999998,10812,443,5,0
16060,2014/03/31,2012/01/16,24,19,0.6007959860000001,25013,24,9,10
16061,2014/03/31,2005/04/23,124,15,0.5149936589999999,29177,124,9,6
16062,2014/03/31,2011/11/21,130,15,0.7457732779999999,20148,130,10,5
16063,2014/03/31,2007/05/29,59,23,0.747732272,20095,59,12,11
16064,2014/03/31,2011/06/21,530,12,0.8087792009999999,18578,530,12,0
16065,2014/03/31,2012/06/11,27,17,0.6936067770000001,21662,27,6,11
16066,2014/03/31,2011/08/29,67,27,0.590669524,25436,67,16,11
16067,2014/03/31,2012/01/25,39,16,0.725161462,20717,39,6,10
16068,2014/03/31,2010/12/29,220,11,0.6196559970000001,24244,220,4,7
16069,2014/03/31,2013/03/16,18,28,0.649767281,23118,18,0,28
16070,2014/03/31,2010/10/11,1,17,0.6307857379999999,23812,1,2,15
16071,2014/03/31,2011/12/08,11,15,0.605909311,24788,11,8,7
16072,2014/03/31,2012/12/19,36,23,0.929393564,16160,36,5,18
16073,2014/03/31,2008/11/20,38,19,0.733939498,20462,38,6,13
16074,2014/03/31,2012/10/05,1,25,0.6285805179999999,23889,1,8,17
16075,2014/03/31,2008/08/01,4,16,0.680159442,22077,4,7,9
16076,2014/03/31,2011/01/23,273,11,0.667326548,22499,273,6,5
16077,2014/03/31,2012/03/09,117,14,0.590842549,25411,117,7,7
16078,2014/03/31,2012/12/18,119,13,0.741606323,20245,119,3,10
16079,2014/03/31,2010/07/23,106,15,0.758866761,19784,106,9,6
16080,2014/03/31,2012/12/09,350,5,0.6814556759999999,22031,350,4,1
16081,2014/03/31,2007/05/21,6,17,0.809589085,18544,6,9,8
16082,2014/03/31,2011/07/08,542,3,0.5656512570000001,26541,542,3,0
16083,2014/03/31,2012/07/31,409,11,0.7800743090000001,19244,409,11,0
16084,2014/03/31,2005/03/02,100,7,1.10422098,13594,100,1,6
16085,2014/03/31,2008/04/25,101,8,1.219820398,12305,101,4,4
16086,2014/03/31,2010/01/20,2,24,0.6736056009999999,22282,2,13,11
16087,2014/03/31,2011/07/09,26,16,0.691106097,21716,26,9,7
16088,2014/03/31,2010/11/30,74,20,0.762917493,19671,74,11,9
16089,2014/03/31,2006/08/30,102,12,0.729630476,20567,102,8,4
16090,2014/03/31,2012/12/21,43,13,0.641644574,23386,43,4,9
16091,2014/03/31,2009/10/31,79,28,0.906003019,16560,79,19,9
16092,2014/03/31,2008/10/17,257,6,0.454455685,33014,257,4,2
16093,2014/03/31,2009/02/12,13,20,0.77081381,19464,13,3,17
16094,2014/03/31,2006/06/05,201,8,0.844220834,17769,201,5,3
16095,2014/03/31,2010/06/28,65,10,0.804981486,18635,65,6,4
16096,2014/03/31,2012/10/24,40,13,0.627643933,23900,40,5,8
16097,2014/03/31,2010/02/26,30,24,0.8438436009999999,17775,30,10,14
16098,2014/03/31,2007/11/01,125,10,0.840791524,17839,125,7,3
16099,2014/03/31,2009/10/20,491,6,1.5,9999,491,6,0
16100,2014/03/31,2007/08/30,167,14,0.804182218,18648,167,5,9
16101,2014/03/31,2011/01/13,69,15,0.733532779,20440,69,8,7
16102,2014/03/31,2012/02/21,111,20,0.742526248,20192,111,10,10
16103,2014/03/31,2012/08/22,76,19,0.853330677,17570,76,10,9
16104,2014/03/31,2006/09/15,15,18,0.8176472509999999,18336,15,8,10
16105,2014/03/31,2012/09/11,48,8,0.7265899290000001,20633,48,1,7
16106,2014/03/31,2006/01/29,47,12,0.53665545,27935,47,6,6
16107,2014/03/31,2011/07/10,50,11,0.762104621,19671,50,9,2
16108,2014/03/31,2011/09/18,30,22,0.8778373159999999,17076,30,12,10
16109,2014/03/31,2011/12/28,18,29,0.653739369,22929,18,23,6
16110,2014/03/31,2006/04/26,141,20,0.545958478,27455,141,11,9
16111,2014/03/31,2010/03/01,120,15,0.84286847,17783,120,5,10
16112,2014/03/31,2006/11/20,21,32,0.6370511729999999,23528,21,9,23
16113,2014/03/31,2011/06/23,9,29,0.465041425,32227,9,8,21
16114,2014/03/31,2012/10/15,22,23,0.7464329120000001,20078,22,8,15
16115,2014/03/31,2009/08/28,1,10,0.694729742,21572,1,6,4
16116,2014/03/31,2012/02/08,36,15,0.8745042890000001,17137,36,10,5
16117,2014/03/31,2008/11/04,40,13,0.734759267,20396,40,2,11
16118,2014/03/31,2011/11/17,60,16,0.738948718,20280,60,11,5
16119,2014/03/31,2009/04/05,22,17,0.570288465,26277,22,7,10
16120,2014/03/31,2006/06/08,1,20,0.722302613,20746,1,13,7
16121,2014/03/31,2009/09/02,2,16,0.386192685,38799,2,7,9
16122,2014/03/31,2012/08/19,124,10,0.923754007,16220,124,6,4
16123,2014/03/31,2010/11/17,5,14,0.87180263,17186,5,9,5
16124,2014/03/31,2005/08/09,6,31,0.75035158,19967,6,18,13
16125,2014/03/31,2006/03/12,6,14,0.7267020759999999,20616,6,5,9
16126,2014/03/31,2009/01/21,6,18,0.684969594,21871,6,11,7
16127,2014/03/31,2010/05/28,9,30,0.8675023159999999,17268,9,10,20
16128,2014/03/31,2006/07/17,29,22,0.639754858,23415,29,11,11
16129,2014/03/31,2006/09/11,12,27,0.622249917,24072,12,11,16
16130,2014/03/31,2011/08/29,211,13,0.81181291,18451,211,7,6
16131,2014/03/31,2012/03/10,148,15,0.63646129,23534,148,10,5
16132,2014/03/31,2011/08/10,178,12,0.825571295,18143,178,8,4
16133,2014/03/31,2006/01/08,258,8,0.818796808,18293,258,4,4
16134,2014/03/31,2009/11/23,22,14,0.544410076,27512,22,11,3
16135,2014/03/31,2012/12/04,84,19,0.748280376,20016,84,8,11
16136,2014/03/31,2005/07/01,93,15,0.637847104,23480,93,3,12
16137,2014/03/31,2012/01/06,446,14,0.817857143,18312,446,14,0
16138,2014/03/31,2013/03/22,217,7,0.958010491,15632,217,2,5
16139,2014/03/31,2012/12/22,81,21,0.699347562,21412,81,7,14
16140,2014/03/31,2011/12/09,529,16,0.708189084,21144,529,16,0
16141,2014/03/31,2010/05/29,121,8,0.550410234,27204,121,0,8
16142,2014/03/31,2010/03/01,4,16,0.8068051509999999,18558,4,12,4
16143,2014/03/31,2006/12/11,391,7,0.583861093,25643,391,7,0
16144,2014/03/31,2011/08/09,8,18,0.626296017,23904,8,10,8
16145,2014/03/31,2012/09/26,7,22,0.7251133390000001,20646,7,8,14
16146,2014/03/31,2011/01/13,118,16,0.867231491,17262,118,11,5
16147,2014/03/31,2009/01/22,20,18,0.7865137659999999,19032,20,6,12
16148,2014/03/31,2008/03/10,15,13,0.777478184,19252,15,5,8
16149,2014/03/31,2009/03/07,6,17,0.81554599,18352,6,10,7
16150,2014/03/31,2008/12/28,130,14,0.674171622,22200,130,7,7
16151,2014/03/31,2012/05/09,27,19,0.8868989629999999,16875,27,7,12
16152,2014/03/31,2009/12/25,14,15,0.724794885,20647,14,3,12
16153,2014/03/31,2008/04/14,228,13,0.6963275940000001,21490,228,9,4
16154,2014/03/31,2012/06/04,15,9,0.839334193,17828,15,3,6
16155,2014/03/31,2005/03/29,198,11,0.716388969,20886,198,9,2
16156,2014/03/31,2011/07/23,2,22,0.743674322,20118,2,6,16
16157,2014/03/31,2008/12/12,85,9,0.655165754,22835,85,7,2
16158,2014/03/31,2006/09/04,75,9,1.452483495,10300,75,4,5
16159,2014/03/31,2010/05/25,27,22,0.735051344,20353,27,12,10
16160,2014/03/31,2007/07/17,51,13,0.588877736,25404,51,3,10
16161,2014/03/31,2012/04/21,123,10,0.8621670220000001,17351,123,4,6
16162,2014/03/31,2008/03/12,78,14,0.548069764,27292,78,7,7
16163,2014/03/31,2004/12/16,74,26,0.664745567,22501,74,13,13
16164,2014/03/31,2006/05/25,90,18,0.8008144140000001,18676,90,11,7
16165,2014/03/31,2012/09/28,22,14,0.770679206,19405,22,6,8
16166,2014/03/31,2006/04/07,8,14,0.7157661190000001,20891,8,8,6
16167,2014/03/31,2010/08/29,66,16,0.8798358340000001,16995,66,5,11
16168,2014/03/31,2010/08/17,34,15,0.6587,22700,34,8,7
16169,2014/03/31,2011/08/11,70,15,0.6726441999999999,22226,70,7,8
16170,2014/03/31,2012/02/14,4,19,0.551163674,27121,4,8,11
16171,2014/03/31,2010/06/28,73,14,0.652916921,22894,73,8,6
16172,2014/03/31,2008/10/21,146,9,1.109546467,13472,146,5,4
16173,2014/03/31,2011/11/29,6,17,0.517326435,28894,6,12,5
16174,2014/03/31,2008/07/19,9,10,0.70232674,21283,9,3,7
16175,2014/03/31,2010/12/23,53,12,0.730297552,20467,53,6,6
16176,2014/03/31,2005/06/16,175,6,1.17165321,12757,175,3,3
16177,2014/03/31,2011/09/22,224,18,0.622960864,23993,224,15,3
16178,2014/03/31,2006/10/26,1,17,0.60579054,24673,1,4,13
16179,2014/03/31,2008/03/05,137,11,0.711850441,20995,137,9,2
16180,2014/03/31,2013/02/01,42,7,0.829316718,18016,42,2,5
16181,2014/03/31,2008/05/22,3,15,0.673959311,22168,3,4,11
16182,2014/03/31,2007/10/15,5,22,0.666165886,22425,5,10,12
16183,2014/03/31,2008/04/24,16,20,0.810110641,18438,16,12,8
16184,2014/03/31,2012/04/07,134,12,0.648055194,23046,134,8,4
16185,2014/03/31,2009/06/26,100,13,0.8891254390000001,16797,100,7,6
16186,2014/03/31,2006/07/30,149,11,0.7660729490000001,19493,149,6,5
16187,2014/03/31,2006/10/24,4,16,0.7530919359999999,19829,4,7,9
16188,2014/03/31,2006/09/28,6,21,0.768644155,19427,6,1,20
16189,2014/03/31,2010/06/18,23,31,0.773140209,19314,23,10,21
16190,2014/03/31,2010/02/23,308,7,0.723952778,20626,308,3,4
16191,2014/03/31,2011/02/25,20,9,0.469381994,31812,20,5,4
16192,2014/03/31,2009/10/15,7,11,0.636253622,23468,7,5,6
16193,2014/03/31,2007/04/28,114,18,0.733628458,20353,114,8,10
16194,2014/03/31,2011/05/11,280,15,0.497631061,30005,280,10,5
16195,2014/03/31,2013/02/28,41,9,0.7144444440000001,20898,41,1,8
16196,2014/03/31,2006/05/25,24,14,0.527581113,28294,24,11,3
16197,2014/03/31,2012/07/03,49,14,0.754618573,19781,49,10,4
16198,2014/03/31,2008/06/17,1,16,0.53526648,27882,1,10,6
16199,2014/03/31,2008/12/20,81,18,0.645815735,23108,81,11,7
16200,2014/03/31,2012/09/08,247,14,0.630760419,23658,247,13,1
16201,2014/03/31,2012/12/04,103,22,0.517272727,28842,103,6,16
16202,2014/03/31,2012/10/26,34,23,0.526731041,28324,34,5,18
16203,2014/03/31,2012/12/14,38,23,0.55483895,26886,38,5,18
16204,2014/03/31,2006/06/01,146,18,0.790314172,18875,146,12,6
16205,2014/03/31,2007/07/05,192,17,0.859269543,17359,192,10,7
16206,2014/03/31,2006/02/27,22,12,0.725957851,20546,22,8,4
16207,2014/03/31,2013/01/14,30,23,0.557659376,26745,30,6,17
16208,2014/03/31,2012/06/29,138,13,0.728696927,20467,138,11,2
16209,2014/03/31,2010/12/29,76,7,1.361859191,10951,76,2,5
16210,2014/03/31,2010/11/18,136,11,0.814847558,18302,136,3,8
16211,2014/03/31,2012/04/11,71,15,0.733305306,20337,71,5,10
16212,2014/03/31,2006/09/08,6,15,0.629268324,23699,6,7,8
16213,2014/03/31,2013/01/23,101,12,0.7847011159999999,19004,101,3,9
16214,2014/03/31,2006/09/04,92,7,0.907174839,16438,92,3,4
16215,2014/03/31,2010/11/27,297,8,0.651859591,22876,297,4,4
16216,2014/03/31,2012/04/01,4,32,0.7848092,18999,4,7,25
16217,2014/03/31,2008/01/16,8,15,0.590454221,25252,8,9,6
16218,2014/03/31,2009/02/08,95,10,0.7492201009999999,19900,95,5,5
16219,2014/03/31,2012/07/22,390,5,0.771657782,19321,390,5,0
16220,2014/03/31,2011/09/13,61,13,0.642625,23200,61,7,6
16221,2014/03/31,2005/02/22,86,16,0.6567973739999999,22697,86,9,7
16222,2014/03/31,2010/03/20,113,20,0.688754332,21643,113,10,10
16223,2014/03/31,2010/01/09,243,16,0.83816408,17784,243,5,11
16224,2014/03/31,2007/01/24,20,6,1.370601379,10875,20,0,6
16225,2014/03/31,2010/04/04,295,10,0.770412488,19346,295,9,1
16226,2014/03/31,2008/05/20,1,26,0.577244451,25817,1,9,17
16227,2014/03/31,2012/04/21,50,16,0.659159147,22608,50,4,12
16228,2014/03/31,2011/05/27,107,14,0.626364171,23791,107,11,3
16229,2014/03/31,2005/04/30,43,14,0.7281649809999999,20463,43,7,7
16230,2014/03/31,2012/04/17,299,9,0.8680995109999999,17164,299,8,1
16231,2014/03/31,2011/07/16,381,14,0.741758351,20087,381,14,0
16232,2014/03/31,2008/05/12,79,15,0.6630121929999999,22472,79,9,6
16233,2014/03/31,2012/12/24,2,38,0.784972338,18979,2,8,30
16234,2014/03/31,2012/03/12,40,20,0.717247821,20769,40,11,9
16235,2014/03/31,2006/06/21,101,17,0.671096094,22197,101,13,4
16236,2014/03/31,2006/01/10,67,10,0.698,21340,67,4,6
16237,2014/03/31,2004/12/02,8,28,0.530993654,28048,8,15,13
16238,2014/03/31,2009/06/28,34,17,0.57852154,25743,34,9,8
16239,2014/03/31,2009/08/25,23,17,0.577264235,25799,23,9,8
16240,2014/03/31,2007/09/17,67,9,0.796666667,18693,67,5,4
16241,2014/03/31,2008/05/06,141,20,0.68291938,21806,141,14,6
16242,2014/03/31,2010/10/29,40,14,0.671683356,22170,40,3,11
16243,2014/03/31,2007/10/14,20,20,0.7564455170000001,19685,20,7,13
16244,2014/03/31,2010/11/18,5,20,0.600936794,24776,5,6,14
16245,2014/03/31,2010/11/01,79,16,0.6987383840000001,21306,79,4,12
16246,2014/03/31,2012/09/14,140,10,0.761131448,19559,140,1,9
16247,2014/03/31,2008/03/07,35,17,0.650531376,22884,35,14,3
16248,2014/03/31,2011/01/03,439,14,0.835809748,17808,439,14,0
16249,2014/03/31,2010/09/25,163,16,0.732319917,20324,163,12,4
16250,2014/03/31,2008/02/16,53,13,0.739945312,20114,53,4,9
16251,2014/03/31,2008/01/31,9,10,0.6709999999999999,22180,9,5,5
16252,2014/03/31,2009/01/16,13,19,0.727607314,20454,13,6,13
16253,2014/03/31,2012/06/14,40,17,0.956065784,15566,40,10,7
16254,2014/03/31,2011/07/20,155,14,0.774016747,19227,155,8,6
16255,2014/03/31,2010/07/18,9,18,0.5827667910000001,25535,9,8,10
16256,2014/03/31,2011/12/12,22,29,0.886206897,16791,22,15,14
16257,2014/03/31,2011/05/24,10,24,0.63600701,23396,10,18,6
16258,2014/03/31,2008/05/10,20,17,0.7049758340000001,21104,20,0,17
16259,2014/03/31,2013/03/14,57,11,0.735323976,20233,57,0,11
16260,2014/03/31,2006/12/07,80,15,0.521475145,28526,80,8,7
16261,2014/03/31,2011/04/13,82,25,0.6529881470000001,22780,82,11,14
16262,2014/03/31,2011/09/08,8,11,0.909117467,16362,8,7,4
16263,2014/03/31,2012/12/01,35,13,0.6822871559999999,21800,35,0,13
16264,2014/03/31,2007/04/12,304,11,0.582887661,25512,304,7,4
16265,2014/03/31,2010/10/27,13,13,0.672478853,22107,13,7,6
16266,2014/03/31,2007/10/25,42,18,0.768990792,19332,42,5,13
16267,2014/03/31,2012/06/10,6,19,0.5570885170000001,26684,6,8,11
16268,2014/03/31,2013/01/24,31,14,0.780847297,19037,31,3,11
16269,2014/03/31,2012/12/15,2,14,0.598529495,24835,2,7,7
16270,2014/03/31,2008/06/13,107,17,0.66083363,22492,107,2,15
16271,2014/03/31,2011/02/02,3,22,0.566933669,26217,3,13,9
16272,2014/03/31,2013/03/20,10,22,0.622789674,23863,10,3,19
16273,2014/03/31,2006/09/15,42,21,0.581612853,25551,42,14,7
16274,2014/03/31,2010/10/05,250,14,0.744304533,19965,250,3,11
16275,2014/03/31,2007/04/26,575,3,0.91827957,16182,575,3,0
16276,2014/03/31,2011/12/08,91,8,0.7257551040000001,20474,91,5,3
16277,2014/03/31,2011/01/09,77,13,0.775677594,19156,77,6,7
16278,2014/03/31,2011/10/25,135,7,0.728283417,20401,135,4,3
16279,2014/03/31,2008/11/11,29,18,0.711320917,20887,29,10,8
16280,2014/03/31,2011/08/12,246,2,1.052657833,14113,246,0,2
16281,2014/03/31,2012/03/27,1,18,0.639072919,23245,1,7,11
16282,2014/03/31,2011/10/28,346,21,0.890020971,16690,346,19,2
16283,2014/03/31,2011/11/07,132,21,0.795646025,18668,132,10,11
16284,2014/03/31,2005/09/09,116,18,0.738966118,20099,116,5,13
16285,2014/03/31,2012/09/03,119,9,0.61548363,24130,119,1,8
16286,2014/03/31,2008/03/16,71,20,0.689008119,21555,71,10,10
16287,2014/03/31,2007/02/17,34,15,0.73699737,20149,34,1,14
16288,2014/03/31,2012/06/06,15,4,0.6141628060000001,24176,15,1,3
16289,2014/03/31,2012/09/28,56,7,0.7824939390000001,18974,56,5,2
16290,2014/03/31,2012/10/30,166,5,0.84,17675,166,1,4
16291,2014/03/31,2008/11/04,70,13,0.6698560729999999,22164,70,9,4
16292,2014/03/31,2009/01/20,26,11,0.6928585429999999,21427,26,7,4
16293,2014/03/31,2012/01/14,257,6,0.645,23016,257,4,2
16294,2014/03/31,2012/01/22,27,18,0.7581016340000001,19580,27,6,12
16295,2014/03/31,2012/02/05,24,19,0.819165563,18120,24,8,11
16296,2014/03/31,2005/12/20,267,24,0.527531544,28135,267,20,4
16297,2014/03/31,2010/04/07,31,22,0.758337336,19571,31,9,13
16298,2014/03/31,2007/07/30,90,16,0.820658077,18083,90,13,3
16299,2014/03/31,2012/12/15,8,21,0.684754961,21670,8,1,20
16300,2014/03/31,2012/05/24,14,12,0.8988647240000001,16507,14,2,10
16301,2014/03/31,2006/07/04,11,19,0.618028492,24007,11,8,11
16302,2014/03/31,2012/11/25,175,8,1.049065262,14143,175,4,4
16303,2014/03/31,2011/12/29,22,12,1.166869052,12715,22,6,6
16304,2014/03/31,2011/10/14,82,15,0.666985704,22244,82,9,6
16305,2014/03/31,2007/10/31,20,21,0.774736292,19150,20,8,13
16306,2014/03/31,2006/07/11,26,10,1.032066087,14375,26,6,4
16307,2014/03/31,2009/10/21,203,4,0.653788894,22690,203,3,1
16308,2014/03/31,2010/03/18,166,10,0.762100288,19464,166,8,2
16309,2014/03/31,2006/12/04,33,23,0.763942937,19417,33,12,11
16310,2014/03/31,2009/07/26,7,21,0.741747175,19998,7,9,12
16311,2014/03/31,2005/06/21,16,23,0.782913698,18945,16,7,16
16312,2014/03/31,2009/10/30,18,28,0.522380516,28393,18,14,14
16313,2014/03/31,2010/12/23,62,12,0.709954047,20891,62,7,5
16314,2014/03/31,2011/12/25,85,15,0.618973246,23959,85,9,6
16315,2014/03/31,2009/09/25,113,8,0.948883983,15627,113,3,5
16316,2014/03/31,2011/08/01,43,16,0.606347019,24454,43,10,6
16317,2014/03/31,2012/03/29,19,14,0.7604760190000001,19495,19,1,13
16318,2014/03/31,2011/01/26,100,10,0.826274663,17942,100,7,3
16319,2014/03/31,2005/07/05,3,10,0.60826194,24372,3,6,4
16320,2014/03/31,2011/12/12,74,11,0.522778895,28353,74,2,9
16321,2014/03/31,2010/04/26,71,11,0.986014502,15032,71,6,5
16322,2014/03/31,2006/09/08,1,14,0.584775095,25344,1,10,4
16323,2014/03/31,2006/07/10,21,5,1.048553134,14134,21,1,4
16324,2014/03/31,2012/09/30,38,15,0.70357326,21062,38,9,6
16325,2014/03/31,2009/07/17,84,11,0.5828281479999999,25423,84,4,7
16326,2014/03/31,2011/12/13,64,19,0.782147382,18944,64,10,9
16327,2014/03/31,2009/08/31,149,17,0.587077819,25238,149,11,6
16328,2014/03/31,2012/06/19,11,23,0.677243555,21876,11,7,16
16329,2014/03/31,2008/08/28,10,19,0.88261082,16784,10,9,10
16330,2014/03/31,2008/08/16,6,18,0.640452659,23130,6,12,6
16331,2014/03/31,2012/07/13,132,15,0.8474455059999999,17479,132,8,7
16332,2014/03/31,2012/12/28,36,12,0.71117294,20828,36,3,9
16333,2014/03/31,2010/11/25,2,14,0.5132237279999999,28861,2,3,11
16334,2014/03/31,2006/06/02,123,11,0.556129759,26634,123,3,8
16335,2014/03/31,2009/09/01,28,11,1.082125374,13687,28,3,8
16336,2014/03/31,2010/09/26,16,14,0.5700831470000001,25978,16,7,7
16337,2014/03/31,2007/03/30,96,17,0.565427055,26191,96,12,5
16338,2014/03/31,2011/06/14,73,19,0.6864908209999999,21572,73,12,7
16339,2014/03/31,2006/04/07,124,15,0.5897355639999999,25110,124,9,6
16340,2014/03/31,2009/11/05,15,11,0.703536678,21048,15,2,9
16341,2014/03/31,2011/01/15,102,15,0.870063458,17019,102,11,4
16342,2014/03/31,2012/12/22,9,15,0.665631181,22244,9,6,9
16343,2014/03/31,2012/05/06,355,15,0.819934098,18057,355,13,2
16344,2014/03/31,2009/08/26,122,12,0.669419851,22115,122,6,6
16345,2014/03/31,2008/06/27,3,13,0.694034602,21328,3,2,11
16346,2014/03/31,2011/10/19,14,22,0.6498024410000001,22778,14,12,10
16347,2014/03/31,2011/11/20,9,14,0.620331098,23860,9,11,3
16348,2014/03/31,2009/04/13,6,23,0.735626243,20120,6,10,13
16349,2014/03/31,2008/04/08,1,9,0.5369172170000001,27566,1,2,7
16350,2014/03/31,2010/03/15,77,8,0.91996084,16088,77,1,7
16351,2014/03/31,2012/08/08,136,11,0.6095658979999999,24280,136,1,10
16352,2014/03/31,2013/01/01,88,13,0.604436185,24485,88,1,12
16353,2014/03/31,2011/10/03,9,2,0.73,20272,9,0,2
16354,2014/03/31,2009/12/30,186,14,0.842500427,17565,186,11,3
16355,2014/03/31,2005/08/16,69,24,0.885900383,16704,69,15,9
16356,2014/03/31,2011/03/25,72,15,0.7959068420000001,18592,72,8,7
16357,2014/03/31,2010/11/28,76,16,0.739500225,20009,76,10,6
16358,2014/03/31,2012/04/12,1,16,0.627919708,23564,1,5,11
16359,2014/03/31,2007/12/18,12,16,0.6147000420000001,24070,12,2,14
16360,2014/03/31,2011/04/27,283,8,0.7969356320000001,18565,283,6,2
16361,2014/03/31,2012/07/24,145,11,0.8118398809999999,18224,145,4,7
16362,2014/03/31,2006/09/11,96,8,1.001292135,14774,96,5,3
16363,2014/03/31,2011/01/01,94,20,0.609471407,24272,94,8,12
16364,2014/03/31,2005/10/12,33,17,0.6973890909999999,21211,33,1,16
16365,2014/03/31,2012/07/10,72,20,0.708617898,20874,72,8,12
16366,2014/03/31,2009/03/13,113,20,0.582713126,25384,113,16,4
16367,2014/03/31,2008/12/10,143,10,0.665384615,22230,143,5,5
16368,2014/03/31,2011/05/29,79,15,0.871267008,16977,79,10,5
16369,2014/03/31,2008/01/24,375,11,0.8029558659999999,18421,375,11,0
16370,2014/03/31,2010/12/11,5,26,0.654337477,22603,5,10,16
16371,2014/03/31,2006/12/16,14,14,0.68575648,21567,14,6,8
16372,2014/03/31,2012/09/27,35,11,0.765847444,19311,35,6,5
16373,2014/03/31,2008/12/30,12,20,0.685594085,21571,12,11,9
16374,2014/03/31,2012/11/10,27,22,0.821192182,18009,27,3,19
16375,2014/03/31,2013/01/07,47,7,0.759778052,19464,47,0,7
16376,2014/03/31,2010/12/30,59,16,0.8656788240000001,17081,59,5,11
16377,2014/03/31,2012/02/12,130,29,0.904151889,16354,130,23,6
16378,2014/03/31,2011/04/15,220,8,0.7458393870000001,19824,220,5,3
16379,2014/03/31,2012/11/24,247,8,0.779076826,18978,247,4,4
16380,2014/03/31,2010/12/22,23,11,0.60404078,24473,23,9,2
16381,2014/03/31,2007/07/25,46,15,0.818665891,18057,46,9,6
16382,2014/03/31,2011/07/20,102,12,0.855424455,17281,102,3,9
16383,2014/03/31,2005/12/15,78,14,0.7615615659999999,19410,78,5,9
16384,2014/03/31,2010/01/01,102,19,0.731113914,20217,102,9,10
16385,2014/03/31,2005/02/28,54,13,0.7820582009999999,18900,54,8,5
16386,2014/03/31,2011/06/06,43,14,0.77925924,18967,43,9,5
16387,2014/03/31,2007/04/01,44,17,0.845973097,17470,44,5,12
16388,2014/03/31,2013/02/05,11,15,0.6994907229999999,21128,11,2,13
16389,2014/03/31,2005/09/24,50,20,0.633030069,23346,50,12,8
16390,2014/03/31,2013/03/15,3,9,0.577777778,25578,3,1,8
16391,2014/03/31,2012/03/24,35,12,0.8330484779999999,17740,35,0,12
16392,2014/03/31,2010/02/14,24,14,0.7350529720000001,20105,24,8,6
16393,2014/03/31,2005/11/15,4,11,0.8160843870000001,18107,4,5,6
16394,2014/03/31,2007/11/27,5,13,0.722155703,20462,5,6,7
16395,2014/03/31,2008/01/16,67,14,0.767623377,19250,67,3,11
16396,2014/03/31,2009/08/01,41,13,0.6212440610000001,23785,41,6,7
16397,2014/03/31,2012/03/25,163,7,0.762113897,19386,163,4,3
16398,2014/03/31,2012/04/01,9,12,0.724116753,20402,9,6,6
16399,2014/03/31,2009/04/22,31,14,0.589193188,25074,31,6,8
16400,2014/03/31,2009/12/03,42,24,0.596576067,24761,42,12,12
16401,2014/03/31,2007/03/05,73,14,0.600722245,24590,73,3,11
16402,2014/03/31,2013/02/01,47,13,0.7200346120000001,20513,47,2,11
16403,2014/03/31,2007/02/01,341,10,0.7855361129999999,18802,341,7,3
16404,2014/03/31,2013/01/31,135,7,0.654355975,22569,135,2,5
16405,2014/03/31,2013/03/07,8,25,0.624938428,23631,8,2,23
16406,2014/03/31,2012/12/22,264,21,0.65965243,22384,264,4,17
16407,2014/03/31,2007/11/14,12,7,0.922955369,15998,12,3,4
16408,2014/03/31,2008/08/01,79,24,0.644284592,22917,79,11,13
16409,2014/03/31,2007/09/12,163,9,0.7795485740000001,18940,163,6,3
16410,2014/03/31,2010/12/07,56,10,0.709671154,20800,56,6,4
16411,2014/03/31,2006/05/10,85,12,0.49460126,29844,85,4,8
16412,2014/03/31,2007/11/01,113,23,0.759864093,19425,113,11,12
16413,2014/03/31,2012/10/08,132,8,0.905091389,16304,132,3,5
16414,2014/03/31,2012/08/15,24,9,0.693622773,21271,24,5,4
16415,2014/03/31,2011/10/08,168,19,0.50744514,29074,168,8,11
16416,2014/03/31,2011/12/25,165,18,0.7809056740000001,18892,165,11,7
16417,2014/03/31,2011/03/24,201,21,0.7666315020000001,19243,201,10,11
16418,2014/03/31,2011/02/27,4,12,0.503902172,29276,4,9,3
16419,2014/03/31,2011/07/20,75,13,0.788724735,18702,75,10,3
16420,2014/03/31,2011/11/30,117,18,0.791004934,18648,117,12,6
16421,2014/03/31,2011/06/13,23,12,0.721053429,20457,23,1,11
16422,2014/03/31,2009/08/11,191,12,0.807538049,18266,191,8,4
16423,2014/03/31,2008/05/15,16,14,0.623700368,23649,16,5,9
16424,2014/03/31,2008/09/12,102,14,0.7309395909999999,20179,102,9,5
16425,2014/03/31,2006/06/29,155,13,0.879035103,16779,155,8,5
16426,2014/03/31,2011/11/22,7,23,0.654707919,22528,7,13,10
16427,2014/03/31,2012/03/30,67,12,0.652127603,22617,67,2,10
16428,2014/03/31,2006/10/17,50,17,0.744453362,19812,50,10,7
16429,2014/03/31,2005/09/09,3,11,0.775454545,19019,3,2,9
16430,2014/03/31,2009/02/03,112,20,0.591620798,24926,112,8,12
16431,2014/03/31,2006/04/25,6,16,0.715459486,20610,6,10,6
16432,2014/03/31,2011/12/29,31,13,0.7166678009999999,20575,31,8,5
16433,2014/03/31,2008/10/12,37,25,0.608361941,24236,37,13,12
16434,2014/03/31,2010/03/12,41,31,0.792867821,18596,41,20,11
16435,2014/03/31,2012/09/20,153,11,0.956514178,15411,153,5,6
16436,2014/03/31,2010/02/25,102,20,0.7585313640000001,19433,102,16,4
16437,2014/03/31,2009/02/20,73,18,0.7332122959999999,20104,73,8,10
16438,2014/03/31,2007/04/02,19,20,0.7493751909999999,19670,19,13,7
16439,2014/03/31,2007/11/20,5,27,0.76837773,19183,5,7,20
16440,2014/03/31,2012/12/30,173,3,0.79,18657,173,1,2
16441,2014/03/31,2010/01/07,48,11,0.7021987709999999,20989,48,5,6
16442,2014/03/31,2012/02/25,35,12,0.725441032,20316,35,5,7
16443,2014/03/31,2006/12/15,29,22,0.8257402220000001,17846,29,19,3
16444,2014/03/31,2007/09/01,32,14,0.61545671,23943,32,3,11
16445,2014/03/31,2006/05/09,242,13,0.794494527,18547,242,10,3
16446,2014/03/31,2010/01/14,239,16,0.846811103,17401,239,12,4
16447,2014/03/31,2011/01/15,147,16,0.7770671379999999,18961,147,7,9
16448,2014/03/31,2006/05/11,37,17,0.50573645,29133,37,9,8
16449,2014/03/31,2007/06/25,204,19,0.711589548,20704,204,12,7
16450,2014/03/31,2005/02/01,16,10,0.788279737,18689,16,3,7
16451,2014/03/31,2008/03/27,81,14,0.815059208,18072,81,10,4
16452,2014/03/31,2006/03/30,72,9,0.704826052,20897,72,5,4
16453,2014/03/31,2009/03/28,76,15,0.821798348,17922,76,13,2
16454,2014/03/31,2009/02/17,2,20,0.782595525,18817,2,5,15
16455,2014/03/31,2011/11/30,17,14,0.8016540529999999,18367,17,5,9
16456,2014/03/31,2006/05/19,1,15,0.6147329970000001,23951,1,10,5
16457,2014/03/31,2010/08/11,15,24,0.7198865640000001,20452,15,6,18
16458,2014/03/31,2009/03/05,3,17,0.63375834,23231,3,8,9
16459,2014/03/31,2011/10/23,62,9,0.819048626,17974,62,4,5
16460,2014/03/31,2007/09/20,6,16,0.712787623,20652,6,4,12
16461,2014/03/31,2010/03/07,5,13,0.690882381,21306,5,6,7
16462,2014/03/31,2008/06/20,43,13,0.75699532,19443,43,10,3
16463,2014/03/31,2012/08/12,109,11,0.94992965,15494,109,5,6
16464,2014/03/31,2011/09/20,122,12,0.762942305,19291,122,5,7
16465,2014/03/31,2011/12/11,243,10,0.982917251,14973,243,8,2
16466,2014/03/31,2012/06/16,247,11,0.6600148,22298,247,9,2
16467,2014/03/31,2012/11/02,25,11,0.814846605,18058,25,3,8
16468,2014/03/31,2011/08/09,23,16,0.765718152,19216,23,10,6
16469,2014/03/31,2010/05/28,113,9,0.711044315,20693,113,5,4
16470,2014/03/31,2010/05/26,105,24,0.7648154690000001,19238,105,10,14
16471,2014/03/31,2011/04/02,215,19,0.680133592,21633,215,11,8
16472,2014/03/31,2010/08/13,8,16,0.562866106,26140,8,10,6
16473,2014/03/31,2012/08/16,65,13,0.7749107279999999,18987,65,5,8
16474,2014/03/31,2006/01/10,373,15,1.046741605,14056,373,15,0
16475,2014/03/31,2007/12/07,62,11,0.606661581,24251,62,1,10
16476,2014/03/31,2011/12/20,274,12,0.515808849,28522,274,10,2
16477,2014/03/31,2007/09/28,136,16,0.814769052,18056,136,11,5
16478,2014/03/31,2009/06/02,375,15,0.6306825,23326,375,15,0
16479,2014/03/31,2010/08/18,468,19,0.838919304,17535,468,19,0
16480,2014/03/31,2012/08/24,82,13,0.816415806,18018,82,7,6
16481,2014/03/31,2013/03/07,79,3,0.6033333329999999,24381,79,0,3
16482,2014/03/31,2009/11/30,67,17,0.68400651,21505,67,13,4
16483,2014/03/31,2011/11/25,29,10,0.789509393,18630,29,8,2
16484,2014/03/31,2011/10/27,161,14,0.82224564,17888,161,7,7
16485,2014/03/31,2009/03/12,24,8,0.627429181,23440,24,6,2
16486,2014/03/31,2010/05/02,43,13,0.6856123829999999,21449,43,5,8
16487,2014/03/31,2005/04/25,25,14,0.7489527840000001,19633,25,9,5
16488,2014/03/31,2013/02/24,174,3,0.8889021220000001,16541,174,0,3
16489,2014/03/31,2009/10/31,139,11,0.655454545,22429,139,9,2
16490,2014/03/31,2012/05/23,9,15,0.528480012,27816,9,4,11
16491,2014/03/31,2006/11/15,13,34,0.8284207859999999,17743,13,18,16
16492,2014/03/31,2011/11/15,19,10,0.7556768290000001,19451,19,3,7
16493,2014/03/31,2011/10/20,9,12,0.5907886170000001,24879,9,4,8
16494,2014/03/31,2007/03/07,3,15,0.467448155,31440,3,0,15
16495,2014/03/31,2007/09/01,25,27,0.656554235,22384,25,15,12
16496,2014/03/31,2008/10/21,156,9,0.8968800729999999,16385,156,4,5
16497,2014/03/31,2008/07/07,30,43,0.831484835,17672,30,23,20
16498,2014/03/31,2012/02/25,2,16,0.806686248,18215,2,2,14
16499,2014/03/31,2010/12/01,325,17,0.609882949,24092,325,16,1
16500,2014/03/31,2006/04/01,31,12,0.7727041809999999,19015,31,9,3
16501,2014/03/31,2009/01/06,68,11,0.763413012,19244,68,5,6
16502,2014/03/31,2012/06/26,45,23,0.7284880490000001,20166,45,13,10
16503,2014/03/31,2008/04/04,21,14,0.672599817,21840,21,7,7
16504,2014/03/31,2010/07/08,144,18,0.86382263,17004,144,14,4
16505,2014/03/31,2010/01/17,260,7,0.656744467,22365,260,4,3
16506,2014/03/31,2013/02/11,146,18,0.8092969309999999,18149,146,4,14
16507,2014/03/31,2008/12/12,388,9,1.1037574209999998,13307,388,9,0
16508,2014/03/31,2009/09/27,80,12,0.653417564,22478,80,4,8
16509,2014/03/31,2008/07/09,104,12,0.841739355,17449,104,8,4
16510,2014/03/31,2010/10/09,114,5,0.649750476,22603,114,2,3
16511,2014/03/31,2007/07/05,110,13,0.69516071,21125,110,0,13
16512,2014/03/31,2012/12/21,19,18,0.683632682,21480,19,4,14
16513,2014/03/31,2008/10/28,4,21,0.541194855,27133,4,10,11
16514,2014/03/31,2004/11/26,184,13,0.7286625309999999,20150,184,5,8
16515,2014/03/31,2009/08/23,9,22,0.8493752170000001,17286,9,6,16
16516,2014/03/31,2012/03/03,43,15,0.6347874960000001,23129,43,5,10
16517,2014/03/31,2010/07/25,24,18,0.7439323,19734,24,9,9
16518,2014/03/31,2009/11/12,14,6,0.463288311,31688,14,0,6
16519,2014/03/31,2007/08/04,1,19,0.62827356,23366,1,8,11
16520,2014/03/31,2007/02/02,103,18,0.56286525,26078,103,7,11
16521,2014/03/31,2007/05/04,311,2,0.6,24464,311,0,2
16522,2014/03/31,2008/12/04,17,10,0.641947081,22865,17,0,10
16523,2014/03/31,2009/07/08,39,11,0.704722689,20825,39,7,4
16524,2014/03/31,2005/10/26,4,19,0.782146245,18763,4,5,14
16525,2014/03/31,2011/12/19,202,16,0.733026973,20020,202,12,4
16526,2014/03/31,2012/04/26,107,11,0.672727273,21813,107,5,6
16527,2014/03/31,2008/02/03,598,13,0.636798021,23042,598,13,0
16528,2014/03/31,2010/07/05,19,21,0.56631581,25908,19,13,8
16529,2014/03/31,2007/02/01,15,26,0.6864827809999999,21372,15,9,17
16530,2014/03/31,2011/04/23,85,23,0.685453654,21404,85,4,19
16531,2014/03/31,2005/09/14,73,11,0.905730337,16198,73,2,9
16532,2014/03/31,2012/07/26,9,21,0.7534182420000001,19472,9,6,15
16533,2014/03/31,2008/03/10,1,12,0.659603435,22241,1,6,6
16534,2014/03/31,2012/11/18,67,23,0.666963579,21993,67,7,16
16535,2014/03/31,2012/08/15,581,3,0.917097662,15994,581,3,0
16536,2014/03/31,2009/09/25,79,16,0.67702054,21665,79,13,3
16537,2014/03/31,2012/09/21,4,12,0.6504527920000001,22549,4,1,11
16538,2014/03/31,2008/12/14,227,11,0.797012825,18402,227,7,4
16539,2014/03/31,2011/06/14,16,19,0.872668135,16802,16,5,14
16540,2014/03/31,2008/07/24,85,14,0.685304758,21394,85,8,6
16541,2014/03/31,2009/11/07,7,20,0.658516888,22264,7,6,14
16542,2014/03/31,2010/03/21,52,18,0.830141563,17660,52,11,7
16543,2014/03/31,2011/05/04,27,11,0.749183872,19568,27,5,6
16544,2014/03/31,2012/05/11,59,17,0.635000217,23085,59,11,6
16545,2014/03/31,2011/08/31,1,19,0.7794315340000001,18805,1,16,3
16546,2014/03/31,2008/04/13,66,19,0.799522121,18331,66,7,12
16547,2014/03/31,2012/06/02,54,17,0.61815996,23706,54,15,2
16548,2014/03/31,2013/01/25,41,11,0.763576677,19191,41,2,9
16549,2014/03/31,2010/09/28,117,16,0.7896114670000001,18557,117,6,10
16550,2014/03/31,2013/03/12,198,2,0.55,26641,198,1,1
16551,2014/03/31,2011/07/03,1,7,0.7446266840000001,19675,1,0,7
16552,2014/03/31,2010/09/01,47,12,0.8280691840000001,17692,47,10,2
16553,2014/03/31,2012/04/23,21,25,0.706031807,20750,21,15,10
16554,2014/03/31,2005/01/28,147,10,0.751356037,19498,147,8,2
16555,2014/03/31,2007/05/31,526,13,0.7320423770000001,20011,526,13,0
16556,2014/03/31,2012/10/16,32,22,0.620126582,23621,32,1,21
16557,2014/03/31,2008/08/02,19,15,0.703071902,20834,19,8,7
16558,2014/03/31,2008/01/07,269,7,1.029481971,14227,269,4,3
16559,2014/03/31,2011/07/29,121,14,0.7577443220000001,19329,121,9,5
16560,2014/03/31,2012/03/11,36,13,0.7865270390000001,18621,36,6,7
16561,2014/03/31,2009/08/02,118,19,0.641988778,22813,118,9,10
16562,2014/03/31,2012/05/19,19,18,0.73782256,19849,19,12,6
16563,2014/03/31,2011/08/03,2,15,0.6384820999999999,22933,2,3,12
16564,2014/03/31,2012/09/17,135,13,0.7361538459999999,19890,135,5,8
16565,2014/03/31,2008/06/26,7,16,0.743768668,19686,7,6,10
16566,2014/03/31,2007/12/12,11,17,0.728086027,20110,11,6,11
16567,2014/03/31,2008/12/26,29,23,0.839443871,17442,29,0,23
16568,2014/03/31,2010/03/03,11,20,0.605584926,24174,11,10,10
16569,2014/03/31,2010/10/28,16,12,0.664164058,22041,16,7,5
16570,2014/03/31,2008/05/23,29,16,0.76356163,19171,29,8,8
16571,2014/03/31,2010/07/22,101,16,0.731242382,20018,101,4,12
16572,2014/03/31,2011/12/26,20,12,0.606016395,24154,20,4,8
16573,2014/03/31,2010/06/15,105,15,0.832402753,17584,105,6,9
16574,2014/03/31,2010/02/06,143,17,0.6264651999999999,23362,143,12,5
16575,2014/03/31,2005/04/20,250,9,0.8998917790000001,16263,250,1,8
16576,2014/03/31,2011/11/17,1,14,0.596634596,24529,1,6,8
16577,2014/03/31,2005/04/20,73,15,0.497984483,29387,73,7,8
16578,2014/03/31,2010/08/08,63,17,0.70866247,20650,63,4,13
16579,2014/03/31,2012/09/19,43,11,0.574597895,25466,43,3,8
16580,2014/03/31,2007/10/09,56,5,0.641715865,22799,56,3,2
16581,2014/03/31,2011/05/19,3,42,0.674576935,21687,3,13,29
16582,2014/03/31,2013/01/17,197,8,0.7875,18576,197,3,5
16583,2014/03/31,2011/05/27,64,16,0.683921642,21389,64,10,6
16584,2014/03/31,2006/04/29,34,22,0.782500802,18694,34,5,17
16585,2014/03/31,2011/02/20,23,13,0.744949325,19635,23,5,8
16586,2014/03/31,2012/07/25,66,27,0.656251346,22288,66,11,16
16587,2014/03/31,2005/04/23,21,17,0.6723352029999999,21754,21,10,7
16588,2014/03/31,2012/12/23,111,11,0.7802721159999999,18742,111,2,9
16589,2014/03/31,2012/06/11,24,19,0.665931594,21957,24,11,8
16590,2014/03/31,2009/06/11,403,20,0.8075416990000001,18106,403,20,0
16591,2014/03/31,2010/01/27,56,18,0.8699220559999999,16807,56,15,3
16592,2014/03/31,2012/11/06,12,16,0.73313108,19942,12,6,10
16593,2014/03/31,2012/05/18,32,17,0.802288317,18223,32,10,7
16594,2014/03/31,2012/11/01,125,13,0.860103554,16996,125,12,1
16595,2014/03/31,2010/03/26,62,12,0.8698732370000001,16803,62,4,8
16596,2014/03/31,2010/10/13,215,9,0.854205143,17110,215,6,3
16597,2014/03/31,2009/07/17,125,18,0.7331497370000001,19935,125,13,5
16598,2014/03/31,2013/01/27,146,13,1.113076923,13130,146,0,13
16599,2014/03/31,2010/10/08,8,20,0.570291133,25624,8,8,12
16600,2014/03/31,2007/02/27,43,24,0.65007385,22478,43,10,14
16601,2014/03/31,2012/03/19,314,18,0.779413177,18745,314,12,6
16602,2014/03/31,2012/01/26,38,17,0.551531521,26490,38,0,17
16603,2014/03/31,2006/07/20,74,19,0.699188762,20894,74,9,10
16604,2014/03/31,2008/08/13,442,19,0.488235687,29921,442,19,0
16605,2014/03/31,2008/06/23,66,27,0.521921964,27987,66,10,17
16606,2014/03/31,2012/05/23,31,13,0.782377203,18669,31,5,8
16607,2014/03/31,2013/03/25,137,13,0.559875029,26086,137,1,12
16608,2014/03/31,2006/03/30,50,18,0.549998117,26554,50,7,11
16609,2014/03/31,2009/02/13,448,13,1.328538937,10992,448,13,0
16610,2014/03/31,2005/11/27,50,32,0.70772974,20632,50,15,17
16611,2014/03/31,2011/07/18,321,5,0.78340308,18639,321,4,1
16612,2014/03/31,2005/02/08,48,10,0.8763335729999999,16662,48,5,5
16613,2014/03/31,2008/01/30,16,23,0.7943332790000001,18381,16,11,12
16614,2014/03/31,2011/08/31,72,25,0.742921183,19653,72,9,16
16615,2014/03/31,2013/03/20,109,5,1.446652794,10092,109,0,5
16616,2014/03/31,2008/02/01,95,9,0.73349176,19904,95,5,4
16617,2014/03/31,2007/04/25,19,21,0.784956985,18598,19,11,10
16618,2014/03/31,2010/08/18,123,17,0.672085539,21721,123,6,11
16619,2014/03/31,2011/05/16,5,21,0.608534684,23988,5,5,16
16620,2014/03/31,2010/02/18,12,12,0.683582935,21354,12,7,5
16621,2014/03/31,2011/03/04,34,15,0.8810889120000001,16567,34,12,3
16622,2014/03/31,2008/02/11,66,14,0.626573661,23296,66,6,8
16623,2014/03/31,2007/07/08,39,25,0.946650237,15419,39,9,16
16624,2014/03/31,2012/02/18,138,8,0.804088806,18152,138,3,5
16625,2014/03/31,2008/09/15,501,10,0.916965127,15915,501,10,0
16626,2014/03/31,2012/08/15,346,11,1.026072282,14222,346,9,2
16627,2014/03/31,2010/06/17,74,20,0.7312131690000001,19956,74,4,16
16628,2014/03/31,2011/07/05,349,22,0.800581619,18225,349,21,1
16629,2014/03/31,2012/08/21,108,9,0.820927812,17773,108,4,5
16630,2014/03/31,2010/02/24,284,16,0.7348446240000001,19855,284,14,2
16631,2014/03/31,2009/03/23,347,11,0.666505231,21887,347,10,1
16632,2014/03/31,2011/06/08,3,15,0.792953903,18396,3,6,9
16633,2014/03/31,2010/11/12,2,23,0.640799613,22761,2,10,13
16634,2014/03/31,2012/07/01,1,27,0.654594049,22281,1,10,17
16635,2014/03/31,2005/04/28,159,15,0.70508146,20685,159,7,8
16636,2014/03/31,2008/08/11,164,18,0.585199823,24922,164,10,8
16637,2014/03/31,2010/03/09,4,9,0.637124509,22890,4,0,9
16638,2014/03/31,2009/06/05,101,11,0.7942233120000001,18360,101,7,4
16639,2014/03/31,2011/04/02,479,3,0.958765205,15209,479,3,0
16640,2014/03/31,2009/11/23,28,16,0.66519458,21919,28,6,10
16641,2014/03/31,2007/12/17,18,19,0.8301053290000001,17564,18,0,19
16642,2014/03/31,2008/04/29,164,15,0.790377318,18446,164,6,9
16643,2014/03/31,2010/04/05,502,13,0.725230065,20103,502,13,0
16644,2014/03/31,2008/11/19,31,15,0.641464273,22728,31,6,9
16645,2014/03/31,2012/04/17,44,15,0.758310445,19224,44,10,5
16646,2014/03/31,2012/02/20,6,8,0.491160377,29680,6,0,8
16647,2014/03/31,2011/07/17,67,13,0.724883143,20110,67,6,7
16648,2014/03/31,2012/05/02,603,3,0.6761387879999999,21558,603,3,0
16649,2014/03/31,2009/07/15,4,16,0.747835813,19490,4,4,12
16650,2014/03/31,2005/05/13,1,22,0.7156687620000001,20366,1,13,9
16651,2014/03/31,2010/05/15,44,4,1.108942842,13139,44,1,3
16652,2014/03/31,2006/10/22,110,10,0.617850903,23582,110,5,5
16653,2014/03/31,2011/05/09,2,23,0.772457052,18860,2,8,15
16654,2014/03/31,2010/09/25,80,19,0.635667845,22917,80,6,13
16655,2014/03/31,2006/07/04,108,10,1.394361061,10447,108,6,4
16656,2014/03/31,2012/09/03,30,20,0.824239629,17669,30,3,17
16657,2014/03/31,2011/02/01,177,12,0.648231916,22465,177,7,5
16658,2014/03/31,2011/10/17,540,6,0.771026157,18886,540,6,0
16659,2014/03/31,2012/07/14,14,17,0.702587821,20724,14,7,10
16660,2014/03/31,2012/01/28,28,11,0.705337887,20643,28,0,11
16661,2014/03/31,2010/03/01,3,7,1.201827487,12115,3,0,7
16662,2014/03/31,2012/01/03,48,18,0.629292475,23137,48,9,9
16663,2014/03/31,2005/03/18,46,11,0.816479363,17832,46,3,8
16664,2014/03/31,2012/07/28,61,14,0.598280666,24335,61,4,10
16665,2014/03/31,2005/12/01,1,12,0.8411174020000001,17308,1,11,1
16666,2014/03/31,2009/12/27,157,10,1.021498842,14251,157,4,6
16667,2014/03/31,2007/03/28,4,13,0.575754519,25281,4,6,7
16668,2014/03/31,2008/08/31,79,10,0.640795139,22713,79,4,6
16669,2014/03/31,2010/09/18,26,22,0.843588198,17251,26,7,15
16670,2014/03/31,2008/02/02,36,23,0.647201566,22484,36,12,11
16671,2014/03/31,2011/12/10,20,11,0.7381818179999999,19712,20,6,5
16672,2014/03/31,2007/03/09,256,16,0.705701052,20619,256,14,2
16673,2014/03/31,2010/11/24,19,13,0.633573979,22966,19,8,5
16674,2014/03/31,2005/09/09,364,13,0.787142239,18483,364,11,2
16675,2014/03/31,2012/06/14,24,14,0.777409426,18714,24,9,5
16676,2014/03/31,2008/11/29,23,9,0.962845986,15109,23,6,3
16677,2014/03/31,2011/09/21,205,10,0.973858204,14937,205,8,2
16678,2014/03/31,2011/04/30,103,12,0.596020734,24404,103,6,6
16679,2014/03/31,2007/10/03,73,12,0.976516281,14895,73,5,7
16680,2014/03/31,2007/01/14,164,16,0.633755175,22947,164,5,11
16681,2014/03/31,2009/11/29,103,16,0.868059452,16753,103,7,9
16682,2014/03/31,2005/07/20,38,18,0.7473436459999999,19459,38,7,11
16683,2014/03/31,2006/01/11,18,18,0.6589808770000001,22068,18,4,14
16684,2014/03/31,2006/12/02,159,10,0.8707868259999999,16700,159,2,8
16685,2014/03/31,2007/04/23,123,20,0.671959706,21641,123,12,8
16686,2014/03/31,2009/08/05,79,11,0.744356061,19536,79,4,7
16687,2014/03/31,2007/02/06,33,14,0.841344674,17283,33,9,5
16688,2014/03/31,2008/07/24,34,16,0.900852487,16141,34,1,15
16689,2014/03/31,2007/11/04,90,10,0.571917948,25423,90,5,5
16690,2014/03/31,2006/10/15,21,17,0.750555986,19371,21,3,14
16691,2014/03/31,2011/01/30,74,17,0.651307289,22321,74,12,5
16692,2014/03/31,2009/03/27,14,17,0.612773563,23724,14,8,9
16693,2014/03/31,2011/01/29,39,10,1.472816616,9870,39,9,1
16694,2014/03/31,2013/02/02,87,17,0.579478174,25085,87,5,12
16695,2014/03/31,2006/05/04,104,14,0.869656575,16714,104,13,1
16696,2014/03/31,2009/12/19,17,22,0.692478323,20990,17,10,12
16697,2014/03/31,2005/04/12,259,14,0.70470303,20625,259,13,1
16698,2014/03/31,2011/12/18,13,11,0.843245721,17235,13,1,10
16699,2014/03/31,2012/06/27,98,21,0.661616134,21966,98,11,10
16700,2014/03/31,2006/10/31,33,12,0.683030032,21277,33,6,6
16701,2014/03/31,2008/12/18,93,15,0.617490546,23535,93,10,5
16702,2014/03/31,2008/08/31,36,14,0.486428571,29876,36,6,8
16703,2014/03/31,2012/09/26,12,15,0.662811075,21924,12,10,5
16704,2014/03/31,2012/04/13,116,15,0.7689209929999999,18897,116,10,5
16705,2014/03/31,2006/11/26,95,10,0.8410105920000001,17277,95,4,6
16706,2014/03/31,2005/11/03,183,10,0.748165808,19420,183,6,4
16707,2014/03/31,2008/07/12,72,17,0.596740872,24347,72,10,7
16708,2014/03/31,2009/07/17,32,17,0.7928283770000001,18325,32,5,12
16709,2014/03/31,2012/12/30,49,24,0.635286195,22869,49,8,16
16710,2014/03/31,2010/09/22,44,17,0.741750166,19581,44,9,8
16711,2014/03/31,2006/09/01,62,19,0.627503672,23146,62,12,7
16712,2014/03/31,2010/11/03,49,28,0.829842875,17502,49,14,14
16713,2014/03/31,2008/10/27,171,15,0.658604535,22050,171,9,6
16714,2014/03/31,2006/06/29,24,18,0.643522113,22566,24,7,11
16715,2014/03/31,2006/10/08,2,20,0.485311142,29922,2,12,8
16716,2014/03/31,2007/04/26,82,15,0.801002262,18129,82,3,12
16717,2014/03/31,2009/03/01,79,12,0.7112102659999999,20417,79,5,7
16718,2014/03/31,2010/03/14,146,11,0.6874588070000001,21120,146,5,6
16719,2014/03/31,2011/01/09,25,16,0.737804655,19678,25,11,5
16720,2014/03/31,2008/02/05,200,11,0.8373803209999999,17338,200,9,2
16721,2014/03/31,2005/11/17,212,7,0.917407899,15825,212,5,2
16722,2014/03/31,2010/08/17,40,10,0.704689806,20600,40,5,5
16723,2014/03/31,2012/02/14,49,12,0.757221701,19170,49,9,3
16724,2014/03/31,2011/07/18,76,19,0.7978946790000001,18192,76,9,10
16725,2014/03/31,2011/09/14,194,13,0.6224250610000001,23319,194,4,9
16726,2014/03/31,2011/01/13,2,14,0.68768633,21105,2,4,10
16727,2014/03/31,2008/03/28,457,13,0.95718243,15162,457,13,0
16728,2014/03/31,2012/03/10,53,11,0.711610435,20392,53,7,4
16729,2014/03/31,2007/01/30,14,15,0.56965061,25473,14,8,7
16730,2014/03/31,2008/06/28,48,15,0.733662335,19777,48,8,7
16731,2014/03/31,2009/10/22,11,28,0.673464699,21543,11,19,9
16732,2014/03/31,2011/01/13,6,12,0.885692308,16380,6,7,5
16733,2014/03/31,2005/07/11,19,14,0.870581528,16663,19,9,5
16734,2014/03/31,2011/08/15,123,18,0.7668971720000001,18915,123,9,9
16735,2014/03/31,2006/04/12,206,18,0.691047592,20991,206,14,4
16736,2014/03/31,2010/08/23,106,25,0.861380048,16840,106,6,19
16737,2014/03/31,2007/05/01,146,16,0.682752307,21244,146,11,5
16738,2014/03/31,2012/04/09,45,25,0.744629839,19478,45,19,6
16739,2014/03/31,2012/01/19,126,12,0.726286744,19969,126,7,5
16740,2014/03/31,2005/06/03,645,3,0.562688189,25772,645,3,0
16741,2014/03/31,2006/08/30,167,13,0.753957987,19232,167,9,4
16742,2014/03/31,2012/03/28,189,11,0.682264471,21250,189,7,4
16743,2014/03/31,2012/08/15,156,10,1.433122776,10116,156,3,7
16744,2014/03/31,2008/08/22,19,25,0.616281512,23523,19,15,10
16745,2014/03/31,2011/01/16,23,10,0.709929477,20419,23,4,6
16746,2014/03/31,2010/11/15,300,10,0.69789793,20770,300,9,1
16747,2014/03/31,2008/05/07,124,15,0.939849575,15423,124,8,7
16748,2014/03/31,2009/08/14,141,8,0.6375,22736,141,4,4
16749,2014/03/31,2011/03/10,43,10,0.7011116490000001,20672,43,4,6
16750,2014/03/31,2008/09/13,2,11,0.755989358,19169,2,0,11
16751,2014/03/31,2006/05/10,1,8,0.637682626,22724,1,0,8
16752,2014/03/31,2010/02/06,206,12,0.7441651690000001,19471,206,8,4
16753,2014/03/31,2009/11/12,39,6,0.7397763709999999,19586,39,3,3
16754,2014/03/31,2006/05/05,468,9,0.5186810829999999,27932,468,9,0
16755,2014/03/31,2012/11/14,13,17,0.6382224670000001,22700,13,4,13
16756,2014/03/31,2011/11/15,104,20,0.689268177,21016,104,13,7
16757,2014/03/31,2013/01/30,5,37,0.6647611179999999,21789,5,7,30
16758,2014/03/31,2008/06/17,20,18,0.625760391,23146,20,2,16
16759,2014/03/31,2012/06/04,182,23,0.831209182,17425,182,19,4
16760,2014/03/31,2006/11/26,65,15,0.7383436990000001,19616,65,4,11
16761,2014/03/31,2010/02/27,117,12,0.8102954179999999,17873,117,6,6
16762,2014/03/31,2009/03/31,25,11,0.939608123,15413,25,8,3
16763,2014/03/31,2010/02/15,34,14,0.623802714,23215,34,4,10
16764,2014/03/31,2006/06/22,1,16,0.7867360240000001,18407,1,7,9
16765,2014/03/31,2011/01/15,54,20,0.772963062,18734,54,10,10
16766,2014/03/31,2010/09/16,207,15,0.859229811,16853,207,6,9
16767,2014/03/31,2010/01/29,45,13,0.585409372,24733,45,7,6
16768,2014/03/31,2007/09/21,3,22,0.952510526,15200,3,15,7
16769,2014/03/31,2009/07/09,74,9,0.817777778,17703,74,5,4
16770,2014/03/31,2006/09/09,12,14,0.562515154,25736,12,8,6
16771,2014/03/31,2010/04/14,77,8,0.87125,16616,77,2,6
16772,2014/03/31,2012/11/09,5,14,0.850772847,17015,5,5,9
16773,2014/03/31,2011/03/01,18,20,0.552938345,26178,18,6,14
16774,2014/03/31,2012/01/09,108,15,0.567844645,25490,108,8,7
16775,2014/03/31,2007/07/22,147,11,0.7387276070000001,19593,147,0,11
16776,2014/03/31,2010/10/18,155,15,0.64543837,22424,155,11,4
16777,2014/03/31,2011/06/22,1,25,0.7156384140000001,20222,1,8,17
16778,2014/03/31,2007/06/13,65,16,0.752708973,19225,65,2,14
16779,2014/03/31,2008/05/26,6,12,0.7377185829999999,19615,6,5,7
16780,2014/03/31,2012/11/24,37,10,1.331437247,10868,37,1,9
16781,2014/03/31,2012/05/01,81,10,0.74418381,19444,81,8,2
16782,2014/03/31,2012/12/14,88,10,0.778284654,18591,88,4,6
16783,2014/03/31,2008/09/24,72,10,0.591175894,24475,72,4,6
16784,2014/03/31,2013/02/01,159,12,0.768326075,18830,159,7,5
16785,2014/03/31,2011/03/19,42,9,0.752319933,19229,42,3,6
16786,2014/03/31,2007/02/15,243,14,0.80355163,18003,243,7,7
16787,2014/03/31,2010/08/20,24,14,0.717914123,20145,24,8,6
16788,2014/03/31,2009/06/27,212,21,0.651044218,22208,212,17,4
16789,2014/03/31,2011/01/07,201,13,0.8280572740000001,17460,201,8,5
16790,2014/03/31,2010/07/24,195,7,0.689386295,20971,195,1,6
16791,2014/03/31,2005/08/01,17,6,0.79477845,18190,17,1,5
16792,2014/03/31,2008/08/10,20,14,0.60519717,23888,20,6,8
16793,2014/03/31,2008/05/28,23,6,0.703580433,20545,23,0,6
16794,2014/03/31,2011/07/23,84,14,0.703192742,20556,84,8,6
16795,2014/03/31,2010/01/21,12,17,0.6671605279999999,21666,12,8,9
16796,2014/03/31,2007/03/14,604,6,1.0,14454,604,6,0
16797,2014/03/31,2006/06/20,21,17,0.90241024,16015,21,4,13
16798,2014/03/31,2011/08/08,19,19,0.533501421,27089,19,8,11
16799,2014/03/31,2007/09/09,16,17,0.68028106,21241,16,11,6
16800,2014/03/31,2009/12/13,1,22,0.563399633,25641,1,16,6
16801,2014/03/31,2012/09/26,44,10,0.768,18810,44,4,6
16802,2014/03/31,2012/03/02,90,18,0.522179005,27664,90,17,1
16803,2014/03/31,2007/04/19,125,17,0.772337058,18703,125,11,6
16804,2014/03/31,2012/11/09,33,10,0.720790918,20040,33,5,5
16805,2014/03/31,2013/02/07,33,7,0.635137631,22742,33,1,6
16806,2014/03/31,2012/03/14,53,18,0.470650438,30687,53,12,6
16807,2014/03/31,2007/01/10,6,13,0.675459052,21381,6,4,9
16808,2014/03/31,2012/07/11,75,13,0.637182508,22662,75,5,8
16809,2014/03/31,2008/12/13,114,13,0.931336602,15502,114,9,4
16810,2014/03/31,2012/04/28,44,15,0.66266581,21787,44,3,12
16811,2014/03/31,2009/02/27,106,17,0.5492953620000001,26283,106,10,7
16812,2014/03/31,2009/05/02,20,12,0.808276132,17861,20,3,9
16813,2014/03/31,2012/11/30,1,16,0.786124816,18363,1,1,15
16814,2014/03/31,2012/04/09,75,12,0.820854137,17585,75,9,3
16815,2014/03/31,2010/04/06,167,11,0.8771814040000001,16455,167,5,6
16816,2014/03/31,2012/12/20,332,12,0.589465409,24486,332,8,4
16817,2014/03/31,2007/11/08,33,15,0.653737204,22078,33,0,15
16818,2014/03/31,2012/11/30,101,4,1.425079976,10128,101,1,3
16819,2014/03/31,2010/10/14,19,18,0.738262649,19547,19,5,13
16820,2014/03/31,2007/03/21,29,21,0.701180758,20580,29,9,12
16821,2014/03/31,2008/04/11,136,16,0.8289050379999999,17407,136,11,5
16822,2014/03/31,2013/03/19,60,19,0.623957793,23124,60,0,19
16823,2014/03/31,2007/09/18,8,13,0.632695259,22803,8,6,7
16824,2014/03/31,2010/05/23,15,17,0.8930424020000001,16155,15,8,9
16825,2014/03/31,2010/05/03,19,17,0.837222609,17232,19,4,13
16826,2014/03/31,2011/06/24,18,13,0.6786292859999999,21259,18,8,5
16827,2014/03/31,2009/07/22,120,19,0.596493797,24180,120,10,9
16828,2014/03/31,2012/05/14,17,20,0.720359195,20017,17,8,12
16829,2014/03/31,2012/12/01,5,13,0.65822415,21905,5,7,6
16830,2014/03/31,2006/10/21,21,9,0.855180308,16860,21,3,6
16831,2014/03/31,2010/12/10,7,12,0.7794339929999999,18498,7,6,6
16832,2014/03/31,2012/05/19,253,10,1.192643944,12088,253,8,2
16833,2014/03/31,2012/12/16,49,15,0.781391328,18450,49,5,10
16834,2014/03/31,2009/12/06,8,21,0.72662248,19840,8,7,14
16835,2014/03/31,2011/11/21,26,18,0.496996139,29006,26,8,10
16836,2014/03/31,2010/06/29,61,16,0.629679787,22891,61,10,6
16837,2014/03/31,2005/05/26,37,12,0.639201153,22545,37,1,11
16838,2014/03/31,2011/08/12,215,10,0.674595075,21362,215,9,1
16839,2014/03/31,2007/02/01,21,24,0.504030921,28589,21,11,13
16840,2014/03/31,2012/11/13,31,14,0.624916732,23058,31,7,7
16841,2014/03/31,2010/09/09,45,13,0.709866982,20298,45,4,9
16842,2014/03/31,2013/01/22,25,13,0.896042418,16078,25,2,11
16843,2014/03/31,2010/10/07,214,11,0.789420115,18245,214,7,4
16844,2014/03/31,2007/12/07,121,12,0.777219254,18531,121,8,4
16845,2014/03/31,2012/09/13,128,8,1.173993641,12267,128,4,4
16846,2014/03/31,2012/12/08,211,6,0.767533976,18763,211,0,6
16847,2014/03/31,2011/03/09,12,15,0.759827996,18953,12,4,11
16848,2014/03/31,2006/09/13,5,13,0.6812252809999999,21138,5,8,5
16849,2014/03/31,2008/02/26,254,13,0.7123637079999999,20214,254,11,2
16850,2014/03/31,2012/05/18,308,7,0.618002146,23300,308,4,3
16851,2014/03/31,2007/03/28,3,14,0.7245514009999999,19873,3,0,14
16852,2014/03/31,2010/10/09,66,15,0.925576626,15556,66,8,7
16853,2014/03/31,2008/03/20,73,13,0.665108093,21648,73,6,7
16854,2014/03/31,2012/01/18,47,8,1.200397699,11994,47,0,8
16855,2014/03/31,2009/01/20,56,15,0.850816688,16922,56,7,8
16856,2014/03/31,2013/03/23,18,17,0.80622781,17857,18,1,16
16857,2014/03/31,2011/05/02,392,8,0.775,18576,392,8,0
16858,2014/03/31,2013/03/18,52,8,0.8155030590000001,17652,52,1,7
16859,2014/03/31,2011/03/08,137,19,0.556796905,25850,137,5,14
16860,2014/03/31,2011/01/07,48,15,0.71953057,20003,48,8,7
16861,2014/03/31,2008/02/21,123,9,0.876064037,16428,123,6,3
16862,2014/03/31,2011/07/12,34,16,0.7001775809999999,20554,34,7,9
16863,2014/03/31,2011/08/30,15,23,0.701371966,20518,15,11,12
16864,2014/03/31,2008/02/28,338,14,1.103535276,13040,338,11,3
16865,2014/03/31,2006/06/26,7,18,0.590920664,24352,7,12,6
16866,2014/03/31,2012/10/09,23,11,0.814004073,17677,23,7,4
16867,2014/03/31,2005/03/16,70,20,0.6859969490000001,20974,70,13,7
16868,2014/03/31,2010/06/01,61,12,0.877362034,16399,61,4,8
16869,2014/03/31,2011/01/26,142,2,0.5400228970000001,26641,142,0,2
16870,2014/03/31,2011/01/15,43,25,0.674451008,21330,43,12,13
16871,2014/03/31,2012/10/30,10,17,0.599235191,24006,10,4,13
16872,2014/03/31,2012/10/29,24,13,0.7365611879999999,19530,24,7,6
16873,2014/03/31,2011/03/28,5,9,0.582619684,24690,5,7,2
16874,2014/03/31,2010/02/03,34,15,0.693381056,20745,34,4,11
16875,2014/03/31,2006/12/29,11,36,0.717773952,20040,11,19,17
16876,2014/03/31,2012/08/15,50,14,0.775377608,18551,50,6,8
16877,2014/03/31,2013/02/28,1,17,0.641904677,22408,1,0,17
16878,2014/03/31,2013/02/28,14,19,0.803593698,17898,14,5,14
16879,2014/03/31,2012/07/28,118,10,0.93129638,15443,118,4,6
16880,2014/03/31,2008/12/06,31,18,0.563318057,25530,31,10,8
16881,2014/03/31,2012/05/06,94,56,0.539426857,26660,94,51,5
16882,2014/03/31,2011/09/10,112,18,0.862738181,16668,112,6,12
16883,2014/03/31,2006/10/20,39,15,0.5206629970000001,27617,39,7,8
16884,2014/03/31,2005/10/27,143,11,0.884286593,16260,143,6,5
16885,2014/03/31,2010/07/28,9,16,0.811883117,17710,9,5,11
16886,2014/03/31,2012/11/21,3,19,0.529835637,27135,3,3,16
16887,2014/03/31,2012/04/01,66,17,0.805532893,17846,66,10,7
16888,2014/03/31,2007/07/28,144,3,0.666643169,21562,144,0,3
16889,2014/03/31,2007/01/17,131,18,0.634526111,22653,131,12,6
16890,2014/03/31,2006/01/18,136,13,0.606411425,23703,136,9,4
16891,2014/03/31,2011/08/03,104,15,0.74213301,19367,104,8,7
16892,2014/03/31,2006/04/17,34,10,0.697244943,20613,34,2,8
16893,2014/03/31,2011/10/09,116,13,0.781021684,18401,116,8,5
16894,2014/03/31,2011/08/28,80,26,0.5091108120000001,28228,80,8,18
16895,2014/03/31,2006/04/01,41,11,0.675278195,21280,41,6,5
16896,2014/03/31,2006/06/01,194,13,0.770418767,18650,194,9,4
16897,2014/03/31,2010/07/23,29,22,0.733031478,19601,29,16,6
16898,2014/03/31,2008/10/13,13,19,0.61404419,23399,13,13,6
16899,2014/03/31,2010/01/13,68,15,0.555886404,25846,68,7,8
16900,2014/03/31,2012/08/14,22,14,0.740076238,19413,22,1,13
16901,2014/03/31,2012/04/26,138,19,0.764914812,18782,138,9,10
16902,2014/03/31,2007/07/06,187,14,0.595526076,24122,187,9,5
16903,2014/03/31,2007/03/06,17,12,0.649673918,22111,17,3,9
16904,2014/03/31,2012/06/22,78,6,0.70789414,20291,78,3,3
16905,2014/03/31,2008/08/08,7,22,0.776774647,18491,7,8,14
16906,2014/03/31,2011/11/22,2,15,0.67677237,21223,2,6,9
16907,2014/03/31,2012/08/13,44,6,0.742057973,19354,44,1,5
16908,2014/03/31,2008/12/16,14,12,0.7801738559999999,18406,14,3,9
16909,2014/03/31,2012/08/25,96,12,0.7153342629999999,20074,96,5,7
16910,2014/03/31,2005/04/30,6,13,0.791676039,18138,6,3,10
16911,2014/03/31,2011/11/16,100,17,0.637097089,22536,100,8,9
16912,2014/03/31,2012/09/24,1,9,1.009880416,14216,1,7,2
16913,2014/03/31,2009/06/12,111,17,0.643947699,22294,111,8,9
16914,2014/03/31,2012/08/19,174,11,0.57712402,24875,174,8,3
16915,2014/03/31,2011/05/26,16,18,0.786843548,18242,16,10,8
16916,2014/03/31,2012/10/31,7,12,0.633220541,22667,7,5,7
16917,2014/03/31,2012/12/12,24,5,0.78841582,18205,24,3,2
16918,2014/03/31,2005/10/20,73,15,0.704958986,20359,73,10,5
16919,2014/03/31,2011/08/28,50,14,0.846490504,16954,50,9,5
16920,2014/03/31,2005/11/01,102,16,0.942864464,15221,102,7,9
16921,2014/03/31,2007/08/05,76,12,0.6946340759999999,20660,76,5,7
16922,2014/03/31,2009/03/26,156,7,0.621367336,23096,156,5,2
16923,2014/03/31,2011/07/09,228,15,0.832485787,17238,228,8,7
16924,2014/03/31,2006/10/06,192,17,0.749717883,19141,192,7,10
16925,2014/03/31,2008/08/10,1,19,0.7268539159999999,19742,1,12,7
16926,2014/03/31,2012/04/30,24,14,0.638230584,22482,24,0,14
16927,2014/03/31,2006/04/29,18,22,0.5896605429999999,24333,18,16,6
16928,2014/03/31,2008/06/10,57,14,0.544204636,26359,57,7,7
16929,2014/03/31,2005/09/08,200,17,0.674878141,21254,200,6,11
16930,2014/03/31,2013/03/07,126,11,0.919457692,15600,126,0,11
16931,2014/03/31,2005/01/15,17,20,0.7321652120000001,19587,17,11,9
16932,2014/03/31,2007/09/19,68,18,0.571072396,25112,68,7,11
16933,2014/03/31,2007/04/12,151,10,0.902253051,15894,151,0,10
16934,2014/03/31,2011/07/25,273,16,0.7366105,19466,273,13,3
16935,2014/03/31,2011/11/14,24,11,0.773412805,18539,24,9,2
16936,2014/03/31,2006/10/29,162,24,0.627573423,22847,162,17,7
16937,2014/03/31,2011/12/22,25,16,0.796405955,18002,25,9,7
16938,2014/03/31,2012/08/06,139,13,0.804533924,17819,139,5,8
16939,2014/03/31,2012/12/08,71,11,0.617704141,23207,71,4,7
16940,2014/03/31,2011/10/25,114,11,0.757983922,18908,114,2,9
16941,2014/03/31,2012/04/04,530,14,0.902879103,15873,530,14,0
16942,2014/03/31,2006/07/04,5,12,0.886763814,16161,5,6,6
16943,2014/03/31,2012/11/14,115,7,1.31668688,10884,115,3,4
16944,2014/03/31,2011/11/02,199,6,1.257217933,11398,199,5,1
16945,2014/03/31,2011/11/14,32,19,0.686612517,20868,32,7,12
16946,2014/03/31,2012/10/25,58,10,0.522019529,27447,58,8,2
16947,2014/03/31,2009/01/17,39,23,0.586066023,24446,39,15,8
16948,2014/03/31,2009/08/08,12,18,0.694522009,20628,12,2,16
16949,2014/03/31,2008/10/19,109,14,0.839079248,17073,109,4,10
16950,2014/03/31,2006/10/31,27,19,0.645408462,22193,27,12,7
16951,2014/03/31,2011/11/05,40,7,0.895652826,15992,40,2,5
16952,2014/03/31,2007/11/01,32,16,0.7570828270000001,18919,32,7,9
16953,2014/03/31,2007/06/28,61,16,0.899858013,15917,61,8,8
16954,2014/03/31,2011/10/25,64,9,0.7457958859999999,19205,64,0,9
16955,2014/03/31,2008/05/07,63,12,0.594925224,24072,63,3,9
16956,2014/03/31,2008/11/26,331,9,0.641440473,22326,331,7,2
16957,2014/03/31,2005/07/27,29,18,0.709228407,20192,29,8,10
16958,2014/03/31,2010/01/18,103,13,0.834222882,17166,103,9,4
16959,2014/03/31,2009/11/20,431,23,0.7085729129999999,20209,431,23,0
16960,2014/03/31,2011/08/21,162,6,0.620962706,23060,162,2,4
16961,2014/03/31,2006/12/04,83,15,0.928672331,15418,83,5,10
16962,2014/03/31,2009/08/07,4,15,0.705203664,20303,4,3,12
16963,2014/03/31,2012/05/13,222,12,0.907053979,15784,222,10,2
16964,2014/03/31,2010/12/26,112,9,0.595367821,24047,112,4,5
16965,2014/03/31,2008/06/09,3,10,0.730806023,19590,3,6,4
16966,2014/03/31,2009/01/27,94,17,0.797950948,17940,94,6,11
16967,2014/03/31,2007/09/16,77,13,0.618490387,23145,77,7,6
16968,2014/03/31,2012/08/28,4,15,0.492871556,29040,4,6,9
16969,2014/03/31,2010/02/23,78,14,0.790720522,18098,78,10,4
16970,2014/03/31,2011/09/10,17,15,0.773685662,18496,17,7,8
16971,2014/03/31,2009/08/25,105,8,0.535132194,26741,105,1,7
16972,2014/03/31,2012/01/18,131,10,0.687651978,20809,131,7,3
16973,2014/03/31,2012/11/06,119,13,0.633898463,22573,119,6,7
16974,2014/03/31,2011/08/17,163,14,0.8640166659999999,16561,163,9,5
16975,2014/03/31,2010/04/06,308,8,0.822017005,17407,308,7,1
16976,2014/03/31,2011/05/31,214,11,0.825857093,17326,214,8,3
16977,2014/03/31,2011/09/16,2,11,0.671300962,21315,2,6,5
16978,2014/03/31,2012/09/03,12,11,0.567247066,25224,12,1,10
16979,2014/03/31,2010/06/13,322,11,0.811778723,17625,322,10,1
16980,2014/03/31,2011/03/20,87,21,0.671041696,21321,87,15,6
16981,2014/03/31,2012/05/01,140,12,0.6908092709999999,20710,140,4,8
16982,2014/03/31,2013/01/23,35,12,0.7749745370000001,18458,35,3,9
16983,2014/03/31,2009/07/02,31,11,0.728176033,19644,31,5,6
16984,2014/03/31,2007/08/30,445,11,0.73493295,19463,445,11,0
16985,2014/03/31,2009/10/25,21,23,0.552222694,25901,21,11,12
16986,2014/03/31,2010/11/02,207,11,0.680393435,21020,207,5,6
16987,2014/03/31,2005/09/09,43,24,0.601184161,23789,43,9,15
16988,2014/03/31,2012/09/13,17,23,0.5454090229999999,26221,17,6,17
16989,2014/03/31,2008/07/06,31,10,0.7690717440000001,18594,31,2,8
16990,2014/03/31,2010/06/06,13,17,0.737539588,19387,13,4,13
16991,2014/03/31,2012/09/21,62,9,0.944100363,15145,62,4,5
16992,2014/03/31,2007/11/21,63,16,0.633903618,22556,63,7,9
16993,2014/03/31,2011/06/29,8,10,0.6524294970000001,21914,8,4,6
16994,2014/03/31,2012/05/04,107,20,0.669125755,21367,107,14,6
16995,2014/03/31,2012/03/27,48,16,0.724192078,19742,48,9,7
16996,2014/03/31,2012/09/05,30,15,0.764913595,18691,30,3,12
16997,2014/03/31,2012/07/22,543,3,0.870882066,16416,543,3,0
16998,2014/03/31,2012/11/21,418,2,0.940023672,15208,418,2,0
16999,2014/03/31,2009/10/11,2,19,0.720662903,19837,2,8,11
17000,2014/03/31,2011/01/15,84,15,0.6909700809999999,20689,84,8,7
17001,2014/03/31,2010/02/25,48,8,0.84018044,17014,48,4,4
17002,2014/03/31,2012/08/30,30,26,0.6963681979999999,20527,30,14,12
17003,2014/03/31,2010/08/20,215,6,0.735675759,19430,215,4,2
17004,2014/03/31,2011/02/21,49,5,0.8088902720000001,17671,49,1,4
17005,2014/03/31,2011/07/01,192,14,0.6711246240000001,21296,192,11,3
17006,2014/03/31,2011/08/10,37,12,0.559453535,25546,37,6,6
17007,2014/03/31,2007/08/20,493,13,0.819725823,17434,493,13,0
17008,2014/03/31,2011/11/19,357,7,0.790616874,18075,357,5,2
17009,2014/03/31,2008/01/29,36,19,0.69973411,20422,36,11,8
17010,2014/03/31,2010/10/29,16,16,0.530204074,26951,16,4,12
17011,2014/03/31,2011/08/12,87,15,0.694901036,20563,87,5,10
17012,2014/03/31,2011/06/09,17,15,0.6846827679999999,20868,17,10,5
17013,2014/03/31,2008/11/29,296,3,0.854621964,16718,296,2,1
17014,2014/03/31,2009/08/22,164,12,0.7071500690000001,20204,164,6,6
17015,2014/03/31,2012/07/12,577,15,0.712388432,20055,577,15,0
17016,2014/03/31,2008/09/01,107,18,0.693527184,20600,107,17,1
17017,2014/03/31,2007/11/21,73,22,0.778716341,18346,73,16,6
17018,2014/03/31,2008/07/24,29,15,0.6961944440000001,20520,29,9,6
17019,2014/03/31,2012/07/26,24,19,0.659678581,21654,24,11,8
17020,2014/03/31,2011/07/20,175,15,0.807205018,17696,175,9,6
17021,2014/03/31,2008/09/15,7,5,0.597952776,23886,7,1,4
17022,2014/03/31,2007/07/28,356,10,0.7585108079999999,18829,356,9,1
17023,2014/03/31,2009/11/12,5,18,0.7872526320000001,18141,5,8,10
17024,2014/03/31,2006/06/15,4,18,0.7207050209999999,19815,4,9,9
17025,2014/03/31,2013/01/27,63,9,0.683333333,20898,63,3,6
17026,2014/03/31,2006/10/16,109,15,0.6462821329999999,22096,109,3,12
17027,2014/03/31,2012/09/15,25,18,0.7196844920000001,19841,25,11,7
17028,2014/03/31,2010/09/11,32,16,0.780256831,18300,32,6,10
17029,2014/03/31,2006/05/25,63,9,0.584901479,24411,63,2,7
17030,2014/03/31,2013/01/01,221,10,0.627655955,22747,221,5,5
17031,2014/03/31,2006/09/08,138,14,0.7689098940000001,18567,138,10,4
17032,2014/03/31,2006/10/01,172,10,0.604494644,23617,172,9,1
17033,2014/03/31,2013/01/27,213,4,0.907751001,15727,213,1,3
17034,2014/03/31,2013/02/23,6,20,0.73917616,19312,6,0,20
17035,2014/03/31,2006/06/14,5,16,0.72796216,19609,5,4,12
17036,2014/03/31,2011/05/21,159,16,0.63123032,22612,159,14,2
17037,2014/03/31,2012/12/06,31,14,0.713176094,20012,31,2,12
17038,2014/03/31,2005/12/20,4,19,0.741495818,19247,4,11,8
17039,2014/03/31,2011/07/12,24,15,0.790300144,18058,24,10,5
17040,2014/03/31,2006/09/10,28,16,0.768344371,18573,28,8,8
17041,2014/03/31,2013/02/24,100,13,0.693887673,20565,100,2,11
17042,2014/03/31,2008/06/03,12,16,0.725220573,19676,12,8,8
17043,2014/03/31,2009/12/12,157,16,0.870024998,16401,157,14,2
17044,2014/03/31,2007/06/27,16,21,0.637837729,22370,16,6,15
17045,2014/03/31,2007/05/23,58,11,1.107332557,12885,58,3,8
17046,2014/03/31,2008/02/24,107,10,0.949643214,15023,107,8,2
17047,2014/03/31,2010/12/17,11,16,0.595625,23952,11,13,3
17048,2014/03/31,2008/07/10,62,19,0.818462421,17430,62,10,9
17049,2014/03/31,2012/09/20,48,19,0.763450361,18685,48,9,10
17050,2014/03/31,2009/08/27,112,15,0.6976967470000001,20445,112,2,13
17051,2014/03/31,2006/10/01,8,19,0.54374757,26233,8,8,11
17052,2014/03/31,2007/01/19,95,15,0.711703423,20042,95,7,8
17053,2014/03/31,2012/05/13,280,6,0.843838372,16903,280,3,3
17054,2014/03/31,2010/03/02,135,10,0.7069714990000001,20175,135,6,4
17055,2014/03/31,2011/09/26,9,14,0.706127834,20198,9,7,7
17056,2014/03/31,2013/03/27,62,14,0.689635898,20681,62,2,12
17057,2014/03/31,2008/10/13,380,11,0.695283249,20512,380,11,0
17058,2014/03/31,2011/03/30,90,8,0.90625,15736,90,1,7
17059,2014/03/31,2007/11/15,105,9,0.672751852,21193,105,0,9
17060,2014/03/31,2011/08/15,27,7,0.7261108279999999,19634,27,0,7
17061,2014/03/31,2009/01/01,30,11,0.825788772,17261,30,4,7
17062,2014/03/31,2009/02/15,24,10,0.7351103659999999,19390,24,3,7
17063,2014/03/31,2009/04/09,43,12,0.748994745,19030,43,0,12
17064,2014/03/31,2011/02/28,81,25,0.8711282929999999,16361,81,18,7
17065,2014/03/31,2006/05/30,155,11,0.647603944,22007,155,4,7
17066,2014/03/31,2012/10/12,179,12,0.8098982779999999,17597,179,9,3
17067,2014/03/31,2012/01/01,13,20,0.944695082,15086,13,3,17
17068,2014/03/31,2012/02/15,23,9,0.8032656970000001,17742,23,2,7
17069,2014/03/31,2012/07/21,3,22,0.632378079,22535,3,10,12
17070,2014/03/31,2010/02/20,61,14,0.8680927140000001,16416,61,5,9
17071,2014/03/31,2005/05/04,100,13,0.591246421,24101,100,8,5
17072,2014/03/31,2013/02/04,337,3,0.7773389340000001,18331,337,2,1
17073,2014/03/31,2010/11/10,546,9,0.782325811,18213,546,9,0
17074,2014/03/31,2009/11/14,6,20,0.733613428,19422,6,10,10
17075,2014/03/31,2011/01/11,375,11,0.72409412,19677,375,11,0
17076,2014/03/31,2011/08/23,36,15,0.820004029,17375,36,1,14
17077,2014/03/31,2013/01/10,113,11,0.6480218329999999,21985,113,2,9
17078,2014/03/31,2011/07/24,37,12,0.981372873,14517,37,9,3
17079,2014/03/31,2006/05/27,5,14,0.698251066,20401,5,5,9
17080,2014/03/31,2011/05/20,265,14,0.789649094,18039,265,6,8
17081,2014/03/31,2012/04/03,12,21,0.6919981540000001,20584,12,8,13
17082,2014/03/31,2010/10/26,134,18,0.616004411,23123,134,14,4
17083,2014/03/31,2013/01/23,114,12,0.731979033,19459,114,2,10
17084,2014/03/31,2008/01/14,30,21,0.5956200079999999,23911,30,17,4
17085,2014/03/31,2010/09/24,207,14,0.8032090690000001,17731,207,11,3
17086,2014/03/31,2012/11/13,323,8,0.8677461609999999,16412,323,5,3
17087,2014/03/31,2005/12/19,31,17,0.614027939,23193,31,12,5
17088,2014/03/31,2012/05/27,502,3,0.7452794640000001,19108,502,3,0
17089,2014/03/31,2005/06/02,238,12,0.844973595,16853,238,8,4
17090,2014/03/31,2012/01/11,28,19,0.861958838,16520,28,9,10
17091,2014/03/31,2011/12/18,198,17,0.814579519,17480,198,10,7
17092,2014/03/31,2012/09/27,1,15,0.785800541,18119,1,8,7
17093,2014/03/31,2010/04/16,72,21,0.5270296879999999,27014,72,9,12
17094,2014/03/31,2008/03/18,70,13,0.8044759,17697,70,12,1
17095,2014/03/31,2012/01/25,2,14,0.83545716,17040,2,6,8
17096,2014/03/31,2012/12/15,15,17,0.698397763,20384,15,1,16
17097,2014/03/31,2005/05/14,3,25,0.422433828,33700,3,12,13
17098,2014/03/31,2012/05/10,189,24,0.931364826,15284,189,16,8
17099,2014/03/31,2012/10/14,120,15,0.609454102,23356,120,6,9
17100,2014/03/31,2011/04/03,36,24,0.6867873000000001,20724,36,13,11
17101,2014/03/31,2011/11/28,100,9,0.761448903,18690,100,3,6
17102,2014/03/31,2009/01/08,40,12,0.8795068290000001,16181,40,8,4
17103,2014/03/31,2011/09/07,23,16,0.837513243,16990,23,7,9
17104,2014/03/31,2013/03/23,14,14,0.5344619310000001,26623,14,2,12
17105,2014/03/31,2007/05/29,29,19,0.729982043,19491,29,11,8
17106,2014/03/31,2006/04/10,102,14,0.627887467,22660,102,6,8
17107,2014/03/31,2012/09/29,103,19,0.764157581,18619,103,3,16
17108,2014/03/31,2012/02/17,30,11,0.847646288,16782,30,8,3
17109,2014/03/31,2009/12/20,74,14,0.7685131559999999,18509,74,5,9
17110,2014/03/31,2013/02/23,3,9,0.607551256,23412,3,2,7
17111,2014/03/31,2011/10/31,87,7,0.686025177,20733,87,3,4
17112,2014/03/31,2012/10/23,44,8,0.728629098,19520,44,0,8
17113,2014/03/31,2007/06/14,21,21,0.671028073,21195,21,12,9
17114,2014/03/31,2010/12/06,3,11,0.7098627270000001,20033,3,4,7
17115,2014/03/31,2012/10/05,107,14,0.703273492,20220,107,4,10
17116,2014/03/31,2009/03/24,24,14,0.611843724,23241,24,3,11
17117,2014/03/31,2006/03/11,52,32,0.481998305,29500,52,1,31
17118,2014/03/31,2011/08/13,1,17,0.81216542,17507,1,12,5
17119,2014/03/31,2013/01/01,4,8,0.627854272,22645,4,2,6
17120,2014/03/31,2011/03/31,39,23,0.649976227,21874,39,10,13
17121,2014/03/31,2007/11/27,8,13,0.747499343,19019,8,9,4
17122,2014/03/31,2007/09/05,74,14,0.7540757440000001,18853,74,6,8
17123,2014/03/31,2009/08/20,469,14,0.788168764,18037,469,14,0
17124,2014/03/31,2007/06/04,35,10,0.666829291,21317,35,4,6
17125,2014/03/31,2012/10/31,14,14,0.516822777,27502,14,5,9
17126,2014/03/31,2011/05/04,49,14,0.946483085,15016,49,6,8
17127,2014/03/31,2009/08/12,44,13,0.6351575420000001,22375,44,8,5
17128,2014/03/31,2005/12/14,146,11,0.817722408,17378,146,5,6
17129,2014/03/31,2011/09/24,86,16,0.659272955,21553,86,12,4
17130,2014/03/31,2012/09/22,61,9,0.765883463,18552,61,4,5
17131,2014/03/31,2006/06/07,41,25,0.653284289,21749,41,16,9
17132,2014/03/31,2010/09/19,441,7,0.779431612,18227,441,7,0
17133,2014/03/31,2007/04/18,232,20,0.7751574179999999,18327,232,12,8
17134,2014/03/31,2005/03/30,458,7,1.141465767,12444,458,7,0
17135,2014/03/31,2011/04/26,397,12,0.780321925,18203,397,12,0
17136,2014/03/31,2012/11/10,1,10,0.693897113,20469,1,1,9
17137,2014/03/31,2012/04/12,275,18,0.7118364070000001,19952,275,13,5
17138,2014/03/31,2009/12/19,43,15,0.888672173,15981,43,2,13
17139,2014/03/31,2009/05/02,25,13,0.636024005,22329,25,3,10
17140,2014/03/31,2007/03/01,161,17,0.707059995,20085,161,4,13
17141,2014/03/31,2012/07/28,413,10,0.7383683440000001,19232,413,10,0
17142,2014/03/31,2010/05/15,23,16,0.933849392,15205,23,13,3
17143,2014/03/31,2012/06/11,39,16,0.559776069,25365,39,3,13
17144,2014/03/31,2012/10/12,86,13,0.7876495059999999,18026,86,4,9
17145,2014/03/31,2012/12/27,71,14,0.635584509,22335,71,1,13
17146,2014/03/31,2010/04/15,16,27,0.739093039,19207,16,5,22
17147,2014/03/31,2011/12/14,42,19,0.66543571,21333,42,7,12
17148,2014/03/31,2011/10/31,11,12,0.597900147,23735,11,3,9
17149,2014/03/31,2012/06/21,626,2,0.7,20272,626,2,0
17150,2014/03/31,2012/06/21,626,2,0.7,20272,626,2,0
17151,2014/03/31,2010/09/30,109,2,0.58,24464,109,0,2
17152,2014/03/31,2011/11/09,136,2,0.58,24464,136,0,2
17153,2014/03/31,2012/01/11,46,2,0.58,24464,46,0,2
17154,2014/03/31,2006/11/01,380,14,0.718472757,19748,380,14,0
17155,2014/03/31,2010/12/31,7,21,0.55066175,25765,7,12,9
17156,2014/03/31,2012/08/14,20,25,0.6108,23225,20,2,23
17157,2014/03/31,2008/08/05,151,15,0.595831058,23807,151,7,8
17158,2014/03/31,2012/05/29,5,15,0.670603783,21150,5,3,12
17159,2014/03/31,2011/08/06,382,9,0.973147386,14574,382,9,0
17160,2014/03/31,2011/10/16,102,20,0.65995998,21489,102,8,12
17161,2014/03/31,2008/10/27,10,14,0.74410138,19057,10,6,8
17162,2014/03/31,2010/05/25,51,13,0.667042525,21258,51,10,3
17163,2014/03/31,2007/07/20,219,12,0.652674799,21725,219,0,12
17164,2014/03/31,2012/06/06,14,12,0.895660413,15831,14,9,3
17165,2014/03/31,2010/04/22,18,26,0.781654537,18138,18,11,15
17166,2014/03/31,2005/10/19,28,16,0.597256794,23735,28,12,4
17167,2014/03/31,2013/03/01,304,3,0.8211156159999999,17264,304,1,2
17168,2014/03/31,2007/01/17,111,14,0.742492143,19092,111,10,4
17169,2014/03/31,2009/03/02,32,22,0.598718479,23675,32,12,10
17170,2014/03/31,2012/08/25,42,23,0.690995466,20513,42,12,11
17171,2014/03/31,2012/08/23,571,4,0.527690704,26861,571,4,0
17172,2014/03/31,2011/11/04,149,14,0.721448715,19645,149,5,9
17173,2014/03/31,2011/05/17,15,16,0.526338248,26927,15,10,6
17174,2014/03/31,2008/01/14,137,13,0.663024235,21374,137,9,4
17175,2014/03/31,2010/06/14,34,15,0.970135551,14607,34,7,8
17176,2014/03/31,2008/06/20,104,11,0.922194455,15366,104,7,4
17177,2014/03/31,2008/09/04,259,6,0.652669154,21711,259,3,3
17178,2014/03/31,2012/01/04,118,16,0.721001934,19652,118,12,4
17179,2014/03/31,2008/02/01,152,14,0.7162139209999999,19783,152,9,5
17180,2014/03/31,2007/06/18,117,10,0.735563574,19261,117,7,3
17181,2014/03/31,2005/03/19,21,12,0.684724021,20690,21,6,6
17182,2014/03/31,2011/04/23,37,13,0.5597079970000001,25308,37,3,10
17183,2014/03/31,2009/06/24,15,23,0.590054572,24005,15,11,12
17184,2014/03/31,2012/04/09,71,13,0.7123300140000001,19884,71,4,9
17185,2014/03/31,2008/07/09,130,13,0.56633292,25009,130,11,2
17186,2014/03/31,2005/07/13,64,15,0.582404392,24318,64,6,9
17187,2014/03/31,2007/04/25,12,23,0.680390602,20814,12,2,21
17188,2014/03/31,2010/11/22,33,16,0.6678207970000001,21205,33,12,4
17189,2014/03/31,2012/08/01,596,2,0.7,20230,596,2,0
17190,2014/03/31,2012/06/06,235,11,0.7691944159999999,18409,235,8,3
17191,2014/03/31,2005/07/26,124,18,0.671191752,21095,124,0,18
17192,2014/03/31,2013/01/01,13,20,0.8058178709999999,17570,13,5,15
17193,2014/03/31,2010/06/20,103,21,0.603672878,23453,103,11,10
17194,2014/03/31,2011/09/19,106,15,0.701812323,20173,106,11,4
17195,2014/03/31,2012/10/23,57,7,0.7114285709999999,19894,57,1,6
17196,2014/03/31,2006/02/24,44,17,0.497362946,28456,44,9,8
17197,2014/03/31,2012/12/20,412,5,0.453160321,31231,412,5,0
17198,2014/03/31,2012/12/30,325,6,1.095564329,12918,325,5,1
17199,2014/03/31,2011/08/05,6,15,0.616020284,22974,6,4,11
17200,2014/03/31,2008/04/23,39,18,0.7386752959999999,19159,39,11,7
17201,2014/03/31,2010/04/01,47,20,0.74970543,18875,47,9,11
17202,2014/03/31,2013/02/12,272,8,0.843881202,16768,272,4,4
17203,2014/03/31,2011/09/01,73,15,0.538220997,26290,73,8,7
17204,2014/03/31,2008/07/29,30,22,0.593357655,23847,30,16,6
17205,2014/03/31,2011/05/16,198,14,0.823033969,17192,198,10,4
17206,2014/03/31,2009/06/28,1,20,0.728990622,19408,1,11,9
17207,2014/03/31,2011/05/27,124,12,0.8082250790000001,17505,124,6,6
17208,2014/03/31,2007/06/24,113,12,1.431006474,9886,113,9,3
17209,2014/03/31,2007/06/11,69,14,0.56298432,25128,69,9,5
17210,2014/03/31,2013/01/20,68,11,0.840301176,16834,68,0,11
17211,2014/03/31,2008/03/11,13,3,0.62001578,22814,13,1,2
17212,2014/03/31,2011/07/31,42,13,0.554793849,25491,42,8,5
17213,2014/03/31,2006/01/26,48,9,0.656732609,21534,48,3,6
17214,2014/03/31,2012/09/14,11,15,0.5955323,23746,11,5,10
17215,2014/03/31,2008/06/02,249,14,0.7372165159999999,19181,249,8,6
17216,2014/03/31,2010/06/14,1,10,0.688751583,20530,1,2,8
17217,2014/03/31,2013/01/19,100,7,0.764285714,18501,100,0,7
17218,2014/03/31,2013/01/01,151,5,1.07,13215,151,1,4
17219,2014/03/31,2005/06/20,12,19,0.8191866059999999,17261,12,11,8
17220,2014/03/31,2011/07/11,94,18,0.815639709,17336,94,14,4
17221,2014/03/31,2012/01/19,74,10,0.572370466,24704,74,3,7
17222,2014/03/31,2012/07/16,87,5,0.905276906,15619,87,0,5
17223,2014/03/31,2007/03/02,3,31,0.769243743,18380,3,9,22
17224,2014/03/31,2011/06/15,160,12,1.449656516,9753,160,5,7
17225,2014/03/31,2010/05/19,19,9,0.506065216,27938,19,6,3
17226,2014/03/31,2012/07/01,91,19,0.554988813,25475,91,9,10
17227,2014/03/31,2011/01/13,66,14,0.742330795,19045,66,4,10
17228,2014/03/31,2011/09/24,279,14,0.780740557,18108,279,12,2
17229,2014/03/31,2011/04/13,19,14,0.506299466,27923,19,5,9
17230,2014/03/31,2012/06/01,256,21,0.903900256,15640,256,18,3
17231,2014/03/31,2005/12/07,22,14,0.5892617760000001,23990,22,5,9
17232,2014/03/31,2006/02/14,63,12,0.634258794,22288,63,6,6
17233,2014/03/31,2006/04/18,440,15,0.6143034070000001,23012,440,15,0
17234,2014/03/31,2009/01/21,21,14,0.697091922,20278,21,7,7
17235,2014/03/31,2006/05/18,103,11,0.82974639,17034,103,7,4
17236,2014/03/31,2008/02/21,20,17,0.62663829,22554,20,13,4
17237,2014/03/31,2011/10/15,75,13,0.607974705,23246,75,4,9
17238,2014/03/31,2010/10/22,175,12,0.608072025,23242,175,8,4
17239,2014/03/31,2011/01/26,71,17,0.78409676,18024,71,9,8
17240,2014/03/31,2008/06/28,451,2,0.7,20188,451,2,0
17241,2014/03/31,2010/06/29,594,2,0.7,20188,594,2,0
17242,2014/03/31,2011/03/10,451,2,0.7,20188,451,2,0
17243,2014/03/31,2012/07/01,25,15,0.764416315,18486,25,8,7
17244,2014/03/31,2009/11/02,3,17,0.8072263479999999,17504,3,4,13
17245,2014/03/31,2011/12/04,255,18,0.6042221179999999,23384,255,14,4
17246,2014/03/31,2011/01/13,15,15,0.69725079,20264,15,0,15
17247,2014/03/31,2005/04/06,94,17,0.62462773,22618,94,4,13
17248,2014/03/31,2008/02/10,19,10,0.921751811,15327,19,7,3
17249,2014/03/31,2009/10/30,14,22,0.7505908609999999,18820,14,16,6
17250,2014/03/31,2007/04/07,36,12,0.760407493,18577,36,4,8
17251,2014/03/31,2010/02/11,100,13,0.7376278270000001,19147,100,8,5
17252,2014/03/31,2005/02/14,33,24,0.537559861,26269,33,9,15
17253,2014/03/31,2012/01/19,30,16,0.8819981259999999,16010,30,9,7
17254,2014/03/31,2011/11/29,14,26,0.77615744,18191,14,15,11
17255,2014/03/31,2009/04/17,3,16,0.702426368,20100,3,6,10
17256,2014/03/31,2010/11/19,54,13,0.6983461959999999,20214,54,11,2
17257,2014/03/31,2007/06/15,275,17,0.621672393,22704,275,12,5
17258,2014/03/31,2008/12/26,21,23,0.520765285,27101,21,13,10
17259,2014/03/31,2012/12/15,52,10,0.875869025,16110,52,4,6
17260,2014/03/31,2006/10/01,374,9,0.528021855,26722,374,9,0
17261,2014/03/31,2013/02/01,4,20,0.718923876,19626,4,2,18
17262,2014/03/31,2011/01/05,98,12,0.67955927,20761,98,8,4
17263,2014/03/31,2011/08/30,143,14,0.8284837629999999,17029,143,11,3
17264,2014/03/31,2011/01/15,149,13,0.714305098,19751,149,8,5
17265,2014/03/31,2008/02/22,109,9,0.6350092270000001,22217,109,1,8
17266,2014/03/31,2007/07/25,103,17,0.606325268,23267,103,9,8
17267,2014/03/31,2008/03/23,4,17,0.645013488,21871,4,12,5
17268,2014/03/31,2009/01/13,95,9,0.660233092,21365,95,2,7
17269,2014/03/31,2005/10/22,14,12,0.97419366,14479,14,1,11
17270,2014/03/31,2012/02/20,71,11,1.038051222,13588,71,5,6
17271,2014/03/31,2005/06/04,173,13,0.8389744809999999,16811,173,11,2
17272,2014/03/31,2011/04/05,155,10,0.954569882,14775,155,3,7
17273,2014/03/31,2008/10/18,7,17,0.570387478,24724,7,6,11
17274,2014/03/31,2011/03/21,125,16,0.739436841,19071,125,11,5
17275,2014/03/31,2012/11/18,12,16,0.6761481659999999,20855,12,4,12
17276,2014/03/31,2007/01/01,154,9,0.722044756,19528,154,8,1
17277,2014/03/31,2011/10/06,265,13,0.7961106720000001,17710,265,12,1
17278,2014/03/31,2011/05/28,301,15,0.792438874,17791,301,13,2
17279,2014/03/31,2012/10/16,355,7,0.90348949,15604,355,5,2
17280,2014/03/31,2011/01/31,490,6,0.737407156,19118,490,6,0
17281,2014/03/31,2010/03/03,12,23,0.79241765,17790,12,5,18
17282,2014/03/31,2012/06/21,65,11,0.6926097,20351,65,5,6
17283,2014/03/31,2007/01/03,16,16,0.7812254740000001,18042,16,9,7
17284,2014/03/31,2006/10/08,63,19,0.8633825509999999,16322,63,14,5
17285,2014/03/31,2010/07/11,118,23,0.712177802,19786,118,20,3
17286,2014/03/31,2012/08/14,18,17,0.604695077,23301,18,9,8
17287,2014/03/31,2012/09/19,87,11,0.538553245,26162,87,2,9
17288,2014/03/31,2006/09/01,1,16,0.804725538,17507,1,7,9
17289,2014/03/31,2010/07/18,92,18,0.625011314,22539,92,5,13
17290,2014/03/31,2010/05/03,23,10,0.613708722,22954,23,4,6
17291,2014/03/31,2012/03/11,17,15,0.69874256,20160,17,0,15
17292,2014/03/31,2009/05/02,60,9,0.572250345,24614,60,7,2
17293,2014/03/31,2007/12/21,344,11,0.682575721,20635,344,9,2
17294,2014/03/31,2008/03/04,67,25,0.6988384440000001,20154,67,15,10
17295,2014/03/31,2009/08/29,3,18,0.707539435,19906,3,10,8
17296,2014/03/31,2008/11/21,11,14,0.575664187,24466,11,7,7
17297,2014/03/31,2006/08/17,228,16,0.768239786,18333,228,12,4
17298,2014/03/31,2010/04/07,33,14,0.722571326,19488,33,9,5
17299,2014/03/31,2011/05/10,170,17,0.8310499290000001,16944,170,8,9
17300,2014/03/31,2012/05/18,233,7,0.600056252,23466,233,4,3
17301,2014/03/31,2011/04/26,31,19,0.815371475,17269,31,13,6
17302,2014/03/31,2012/12/08,32,11,0.72786198,19345,32,6,5
17303,2014/03/31,2013/01/11,72,13,0.6357820829999999,22146,72,5,8
17304,2014/03/31,2007/07/10,14,12,0.751668625,18728,14,3,9
17305,2014/03/31,2012/10/16,104,18,0.616710624,22825,104,10,8
17306,2014/03/31,2012/09/21,107,13,0.804154479,17504,107,5,8
17307,2014/03/31,2012/05/30,31,22,0.8155191190000001,17260,31,5,17
17308,2014/03/31,2009/12/29,415,11,0.402482128,34970,415,11,0
17309,2014/03/31,2007/08/30,133,10,0.671653622,20954,133,7,3
17310,2014/03/31,2007/04/29,23,18,0.64572746,21795,23,6,12
17311,2014/03/31,2007/11/07,282,12,0.833282018,16889,282,8,4
17312,2014/03/31,2005/05/04,47,12,0.837556838,16802,47,3,9
17313,2014/03/31,2006/06/27,22,20,0.479519136,29343,22,10,10
17314,2014/03/31,2008/02/23,151,9,0.873401614,16110,151,1,8
17315,2014/03/31,2009/12/22,223,9,0.741163085,18984,223,2,7
17316,2014/03/31,2008/10/22,127,11,0.801764203,17549,127,7,4
17317,2014/03/31,2008/08/28,291,13,0.692305762,20323,291,10,3
17318,2014/03/31,2010/08/01,167,12,0.842858255,16692,167,9,3
17319,2014/03/31,2012/05/09,133,12,0.930355112,15122,133,4,8
17320,2014/03/31,2010/06/12,12,15,0.668854236,21034,12,8,7
17321,2014/03/31,2013/01/17,12,15,0.942496148,14927,12,6,9
17322,2014/03/31,2010/08/10,156,9,0.952820183,14765,156,7,2
17323,2014/03/31,2011/12/02,132,12,0.611016765,23024,132,3,9
17324,2014/03/31,2012/04/26,9,3,0.616639783,22814,9,0,3
17325,2014/03/31,2005/08/02,9,19,0.696219935,20206,9,9,10
17326,2014/03/31,2009/05/05,5,9,0.764895329,18391,5,3,6
17327,2014/03/31,2007/10/25,119,16,0.609206617,23091,119,12,4
17328,2014/03/31,2011/11/22,21,8,1.309984167,10737,21,3,5
17329,2014/03/31,2006/12/10,347,12,0.818365625,17187,347,11,1
17330,2014/03/31,2008/11/17,204,7,0.968650138,14520,204,3,4
17331,2014/03/31,2009/01/31,82,11,0.65,21637,82,4,7
17332,2014/03/31,2011/11/27,73,18,0.743685936,18907,73,9,9
17333,2014/03/31,2012/06/18,192,12,0.765833333,18360,192,7,5
17334,2014/03/31,2011/09/06,20,12,0.917624331,15322,20,8,4
17335,2014/03/31,2012/10/26,15,14,0.636461747,22090,15,10,4
17336,2014/03/31,2013/03/11,23,11,0.6826326779999999,20595,23,0,11
17337,2014/03/31,2012/04/07,32,23,0.913920817,15382,32,14,9
17338,2014/03/31,2006/12/12,109,7,0.878344892,16005,109,3,4
17339,2014/03/31,2005/01/18,67,11,0.844414344,16648,67,6,5
17340,2014/03/31,2007/03/21,144,10,0.630191885,22305,144,7,3
17341,2014/03/31,2009/08/24,106,12,0.766672848,18334,106,3,9
17342,2014/03/31,2007/09/19,5,9,1.181515636,11896,5,5,4
17343,2014/03/31,2011/05/16,8,14,0.710563701,19780,8,11,3
17344,2014/03/31,2012/04/18,89,10,0.526,26720,89,4,6
17345,2014/03/31,2012/02/20,34,14,0.892182441,15753,34,6,8
17346,2014/03/31,2012/02/15,71,8,0.786445999,17870,71,4,4
17347,2014/03/31,2005/07/21,27,17,0.668754105,21013,27,4,13
17348,2014/03/31,2005/10/31,60,12,0.833306055,16863,60,7,5
17349,2014/03/31,2011/05/14,80,19,0.6837927009999999,20550,80,11,8
17350,2014/03/31,2012/08/06,16,26,0.7761743259999999,18104,16,14,12
17351,2014/03/31,2007/07/30,75,19,0.530618533,26482,75,13,6
17352,2014/03/31,2006/05/10,128,7,1.454571429,9660,128,4,3
17353,2014/03/31,2007/12/08,9,13,1.0061324740000002,13965,9,3,10
17354,2014/03/31,2011/02/28,14,23,0.6633168079999999,21180,14,17,6
17355,2014/03/31,2012/12/03,372,8,0.75625,18576,372,8,0
17356,2014/03/31,2012/07/25,32,13,0.8207537690000001,17114,32,10,3
17357,2014/03/31,2010/07/08,136,5,1.077304801,13038,136,2,3
17358,2014/03/31,2011/09/17,2,25,0.57759921,24317,2,7,18
17359,2014/03/31,2007/07/01,16,13,0.635608365,22092,16,4,9
17360,2014/03/31,2012/02/28,70,16,0.901433616,15576,70,13,3
17361,2014/03/31,2011/10/28,151,17,0.539962697,26003,151,14,3
17362,2014/03/31,2007/05/08,40,12,0.776906304,18069,40,0,12
17363,2014/03/31,2012/08/30,126,12,0.86263504,16273,126,8,4
17364,2014/03/31,2009/07/06,72,15,0.494251963,28401,72,8,7
17365,2014/03/31,2010/09/05,599,14,1.0,14036,599,14,0
17366,2014/03/31,2010/10/18,75,10,0.71089804,19743,75,2,8
17367,2014/03/31,2005/07/10,67,12,0.99160602,14153,67,8,4
17368,2014/03/31,2012/03/15,522,8,0.759752599,18472,522,8,0
17369,2014/03/31,2012/04/27,478,12,0.65932522,21281,478,12,0
17370,2014/03/31,2007/07/24,9,17,0.7297534720000001,19227,9,3,14
17371,2014/03/31,2008/11/21,483,17,0.618444484,22687,483,17,0
17372,2014/03/31,2007/06/26,115,10,1.199051363,11701,115,4,6
17373,2014/03/31,2008/06/12,48,13,0.588095577,23855,48,8,5
17374,2014/03/31,2013/01/31,186,22,0.924090909,15180,186,0,22
17375,2014/03/31,2007/07/04,4,16,0.689758568,20337,4,9,7
17376,2014/03/31,2011/09/08,4,12,0.773451698,18136,4,5,7
17377,2014/03/31,2011/01/09,41,9,0.744266157,18846,41,5,4
17378,2014/03/31,2008/09/30,58,12,0.498877823,28115,58,2,10
17379,2014/03/31,2008/11/10,351,11,0.922690789,15200,351,8,3
17380,2014/03/31,2009/06/18,56,14,0.7414930740000001,18914,56,4,10
17381,2014/03/31,2012/05/17,369,13,0.922990851,15193,369,13,0
17382,2014/03/31,2012/08/18,2,31,0.7721548540000001,18159,2,14,17
17383,2014/03/31,2010/12/13,122,14,0.643126319,21802,122,3,11
17384,2014/03/31,2012/10/27,1,11,0.866825966,16175,1,3,8
17385,2014/03/31,2008/06/13,7,17,0.646764624,21676,7,5,12
17386,2014/03/31,2009/01/05,117,10,0.8100757009999999,17305,117,8,2
17387,2014/03/31,2007/11/02,51,17,0.561471542,24967,51,8,9
17388,2014/03/31,2013/01/15,129,6,0.723333333,19380,129,2,4
17389,2014/03/31,2006/09/27,153,16,0.73311261,19119,153,12,4
17390,2014/03/31,2008/06/16,268,11,0.919570922,15242,268,8,3
17391,2014/03/31,2012/11/13,111,8,0.569807684,24595,111,1,7
17392,2014/03/31,2005/09/11,1,14,0.629425107,22265,1,6,8
17393,2014/03/31,2011/04/26,344,12,1.0,14014,344,11,1
17394,2014/03/31,2008/09/06,1,11,0.607769104,23058,1,5,6
17395,2014/03/31,2011/07/21,11,19,0.7234512129999999,19370,11,9,10
17396,2014/03/31,2008/01/26,4,14,0.668571429,20958,4,3,11
17397,2014/03/31,2013/02/23,1,22,0.685454545,20438,1,4,18
17398,2014/03/31,2009/03/18,28,22,0.467474889,29967,28,7,15
17399,2014/03/31,2009/03/20,3,18,0.6738207709999999,20789,3,8,10
17400,2014/03/31,2008/05/05,50,14,0.7541573340000001,18572,50,0,14
17401,2014/03/31,2008/03/26,237,20,0.6534370629999999,21434,237,15,5
17402,2014/03/31,2010/11/17,27,21,0.8144475459999999,17196,27,8,13
17403,2014/03/31,2008/02/04,69,15,0.852706126,16422,69,10,5
17404,2014/03/31,2007/06/12,67,9,0.8770416540000001,15965,67,4,5
17405,2014/03/31,2008/04/18,177,22,0.809151592,17303,177,18,4
17406,2014/03/31,2011/12/01,9,20,0.500167548,27992,9,9,11
17407,2014/03/31,2009/01/30,2,13,0.7172767329999999,19517,2,4,9
17408,2014/03/31,2008/04/16,146,13,0.6852513579999999,20429,146,8,5
17409,2014/03/31,2009/07/08,31,11,0.61123963,22902,31,1,10
17410,2014/03/31,2012/03/21,39,14,0.694266726,20163,39,7,7
17411,2014/03/31,2009/10/18,16,15,0.814847779,17179,16,8,7
17412,2014/03/31,2010/12/22,12,14,0.924654512,15138,12,8,6
17413,2014/03/31,2008/04/13,6,22,0.667876706,20958,6,6,16
17414,2014/03/31,2008/04/23,14,15,0.931626947,15022,14,5,10
17415,2014/03/31,2011/01/28,27,9,0.833962219,16781,27,0,9
17416,2014/03/31,2012/06/14,144,9,0.598519374,23382,144,7,2
17417,2014/03/31,2011/09/24,22,13,0.6243724620000001,22413,22,2,11
17418,2014/03/31,2012/07/19,21,13,0.662483075,21123,21,3,10
17419,2014/03/31,2011/02/12,332,13,0.7067759370000001,19798,332,12,1
17420,2014/03/31,2009/09/26,9,19,1.04750992,13357,9,4,15
17421,2014/03/31,2012/09/24,83,12,0.68918674,20301,83,3,9
17422,2014/03/31,2007/09/09,2,12,0.667475788,20961,2,5,7
17423,2014/03/31,2008/12/02,11,14,0.7412360259999999,18875,11,0,14
17424,2014/03/31,2006/07/25,176,12,0.667497137,20960,176,9,3
17425,2014/03/31,2010/11/29,20,12,0.692929813,20189,20,6,6
17426,2014/03/31,2007/09/01,7,14,0.7511565720000001,18624,7,3,11
17427,2014/03/31,2008/12/26,19,16,0.641456805,21808,19,12,4
17428,2014/03/31,2010/12/14,37,15,0.854226823,16374,37,10,5
17429,2014/03/31,2009/07/13,39,20,0.779646042,17940,39,7,13
17430,2014/03/31,2012/08/02,65,12,0.8259084740000001,16935,65,4,8
17431,2014/03/31,2007/07/10,76,11,0.708692744,19736,76,9,2
17432,2014/03/31,2007/06/01,7,15,0.577201222,24232,7,5,10
17433,2014/03/31,2006/06/02,11,10,0.464264091,30126,11,3,7
17434,2014/03/31,2007/10/18,34,15,0.627666831,22283,34,4,11
17435,2014/03/31,2011/03/10,85,18,0.7473607990000001,18714,85,8,10
17436,2014/03/31,2010/11/21,3,23,0.843834319,16574,3,6,17
17437,2014/03/31,2010/09/15,98,5,1.325256325,10553,98,2,3
17438,2014/03/31,2012/07/09,23,8,0.777338929,17989,23,4,4
17439,2014/03/31,2008/05/09,52,10,0.7887026909999999,17729,52,2,8
17440,2014/03/31,2011/10/19,186,9,1.01035624,13839,186,5,4
17441,2014/03/31,2012/06/27,14,18,0.720493687,19405,14,8,10
17442,2014/03/31,2007/03/03,2,16,0.7789707440000001,17945,2,6,10
17443,2014/03/31,2011/05/19,100,9,0.578783901,24151,100,5,4
17444,2014/03/31,2012/09/28,156,12,0.6663426610000001,20977,156,4,8
17445,2014/03/31,2011/11/15,74,11,0.617516236,22635,74,1,10
17446,2014/03/31,2011/08/12,203,10,0.872245382,16024,203,5,5
17447,2014/03/31,2011/05/29,234,11,0.7084438359999999,19728,234,8,3
17448,2014/03/31,2007/03/21,9,18,0.813605775,17178,9,8,10
17449,2014/03/31,2008/10/08,121,12,0.7446842859999999,18767,121,4,8
17450,2014/03/31,2005/04/19,27,22,0.664896998,21019,27,8,14
17451,2014/03/31,2005/09/23,212,9,0.977289831,14298,212,6,3
17452,2014/03/31,2010/12/05,84,13,0.596245626,23434,84,6,7
17453,2014/03/31,2011/01/20,1,13,0.794834727,17577,1,5,8
17454,2014/03/31,2007/01/10,51,14,0.690756032,20224,51,7,7
17455,2014/03/31,2008/11/16,103,14,0.69342104,20143,103,8,6
17456,2014/03/31,2012/08/27,47,11,0.821313654,17006,47,4,7
17457,2014/03/31,2011/07/27,88,17,0.6914311879999999,20200,88,3,14
17458,2014/03/31,2009/05/21,355,21,0.859339814,16253,355,20,1
17459,2014/03/31,2012/10/15,2,18,0.5724415939999999,24398,2,6,12
17460,2014/03/31,2011/09/18,66,15,0.506834809,27556,66,5,10
17461,2014/03/31,2012/06/21,263,7,0.7142857140000001,19551,263,5,2
17462,2014/03/31,2012/02/19,9,8,0.536918759,26009,9,1,7
17463,2014/03/31,2013/03/04,23,15,0.7250503629999999,19260,23,3,12
17464,2014/03/31,2010/05/20,87,16,0.6771272,20621,87,10,6
17465,2014/03/31,2010/02/27,245,15,0.704381716,19821,245,12,3
17466,2014/03/31,2011/05/23,149,13,0.782417059,17844,149,10,3
17467,2014/03/31,2009/08/17,21,13,0.796820958,17521,21,7,6
17468,2014/03/31,2007/08/25,20,16,0.7548413079999999,18495,20,7,9
17469,2014/03/31,2006/11/05,89,12,0.73989453,18868,89,3,9
17470,2014/03/31,2008/08/28,37,11,0.6963036859999999,20047,37,6,5
17471,2014/03/31,2010/10/16,28,14,0.8561371440000001,16304,28,9,5
17472,2014/03/31,2011/11/15,44,14,0.748764551,18641,44,6,8
17473,2014/03/31,2013/02/05,34,8,0.630035211,22152,34,0,8
17474,2014/03/31,2010/12/11,111,10,0.7516018529999999,18566,111,4,6
17475,2014/03/31,2012/01/16,6,18,0.783619363,17807,6,13,5
17476,2014/03/31,2010/07/02,204,8,0.8863969,15742,204,7,1
17477,2014/03/31,2011/12/05,31,11,0.617272727,22605,31,5,6
17478,2014/03/31,2009/11/09,58,17,0.7098850109999999,19654,58,5,12
17479,2014/03/31,2009/12/23,150,8,0.562225133,24812,150,4,4
17480,2014/03/31,2007/03/08,158,12,0.67726924,20595,158,8,4
17481,2014/03/31,2011/06/07,1,26,0.6741138659999999,20691,1,11,15
17482,2014/03/31,2008/02/08,110,9,0.78465429,17775,110,5,4
17483,2014/03/31,2006/07/20,49,12,0.774235275,18013,49,0,12
17484,2014/03/31,2010/06/11,33,26,0.7488337629999999,18624,33,18,8
17485,2014/03/31,2007/02/05,141,10,0.953704084,14619,141,4,6
17486,2014/03/31,2013/01/04,36,11,0.7371837990000001,18912,36,0,11
17487,2014/03/31,2008/04/13,5,9,0.8777567209999999,15883,5,3,6
17488,2014/03/31,2009/01/23,196,16,0.935542953,14900,196,9,7
17489,2014/03/31,2009/01/16,23,19,0.643855143,21649,23,5,14
17490,2014/03/31,2012/08/13,97,7,0.654813719,21285,97,1,6
17491,2014/03/31,2010/09/27,49,11,0.7404335120000001,18823,49,3,8
17492,2014/03/31,2012/10/14,99,18,0.726227005,19189,99,10,8
17493,2014/03/31,2011/05/27,23,14,0.7559971790000001,18432,23,8,6
17494,2014/03/31,2011/01/15,120,11,0.648436409,21489,120,7,4
17495,2014/03/31,2009/11/15,10,17,0.632837353,22017,10,7,10
17496,2014/03/31,2005/07/30,31,18,0.552741411,25206,31,7,11
17497,2014/03/31,2011/10/25,75,15,0.504143958,27633,75,11,4
17498,2014/03/31,2007/04/10,55,10,0.917350191,15186,55,5,5
17499,2014/03/31,2006/03/05,13,17,0.433802005,32112,13,10,7
17500,2014/03/31,2012/05/25,35,11,0.968181818,14388,35,6,5
17501,2014/03/31,2010/07/27,177,12,0.666827669,20890,177,6,6
17502,2014/03/31,2011/07/14,41,21,0.7360980770000001,18924,41,15,6
17503,2014/03/31,2009/03/11,435,17,0.94739849,14703,435,17,0
17504,2014/03/31,2012/02/10,76,19,0.649380857,21449,76,5,14
17505,2014/03/31,2010/02/23,17,13,0.635944934,21901,17,5,8
17506,2014/03/31,2010/11/17,56,19,0.533422575,26109,56,11,8
17507,2014/03/31,2006/04/23,26,13,0.6289026870000001,22145,26,7,6
17508,2014/03/31,2012/07/19,315,12,0.725969558,19184,315,11,1
17509,2014/03/31,2012/11/15,76,13,0.6398584820000001,21764,76,4,9
17510,2014/03/31,2010/03/19,10,15,0.844794637,16483,10,2,13
17511,2014/03/31,2011/09/30,61,19,0.8122516479999999,17143,61,5,14
17512,2014/03/31,2012/12/11,41,4,0.7756922390000001,17949,41,2,2
17513,2014/03/31,2009/04/08,144,10,0.8440545620000001,16495,144,0,10
17514,2014/03/31,2006/12/28,10,13,0.8478753729999999,16417,10,5,8
17515,2014/03/31,2012/04/12,93,12,0.762236583,18260,93,6,6
17516,2014/03/31,2008/01/05,95,12,0.788747945,17643,95,8,4
17517,2014/03/31,2007/08/02,163,9,1.103544013,12610,163,4,5
17518,2014/03/31,2012/06/19,80,3,0.592619139,23481,80,1,2
17519,2014/03/31,2006/04/17,12,17,0.7291312090000001,19084,12,5,12
17520,2014/03/31,2012/01/05,306,20,0.882746479,15762,306,17,3
17521,2014/03/31,2009/06/10,550,5,1.472668572,9447,550,5,0
17522,2014/03/31,2011/05/22,1,22,0.842395398,16515,1,8,14
17523,2014/03/31,2007/04/19,128,10,0.931822505,14930,128,4,6
17524,2014/03/31,2005/11/01,89,11,0.67133047,20722,89,8,3
17525,2014/03/31,2009/08/04,21,24,0.5006197139999999,27787,21,13,11
17526,2014/03/31,2013/01/01,38,11,0.932692772,14914,38,0,11
17527,2014/03/31,2012/04/03,66,11,0.554608668,25081,66,8,3
17528,2014/03/31,2012/04/12,259,15,0.632042078,22007,259,13,2
17529,2014/03/31,2010/03/07,55,8,0.724592103,19196,55,1,7
17530,2014/03/31,2012/04/17,44,27,0.828807651,16782,44,19,8
17531,2014/03/31,2006/04/02,95,7,0.91938789,15128,95,5,2
17532,2014/03/31,2007/09/08,52,9,0.813079801,17105,52,4,5
17533,2014/03/31,2012/01/03,80,13,0.753239452,18463,80,7,6
17534,2014/03/31,2008/12/30,6,14,0.7474580740000001,18604,6,6,8
17535,2014/03/31,2011/02/19,86,10,0.8349234459999999,16655,86,8,2
17536,2014/03/31,2009/01/15,3,24,0.6690016360000001,20784,3,13,11
17537,2014/03/31,2011/04/01,148,25,0.57414048,24217,148,16,9
17538,2014/03/31,2010/04/08,350,10,0.876885721,15856,350,9,1
17539,2014/03/31,2007/06/24,290,6,1.4867564969999998,9351,290,4,2
17540,2014/03/31,2008/07/09,153,11,0.853221015,16293,153,9,2
17541,2014/03/31,2009/03/04,205,10,0.696747531,19951,205,7,3
17542,2014/03/31,2011/09/22,31,14,0.754012476,18435,31,9,5
17543,2014/03/31,2012/03/23,456,8,1.4326839830000002,9702,456,8,0
17544,2014/03/31,2010/06/18,58,13,0.8523627890000001,16307,58,8,5
17545,2014/03/31,2009/02/18,26,16,0.597671569,23256,26,9,7
17546,2014/03/31,2012/10/30,5,16,0.648439002,21435,5,5,11
17547,2014/03/31,2009/12/09,120,10,0.849169721,16368,120,7,3
17548,2014/03/31,2007/10/10,37,16,0.6644421070000001,20918,37,9,7
17549,2014/03/31,2011/09/08,163,17,0.576768477,24097,163,8,9
17550,2014/03/31,2012/07/22,30,21,0.581478599,23901,30,9,12
17551,2014/03/31,2010/05/20,18,11,0.7264784609999999,19128,18,7,4
17552,2014/03/31,2011/05/19,341,13,0.7542501220000001,18423,341,11,2
17553,2014/03/31,2010/03/19,131,15,0.797888934,17413,131,8,7
17554,2014/03/31,2005/03/19,20,16,0.54105628,25675,20,6,10
17555,2014/03/31,2012/10/02,340,7,0.809410325,17162,340,6,1
17556,2014/03/31,2012/04/24,28,17,0.697351775,19919,28,12,5
17557,2014/03/31,2011/12/24,1,17,0.567168232,24490,1,14,3
17558,2014/03/31,2007/04/26,103,25,0.6731389940000001,20634,103,19,6
17559,2014/03/31,2011/11/07,74,15,0.723024624,19209,74,7,8
17560,2014/03/31,2011/06/01,2,23,0.5895008279999999,23559,2,16,7
17561,2014/03/31,2012/07/09,110,12,0.553843577,25073,110,8,4
17562,2014/03/31,2010/07/11,13,18,0.834158707,16647,13,8,10
17563,2014/03/31,2008/09/22,38,11,0.7588905890000001,18298,38,7,4
17564,2014/03/31,2013/03/21,2,20,0.68905915,20152,2,3,17
17565,2014/03/31,2009/09/26,15,14,0.7290338670000001,19045,15,4,10
17566,2014/03/31,2009/03/20,129,12,0.512543468,27089,129,4,8
17567,2014/03/31,2011/03/05,15,14,0.524735231,26457,15,6,8
17568,2014/03/31,2011/03/04,168,13,0.779697242,17803,168,11,2
17569,2014/03/31,2005/09/09,88,18,0.650544125,21337,88,7,11
17570,2014/03/31,2008/07/28,19,12,0.579305782,23955,19,3,9
17571,2014/03/31,2009/08/20,10,9,0.731998206,18957,10,0,9
17572,2014/03/31,2010/05/16,422,7,0.75,18501,422,7,0
17573,2014/03/31,2010/02/26,306,6,0.987805937,14047,306,5,1
17574,2014/03/31,2006/06/01,373,13,0.653189286,21243,373,13,0
17575,2014/03/31,2007/08/09,9,11,0.823517123,16849,9,6,5
17576,2014/03/31,2010/04/24,206,12,0.539755699,25706,206,9,3
17577,2014/03/31,2006/03/15,345,13,0.575785433,24095,345,11,2
17578,2014/03/31,2011/09/28,2,12,0.7742752690000001,17917,2,0,12
17579,2014/03/31,2005/11/28,19,14,0.771144588,17989,19,5,9
17580,2014/03/31,2012/11/28,26,20,0.8358318770000001,16595,26,11,9
17581,2014/03/31,2006/03/28,166,15,0.8490236290000001,16336,166,10,5
17582,2014/03/31,2010/06/07,318,11,0.542797041,25552,318,10,1
17583,2014/03/31,2008/11/18,20,16,0.483453709,28688,20,8,8
17584,2014/03/31,2013/01/10,64,6,0.566415911,24486,64,2,4
17585,2014/03/31,2012/05/04,26,17,0.822831207,16855,26,11,6
17586,2014/03/31,2010/12/21,298,9,1.41933579,9771,298,7,2
17587,2014/03/31,2006/04/29,23,9,0.7633714979999999,18167,23,6,3
17588,2014/03/31,2010/12/17,4,25,0.637753047,21745,4,7,18
17589,2014/03/31,2008/01/03,36,10,0.7489376759999999,18516,36,4,6
17590,2014/03/31,2011/05/06,421,15,0.800649576,17319,421,15,0
17591,2014/03/31,2009/07/10,21,9,0.883264539,15699,21,3,6
17592,2014/03/31,2011/05/04,2,17,0.664354846,20871,2,6,11
17593,2014/03/31,2012/11/02,6,16,0.638560836,21714,6,5,11
17594,2014/03/31,2008/06/30,257,14,0.7571428570000001,18312,257,11,3
17595,2014/03/31,2012/12/08,5,7,0.8464680379999999,16379,5,2,5
17596,2014/03/31,2012/05/29,9,25,0.505342471,27433,9,5,20
17597,2014/03/31,2010/04/29,63,15,1.446112038,9586,63,7,8
17598,2014/03/31,2009/04/19,74,23,0.6314924829999999,21950,74,9,14
17599,2014/03/31,2007/09/13,76,13,0.7624416940000001,18180,76,5,8
17600,2014/03/31,2006/04/26,188,12,1.211008301,11445,188,7,5
17601,2014/03/31,2011/03/22,304,16,0.73554559,18842,304,14,2
17602,2014/03/31,2008/05/15,63,18,0.594446017,23313,63,8,10
17603,2014/03/31,2012/07/30,129,16,0.737608048,18788,129,7,9
17604,2014/03/31,2007/06/08,174,16,0.554576163,24986,174,8,8
17605,2014/03/31,2011/01/04,50,16,0.6682204860000001,20736,50,8,8
17606,2014/03/31,2011/09/02,96,24,0.544060082,25465,96,5,19
17607,2014/03/31,2012/05/22,24,14,0.780852827,17741,24,8,6
17608,2014/03/31,2005/04/29,61,20,0.598067176,23163,61,13,7
17609,2014/03/31,2013/01/17,27,16,0.8281467090000001,16727,27,6,10
17610,2014/03/31,2010/05/18,7,14,0.787263995,17595,7,4,10
17611,2014/03/31,2010/06/16,3,18,0.635209595,21804,3,8,10
17612,2014/03/31,2005/09/09,312,12,0.7197848459999999,19242,312,9,3
17613,2014/03/31,2013/01/23,41,17,0.845563561,16378,41,2,15
17614,2014/03/31,2007/06/01,51,24,0.468614937,29551,51,14,10
17615,2014/03/31,2012/11/22,67,10,0.6272514379999999,22077,67,1,9
17616,2014/03/31,2005/08/27,39,19,0.825841484,16768,39,13,6
17617,2014/03/31,2009/02/07,216,12,0.63006734,21978,216,6,6
17618,2014/03/31,2012/07/10,202,5,0.952704506,14535,202,2,3
17619,2014/03/31,2006/03/14,9,14,0.7229330690000001,19154,9,6,8
17620,2014/03/31,2009/12/23,150,25,0.81541782,16981,150,24,1
17621,2014/03/31,2007/10/13,25,15,0.667714713,20737,25,2,13
17622,2014/03/31,2011/11/01,59,7,0.7141961109999999,19387,59,5,2
17623,2014/03/31,2010/12/01,71,10,0.688867108,20099,71,5,5
17624,2014/03/31,2007/11/26,8,13,0.68090842,20332,8,6,7
17625,2014/03/31,2010/07/20,133,14,0.732031944,18908,133,13,1
17626,2014/03/31,2011/08/18,2,34,0.644879322,21462,2,7,27
17627,2014/03/31,2008/06/06,120,16,0.555301766,24920,120,9,7
17628,2014/03/31,2008/01/14,158,11,0.738468805,18737,158,8,3
17629,2014/03/31,2011/08/11,48,21,0.592524625,23350,48,11,10
17630,2014/03/31,2008/02/09,82,13,0.511082748,27070,82,9,4
17631,2014/03/31,2011/06/23,167,10,0.97872515,14135,167,7,3
17632,2014/03/31,2012/05/14,68,16,0.633299762,21844,68,14,2
17633,2014/03/31,2011/11/19,69,16,0.536146661,25801,69,8,8
17634,2014/03/31,2009/10/10,158,17,0.719160385,19235,158,6,11
17635,2014/03/31,2012/03/27,28,26,0.751299223,18411,28,3,23
17636,2014/03/31,2010/04/04,99,18,0.792937973,17444,99,2,16
17637,2014/03/31,2006/02/20,131,14,0.7503770409999999,18433,131,6,8
17638,2014/03/31,2011/10/08,117,10,0.927157796,14918,117,5,5
17639,2014/03/31,2013/03/07,61,12,0.710613472,19463,61,2,10
17640,2014/03/31,2006/05/19,207,10,0.672693093,20560,207,4,6
17641,2014/03/31,2012/08/29,571,3,0.864718019,15994,571,3,0
17642,2014/03/31,2011/11/01,95,14,0.70699315,19562,95,8,6
17643,2014/03/31,2009/08/06,44,18,0.604232585,22882,44,14,4
17644,2014/03/31,2007/07/13,29,7,1.435700935,9630,29,1,6
17645,2014/03/31,2006/08/25,197,16,0.63772048,21680,197,10,6
17646,2014/03/31,2009/10/02,263,7,0.865541852,15973,263,3,4
17647,2014/03/31,2012/05/16,337,16,0.711536878,19429,337,13,3
17648,2014/03/31,2011/06/13,108,15,0.6790337,20356,108,7,8
17649,2014/03/31,2008/11/16,273,2,0.565,24464,273,0,2
17650,2014/03/31,2008/11/16,273,2,0.565,24464,273,0,2
17651,2014/03/31,2008/03/14,7,7,0.943460068,14650,7,0,7
17652,2014/03/31,2006/03/11,1,9,0.8577193740000001,16114,1,4,5
17653,2014/03/31,2006/12/06,169,14,0.793200758,17424,169,12,2
17654,2014/03/31,2011/02/03,18,12,0.699413402,19758,18,3,9
17655,2014/03/31,2007/05/30,48,19,0.5353915,25811,48,6,13
17656,2014/03/31,2011/11/14,111,23,0.577896454,23912,111,10,13
17657,2014/03/31,2012/12/28,44,7,1.104078779,12516,44,0,7
17658,2014/03/31,2005/07/02,82,15,0.71201989,19407,82,8,7
17659,2014/03/31,2010/12/26,47,8,0.659710671,20945,47,3,5
17660,2014/03/31,2010/12/24,28,20,0.644539136,21438,28,9,11
17661,2014/03/31,2006/10/14,43,15,0.7989314829999999,17295,43,9,6
17662,2014/03/31,2013/01/26,3,8,0.5593478000000001,24701,3,2,6
17663,2014/03/31,2008/05/12,7,11,0.986542416,14004,7,1,10
17664,2014/03/31,2008/09/05,101,12,0.79220094,17438,101,1,11
17665,2014/03/31,2005/09/15,81,21,0.8280877590000001,16682,81,10,11
17666,2014/03/31,2006/06/19,130,15,0.61984429,22285,130,10,5
17667,2014/03/31,2005/11/07,1,19,0.666993432,20708,1,8,11
17668,2014/03/31,2006/10/29,13,10,0.757710288,18225,13,4,6
17669,2014/03/31,2010/12/24,15,11,0.603994226,22863,15,4,7
17670,2014/03/31,2006/09/12,4,16,0.741828829,18613,4,11,5
17671,2014/03/31,2013/02/01,255,7,0.751796798,18366,255,3,4
17672,2014/03/31,2011/05/25,100,16,0.507820362,27188,100,8,8
17673,2014/03/31,2006/06/01,17,16,0.579884913,23808,17,0,16
17674,2014/03/31,2012/04/19,6,9,0.998194505,13830,6,5,4
17675,2014/03/31,2009/02/19,60,9,0.8929353170000001,15460,60,1,8
17676,2014/03/31,2012/04/20,133,14,0.589959826,23398,133,6,8
17677,2014/03/31,2011/08/10,83,22,0.747143166,18475,83,5,17
17678,2014/03/31,2010/12/30,30,12,1.147986527,12024,30,6,6
17679,2014/03/31,2012/02/24,207,8,0.723286523,19084,207,4,4
17680,2014/03/31,2006/06/06,131,12,0.764790559,18048,131,7,5
17681,2014/03/31,2012/06/24,90,14,0.529870628,26049,90,5,9
17682,2014/03/31,2012/06/09,8,9,0.954374222,14462,8,4,5
17683,2014/03/31,2010/03/30,66,14,0.753135436,18326,66,9,5
17684,2014/03/31,2012/09/02,13,16,0.730300032,18898,13,4,12
17685,2014/03/31,2010/10/30,93,7,0.554020312,24911,93,6,1
17686,2014/03/31,2007/09/02,67,10,0.8921137690000001,15470,67,8,2
17687,2014/03/31,2008/07/22,459,13,0.7276257509999999,18966,459,13,0
17688,2014/03/31,2013/03/30,47,10,0.708589474,19475,47,1,9
17689,2014/03/31,2006/09/01,8,21,0.7139698879999999,19328,8,8,13
17690,2014/03/31,2012/03/08,8,22,0.658987584,20940,8,13,9
17691,2014/03/31,2012/10/09,13,12,0.633575003,21779,13,3,9
17692,2014/03/31,2012/02/17,593,14,0.755486202,18264,593,14,0
17693,2014/03/31,2012/05/05,7,8,1.4541178330000002,9488,7,3,5
17694,2014/03/31,2006/01/24,35,23,0.602861388,22884,35,16,7
17695,2014/03/31,2011/05/07,44,18,0.632125183,21824,44,9,9
17696,2014/03/31,2010/11/29,89,18,0.827304348,16675,89,6,12
17697,2014/03/31,2006/08/23,16,10,0.615695796,22406,16,2,8
17698,2014/03/31,2011/12/05,81,17,0.7480527090000001,18441,81,12,5
17699,2014/03/31,2012/03/07,8,15,0.6298963470000001,21900,8,13,2
17700,2014/03/31,2012/09/10,127,21,0.793098373,17393,127,11,10
17701,2014/03/31,2011/09/06,170,9,0.8262377959999999,16695,170,7,2
17702,2014/03/31,2008/01/14,111,13,0.69966063,19713,111,9,4
17703,2014/03/31,2006/05/29,10,12,0.765175589,18025,10,2,10
17704,2014/03/31,2006/07/26,10,12,0.736581927,18724,10,4,8
17705,2014/03/31,2010/04/17,8,18,0.811771839,16988,8,8,10
17706,2014/03/31,2013/01/01,11,14,0.701758689,19651,11,0,14
17707,2014/03/31,2005/08/04,186,14,0.80983028,17028,186,6,8
17708,2014/03/31,2005/11/25,16,18,0.6914312220000001,19941,16,8,10
17709,2014/03/31,2009/06/12,31,31,0.766774194,17980,31,20,11
17710,2014/03/31,2011/09/20,2,11,0.781330689,17645,2,4,7
17711,2014/03/31,2013/01/08,14,24,0.812444156,16967,14,5,19
17712,2014/03/31,2012/08/28,77,6,1.204407165,11445,77,5,1
17713,2014/03/31,2006/07/11,28,11,0.694308886,19852,28,7,4
17714,2014/03/31,2012/07/11,164,15,0.694865642,19835,164,13,2
17715,2014/03/31,2011/04/14,83,14,0.8698939659999999,15844,83,11,3
17716,2014/03/31,2007/10/19,3,7,0.764285714,18032,3,2,5
17717,2014/03/31,2009/07/20,224,12,0.793858295,17360,224,8,4
17718,2014/03/31,2008/04/29,161,12,0.717469804,19208,161,6,6
17719,2014/03/31,2009/08/16,15,40,0.621466967,22175,15,11,29
17720,2014/03/31,2006/05/07,138,11,0.864850006,15934,138,9,2
17721,2014/03/31,2011/01/07,76,23,0.637134665,21624,76,11,12
17722,2014/03/31,2008/12/04,22,12,0.797616952,17272,22,5,7
17723,2014/03/31,2005/11/29,14,17,0.7471196920000001,18439,14,8,9
17724,2014/03/31,2011/12/19,67,19,0.583195885,23621,67,9,10
17725,2014/03/31,2005/04/23,17,14,0.647695961,21267,17,8,6
17726,2014/03/31,2010/06/09,12,15,0.739253475,18633,12,9,6
17727,2014/03/31,2010/10/27,244,19,0.626853099,21974,244,12,7
17728,2014/03/31,2011/11/19,11,15,0.816825218,16861,11,6,9
17729,2014/03/31,2007/03/01,11,15,0.751636374,18321,11,9,6
17730,2014/03/31,2011/04/08,15,18,0.749282294,18378,15,9,9
17731,2014/03/31,2009/02/16,66,12,0.793006566,17362,66,4,8
17732,2014/03/31,2006/12/13,75,17,0.6873719420000001,20030,75,5,12
17733,2014/03/31,2011/06/23,151,13,0.7306028440000001,18844,151,4,9
17734,2014/03/31,2009/09/18,156,12,0.6710880370000001,20514,156,7,5
17735,2014/03/31,2012/05/15,11,15,0.584123987,23567,11,12,3
17736,2014/03/31,2011/08/07,200,15,0.7299464390000001,18857,200,12,3
17737,2014/03/31,2010/11/17,24,20,0.575057029,23935,24,1,19
17738,2014/03/31,2012/06/23,14,26,0.6896041890000001,19959,14,7,19
17739,2014/03/31,2009/08/15,27,21,0.778559792,17678,27,13,8
17740,2014/03/31,2005/05/17,118,12,0.751728752,18308,118,7,5
17741,2014/03/31,2005/08/22,188,13,0.7193962359999999,19130,188,6,7
17742,2014/03/31,2008/08/24,31,19,0.626884566,21952,31,8,11
17743,2014/03/31,2013/02/27,2,5,0.852,16150,2,1,4
17744,2014/03/31,2012/10/16,52,20,0.6031373839999999,22812,52,11,9
17745,2014/03/31,2004/11/30,245,10,0.810207879,16981,245,4,6
17746,2014/03/31,2012/08/23,196,9,0.7042419120000001,19536,196,4,5
17747,2014/03/31,2007/03/24,211,11,0.814615111,16888,211,9,2
17748,2014/03/31,2010/12/13,146,14,0.586577691,23452,146,7,7
17749,2014/03/31,2009/10/13,17,12,0.586649751,23449,17,5,7
17750,2014/03/31,2009/06/23,29,16,0.70875,19408,29,9,7
17751,2014/03/31,2011/10/19,67,16,0.8282675979999999,16607,67,9,7
17752,2014/03/31,2008/10/27,19,20,0.6386896360000001,21536,19,10,10
17753,2014/03/31,2013/03/16,186,13,0.6803501999999999,20217,186,2,11
17754,2014/03/31,2011/09/06,44,14,0.617846555,22262,44,8,6
17755,2014/03/31,2008/12/13,109,9,0.996517171,13802,109,6,3
17756,2014/03/31,2011/10/06,316,12,0.790860215,17391,316,8,4
17757,2014/03/31,2009/05/01,62,6,0.7820362790000001,17586,62,1,5
17758,2014/03/31,2012/01/19,45,16,0.536580436,25629,45,8,8
17759,2014/03/31,2009/03/01,152,24,0.8202266490000001,16766,152,13,11
17760,2014/03/31,2009/03/19,3,22,0.725891575,18944,3,6,16
17761,2014/03/31,2013/03/27,12,13,0.6140209870000001,22395,12,0,13
17762,2014/03/31,2009/12/23,308,13,0.6642729470000001,20700,308,11,2
17763,2014/03/31,2005/10/09,8,6,1.440886514,9543,8,2,4
17764,2014/03/31,2012/06/22,27,14,0.842415145,16322,27,5,9
17765,2014/03/31,2005/05/30,242,14,0.901127277,15258,242,13,1
17766,2014/03/31,2012/08/06,340,11,0.637646104,21560,340,9,2
17767,2014/03/31,2010/11/24,47,16,0.682421445,20145,47,2,14
17768,2014/03/31,2009/06/11,95,12,0.62447488,22014,95,6,6
17769,2014/03/31,2008/09/24,541,3,0.800736922,17166,541,3,0
17770,2014/03/31,2007/12/13,41,15,0.673560543,20407,41,6,9
17771,2014/03/31,2010/10/01,32,11,0.5874544829999999,23398,32,7,4
17772,2014/03/31,2012/03/14,37,13,0.686091145,20034,37,10,3
17773,2014/03/31,2011/01/30,171,11,0.7917672809999999,17360,171,5,6
17774,2014/03/31,2006/01/27,313,11,0.967671079,14204,313,9,2
17775,2014/03/31,2007/06/03,193,5,0.7444342740000001,18463,193,0,5
17776,2014/03/31,2012/09/20,265,6,1.46638963,9373,265,4,2
17777,2014/03/31,2005/09/02,18,15,0.743652202,18482,18,0,15
17778,2014/03/31,2011/10/18,347,4,1.3,10572,347,3,1
17779,2014/03/31,2011/05/27,43,19,0.5113345979999999,26877,43,11,8
17780,2014/03/31,2012/12/29,112,11,0.628733644,21858,112,0,11
17781,2014/03/31,2012/12/06,173,11,1.362192704,10088,173,7,4
17782,2014/03/31,2007/01/16,64,17,0.546762026,25133,64,6,11
17783,2014/03/31,2008/08/20,1,16,0.662022456,20752,1,3,13
17784,2014/03/31,2006/07/04,2,16,0.63166774,21748,2,5,11
17785,2014/03/31,2006/11/01,194,14,0.5982236639999999,22963,194,8,6
17786,2014/03/31,2012/04/11,151,23,0.719873703,19082,151,13,10
17787,2014/03/31,2012/06/15,6,12,0.673749755,20388,6,4,8
17788,2014/03/31,2013/03/08,279,8,0.5944806539999999,23106,279,4,4
17789,2014/03/31,2007/06/01,95,18,0.668311113,20552,95,11,7
17790,2014/03/31,2011/07/01,480,8,1.5,9156,480,8,0
17791,2014/03/31,2011/01/01,111,25,0.651076609,21094,111,12,13
17792,2014/03/31,2011/07/25,191,10,0.976406428,14064,191,7,3
17793,2014/03/31,2010/05/15,73,10,0.716056213,19177,73,3,7
17794,2014/03/31,2008/03/19,16,15,0.754264762,18205,16,1,14
17795,2014/03/31,2008/03/01,44,11,0.766239397,17920,44,5,6
17796,2014/03/31,2005/03/14,7,12,0.670767465,20470,7,6,6
17797,2014/03/31,2007/10/18,488,13,1.0,13730,488,13,0
17798,2014/03/31,2006/07/27,8,15,0.785535592,17476,8,9,6
17799,2014/03/31,2012/05/11,198,5,0.85,16150,198,4,1
17800,2014/03/31,2012/07/05,618,4,0.717119423,19142,618,4,0
17801,2014/03/31,2011/06/13,70,13,0.7585168809999999,18097,70,5,8
17802,2014/03/31,2012/12/26,18,10,0.76409931,17964,18,3,7
17803,2014/03/31,2005/10/08,76,12,1.012099985,13562,76,5,7
17804,2014/03/31,2007/05/11,7,16,0.679936097,20187,7,9,7
17805,2014/03/31,2012/09/16,62,14,0.6917179859999999,19843,62,1,13
17806,2014/03/31,2008/04/30,155,12,0.779015212,17618,155,8,4
17807,2014/03/31,2009/02/07,16,16,0.5728050920000001,23960,16,3,13
17808,2014/03/31,2011/11/10,339,12,0.577540715,23763,339,10,2
17809,2014/03/31,2012/10/01,24,37,0.8073357259999999,16999,24,14,23
17810,2014/03/31,2005/04/18,111,17,0.783333143,17518,111,12,5
17811,2014/03/31,2009/09/10,28,18,0.801982229,17107,28,6,12
17812,2014/03/31,2005/04/01,16,20,0.5689847379999999,24112,16,9,11
17813,2014/03/31,2011/11/24,3,14,0.8057509540000001,17025,3,7,7
17814,2014/03/31,2007/12/14,493,22,0.709247195,19341,493,22,0
17815,2014/03/31,2011/10/19,273,15,0.449335364,30528,273,12,3
17816,2014/03/31,2012/01/27,59,6,0.778499915,17619,59,2,4
17817,2014/03/31,2009/01/09,143,17,0.841914554,16291,143,7,10
17818,2014/03/31,2012/12/31,6,13,0.507742401,27011,6,9,4
17819,2014/03/31,2009/07/13,11,20,0.650471448,21084,11,9,11
17820,2014/03/31,2012/05/10,16,10,1.032934398,13277,16,2,8
17821,2014/03/31,2006/10/07,123,18,0.699914765,19593,123,12,6
17822,2014/03/31,2012/06/03,34,10,0.756466045,18127,34,1,9
17823,2014/03/31,2011/03/20,150,9,0.689607725,19884,150,5,4
17824,2014/03/31,2006/04/13,66,6,0.720161765,19040,66,1,5
17825,2014/03/31,2010/04/19,6,12,0.801827007,17099,6,4,8
17826,2014/03/31,2005/12/03,234,10,0.561092695,24435,234,8,2
17827,2014/03/31,2011/11/08,233,23,0.8639130429999999,15870,233,14,9
17828,2014/03/31,2007/09/16,216,12,0.735736825,18634,216,4,8
17829,2014/03/31,2011/09/14,190,21,0.557258759,24602,190,13,8
17830,2014/03/31,2011/12/07,35,8,1.115395004,12291,35,1,7
17831,2014/03/31,2007/06/23,12,14,0.6804621259999999,20146,12,9,5
17832,2014/03/31,2012/10/31,58,11,0.541668313,25307,58,3,8
17833,2014/03/31,2012/05/15,371,5,1.4411269969999998,9512,371,5,0
17834,2014/03/31,2010/06/11,30,9,0.7076135659999999,19372,30,3,6
17835,2014/03/31,2010/08/01,168,8,0.75469581,18163,168,1,7
17836,2014/03/31,2008/06/22,47,15,0.7276811590000001,18837,47,12,3
17837,2014/03/31,2008/01/09,187,12,0.837437683,16368,187,11,1
17838,2014/03/31,2011/01/04,92,18,0.664969435,20612,92,8,10
17839,2014/03/31,2011/04/15,146,14,0.68192367,20097,146,8,6
17840,2014/03/31,2010/07/30,12,11,0.584367218,23452,12,3,8
17841,2014/03/31,2013/01/21,2,9,0.635997308,21548,2,2,7
17842,2014/03/31,2005/02/05,69,12,0.58511891,23421,69,4,8
17843,2014/03/31,2008/01/30,66,8,0.8043232770000001,17038,66,4,4
17844,2014/03/31,2005/12/09,139,11,0.6206277170000001,22080,139,8,3
17845,2014/03/31,2012/12/03,3,23,0.6267515889999999,21863,3,5,18
17846,2014/03/31,2008/03/18,6,26,0.503846154,27196,6,14,12
17847,2014/03/31,2012/10/20,11,9,0.552419966,24802,11,0,9
17848,2014/03/31,2012/06/08,339,14,0.735466209,18629,339,8,6
17849,2014/03/31,2011/11/30,336,11,0.898910833,15241,336,8,3
17850,2014/03/31,2012/08/24,13,19,0.857797884,15971,13,9,10
17851,2014/03/31,2009/09/16,112,16,0.7085884240000001,19333,112,11,5
17852,2014/03/31,2012/01/01,41,4,1.094730281,12513,41,2,2
17853,2014/03/31,2011/01/13,136,15,0.655436489,20894,136,9,6
17854,2014/03/31,2011/12/29,77,12,0.643141408,21293,77,9,3
17855,2014/03/31,2012/11/25,6,15,0.518881479,26392,6,2,13
17856,2014/03/31,2012/11/20,23,14,0.690916292,19819,23,5,9
17857,2014/03/31,2005/05/14,13,11,1.173361611,11670,13,4,7
17858,2014/03/31,2009/06/01,84,29,0.856436703,15988,84,11,18
17859,2014/03/31,2008/09/15,564,8,0.723347773,18929,564,8,0
17860,2014/03/31,2013/03/21,8,13,0.791627544,17296,8,0,13
17861,2014/03/31,2011/12/26,113,19,0.856575951,15984,113,12,7
17862,2014/03/31,2013/01/10,30,10,0.696,19670,30,1,9
17863,2014/03/31,2009/10/01,369,24,0.638253532,21449,369,24,0
17864,2014/03/31,2011/01/01,14,14,0.542483751,25232,14,5,9
17865,2014/03/31,2011/03/31,606,11,0.863001261,15860,606,11,0
17866,2014/03/31,2010/04/12,7,14,0.751454925,18214,7,9,5
17867,2014/03/31,2011/09/27,4,13,0.7686381,17806,4,5,8
17868,2014/03/31,2009/05/29,170,18,0.5559013,24620,170,10,8
17869,2014/03/31,2011/12/02,25,18,0.6545296279999999,20909,25,6,12
17870,2014/03/31,2008/06/04,22,28,0.75887213,18034,22,13,15
17871,2014/03/31,2008/04/24,78,15,0.6294737810000001,21740,78,4,11
17872,2014/03/31,2010/05/28,381,4,0.542467491,25224,381,4,0
17873,2014/03/31,2009/08/24,279,10,0.534853602,25581,279,9,1
17874,2014/03/31,2006/09/11,25,17,0.761328808,17971,25,9,8
17875,2014/03/31,2008/03/05,13,21,0.575657479,23765,13,10,11
17876,2014/03/31,2012/05/29,286,14,0.8605636640000001,15896,286,13,1
17877,2014/03/31,2010/10/28,50,6,0.511665295,26734,50,1,5
17878,2014/03/31,2006/05/13,253,4,1.449620602,9436,253,2,2
17879,2014/03/31,2009/12/14,234,13,0.7468120770000001,18316,234,2,11
17880,2014/03/31,2007/01/08,104,12,0.7513595909999999,18204,104,10,2
17881,2014/03/31,2010/12/07,106,22,0.655144896,20877,106,12,10
17882,2014/03/31,2007/10/12,352,12,1.128947586,12115,352,10,2
17883,2014/03/31,2009/04/26,5,7,0.630573997,21690,5,3,4
17884,2014/03/31,2006/07/19,306,7,0.7428571429999999,18410,306,6,1
17885,2014/03/31,2011/03/12,18,20,0.807823262,16929,18,11,9
17886,2014/03/31,2009/10/22,9,14,0.661496227,20672,9,8,6
17887,2014/03/31,2008/09/11,62,11,0.66115764,20680,62,9,2
17888,2014/03/31,2007/06/22,389,10,0.617110549,22153,389,10,0
17889,2014/03/31,2008/10/22,30,13,0.587663471,23261,30,12,1
17890,2014/03/31,2011/05/22,13,12,0.564401272,24218,13,0,12
17891,2014/03/31,2010/12/30,77,7,0.69664186,19618,77,3,4
17892,2014/03/31,2011/08/19,31,18,0.690618051,19788,31,10,8
17893,2014/03/31,2008/07/22,26,15,0.657772911,20776,26,7,8
17894,2014/03/31,2012/09/05,3,11,1.083905457,12608,3,6,5
17895,2014/03/31,2012/06/02,20,15,0.747545405,18280,20,7,8
17896,2014/03/31,2009/09/14,127,14,0.60537238,22571,127,10,4
17897,2014/03/31,2008/10/27,10,18,0.630097307,21684,10,4,14
17898,2014/03/31,2009/02/19,36,16,0.635404865,21501,36,4,12
17899,2014/03/31,2011/10/27,108,8,0.605956975,22545,108,6,2
17900,2014/03/31,2012/04/02,4,10,0.655497649,20838,4,8,2
17901,2014/03/31,2012/03/21,175,10,0.740966692,18434,175,4,6
17902,2014/03/31,2007/06/02,223,7,0.698571429,19551,223,4,3
17903,2014/03/31,2007/08/05,156,8,0.8,17072,156,6,2
17904,2014/03/31,2011/11/01,127,14,0.483197707,28264,127,9,5
17905,2014/03/31,2006/08/05,20,13,0.8567216609999999,15941,20,4,9
17906,2014/03/31,2012/12/10,12,24,0.642059238,21270,12,6,18
17907,2014/03/31,2008/08/14,2,16,0.512874526,26627,2,7,9
17908,2014/03/31,2011/10/23,21,7,0.6959244729999999,19622,21,3,4
17909,2014/03/31,2007/12/21,43,13,0.8092065190000001,16875,43,8,5
17910,2014/03/31,2011/08/23,50,6,0.590393462,23128,50,4,2
17911,2014/03/31,2011/09/15,1,17,0.643463097,21218,1,6,11
17912,2014/03/31,2012/07/19,322,10,0.719179309,18984,322,9,1
17913,2014/03/31,2005/02/04,231,12,0.7584018440000001,18002,231,10,2
17914,2014/03/31,2010/10/22,25,13,0.768941707,17755,25,4,9
17915,2014/03/31,2005/10/14,98,15,0.71392041,19123,98,13,2
17916,2014/03/31,2013/03/19,13,12,0.594206311,22975,13,2,10
17917,2014/03/31,2011/05/25,95,17,0.615355871,22185,95,10,7
17918,2014/03/31,2010/06/22,111,16,0.760674283,17945,111,9,7
17919,2014/03/31,2011/10/16,21,15,0.643056014,21227,21,5,10
17920,2014/03/31,2005/08/27,190,13,0.58837493,23199,190,8,5
17921,2014/03/31,2009/01/13,103,15,0.788037529,17320,103,8,7
17922,2014/03/31,2008/02/16,16,17,0.605330701,22543,16,6,11
17923,2014/03/31,2010/03/09,66,13,0.789998263,17273,66,4,9
17924,2014/03/31,2011/10/24,54,12,0.628934827,21696,54,9,3
17925,2014/03/31,2007/02/28,6,10,0.618757482,22052,6,7,3
17926,2014/03/31,2012/08/10,32,16,0.7003099979999999,19484,32,6,10
17927,2014/03/31,2009/09/28,33,19,0.552664749,24689,33,8,11
17928,2014/03/31,2007/06/07,10,13,0.7394082259999999,18453,10,7,6
17929,2014/03/31,2007/08/28,238,14,0.675428713,20200,238,12,2
17930,2014/03/31,2006/06/25,21,13,0.7901737520000001,17266,21,6,7
17931,2014/03/31,2012/02/10,129,21,0.850249283,16046,129,15,6
17932,2014/03/31,2012/06/09,12,19,0.448120874,30445,12,11,8
17933,2014/03/31,2013/03/13,22,9,0.8148918890000001,16742,22,2,7
17934,2014/03/31,2005/05/19,27,16,0.726308167,18782,27,7,9
17935,2014/03/31,2009/11/01,14,20,0.798557546,17082,14,16,4
17936,2014/03/31,2011/12/12,17,12,0.7285856209999999,18722,17,2,10
17937,2014/03/31,2009/10/12,1,15,0.692155072,19707,1,4,11
17938,2014/03/31,2009/01/20,102,15,0.7287737759999999,18716,102,9,6
17939,2014/03/31,2008/04/30,135,16,0.7129309979999999,19130,135,9,7
17940,2014/03/31,2007/07/11,287,9,0.788423517,17298,287,8,1
17941,2014/03/31,2012/04/13,4,22,0.7701191479999999,17709,4,10,12
17942,2014/03/31,2007/06/18,7,20,0.502941654,27114,7,3,17
17943,2014/03/31,2012/01/16,582,11,1.104,12350,582,11,0
17944,2014/03/31,2008/03/05,339,10,0.935423671,14575,339,8,2
17945,2014/03/31,2011/08/10,681,2,0.966024942,14113,681,2,0
17946,2014/03/31,2013/01/09,84,7,1.214885047,11222,84,1,6
17947,2014/03/31,2010/04/20,69,10,0.7751265140000001,17587,69,8,2
17948,2014/03/31,2010/04/19,15,21,0.615642218,22142,15,11,10
17949,2014/03/31,2012/10/19,25,5,1.386,9835,25,1,4
17950,2014/03/31,2007/11/21,57,13,0.533076923,25571,57,5,8
17951,2014/03/31,2007/04/25,21,13,0.7171552590000001,19007,21,4,9
17952,2014/03/31,2006/05/25,21,13,0.6276897220000001,21716,21,3,10
17953,2014/03/31,2010/03/28,7,39,0.5741125429999999,23742,7,3,36
17954,2014/03/31,2005/04/22,29,12,0.618277239,22046,29,6,6
17955,2014/03/31,2012/04/23,44,15,0.672243046,20276,44,8,7
17956,2014/03/31,2005/02/01,35,18,0.801271605,17010,35,4,14
17957,2014/03/31,2012/07/13,139,14,0.725127155,18796,139,8,6
17958,2014/03/31,2009/04/20,7,8,0.822746152,16565,7,4,4
17959,2014/03/31,2010/08/10,80,10,0.5899294429999999,23102,80,7,3
17960,2014/03/31,2010/12/27,104,15,0.761091813,17906,104,6,9
17961,2014/03/31,2010/03/03,12,17,0.694353187,19627,12,7,10
17962,2014/03/31,2011/08/25,523,9,0.566666667,24048,523,9,0
17963,2014/03/31,2010/08/15,8,23,0.73238364,18606,8,13,10
17964,2014/03/31,2012/01/01,282,12,0.66986432,20342,282,11,1
17965,2014/03/31,2013/03/17,50,11,0.72842457,18706,50,1,10
17966,2014/03/31,2008/10/15,100,15,0.800333627,17025,100,10,5
17967,2014/03/31,2011/08/30,426,12,0.5708333329999999,23868,426,12,0
17968,2014/03/31,2006/02/23,85,11,0.639993424,21288,85,5,6
17969,2014/03/31,2012/10/05,91,13,0.5771986610000001,23603,91,5,8
17970,2014/03/31,2008/03/13,152,8,0.8939943570000001,15239,152,5,3
17971,2014/03/31,2012/07/01,19,17,0.574768796,23702,19,9,8
17972,2014/03/31,2008/07/18,13,21,0.524574685,25969,13,7,14
17973,2014/03/31,2008/05/16,117,8,1.210149267,11255,117,1,7
17974,2014/03/31,2010/05/14,30,18,0.709041545,19208,30,7,11
17975,2014/03/31,2008/12/23,82,18,0.936735452,14538,82,16,2
17976,2014/03/31,2005/10/27,17,15,0.542116724,25119,17,4,11
17977,2014/03/31,2007/11/01,1,20,0.950539578,14326,1,6,14
17978,2014/03/31,2011/12/06,543,7,0.638127372,21339,543,7,0
17979,2014/03/31,2012/03/07,348,11,0.7863636359999999,17314,348,9,2
17980,2014/03/31,2008/06/03,208,13,0.872626114,15601,208,8,5
17981,2014/03/31,2012/04/26,42,17,0.56168097,24236,42,10,7
17982,2014/03/31,2007/08/02,1,14,0.7515548559999999,18111,1,8,6
17983,2014/03/31,2007/12/16,19,8,1.112402746,12236,19,5,3
17984,2014/03/31,2004/11/06,62,22,0.556054825,24478,62,18,4
17985,2014/03/31,2007/08/09,430,10,0.611235627,22264,430,10,0
17986,2014/03/31,2005/05/04,61,13,0.826211523,16471,61,3,10
17987,2014/03/31,2013/03/16,2,5,0.7058597440000001,19279,2,1,4
17988,2014/03/31,2011/03/01,13,18,0.817851433,16639,13,3,15
17989,2014/03/31,2009/07/16,22,13,0.7994266240000001,17022,22,3,10
17990,2014/03/31,2010/08/14,35,8,0.7396314820000001,18398,35,4,4
17991,2014/03/31,2006/06/13,63,12,0.800954735,16989,63,5,7
17992,2014/03/31,2008/07/04,10,14,1.123492693,12111,10,11,3
17993,2014/03/31,2012/09/22,36,11,0.705942721,19274,36,6,5
17994,2014/03/31,2012/11/17,32,16,0.881675199,15431,32,10,6
17995,2014/03/31,2008/01/24,295,17,0.8285200970000001,16420,295,16,1
17996,2014/03/31,2008/12/01,210,10,0.6961849440000001,19541,210,6,4
17997,2014/03/31,2008/12/17,19,15,0.547758405,24835,19,6,9
17998,2014/03/31,2010/01/08,165,18,0.624265455,21789,165,15,3
17999,2014/03/31,2012/07/02,12,20,0.8654651309999999,15716,12,7,13
18000,2014/03/31,2005/05/29,6,9,0.769970563,17665,6,5,4
18001,2014/03/31,2008/12/07,30,15,0.724001384,18786,30,5,10
18002,2014/03/31,2012/10/04,37,16,0.593649498,22910,37,7,9
18003,2014/03/31,2009/04/02,118,13,0.743900558,18282,118,8,5
18004,2014/03/31,2006/08/04,22,19,0.6218918920000001,21867,22,11,8
18005,2014/03/31,2011/12/21,221,14,0.663781184,20483,221,10,4
18006,2014/03/31,2011/02/23,171,14,0.941698414,14437,171,12,2
18007,2014/03/31,2011/09/26,361,4,0.736547838,18458,361,2,2
18008,2014/03/31,2009/10/16,143,22,0.666696258,20389,143,13,9
18009,2014/03/31,2007/07/21,11,21,0.647510004,20992,11,16,5
18010,2014/03/31,2012/09/30,157,19,0.7642633000000001,17782,157,6,13
18011,2014/03/31,2012/09/21,68,8,0.641099632,21198,68,7,1
18012,2014/03/31,2008/11/06,72,10,0.805517752,16871,72,6,4
18013,2014/03/31,2007/10/31,18,24,0.823371304,16504,18,12,12
18014,2014/03/31,2009/05/20,27,10,0.6952586340000001,19545,27,5,5
18015,2014/03/31,2011/08/21,13,13,0.664445748,20451,13,9,4
18016,2014/03/31,2009/12/07,61,13,0.800094229,16980,61,4,9
18017,2014/03/31,2007/04/03,36,17,0.648140955,20957,36,11,6
18018,2014/03/31,2007/08/05,27,11,0.6765784890000001,20073,27,8,3
18019,2014/03/31,2008/08/16,187,6,1.200781609,11310,187,1,5
18020,2014/03/31,2012/04/23,125,7,0.689413168,19699,125,3,4
18021,2014/03/31,2010/01/06,85,16,0.5948966179999999,22828,85,10,6
18022,2014/03/31,2012/07/26,120,14,0.657069725,20667,120,4,10
18023,2014/03/31,2012/08/23,45,10,0.759040246,17890,45,2,8
18024,2014/03/31,2011/07/13,8,11,0.687068407,19764,8,4,7
18025,2014/03/31,2013/01/30,15,23,0.896433193,15148,15,3,20
18026,2014/03/31,2012/11/24,111,9,1.172994126,11576,111,1,8
18027,2014/03/31,2012/06/13,8,18,0.5952395770000001,22811,8,6,12
18028,2014/03/31,2007/01/14,77,15,0.8643780240000001,15708,77,9,6
18029,2014/03/31,2011/11/03,31,14,0.627274197,21645,31,9,5
18030,2014/03/31,2010/07/18,1,18,0.731839892,18550,1,10,8
18031,2014/03/31,2006/02/02,11,17,0.643197801,21102,11,8,9
18032,2014/03/31,2012/08/22,78,20,0.782552468,17344,78,1,19
18033,2014/03/31,2013/01/30,1,14,0.672493806,20182,1,3,11
18034,2014/03/31,2013/01/16,4,14,0.633742062,21416,4,3,11
18035,2014/03/31,2012/01/15,483,3,0.79440281,17080,483,3,0
18036,2014/03/31,2012/08/12,80,5,0.830305979,16341,80,2,3
18037,2014/03/31,2007/08/27,33,14,0.69525237,19515,33,5,9
18038,2014/03/31,2012/01/19,65,16,0.871234187,15573,65,9,7
18039,2014/03/31,2006/06/28,25,12,0.708990907,19136,25,5,7
18040,2014/03/31,2012/12/01,16,14,0.5814116739999999,23334,16,7,7
18041,2014/03/31,2012/08/17,77,13,0.81173039,16713,77,7,6
18042,2014/03/31,2012/06/30,542,5,0.84,16150,542,5,0
18043,2014/03/31,2012/03/03,128,19,0.594336911,22825,128,4,15
18044,2014/03/31,2007/10/26,195,14,0.751635265,18046,195,11,3
18045,2014/03/31,2012/12/07,437,7,0.5928702570000001,22876,437,7,0
18046,2014/03/31,2006/06/04,123,17,0.804460526,16859,123,14,3
18047,2014/03/31,2012/10/08,357,7,0.693966223,19540,357,5,2
18048,2014/03/31,2007/04/20,167,12,0.80104691,16926,167,8,4
18049,2014/03/31,2013/01/19,2,13,0.890743052,15221,2,0,13
18050,2014/03/31,2013/03/14,11,15,0.7357508,18427,11,0,15
18051,2014/03/31,2009/12/19,235,14,0.739510173,18333,235,7,7
18052,2014/03/31,2010/05/26,34,17,0.8698139359999999,15586,34,9,8
18053,2014/03/31,2010/07/01,19,17,0.892045275,15196,19,4,13
18054,2014/03/31,2012/08/08,47,13,0.7563667820000001,17918,47,7,6
18055,2014/03/31,2012/06/05,20,18,0.816103818,16606,20,9,9
18056,2014/03/31,2012/02/22,4,25,0.464976668,29144,4,7,18
18057,2014/03/31,2011/02/05,330,9,0.705555556,19206,330,7,2
18058,2014/03/31,2012/09/10,187,8,0.929827066,14572,187,3,5
18059,2014/03/31,2013/01/04,14,14,0.7918075040000001,17112,14,1,13
18060,2014/03/31,2011/08/02,370,7,0.936916534,14461,370,7,0
18061,2014/03/31,2010/04/12,40,17,0.537968868,25183,40,8,9
18062,2014/03/31,2010/09/29,213,9,0.70777859,19141,213,6,3
18063,2014/03/31,2011/12/18,249,19,0.76475048,17714,249,13,6
18064,2014/03/31,2011/02/24,115,12,0.8396194370000001,16134,115,5,7
18065,2014/03/31,2007/11/24,113,10,0.699455259,19367,113,8,2
18066,2014/03/31,2011/01/14,104,13,0.69630256,19454,104,7,6
18067,2014/03/31,2007/09/06,12,19,0.560240301,24178,12,8,11
18068,2014/03/31,2007/02/01,63,7,1.287318,10522,63,3,4
18069,2014/03/31,2005/06/07,6,15,0.827238747,16373,6,7,8
18070,2014/03/31,2010/06/24,196,17,0.701888895,19297,196,9,8
18071,2014/03/31,2012/04/21,11,21,0.5976604010000001,22662,11,11,10
18072,2014/03/31,2007/09/26,348,4,0.7601852370000001,17815,348,3,1
18073,2014/03/31,2012/09/06,5,14,0.646852489,20934,5,3,11
18074,2014/03/31,2010/01/17,45,10,0.759940506,17817,45,4,6
18075,2014/03/31,2008/01/08,40,11,1.075291875,12591,40,2,9
18076,2014/03/31,2012/07/12,6,17,0.739338685,18312,6,8,9
18077,2014/03/31,2006/04/13,124,6,0.6183333329999999,21894,124,0,6
18078,2014/03/31,2008/10/12,40,17,0.57307396,23621,40,7,10
18079,2014/03/31,2008/11/26,6,5,1.188727385,11386,6,0,5
18080,2014/03/31,2011/04/11,270,12,0.956252649,14154,270,11,1
18081,2014/03/31,2008/07/05,62,10,0.7365866670000001,18375,62,8,2
18082,2014/03/31,2007/06/06,22,14,0.587432614,23039,22,10,4
18083,2014/03/31,2012/12/10,76,5,0.838,16150,76,1,4
18084,2014/03/31,2011/08/07,13,18,0.695622205,19455,13,13,5
18085,2014/03/31,2010/10/31,2,25,0.762741517,17742,2,13,12
18086,2014/03/31,2009/10/17,134,15,0.588467125,22996,134,11,4
18087,2014/03/31,2011/11/24,8,14,0.458989587,29483,8,6,8
18088,2014/03/31,2009/08/01,142,8,1.109192623,12200,142,3,5
18089,2014/03/31,2006/02/12,43,25,0.911528461,14845,43,15,10
18090,2014/03/31,2010/12/22,68,15,0.665091678,20343,68,7,8
18091,2014/03/31,2012/06/26,142,10,0.8145854659999999,16609,142,6,4
18092,2014/03/31,2008/06/07,17,14,0.626036557,21610,17,8,6
18093,2014/03/31,2009/03/29,19,18,0.708118817,19105,19,11,7
18094,2014/03/31,2005/05/30,30,14,0.8768814420000001,15427,30,5,9
18095,2014/03/31,2012/10/08,94,18,0.580432544,23304,94,7,11
18096,2014/03/31,2008/02/07,94,24,0.61765767,21897,94,16,8
18097,2014/03/31,2008/08/13,41,7,0.910874192,14848,41,1,6
18098,2014/03/31,2008/09/14,10,8,1.003824228,13472,10,1,7
18099,2014/03/31,2012/08/30,104,15,0.587564303,23016,104,7,8
18100,2014/03/31,2012/03/17,33,17,0.935719624,14452,33,7,10
18101,2014/03/31,2007/04/17,159,9,0.7075497070000001,19112,159,6,3
18102,2014/03/31,2004/11/27,42,16,0.75387622,17935,42,7,9
18103,2014/03/31,2007/01/09,36,10,0.7376136179999999,18329,36,3,7
18104,2014/03/31,2007/04/25,23,16,0.743685571,18179,23,1,15
18105,2014/03/31,2007/12/20,25,16,0.748952967,18051,25,8,8
18106,2014/03/31,2011/01/30,297,8,0.809266687,16705,297,1,7
18107,2014/03/31,2007/07/03,14,12,0.64411703,20986,14,6,6
18108,2014/03/31,2012/12/31,6,15,0.722052035,18718,6,2,13
18109,2014/03/31,2007/03/02,12,13,0.834280775,16198,12,6,7
18110,2014/03/31,2008/02/20,98,15,0.749609475,18027,98,11,4
18111,2014/03/31,2011/05/11,24,13,0.797100047,16952,24,6,7
18112,2014/03/31,2004/11/22,70,10,0.916839248,14737,70,3,7
18113,2014/03/31,2012/05/16,12,19,0.4578947370000001,29507,12,6,13
18114,2014/03/31,2012/11/20,17,15,0.8199465920000001,16477,17,4,11
18115,2014/03/31,2009/12/07,162,4,0.8362366920000001,16156,162,1,3
18116,2014/03/31,2009/02/17,170,14,0.747304458,18078,170,9,5
18117,2014/03/31,2005/07/27,34,15,0.6211508579999999,21749,34,7,8
18118,2014/03/31,2012/09/09,89,24,0.7036130209999999,19200,89,11,13
18119,2014/03/31,2011/05/02,33,11,0.86227293,15667,33,4,7
18120,2014/03/31,2012/01/14,103,12,0.704243562,19182,103,3,9
18121,2014/03/31,2011/10/04,6,15,0.7966849490000001,16956,6,8,7
18122,2014/03/31,2007/10/14,272,12,0.843505683,16014,272,10,2
18123,2014/03/31,2006/07/16,33,10,0.645040829,20941,33,6,4
18124,2014/03/31,2005/10/31,79,19,0.745355113,18121,79,8,11
18125,2014/03/31,2007/03/21,186,11,0.542735675,24886,186,8,3
18126,2014/03/31,2010/04/17,31,22,0.586688097,23020,31,17,5
18127,2014/03/31,2007/10/13,309,13,1.0,13505,309,8,5
18128,2014/03/31,2006/04/25,38,7,0.64689632,20872,38,4,3
18129,2014/03/31,2008/01/02,35,10,0.644483055,20950,35,4,6
18130,2014/03/31,2010/03/12,9,15,0.8159726840000001,16547,9,5,10
18131,2014/03/31,2008/03/13,119,8,0.692650695,19493,119,2,6
18132,2014/03/31,2009/04/03,118,12,0.894127815,15100,118,5,7
18133,2014/03/31,2010/08/24,155,10,0.660995349,20425,155,2,8
18134,2014/03/31,2005/12/06,432,11,0.7907168790000001,17074,432,11,0
18135,2014/03/31,2012/01/23,19,14,0.6591333429999999,20481,19,10,4
18136,2014/03/31,2010/12/16,50,2,0.89,15168,50,1,1
18137,2014/03/31,2010/09/30,71,20,0.626837242,21535,71,7,13
18138,2014/03/31,2012/11/17,379,11,0.762161933,17711,379,11,0
18139,2014/03/31,2008/04/20,2,15,0.844033267,15992,2,11,4
18140,2014/03/31,2005/05/30,12,11,0.6533719020000001,20656,12,6,5
18141,2014/03/31,2009/07/07,378,16,0.727037875,18561,378,16,0
18142,2014/03/31,2005/01/25,2,12,0.8012410190000001,16841,2,7,5
18143,2014/03/31,2012/02/27,189,12,0.595982068,22641,189,1,11
18144,2014/03/31,2005/02/04,20,17,0.6714889279999999,20095,20,10,7
18145,2014/03/31,2006/12/14,25,15,0.659841992,20442,25,8,7
18146,2014/03/31,2012/03/28,245,9,0.640333745,21064,245,5,4
18147,2014/03/31,2007/06/21,279,9,0.6675146,20206,279,7,2
18148,2014/03/31,2010/06/19,26,21,0.843217255,15995,26,8,13
18149,2014/03/31,2011/02/20,77,21,0.715534511,18849,77,17,4
18150,2014/03/31,2011/11/15,52,16,0.6475121229999999,20829,52,7,9
18151,2014/03/31,2012/10/13,81,7,0.551428571,24458,81,3,4
18152,2014/03/31,2010/06/05,16,20,0.848878958,15887,16,12,8
18153,2014/03/31,2011/07/28,21,13,0.7685990309999999,17545,21,6,7
18154,2014/03/31,2010/10/01,466,11,0.692748523,19465,466,11,0
18155,2014/03/31,2012/11/25,57,6,0.715289655,18850,57,2,4
18156,2014/03/31,2004/12/26,16,14,0.76478473,17629,16,10,4
18157,2014/03/31,2009/11/10,84,14,0.5038446879999999,26759,84,7,7
18158,2014/03/31,2011/10/31,51,11,0.8810776370000001,15302,51,3,8
18159,2014/03/31,2012/01/21,187,7,0.880302338,15314,187,6,1
18160,2014/03/31,2011/09/22,6,10,0.6281621620000001,21460,6,3,7
18161,2014/03/31,2008/08/29,87,4,0.713170035,18902,87,2,2
18162,2014/03/31,2012/05/15,77,10,0.661222348,20387,77,4,6
18163,2014/03/31,2010/02/07,9,17,0.63517412,21221,9,0,17
18164,2014/03/31,2006/01/06,382,11,0.6663609389999999,20225,382,11,0
18165,2014/03/31,2006/09/26,5,23,0.776164747,17360,5,8,15
18166,2014/03/31,2010/11/29,1,19,0.730570948,18443,1,7,12
18167,2014/03/31,2007/11/29,45,7,0.771468652,17465,45,2,5
18168,2014/03/31,2010/07/18,58,13,0.853035907,15791,58,7,6
18169,2014/03/31,2010/05/13,30,8,0.6849092390000001,19667,30,7,1
18170,2014/03/31,2008/01/09,25,22,0.714144001,18861,25,14,8
18171,2014/03/31,2006/11/07,11,14,0.73377118,18355,11,5,9
18172,2014/03/31,2006/06/16,1,15,0.631411627,21330,1,9,6
18173,2014/03/31,2009/03/13,3,17,0.592206781,22739,3,3,14
18174,2014/03/31,2007/07/24,5,30,0.512838373,26258,5,9,21
18175,2014/03/31,2005/06/29,154,15,0.687438097,19587,154,12,3
18176,2014/03/31,2005/03/04,26,18,0.617031758,21821,26,14,4
18177,2014/03/31,2012/11/30,47,11,0.781609195,17226,47,4,7
18178,2014/03/31,2012/07/28,406,14,0.720995555,18673,406,14,0
18179,2014/03/31,2007/10/25,86,2,0.885,15212,86,1,1
18180,2014/03/31,2008/12/28,2,12,0.6837296829999999,19688,2,6,6
18181,2014/03/31,2013/01/21,29,8,1.005917651,13382,29,4,4
18182,2014/03/31,2009/12/13,84,13,0.8046425159999999,16728,84,5,8
18183,2014/03/31,2005/05/24,29,18,0.8876233179999999,15164,29,7,11
18184,2014/03/31,2012/03/14,33,15,0.830410908,16208,33,10,5
18185,2014/03/31,2006/04/29,44,9,0.738411061,18226,44,2,7
18186,2014/03/31,2011/08/04,110,9,0.711299683,18920,110,3,6
18187,2014/03/31,2012/06/15,243,9,0.90094999,14937,243,8,1
18188,2014/03/31,2006/11/01,568,10,0.856257954,15716,568,10,0
18189,2014/03/31,2011/03/30,721,2,0.55,24464,721,2,0
18190,2014/03/31,2011/06/06,479,2,0.55,24464,479,2,0
18191,2014/03/31,2012/05/16,664,2,0.55,24464,664,2,0
18192,2014/03/31,2012/11/11,398,2,0.55,24464,398,2,0
18193,2014/03/31,2011/03/04,422,2,0.55,24464,422,2,0
18194,2014/03/31,2012/09/03,556,2,0.55,24464,556,2,0
18195,2014/03/31,2011/03/04,422,2,0.55,24464,422,2,0
18196,2014/03/31,2012/05/13,661,2,0.55,24464,661,2,0
18197,2014/03/31,2012/04/19,655,2,0.55,24464,655,2,0
18198,2014/03/31,2006/06/15,111,13,0.556434391,24181,111,3,10
18199,2014/03/31,2012/06/20,4,23,0.61214159,21979,4,0,23
18200,2014/03/31,2012/04/30,88,12,1.042040121,12911,88,8,4
18201,2014/03/31,2007/07/11,75,21,0.861579891,15615,75,13,8
18202,2014/03/31,2006/07/27,13,20,0.738918548,18207,13,3,17
18203,2014/03/31,2010/06/01,128,25,0.824067267,16323,128,13,12
18204,2014/03/31,2005/08/06,104,8,1.486276243,9050,104,6,2
18205,2014/03/31,2009/10/17,236,14,0.7627263959999999,17635,236,12,2
18206,2014/03/31,2010/07/30,2,10,0.59734867,22517,2,5,5
18207,2014/03/31,2007/08/09,203,18,0.6969711890000001,19298,203,15,3
18208,2014/03/31,2009/08/17,124,9,0.990651101,13577,124,5,4
18209,2014/03/31,2010/09/09,259,20,0.87687443,15338,259,18,2
18210,2014/03/31,2010/11/21,189,10,1.037529121,12963,189,7,3
18211,2014/03/31,2007/05/05,107,15,0.7469502920000001,18005,107,8,7
18212,2014/03/31,2006/11/20,19,7,1.4131375430000002,9517,19,4,3
18213,2014/03/31,2010/07/16,12,17,0.976358356,13774,12,4,13
18214,2014/03/31,2011/02/25,126,9,0.815086975,16499,126,6,3
18215,2014/03/31,2009/01/05,10,18,0.7586094659999999,17727,10,4,14
18216,2014/03/31,2011/06/24,2,11,0.616215003,21823,2,4,7
18217,2014/03/31,2012/01/24,27,17,0.828342061,16231,27,7,10
18218,2014/03/31,2007/11/19,2,17,0.7252988779999999,18536,2,8,9
18219,2014/03/31,2010/05/03,1,20,0.667260138,20147,1,3,17
18220,2014/03/31,2009/02/12,17,12,0.70341845,19111,17,8,4
18221,2014/03/31,2010/07/27,7,17,0.692153228,19422,7,10,7
18222,2014/03/31,2008/10/16,492,7,0.736984649,18240,492,7,0
18223,2014/03/31,2010/08/03,331,15,0.716887099,18751,331,14,1
18224,2014/03/31,2012/02/09,150,13,0.693295167,19389,150,8,5
18225,2014/03/31,2010/12/17,71,17,0.8168878759999999,16455,71,6,11
18226,2014/03/31,2012/10/31,4,20,0.7384606090000001,18202,4,6,14
18227,2014/03/31,2009/12/15,24,11,0.605169511,22211,24,3,8
18228,2014/03/31,2011/05/26,353,18,0.762108755,17636,353,17,1
18229,2014/03/31,2008/02/24,159,8,0.975632985,13776,159,6,2
18230,2014/03/31,2012/02/23,69,15,0.6904680440000001,19464,69,6,9
18231,2014/03/31,2010/03/31,33,41,0.798333135,16834,33,26,15
18232,2014/03/31,2010/10/29,97,13,0.928030387,14480,97,9,4
18233,2014/03/31,2011/04/29,23,14,0.747444655,17978,23,9,5
18234,2014/03/31,2010/10/28,11,16,0.628560135,21377,11,3,13
18235,2014/03/31,2012/09/26,15,22,0.7878332259999999,17053,15,7,15
18236,2014/03/31,2011/08/17,83,15,0.593896822,22621,83,9,6
18237,2014/03/31,2008/10/15,225,10,0.7925315629999999,16950,225,9,1
18238,2014/03/31,2007/06/02,161,11,0.8079903759999999,16625,161,6,5
18239,2014/03/31,2008/01/24,107,7,0.6759922490000001,19869,107,0,7
18240,2014/03/31,2010/12/03,67,21,0.733898148,18301,67,8,13
18241,2014/03/31,2011/11/30,313,12,0.566357426,23714,313,10,2
18242,2014/03/31,2010/05/10,83,15,0.703581308,19088,83,9,6
18243,2014/03/31,2009/11/11,138,13,0.761474257,17636,138,9,4
18244,2014/03/31,2012/11/24,5,9,1.318657698,10184,5,2,7
18245,2014/03/31,2008/05/23,11,23,0.5717874479999999,23486,11,5,18
18246,2014/03/31,2009/10/27,98,16,0.779896039,17218,98,5,11
18247,2014/03/31,2009/12/31,194,14,0.6624333929999999,20268,194,11,3
18248,2014/03/31,2011/11/09,18,15,0.630658556,21289,18,3,12
18249,2014/03/31,2011/11/21,121,21,0.8649664990000001,15522,121,12,9
18250,2014/03/31,2007/12/12,23,22,0.697402847,19248,23,10,12
18251,2014/03/31,2011/05/23,106,13,0.555830642,24150,106,8,5
18252,2014/03/31,2005/06/25,110,4,1.302209934,10308,110,1,3
18253,2014/03/31,2012/06/12,70,12,0.669257043,20055,70,2,10
18254,2014/03/31,2010/06/18,13,12,0.793092832,16923,13,2,10
18255,2014/03/31,2005/01/21,31,11,0.716812841,18722,31,5,6
18256,2014/03/31,2012/02/27,126,7,0.7771179570000001,17269,126,2,5
18257,2014/03/31,2012/11/07,68,11,0.6738415190000001,19914,68,4,7
18258,2014/03/31,2009/03/23,417,18,0.598919884,22405,417,18,0
18259,2014/03/31,2009/07/13,40,17,0.7445979690000001,18021,40,8,9
18260,2014/03/31,2012/09/21,159,12,0.701464792,19129,159,10,2
18261,2014/03/31,2011/06/07,432,5,1.247953869,10752,432,5,0
18262,2014/03/31,2006/09/18,43,12,0.583476994,22994,43,9,3
18263,2014/03/31,2008/04/11,67,15,0.7905533290000001,16970,67,4,11
18264,2014/03/31,2009/08/09,4,17,0.909200271,14755,4,8,9
18265,2014/03/31,2006/02/02,142,17,0.7640146940000001,17558,142,7,10
18266,2014/03/31,2010/12/07,34,17,0.84165715,15937,34,5,12
18267,2014/03/31,2009/09/03,118,10,0.768662464,17450,118,8,2
18268,2014/03/31,2010/03/03,11,13,0.7022099479999999,19100,11,6,7
18269,2014/03/31,2011/12/15,77,17,0.951583055,14093,77,9,8
18270,2014/03/31,2008/08/07,225,13,0.7840983509999999,17102,225,10,3
18271,2014/03/31,2012/04/24,538,6,0.797428045,16816,538,6,0
18272,2014/03/31,2012/06/25,101,16,0.734314273,18258,101,5,11
18273,2014/03/31,2012/05/17,130,19,0.6917098340000001,19382,130,9,10
18274,2014/03/31,2007/10/07,218,10,1.0393604159999998,12899,218,2,8
18275,2014/03/31,2007/03/29,47,7,0.752488213,17816,47,2,5
18276,2014/03/31,2012/04/01,129,11,0.8397844879999999,15962,129,2,9
18277,2014/03/31,2012/12/20,284,5,0.83,16150,284,4,1
18278,2014/03/31,2012/07/20,213,5,0.83,16150,213,3,2
18279,2014/03/31,2008/03/29,25,12,0.661146789,20274,25,3,9
18280,2014/03/31,2010/08/29,160,7,1.080056406,12410,160,5,2
18281,2014/03/31,2008/10/12,61,14,0.496719294,26982,61,7,7
18282,2014/03/31,2010/01/16,122,22,0.548943639,24414,122,13,9
18283,2014/03/31,2006/12/09,167,13,0.648155654,20674,167,4,9
18284,2014/03/31,2012/09/22,77,14,0.794516722,16864,77,8,6
18285,2014/03/31,2012/12/02,13,22,0.75174662,17823,13,2,20
18286,2014/03/31,2010/07/10,7,13,0.83037868,16135,7,4,9
18287,2014/03/31,2009/02/23,209,12,0.711895425,18819,209,4,8
18288,2014/03/31,2009/12/03,340,23,0.760461486,17617,340,22,1
18289,2014/03/31,2007/02/13,80,23,0.8470118870000001,15816,80,14,9
18290,2014/03/31,2006/04/17,10,14,0.530501742,25252,10,5,9
18291,2014/03/31,2012/06/22,11,19,0.758947368,17651,11,12,7
18292,2014/03/31,2005/05/19,9,13,0.646970443,20706,9,8,5
18293,2014/03/31,2013/01/07,146,17,0.7284702809999999,18389,146,7,10
18294,2014/03/31,2011/10/24,90,3,0.8286304590000001,16166,90,0,3
18295,2014/03/31,2008/05/26,249,9,0.717643844,18666,249,7,2
18296,2014/03/31,2005/04/01,265,7,0.972857143,13769,265,6,1
18297,2014/03/31,2008/01/16,102,18,0.708276136,18911,102,4,14
18298,2014/03/31,2010/09/28,25,12,0.720337206,18594,25,5,7
18299,2014/03/31,2009/07/15,45,20,0.623237785,21490,45,9,11
18300,2014/03/31,2008/07/28,61,9,0.771394425,17362,61,3,6
18301,2014/03/31,2010/02/01,11,5,0.627297981,21347,11,0,5
18302,2014/03/31,2010/01/12,9,19,0.7412976090000001,18064,9,0,19
18303,2014/03/31,2012/11/09,500,4,0.8349803579999999,16037,500,4,0
18304,2014/03/31,2008/10/13,259,8,0.519508826,25775,259,5,3
18305,2014/03/31,2011/10/07,46,9,0.886648126,15102,46,5,4
18306,2014/03/31,2006/11/07,205,16,0.68063037,19671,205,11,5
18307,2014/03/31,2013/01/31,110,10,0.794180804,16858,110,3,7
18308,2014/03/31,2012/01/01,1,18,0.752934593,17781,1,5,13
18309,2014/03/31,2006/06/08,11,22,0.725699805,18448,11,10,12
18310,2014/03/31,2007/07/19,177,5,1.264878118,10584,177,4,1
18311,2014/03/31,2004/11/27,16,16,0.63930468,20940,16,10,6
18312,2014/03/31,2007/09/23,30,11,0.948869984,14106,30,8,3
18313,2014/03/31,2009/02/03,27,28,0.7226775009999999,18521,27,12,16
18314,2014/03/31,2008/01/23,19,13,0.613620026,21812,19,1,12
18315,2014/03/31,2007/10/10,67,16,0.7788518390000001,17184,67,7,9
18316,2014/03/31,2012/12/27,23,11,0.686483381,19496,23,3,8
18317,2014/03/31,2009/10/26,103,21,0.620935789,21554,103,11,10
18318,2014/03/31,2012/12/22,83,11,0.646923672,20687,83,5,6
18319,2014/03/31,2008/10/20,37,16,0.598743177,22350,37,9,7
18320,2014/03/31,2009/10/09,112,15,0.667996605,20031,112,8,7
18321,2014/03/31,2005/09/09,39,9,0.756768282,17681,39,4,5
18322,2014/03/31,2006/06/05,77,14,0.554444306,24132,77,5,9
18323,2014/03/31,2007/03/09,39,12,0.573168673,23341,39,6,6
18324,2014/03/31,2011/06/09,16,15,0.484737853,27599,16,6,9
18325,2014/03/31,2012/12/20,59,8,0.728896698,18354,59,3,5
18326,2014/03/31,2007/09/05,37,13,0.7474430040000001,17896,37,9,4
18327,2014/03/31,2012/08/26,159,21,0.575532464,23241,159,7,14
18328,2014/03/31,2006/07/11,6,25,0.6999680779999999,19109,6,14,11
18329,2014/03/31,2005/01/25,203,12,0.500741295,26710,203,8,4
18330,2014/03/31,2011/06/15,281,10,0.854284893,15655,281,8,2
18331,2014/03/31,2011/08/16,238,10,0.653630987,20460,238,8,2
18332,2014/03/31,2008/05/21,23,10,0.631410293,21180,23,0,10
18333,2014/03/31,2011/06/12,229,12,0.466685978,28654,229,6,6
18334,2014/03/31,2008/03/17,49,16,0.645878176,20702,49,2,14
18335,2014/03/31,2012/02/23,58,14,0.8594183059999999,15558,58,6,8
18336,2014/03/31,2007/05/18,449,5,1.457127289,9176,449,5,0
18337,2014/03/31,2012/10/12,43,18,0.554533803,24110,43,5,13
18338,2014/03/31,2011/11/06,41,11,0.623748309,21431,41,4,7
18339,2014/03/31,2011/01/19,4,9,1.304522299,10247,4,4,5
18340,2014/03/31,2011/05/25,148,13,0.926488285,14426,148,5,8
18341,2014/03/31,2010/06/14,229,12,0.8335131929999999,16031,229,10,2
18342,2014/03/31,2012/04/12,1,12,0.833308177,16033,1,9,3
18343,2014/03/31,2012/07/11,4,11,0.761034463,17555,4,7,4
18344,2014/03/31,2012/03/03,4,12,1.3640933219999998,9794,4,3,9
18345,2014/03/31,2012/12/21,66,13,0.646368475,20669,66,1,12
18346,2014/03/31,2012/06/17,73,16,0.719402262,18570,73,7,9
18347,2014/03/31,2010/11/17,59,7,0.709413733,18831,59,3,4
18348,2014/03/31,2010/06/25,112,20,0.746884714,17886,112,10,10
18349,2014/03/31,2007/06/16,125,11,0.744748843,17937,125,10,1
18350,2014/03/31,2006/11/07,101,15,0.7711268259999999,17323,101,8,7
18351,2014/03/31,2012/05/11,59,13,0.7932486040000001,16838,59,4,9
18352,2014/03/31,2012/07/31,3,14,0.6135611910000001,21768,3,0,14
18353,2014/03/31,2010/07/13,68,15,0.535795724,24927,68,6,9
18354,2014/03/31,2008/08/12,91,12,0.701071972,19049,91,1,11
18355,2014/03/31,2009/02/14,206,13,0.642245948,20793,206,9,4
18356,2014/03/31,2005/10/25,12,15,0.607936811,21966,12,7,8
18357,2014/03/31,2008/05/13,17,17,0.751698379,17764,17,7,10
18358,2014/03/31,2010/11/28,72,17,0.7642951179999999,17471,72,9,8
18359,2014/03/31,2009/11/12,126,17,0.837836345,15936,126,11,6
18360,2014/03/31,2010/08/03,499,16,0.6446569120000001,20709,499,16,0
18361,2014/03/31,2011/11/10,64,13,0.678799837,19664,64,8,5
18362,2014/03/31,2008/08/19,25,2,0.88,15168,25,1,1
18363,2014/03/31,2007/11/03,21,21,0.684309664,19505,21,15,6
18364,2014/03/31,2012/08/10,27,21,1.113279947,11988,27,14,7
18365,2014/03/31,2012/05/03,153,3,0.9723124,13726,153,2,1
18366,2014/03/31,2008/12/24,12,13,0.662345642,20148,12,10,3
18367,2014/03/31,2011/08/01,5,13,0.7411546790000001,18005,5,2,11
18368,2014/03/31,2012/03/19,123,13,1.055514595,12641,123,5,8
18369,2014/03/31,2006/09/28,309,13,0.7626786329999999,17494,309,9,4
18370,2014/03/31,2012/04/02,15,14,0.8442175540000001,15803,15,9,5
18371,2014/03/31,2010/03/25,674,4,0.495254288,26938,674,4,0
18372,2014/03/31,2007/07/22,8,15,0.5512561460000001,24201,8,7,8
18373,2014/03/31,2011/02/03,214,14,0.64386843,20719,214,6,8
18374,2014/03/31,2007/02/23,34,30,0.5181547670000001,25742,34,23,7
18375,2014/03/31,2006/08/20,318,23,0.800600312,16658,318,21,2
18376,2014/03/31,2012/02/21,71,17,0.646315917,20632,71,8,9
18377,2014/03/31,2005/10/29,81,19,0.5702082620000001,23384,81,8,11
18378,2014/03/31,2013/03/07,3,20,0.592492557,22503,3,8,12
18379,2014/03/31,2011/01/14,49,16,0.839068597,15890,49,9,7
18380,2014/03/31,2008/11/04,19,10,0.721337986,18483,19,3,7
18381,2014/03/31,2012/11/14,43,11,0.625552949,21313,43,1,10
18382,2014/03/31,2012/06/21,1,8,0.93284075,14292,1,4,4
18383,2014/03/31,2012/11/22,47,12,0.706901745,18859,47,4,8
18384,2014/03/31,2009/09/10,80,11,0.972723292,13704,80,5,6
18385,2014/03/31,2011/09/11,256,13,0.7009234329999999,19016,256,9,4
18386,2014/03/31,2010/06/12,152,17,0.8811086140000001,15127,152,9,8
18387,2014/03/31,2010/09/09,25,12,0.8016403009999999,16625,25,8,4
18388,2014/03/31,2011/12/29,184,8,0.778869733,17111,184,4,4
18389,2014/03/31,2010/07/19,45,11,0.791818182,16830,45,6,5
18390,2014/03/31,2007/06/12,241,3,0.771365478,17276,241,0,3
18391,2014/03/31,2012/10/11,42,12,0.7017953440000001,18988,42,2,10
18392,2014/03/31,2013/02/11,341,6,0.994405464,13397,341,4,2
18393,2014/03/31,2007/05/19,130,11,0.883059791,15086,130,9,2
18394,2014/03/31,2008/02/27,124,16,0.8952721770000001,14880,124,9,7
18395,2014/03/31,2012/08/04,22,14,0.698400965,19074,22,1,13
18396,2014/03/31,2012/09/22,117,12,0.77126281,17271,117,3,9
18397,2014/03/31,2010/10/22,72,9,0.809382026,16457,72,1,8
18398,2014/03/31,2011/12/16,22,12,0.667930395,19941,22,10,2
18399,2014/03/31,2012/01/08,45,13,0.718461538,18538,45,6,7
18400,2014/03/31,2010/06/09,20,17,0.562663709,23670,20,10,7
18401,2014/03/31,2010/08/28,163,18,0.652469989,20409,163,15,3
18402,2014/03/31,2012/05/12,34,10,0.7023328059999999,18960,34,1,9
18403,2014/03/31,2012/09/09,384,5,1.386949276,9601,384,5,0
18404,2014/03/31,2012/04/24,168,11,0.591181459,22523,168,6,5
18405,2014/03/31,2012/12/15,6,17,0.794858814,16751,6,2,15
18406,2014/03/31,2012/04/13,381,11,0.7,19019,381,11,0
18407,2014/03/31,2011/11/17,69,17,0.5800427020000001,22950,69,8,9
18408,2014/03/31,2008/04/27,284,18,0.845714104,15740,284,14,4
18409,2014/03/31,2011/08/24,44,5,0.6940000000000001,19180,44,2,3
18410,2014/03/31,2011/11/06,398,9,0.770913935,17266,398,9,0
18411,2014/03/31,2009/03/11,585,9,0.666126126,19980,585,9,0
18412,2014/03/31,2009/03/25,212,12,0.649120531,20501,212,6,6
18413,2014/03/31,2009/07/20,223,16,0.712376874,18680,223,10,6
18414,2014/03/31,2012/12/30,75,16,0.725114163,18351,75,3,13
18415,2014/03/31,2012/12/06,298,4,0.672613993,19782,298,2,2
18416,2014/03/31,2012/06/04,149,11,0.568752191,23393,149,4,7
18417,2014/03/31,2012/09/19,9,15,0.636692672,20893,9,4,11
18418,2014/03/31,2006/10/11,161,16,0.8114857529999999,16389,161,15,1
18419,2014/03/31,2008/08/30,4,16,0.710355216,18721,4,5,11
18420,2014/03/31,2006/07/24,41,18,0.710916818,18706,41,0,18
18421,2014/03/31,2012/05/19,6,13,0.857446644,15509,6,6,7
18422,2014/03/31,2011/05/21,8,21,0.488102632,27243,8,8,13
18423,2014/03/31,2009/02/19,2,8,0.8799503670000001,15111,2,2,6
18424,2014/03/31,2010/02/04,402,10,0.683624679,19450,402,10,0
18425,2014/03/31,2010/10/01,72,13,0.655733097,20277,72,6,7
18426,2014/03/31,2008/07/15,47,13,0.668881175,19878,47,8,5
18427,2014/03/31,2010/05/25,25,17,0.71942752,18481,25,8,9
18428,2014/03/31,2010/10/29,232,14,0.776066425,17132,232,11,3
18429,2014/03/31,2012/06/21,44,7,0.7152816479999999,18587,44,6,1
18430,2014/03/31,2007/10/01,266,12,0.7873847890000001,16882,266,8,4
18431,2014/03/31,2012/03/08,317,13,0.780354627,17032,317,11,2
18432,2014/03/31,2007/08/21,17,20,0.6489292520000001,20481,17,0,20
18433,2014/03/31,2012/04/08,171,12,0.6761827709999999,19653,171,6,6
18434,2014/03/31,2007/05/31,40,15,0.756604225,17563,40,12,3
18435,2014/03/31,2012/12/11,16,19,0.749834095,17721,16,0,19
18436,2014/03/31,2006/07/06,72,13,0.820782679,16188,72,5,8
18437,2014/03/31,2012/02/19,22,17,0.761368481,17450,22,14,3
18438,2014/03/31,2007/07/05,23,15,0.692326212,19190,23,9,6
18439,2014/03/31,2012/02/06,101,12,0.782127635,16986,101,2,10
18440,2014/03/31,2007/08/15,205,11,0.7717916690000001,17213,205,6,5
18441,2014/03/31,2012/12/02,62,13,0.679137058,19561,62,1,12
18442,2014/03/31,2007/03/16,1,10,0.613848607,21639,1,5,5
18443,2014/03/31,2012/08/16,179,9,0.870158543,15264,179,5,4
18444,2014/03/31,2013/03/01,16,6,0.612868217,21672,16,0,6
18445,2014/03/31,2012/09/19,496,7,1.3509714169999998,9831,496,7,0
18446,2014/03/31,2013/03/13,43,20,0.729184693,18214,43,2,18
18447,2014/03/31,2011/06/20,10,12,0.652656772,20348,10,7,5
18448,2014/03/31,2013/03/19,8,28,0.590882759,22475,8,0,28
18449,2014/03/31,2009/09/10,241,8,0.6580797820000001,20180,241,6,2
18450,2014/03/31,2011/12/30,176,10,0.6598474529999999,20125,176,4,6
18451,2014/03/31,2012/09/27,6,10,0.89439445,14846,6,5,5
18452,2014/03/31,2012/12/16,48,10,0.675,19670,48,1,9
18453,2014/03/31,2010/09/27,29,19,0.608685586,21812,29,11,8
18454,2014/03/31,2012/10/19,174,8,0.72625,18280,174,3,5
18455,2014/03/31,2012/09/12,12,10,0.765872036,17333,12,5,5
18456,2014/03/31,2005/09/09,14,16,0.662994505,20020,14,6,10
18457,2014/03/31,2007/01/30,23,13,0.870098335,15254,23,9,4
18458,2014/03/31,2011/08/10,201,17,0.676481982,19619,201,10,7
18459,2014/03/31,2011/08/17,134,12,0.622213315,21330,134,3,9
18460,2014/03/31,2012/07/23,156,15,0.753035633,17624,156,8,7
18461,2014/03/31,2010/06/18,42,12,0.742581692,17872,42,2,10
18462,2014/03/31,2008/11/04,256,15,0.8425684170000001,15749,256,8,7
18463,2014/03/31,2006/08/30,63,17,0.5010777129999999,26482,63,5,12
18464,2014/03/31,2006/07/05,158,6,0.7882112520000001,16833,158,2,4
18465,2014/03/31,2013/03/18,18,15,0.713982887,18582,18,2,13
18466,2014/03/31,2009/12/14,63,12,0.7754088490000001,17109,63,3,9
18467,2014/03/31,2008/12/12,69,12,0.823868464,16102,69,3,9
18468,2014/03/31,2007/11/22,60,15,0.6991514259999999,18973,60,9,6
18469,2014/03/31,2010/09/19,25,5,0.626,21190,25,2,3
18470,2014/03/31,2010/04/11,30,7,0.5658281789999999,23443,30,1,6
18471,2014/03/31,2011/07/25,3,11,0.626858547,21159,3,2,9
18472,2014/03/31,2012/05/16,87,10,0.729634703,18177,87,3,7
18473,2014/03/31,2005/12/16,348,12,0.8206466579999999,16160,348,11,1
18474,2014/03/31,2011/05/07,15,10,0.622025144,21317,15,6,4
18475,2014/03/31,2011/07/13,396,9,1.5,8838,396,9,0
18476,2014/03/31,2010/03/14,3,9,0.699331083,18956,3,2,7
18477,2014/03/31,2010/01/19,23,16,0.724666266,18293,23,4,12
18478,2014/03/31,2007/08/07,2,16,0.437980506,30265,2,5,11
18479,2014/03/31,2010/07/04,5,14,0.7445113459999999,17804,5,5,9
18480,2014/03/31,2011/04/01,84,10,0.6906675,19191,84,2,8
18481,2014/03/31,2012/10/06,12,7,0.979117234,13537,12,3,4
18482,2014/03/31,2006/03/19,149,13,0.782100325,16945,149,3,10
18483,2014/03/31,2011/05/02,54,4,1.2225,10840,54,3,1
18484,2014/03/31,2009/02/26,45,13,0.714759978,18540,45,7,6
18485,2014/03/31,2011/01/19,8,14,0.620057557,21370,8,6,8
18486,2014/03/31,2011/07/28,454,3,0.85,15588,454,3,0
18487,2014/03/31,2008/11/24,69,10,0.8139647329999999,16276,69,0,10
18488,2014/03/31,2008/11/20,28,18,0.540675891,24501,28,9,9
18489,2014/03/31,2013/03/02,224,8,1.1114289309999998,11918,224,3,5
18490,2014/03/31,2007/03/09,86,11,0.6200978420000001,21361,86,1,10
18491,2014/03/31,2007/10/25,44,15,0.61387931,21576,44,4,11
18492,2014/03/31,2007/03/02,142,17,0.853801328,15513,142,8,9
18493,2014/03/31,2012/03/23,43,13,0.837087415,15821,43,11,2
18494,2014/03/31,2008/04/20,50,12,0.859343326,15411,50,7,5
18495,2014/03/31,2006/09/12,25,11,0.588885578,22487,25,6,5
18496,2014/03/31,2010/11/08,16,17,0.430700625,30744,16,9,8
18497,2014/03/31,2013/02/24,133,23,0.8898024059999999,14879,133,6,17
18498,2014/03/31,2006/12/12,12,12,0.884721647,14963,12,7,5
18499,2014/03/31,2010/03/22,37,19,0.74790565,17700,37,5,14
18500,2014/03/31,2006/05/31,66,11,0.611818182,21637,66,7,4
18501,2014/03/31,2008/01/13,87,14,0.8171424159999999,16199,87,5,9
18502,2014/03/31,2008/10/17,5,11,0.73364372,18042,5,6,5
18503,2014/03/31,2010/07/22,133,12,0.731494888,18095,133,6,6
18504,2014/03/31,2007/06/01,19,19,0.5609514320000001,23596,19,2,17
18505,2014/03/31,2008/05/14,17,14,0.789931368,16756,17,7,7
18506,2014/03/31,2011/01/20,580,8,0.7125,18576,580,8,0
18507,2014/03/31,2012/12/19,95,14,0.784767835,16863,95,4,10
18508,2014/03/31,2009/11/11,198,19,0.6373912620000001,20761,198,10,9
18509,2014/03/31,2008/06/02,14,18,0.54811946,24142,14,9,9
18510,2014/03/31,2012/04/02,511,4,0.715388982,18497,511,4,0
18511,2014/03/31,2012/07/10,7,15,0.885466408,14944,7,8,7
18512,2014/03/31,2011/05/11,590,2,0.95987305,13785,590,2,0
18513,2014/03/31,2011/11/29,171,13,0.7041029329999999,18789,171,6,7
18514,2014/03/31,2012/10/20,48,11,0.702998725,18818,48,4,7
18515,2014/03/31,2008/12/04,127,12,0.801725455,16500,127,9,3
18516,2014/03/31,2013/02/27,16,13,0.75793226,17449,16,0,13
18517,2014/03/31,2010/03/14,7,19,0.7705867609999999,17162,7,10,9
18518,2014/03/31,2006/11/01,64,20,0.90849124,14555,64,14,6
18519,2014/03/31,2007/11/29,58,7,0.743929898,17774,58,1,6
18520,2014/03/31,2005/07/06,265,12,0.834108517,15850,265,10,2
18521,2014/03/31,2013/03/03,2,5,1.201556081,11002,2,1,4
18522,2014/03/31,2011/01/13,41,23,0.611048909,21632,41,0,23
18523,2014/03/31,2011/11/15,123,24,0.739241568,17879,123,16,8
18524,2014/03/31,2004/11/26,68,30,0.622219868,21240,68,10,20
18525,2014/03/31,2012/05/09,232,13,0.812761272,16257,232,9,4
18526,2014/03/31,2008/07/09,146,13,0.787273269,16782,146,12,1
18527,2014/03/31,2010/11/09,74,14,0.457549183,28872,74,7,7
18528,2014/03/31,2007/10/31,20,13,0.765984343,17245,20,6,7
18529,2014/03/31,2005/04/15,181,8,0.967078117,13659,181,5,3
18530,2014/03/31,2008/10/13,266,13,0.8077652740000001,16351,266,9,4
18531,2014/03/31,2010/02/16,27,17,0.6893032720000001,19161,27,4,13
18532,2014/03/31,2011/05/14,341,10,0.6200455420000001,21299,341,8,2
18533,2014/03/31,2005/07/26,59,12,0.728618882,18123,59,0,12
18534,2014/03/31,2011/07/16,268,2,0.863974351,15283,268,0,2
18535,2014/03/31,2009/06/18,7,16,0.7718771190000001,17106,7,9,7
18536,2014/03/31,2012/08/04,48,19,0.7391289259999999,17863,48,2,17
18537,2014/03/31,2010/06/27,115,16,0.642613288,20545,115,12,4
18538,2014/03/31,2006/03/09,6,14,0.7348769759999999,17964,6,4,10
18539,2014/03/31,2008/06/07,236,12,0.68857128,19171,236,10,2
18540,2014/03/31,2007/06/14,4,6,1.300733149,10148,4,1,5
18541,2014/03/31,2012/04/02,17,21,0.74651151,17681,17,7,14
18542,2014/03/31,2010/06/01,130,15,0.667315334,19779,130,9,6
18543,2014/03/31,2013/03/03,161,13,0.783961155,16836,161,3,10
18544,2014/03/31,2011/07/11,4,13,0.676212533,19517,4,9,4
18545,2014/03/31,2010/10/22,52,15,0.673688617,19590,52,4,11
18546,2014/03/31,2009/10/13,163,6,1.433472735,9206,163,1,5
18547,2014/03/31,2011/11/28,20,7,1.277353596,10331,20,3,4
18548,2014/03/31,2010/11/17,6,34,0.7945986629999999,16607,6,5,29
18549,2014/03/31,2013/03/14,90,10,0.754593961,17486,90,2,8
18550,2014/03/31,2012/04/03,73,25,0.742610311,17768,73,16,9
18551,2014/03/31,2006/07/11,44,8,0.8802448629999999,14988,44,5,3
18552,2014/03/31,2010/05/15,130,16,0.649001132,20323,130,12,4
18553,2014/03/31,2005/11/16,17,16,0.752299795,17532,17,7,9
18554,2014/03/31,2011/09/04,46,10,0.8466574659999999,15578,46,5,5
18555,2014/03/31,2012/07/28,39,10,0.950364606,13878,39,5,5
18556,2014/03/31,2008/08/12,142,15,0.735293822,17936,142,8,7
18557,2014/03/31,2008/07/07,20,17,0.60537321,21784,20,4,13
18558,2014/03/31,2011/07/05,50,10,0.72874551,18095,50,0,10
18559,2014/03/31,2007/09/29,37,16,0.431071989,30588,37,7,9
18560,2014/03/31,2012/02/25,138,16,0.583997165,22576,138,13,3
18561,2014/03/31,2010/11/05,73,20,0.7423745709999999,17759,73,15,5
18562,2014/03/31,2006/02/20,25,15,0.826551075,15947,25,7,8
18563,2014/03/31,2012/07/05,95,7,0.590353832,22327,95,3,4
18564,2014/03/31,2006/01/12,26,20,0.894928707,14728,26,16,4
18565,2014/03/31,2012/09/21,13,14,0.829201636,15895,13,3,11
18566,2014/03/31,2005/01/01,50,9,0.995468278,13240,50,4,5
18567,2014/03/31,2007/04/22,106,21,0.638435865,20644,106,15,6
18568,2014/03/31,2012/03/27,68,20,0.540240203,24396,68,9,11
18569,2014/03/31,2012/01/18,518,11,0.68796596,19154,518,11,0
18570,2014/03/31,2012/10/25,139,8,0.712857993,18485,139,4,4
18571,2014/03/31,2006/12/18,109,9,0.7573320309999999,17399,109,5,4
18572,2014/03/31,2012/04/05,598,2,0.65,20272,598,2,0
18573,2014/03/31,2012/08/03,339,13,0.70233463,18761,339,10,3
18574,2014/03/31,2010/04/21,115,9,0.7287682520000001,18080,115,2,7
18575,2014/03/31,2005/07/20,43,13,0.7731400740000001,17041,43,8,5
18576,2014/03/31,2010/08/04,7,16,0.601995431,21885,7,9,7
18577,2014/03/31,2010/04/22,123,10,1.246176693,10572,123,5,5
18578,2014/03/31,2011/08/05,59,10,0.7734231540000001,17034,59,1,9
18579,2014/03/31,2012/10/30,29,15,0.698823467,18852,29,0,15
18580,2014/03/31,2012/10/11,74,10,0.7388682,17830,74,3,7
18581,2014/03/31,2006/06/26,259,11,0.983050746,13400,259,9,2
18582,2014/03/31,2010/12/30,83,16,0.927124155,14208,83,4,12
18583,2014/03/31,2007/10/31,130,10,0.927498064,14201,130,8,2
18584,2014/03/31,2010/06/03,25,19,0.6856470590000001,19210,25,13,6
18585,2014/03/31,2012/04/02,169,9,1.333059717,9880,169,4,5
18586,2014/03/31,2010/09/28,48,13,0.7321029520000001,17989,48,9,4
18587,2014/03/31,2007/07/01,7,16,0.619121726,21269,7,9,7
18588,2014/03/31,2008/10/28,55,13,0.553674894,23783,55,10,3
18589,2014/03/31,2013/03/28,59,10,0.744503562,17686,59,1,9
18590,2014/03/31,2013/02/25,2,10,0.770369179,17092,2,1,9
18591,2014/03/31,2010/11/19,2,15,0.613682591,21455,2,4,11
18592,2014/03/31,2007/08/23,132,18,0.794222718,16577,132,5,13
18593,2014/03/31,2010/05/25,329,16,0.613563272,21455,329,15,1
18594,2014/03/31,2007/11/22,149,20,0.818742303,16077,149,17,3
18595,2014/03/31,2011/04/14,144,10,0.80103761,16432,144,3,7
18596,2014/03/31,2009/06/10,222,16,0.8567037690000001,15363,222,9,7
18597,2014/03/31,2009/09/16,59,18,0.5468662479999999,24067,59,7,11
18598,2014/03/31,2012/02/22,221,15,0.835088521,15759,221,8,7
18599,2014/03/31,2005/04/08,308,22,0.744722992,17671,308,18,4
18600,2014/03/31,2007/12/12,192,9,0.7758207020000001,16955,192,5,4
18601,2014/03/31,2009/07/14,142,19,0.900015737,14615,142,12,7
18602,2014/03/31,2005/04/09,124,13,0.8407139659999999,15645,124,11,2
18603,2014/03/31,2012/09/19,33,19,0.5804877079999999,22657,33,4,15
18604,2014/03/31,2012/12/06,39,12,0.6260188489999999,21009,39,2,10
18605,2014/03/31,2011/05/18,22,15,0.766927922,17148,22,7,8
18606,2014/03/31,2012/08/11,179,9,0.869373967,15127,179,8,1
18607,2014/03/31,2012/08/06,177,18,0.746893673,17606,177,13,5
18608,2014/03/31,2013/01/12,43,13,0.662182496,19858,43,3,10
18609,2014/03/31,2006/06/09,132,12,0.65689948,20016,132,6,6
18610,2014/03/31,2012/01/25,35,14,0.841331115,15626,35,7,7
18611,2014/03/31,2006/07/07,58,13,0.516356245,25460,58,4,9
18612,2014/03/31,2012/02/07,2,22,0.6289980860000001,20900,2,9,13
18613,2014/03/31,2009/01/07,121,9,0.776575496,16928,121,0,9
18614,2014/03/31,2010/05/12,71,18,0.83042072,15830,71,11,7
18615,2014/03/31,2005/04/18,129,10,0.616,21340,129,2,8
18616,2014/03/31,2012/01/01,34,7,0.616374678,21325,34,3,4
18617,2014/03/31,2011/11/26,77,15,0.732513238,17941,77,13,2
18618,2014/03/31,2012/10/11,87,15,0.550320784,23879,87,10,5
18619,2014/03/31,2011/08/10,3,23,0.680303375,19316,3,6,17
18620,2014/03/31,2006/06/15,510,8,0.705570769,18624,510,8,0
18621,2014/03/31,2009/09/22,2,12,0.718894299,18278,2,6,6
18622,2014/03/31,2011/12/16,187,13,0.666590909,19712,187,12,1
18623,2014/03/31,2011/05/01,24,16,0.6940578940000001,18931,24,6,10
18624,2014/03/31,2007/03/28,163,6,0.728037238,18046,163,3,3
18625,2014/03/31,2011/03/02,66,10,0.8160740459999999,16098,66,6,4
18626,2014/03/31,2012/05/30,132,16,0.6919193090000001,18986,132,13,3
18627,2014/03/31,2012/10/29,31,13,0.8711273209999999,15080,31,6,7
18628,2014/03/31,2012/07/11,26,15,0.489254004,26850,26,7,8
18629,2014/03/31,2011/07/20,12,13,0.69710328,18842,12,3,10
18630,2014/03/31,2011/10/09,7,17,0.660947109,19871,7,5,12
18631,2014/03/31,2009/07/01,124,20,0.619739996,21192,124,9,11
18632,2014/03/31,2011/07/07,115,15,0.666484649,19705,115,5,10
18633,2014/03/31,2008/03/15,64,7,1.3643237069999998,9626,64,2,5
18634,2014/03/31,2011/09/19,112,9,0.724672773,18122,112,1,8
18635,2014/03/31,2012/06/06,72,22,0.71835567,18281,72,13,9
18636,2014/03/31,2005/06/14,65,12,0.78515128,16724,65,10,2
18637,2014/03/31,2008/04/27,98,17,0.948033213,13850,98,4,13
18638,2014/03/31,2007/08/11,104,9,0.663275575,19795,104,1,8
18639,2014/03/31,2012/05/26,81,18,0.6500158429999999,20198,81,14,4
18640,2014/03/31,2013/02/27,16,12,0.564753936,23246,16,2,10
18641,2014/03/31,2012/06/13,28,8,0.690028385,19024,28,5,3
18642,2014/03/31,2011/05/21,204,11,0.5316049079999999,24693,204,4,7
18643,2014/03/31,2011/04/20,140,20,0.768384264,17082,140,8,12
18644,2014/03/31,2006/03/02,8,16,0.685868213,19137,8,6,10
18645,2014/03/31,2004/11/25,162,13,1.0726373,12236,162,8,5
18646,2014/03/31,2012/07/10,7,9,0.732379039,17919,7,7,2
18647,2014/03/31,2012/04/27,69,14,0.672239525,19522,69,4,10
18648,2014/03/31,2006/08/27,236,11,0.677817262,19361,236,7,4
18649,2014/03/31,2009/01/11,12,10,0.5774315760000001,22726,12,5,5
18650,2014/03/31,2007/02/15,8,17,0.67726475,19373,8,11,6
18651,2014/03/31,2008/09/14,16,20,0.7874534870000001,16662,16,12,8
18652,2014/03/31,2012/11/21,140,11,0.583464378,22486,140,5,6
18653,2014/03/31,2011/02/05,550,7,0.807142857,16254,550,7,0
18654,2014/03/31,2008/11/28,67,18,0.6622139220000001,19811,67,5,13
18655,2014/03/31,2007/02/01,42,14,0.749771961,17497,42,7,7
18656,2014/03/31,2004/12/28,82,17,0.5187381870000001,25289,82,11,6
18657,2014/03/31,2007/04/01,65,11,0.6219578,21090,65,3,8
18658,2014/03/31,2012/07/17,47,17,0.644911746,20339,47,7,10
18659,2014/03/31,2011/09/01,8,16,0.692843407,18928,8,7,9
18660,2014/03/31,2009/09/01,5,9,1.454537992,9015,5,5,4
18661,2014/03/31,2013/02/08,15,18,0.631976189,20747,15,0,18
18662,2014/03/31,2008/08/29,154,9,0.964845831,13589,154,8,1
18663,2014/03/31,2008/03/25,1,15,0.64245161,20407,1,9,6
18664,2014/03/31,2005/06/23,163,12,0.80102279,16367,163,8,4
18665,2014/03/31,2011/10/08,78,8,0.965928519,13570,78,6,2
18666,2014/03/31,2012/01/14,454,4,0.706933283,18541,454,4,0
18667,2014/03/31,2008/11/27,79,21,0.649415845,20183,79,17,4
18668,2014/03/31,2008/02/05,72,10,0.631,20770,72,7,3
18669,2014/03/31,2012/07/16,25,13,0.922621093,14204,25,5,8
18670,2014/03/31,2012/02/11,24,9,0.6257536539999999,20938,24,2,7
18671,2014/03/31,2012/05/01,39,29,0.597505131,21925,39,11,18
18672,2014/03/31,2011/05/20,9,17,0.629480563,20811,9,5,12
18673,2014/03/31,2011/07/04,3,27,0.58427501,22421,3,18,9
18674,2014/03/31,2012/12/16,1,9,0.608186545,21539,1,2,7
18675,2014/03/31,2008/07/27,75,17,0.68810622,19036,75,12,5
18676,2014/03/31,2012/11/13,69,10,0.713300114,18363,69,0,10
18677,2014/03/31,2012/03/09,2,17,0.610089431,21469,2,9,8
18678,2014/03/31,2011/10/28,13,13,0.664659495,19706,13,7,6
18679,2014/03/31,2012/04/26,14,13,0.81348531,16099,14,3,10
18680,2014/03/31,2008/11/08,128,10,0.659975306,19843,128,1,9
18681,2014/03/31,2010/01/09,44,5,0.618,21190,44,3,2
18682,2014/03/31,2012/01/16,147,9,0.781514085,16756,147,8,1
18683,2014/03/31,2007/07/24,628,3,0.7928372490000001,16516,628,3,0
18684,2014/03/31,2005/10/16,306,6,0.811304213,16140,306,1,5
18685,2014/03/31,2005/12/26,152,16,0.7447136440000001,17583,152,6,10
18686,2014/03/31,2011/10/02,553,13,0.719538935,18197,553,13,0
18687,2014/03/31,2009/01/15,20,4,1.4325,9140,20,1,3
18688,2014/03/31,2012/05/21,3,9,0.783247383,16715,3,5,4
18689,2014/03/31,2007/08/01,21,14,0.826232405,15843,21,7,7
18690,2014/03/31,2012/12/14,225,9,0.804096075,16279,225,3,6
18691,2014/03/31,2010/02/21,110,9,0.923215545,14178,110,6,3
18692,2014/03/31,2007/07/14,122,17,0.7660429590000001,17086,122,9,8
18693,2014/03/31,2012/08/16,1,15,0.784047205,16693,1,8,7
18694,2014/03/31,2007/07/30,389,8,0.781439575,16748,389,8,0
18695,2014/03/31,2008/12/02,39,7,0.85132505,15373,39,5,2
18696,2014/03/31,2007/11/20,109,7,0.878626385,14895,109,1,6
18697,2014/03/31,2012/10/04,6,14,0.541895317,24149,6,3,11
18698,2014/03/31,2007/06/04,94,17,0.875395371,14948,94,13,4
18699,2014/03/31,2006/06/19,109,5,0.648561657,20176,109,2,3
18700,2014/03/31,2007/10/07,2,12,0.7370837090000001,17752,2,8,4
18701,2014/03/31,2010/04/22,262,11,0.8781308720000001,14900,262,8,3
18702,2014/03/31,2007/07/27,120,16,0.772135647,16941,120,15,1
18703,2014/03/31,2007/12/23,72,5,0.665617749,19652,72,0,5
18704,2014/03/31,2007/05/12,106,25,0.71326081,18339,106,9,16
18705,2014/03/31,2005/04/10,32,17,0.540858903,24182,32,11,6
18706,2014/03/31,2007/12/29,86,18,0.47052249,27790,86,11,7
18707,2014/03/31,2011/02/25,285,16,0.779275285,16779,285,11,5
18708,2014/03/31,2010/03/22,2,17,0.65105617,20082,2,11,6
18709,2014/03/31,2010/09/21,25,14,0.554736507,23568,25,12,2
18710,2014/03/31,2011/12/21,4,12,0.459184111,28472,4,4,8
18711,2014/03/31,2010/11/25,4,13,0.581510609,22481,4,4,9
18712,2014/03/31,2013/03/07,15,9,0.804162412,16255,15,3,6
18713,2014/03/31,2007/09/05,78,16,0.798618562,16367,78,12,4
18714,2014/03/31,2012/06/06,31,6,0.7863798809999999,16621,31,2,4
18715,2014/03/31,2005/11/25,185,12,0.945262549,13826,185,9,3
18716,2014/03/31,2008/09/28,189,7,0.746457417,17507,189,3,4
18717,2014/03/31,2012/05/17,8,14,0.671846178,19451,8,6,8
18718,2014/03/31,2012/07/10,1,21,0.458876677,28478,1,9,12
18719,2014/03/31,2010/11/25,4,6,1.178769619,11086,4,0,6
18720,2014/03/31,2011/07/09,187,21,0.7298843770000001,17903,187,17,4
18721,2014/03/31,2009/10/12,3,10,0.7405078209999999,17644,3,5,5
18722,2014/03/31,2012/07/25,348,13,0.65477873,19953,348,12,1
18723,2014/03/31,2006/07/11,192,6,0.840698198,15540,192,2,4
18724,2014/03/31,2011/04/12,99,25,0.7226623520000001,18078,99,14,11
18725,2014/03/31,2007/10/14,242,5,1.360765625,9600,242,2,3
18726,2014/03/31,2012/11/17,88,12,0.676927143,19298,88,2,10
18727,2014/03/31,2008/01/13,369,13,0.800171527,16324,369,13,0
18728,2014/03/31,2008/10/22,220,12,0.884060237,14775,220,1,11
18729,2014/03/31,2011/11/19,24,11,0.610867552,21382,24,6,5
18730,2014/03/31,2011/12/17,272,13,0.444402817,29388,272,9,4
18731,2014/03/31,2011/07/21,363,5,0.784290175,16652,363,4,1
18732,2014/03/31,2013/03/02,16,24,0.66243989,19714,16,2,22
18733,2014/03/31,2012/09/24,131,12,0.682587424,19131,131,3,9
18734,2014/03/31,2007/05/11,40,21,0.797418173,16376,40,19,2
18735,2014/03/31,2006/03/05,5,8,0.799682715,16326,5,0,8
18736,2014/03/31,2007/06/28,166,8,0.723597162,18042,166,5,3
18737,2014/03/31,2013/03/25,210,7,0.7824154879999999,16684,210,0,7
18738,2014/03/31,2007/12/25,6,5,1.399865952,9325,6,0,5
18739,2014/03/31,2008/12/09,223,24,1.042932247,12516,223,21,3
18740,2014/03/31,2012/06/21,39,11,0.6281081860000001,20779,39,6,5
18741,2014/03/31,2011/01/22,160,14,0.772820513,16887,160,8,6
18742,2014/03/31,2008/01/01,179,5,0.7520977409999999,17352,179,3,2
18743,2014/03/31,2012/09/23,32,10,0.812187714,16067,32,2,8
18744,2014/03/31,2010/09/06,15,14,0.973616355,13403,15,6,8
18745,2014/03/31,2006/06/22,84,13,0.568520891,22953,84,5,8
18746,2014/03/31,2008/01/12,9,12,0.7432036679999999,17558,9,6,6
18747,2014/03/31,2011/02/25,578,4,1.286629856,10142,578,4,0
18748,2014/03/31,2008/03/19,180,12,0.6666414629999999,19574,180,9,3
18749,2014/03/31,2007/06/04,4,17,0.56688969,23017,4,5,12
18750,2014/03/31,2008/01/31,129,4,0.87488132,14914,129,1,3
18751,2014/03/31,2007/04/01,60,16,0.712608957,18310,60,7,9
18752,2014/03/31,2012/03/14,8,14,0.7327684790000001,17804,8,5,9
18753,2014/03/31,2005/09/18,88,8,0.929759088,14030,88,4,4
18754,2014/03/31,2011/12/28,15,21,0.550270829,23705,15,3,18
18755,2014/03/31,2007/12/26,44,23,0.8639422440000001,15098,44,7,16
18756,2014/03/31,2011/12/21,108,15,0.767378949,16997,108,8,7
18757,2014/03/31,2009/09/03,12,14,0.5553706939999999,23483,12,7,7
18758,2014/03/31,2007/08/04,146,12,0.738230499,17666,146,7,5
18759,2014/03/31,2012/03/06,28,14,0.7260842940000001,17961,28,5,9
18760,2014/03/31,2012/08/14,26,25,0.629774934,20705,26,9,16
18761,2014/03/31,2009/04/11,153,19,0.565720484,23047,153,15,4
18762,2014/03/31,2007/06/20,225,7,1.393374305,9356,225,5,2
18763,2014/03/31,2006/04/06,1,7,0.654788527,19908,1,4,3
18764,2014/03/31,2009/06/03,71,13,0.805285723,16187,71,7,6
18765,2014/03/31,2005/11/01,36,12,0.532311117,24486,36,6,6
18766,2014/03/31,2011/03/06,146,18,0.625978673,20819,146,11,7
18767,2014/03/31,2012/11/25,17,16,0.565982279,23023,17,4,12
18768,2014/03/31,2010/06/10,16,12,0.638031631,20423,16,6,6
18769,2014/03/31,2005/01/12,25,5,1.41,9241,25,0,5
18770,2014/03/31,2008/12/11,65,12,0.589380287,22107,65,8,4
18771,2014/03/31,2007/10/25,64,10,0.7601079279999999,17141,64,3,7
18772,2014/03/31,2012/02/08,44,16,0.616933422,21118,44,11,5
18773,2014/03/31,2010/07/24,76,12,0.742090453,17556,76,2,10
18774,2014/03/31,2005/07/04,23,10,0.636549399,20466,23,6,4
18775,2014/03/31,2005/09/12,64,11,0.671514948,19400,64,4,7
18776,2014/03/31,2011/11/25,235,6,0.676209188,19265,235,0,6
18777,2014/03/31,2013/02/13,42,4,0.509640063,25560,42,2,2
18778,2014/03/31,2005/08/30,44,9,0.7834861059999999,16626,44,2,7
18779,2014/03/31,2011/05/20,139,10,0.862256719,15106,139,8,2
18780,2014/03/31,2008/07/19,521,9,0.8439836709999999,15433,521,9,0
18781,2014/03/31,2011/11/25,79,13,0.379783636,34294,79,7,6
18782,2014/03/31,2006/12/15,121,6,0.813140805,16015,121,3,3
18783,2014/03/31,2007/11/23,151,9,0.724960748,17961,151,7,2
18784,2014/03/31,2008/03/10,2,9,0.739247147,17613,2,2,7
18785,2014/03/31,2008/07/26,80,22,0.424454913,30674,80,5,17
18786,2014/03/31,2011/11/15,222,8,0.5625,23144,222,4,4
18787,2014/03/31,2006/04/26,61,15,0.459051095,28359,61,4,11
18788,2014/03/31,2007/09/12,72,16,0.759484831,17140,72,7,9
18789,2014/03/31,2009/12/11,34,12,0.7332497609999999,17749,34,2,10
18790,2014/03/31,2012/10/26,396,8,0.738109687,17632,396,8,0
18791,2014/03/31,2012/03/17,49,13,0.63648486,20443,49,6,7
18792,2014/03/31,2007/09/02,4,11,0.679131479,19159,4,5,6
18793,2014/03/31,2012/10/15,16,19,0.797049743,16324,16,4,15
18794,2014/03/31,2005/06/06,2,18,0.558261243,23304,2,6,12
18795,2014/03/31,2011/06/14,50,17,0.796376102,16336,50,12,5
18796,2014/03/31,2011/09/17,9,9,0.63309744,20546,9,1,8
18797,2014/03/31,2010/11/29,65,22,0.7145457040000001,18204,65,8,14
18798,2014/03/31,2012/09/15,226,22,0.81534821,15953,226,16,6
18799,2014/03/31,2009/02/23,82,7,0.501478968,25937,82,4,3
18800,2014/03/31,2012/04/13,25,12,0.698000966,18634,25,7,5
18801,2014/03/31,2012/08/01,115,11,0.8907411470000001,14599,115,4,7
18802,2014/03/31,2007/06/12,490,2,0.8,16254,490,2,0
18803,2014/03/31,2012/09/30,541,2,0.8,16254,541,2,0
18804,2014/03/31,2012/05/03,307,2,0.8,16254,307,1,1
18805,2014/03/31,2011/04/04,142,15,0.582379608,22323,142,11,4
18806,2014/03/31,2010/05/17,533,13,0.785902551,16542,533,13,0
18807,2014/03/31,2012/07/07,32,13,0.782061601,16623,32,2,11
18808,2014/03/31,2012/08/19,65,12,0.760032156,17104,65,5,7
18809,2014/03/31,2007/01/05,135,12,0.828194329,15695,135,3,9
18810,2014/03/31,2011/09/24,101,9,0.7979575170000001,16289,101,0,9
18811,2014/03/31,2009/09/08,213,19,0.412652867,31498,213,13,6
18812,2014/03/31,2005/07/15,162,12,0.791858779,16414,162,9,3
18813,2014/03/31,2009/08/22,18,12,0.6436297910000001,20194,18,4,8
18814,2014/03/31,2008/03/14,1,19,0.6794614379999999,19125,1,12,7
18815,2014/03/31,2009/08/12,36,11,0.604330233,21500,36,7,4
18816,2014/03/31,2005/08/12,139,11,0.836687275,15528,139,2,9
18817,2014/03/31,2010/12/07,83,14,0.5868321439999999,22138,83,6,8
18818,2014/03/31,2009/11/08,129,13,0.800766196,16223,129,8,5
18819,2014/03/31,2007/01/11,45,10,0.755974857,17182,45,4,6
18820,2014/03/31,2012/11/26,10,17,0.7320605309999999,17743,10,4,13
18821,2014/03/31,2007/01/02,3,9,0.902103764,14398,3,2,7
18822,2014/03/31,2011/04/18,31,28,0.7929444440000001,16380,31,13,15
18823,2014/03/31,2009/12/31,82,12,0.954933461,13601,82,7,5
18824,2014/03/31,2008/02/01,26,12,0.7203671859999999,18029,26,5,7
18825,2014/03/31,2008/01/09,438,12,0.7243000559999999,17930,438,12,0
18826,2014/03/31,2009/08/28,294,13,0.7984279129999999,16265,294,10,3
18827,2014/03/31,2010/07/11,5,10,0.799493936,16243,5,1,9
18828,2014/03/31,2008/10/10,202,11,0.669540088,19395,202,6,5
18829,2014/03/31,2012/10/31,118,11,0.7278934979999999,17840,118,5,6
18830,2014/03/31,2007/06/02,7,15,0.542695281,23927,7,4,11
18831,2014/03/31,2007/10/03,109,10,0.8441119490000001,15382,109,6,4
18832,2014/03/31,2006/06/09,16,11,0.612684158,21191,16,7,4
18833,2014/03/31,2006/11/21,17,27,0.6806674709999999,19072,17,6,21
18834,2014/03/31,2011/03/13,730,2,1.029096099,12612,730,2,0
18835,2014/03/31,2007/05/14,121,9,0.974454539,13319,121,5,4
18836,2014/03/31,2011/08/02,12,19,0.696565586,18632,12,3,16
18837,2014/03/31,2011/03/15,3,8,0.930032253,13952,3,2,6
18838,2014/03/31,2011/02/20,246,9,0.675555556,19206,246,6,3
18839,2014/03/31,2012/11/02,35,14,0.711957858,18224,35,4,10
18840,2014/03/31,2011/02/05,95,19,0.560817844,23134,95,13,6
18841,2014/03/31,2012/01/27,27,6,1.41,9201,27,0,6
18842,2014/03/31,2011/08/29,158,14,0.773958358,16762,158,9,5
18843,2014/03/31,2006/05/14,82,12,0.656129881,19772,82,7,5
18844,2014/03/31,2008/03/02,135,12,0.844348392,15362,135,8,4
18845,2014/03/31,2012/02/26,159,15,0.681099617,19043,159,12,3
18846,2014/03/31,2010/12/13,18,13,0.752977068,17225,18,4,9
18847,2014/03/31,2009/11/05,15,20,0.716303435,18106,15,5,15
18848,2014/03/31,2012/03/15,298,18,0.8067429709999999,16076,298,13,5
18849,2014/03/31,2008/02/20,174,13,0.63970552,20273,174,11,2
18850,2014/03/31,2010/03/17,188,27,0.894444444,14499,188,25,2
18851,2014/03/31,2011/01/02,81,10,0.762009167,17017,81,4,6
18852,2014/03/31,2011/06/14,4,14,0.844429827,15355,4,0,14
18853,2014/03/31,2007/03/09,189,15,0.6864307270000001,18889,189,9,6
18854,2014/03/31,2012/08/08,44,2,0.53,24464,44,0,2
18855,2014/03/31,2007/11/09,94,2,0.53,24464,94,0,2
18856,2014/03/31,2010/05/03,397,13,0.918129028,14121,397,13,0
18857,2014/03/31,2007/09/26,200,14,0.569623869,22758,200,9,5
18858,2014/03/31,2009/03/20,90,18,0.74005652,17516,90,16,2
18859,2014/03/31,2012/06/10,10,17,0.5519178020000001,23480,10,7,10
18860,2014/03/31,2007/04/26,67,19,0.6713942279999999,19301,67,9,10
18861,2014/03/31,2011/11/08,33,14,0.624566705,20748,33,4,10
18862,2014/03/31,2007/07/30,16,6,0.7674071659999999,16885,16,1,5
18863,2014/03/31,2011/04/29,8,9,0.719220649,18015,8,4,5
18864,2014/03/31,2010/11/17,42,17,0.841021097,15405,42,14,3
18865,2014/03/31,2013/03/29,20,14,0.672679545,19257,20,0,14
18866,2014/03/31,2007/08/19,38,9,0.693122692,18689,38,0,9
18867,2014/03/31,2006/01/25,81,13,0.586816781,22072,81,7,6
18868,2014/03/31,2012/03/15,245,6,0.7307414090000001,17723,245,5,1
18869,2014/03/31,2010/12/15,6,20,0.574617945,22536,6,11,9
18870,2014/03/31,2010/01/01,81,7,0.8116635329999999,15954,81,6,1
18871,2014/03/31,2009/11/10,191,12,0.715388653,18101,191,8,4
18872,2014/03/31,2011/10/13,2,12,0.755771319,17133,2,4,8
18873,2014/03/31,2007/10/14,11,12,0.831150266,15579,11,6,6
18874,2014/03/31,2007/09/26,99,11,0.601357641,21530,99,7,4
18875,2014/03/31,2007/11/19,577,4,0.565874126,22880,577,4,0
18876,2014/03/31,2007/10/24,77,14,0.674006455,19209,77,7,7
18877,2014/03/31,2006/04/17,25,12,0.6892754090000001,18783,25,5,7
18878,2014/03/31,2011/07/23,297,6,0.6787684159999999,19073,297,4,2
18879,2014/03/31,2011/09/15,25,16,0.5887738770000001,21988,25,12,4
18880,2014/03/31,2013/03/01,168,11,1.081522974,11970,168,3,8
18881,2014/03/31,2006/03/29,271,8,0.603714499,21443,271,7,1
18882,2014/03/31,2005/10/27,110,11,0.907421842,14266,110,6,5
18883,2014/03/31,2010/07/11,157,19,0.6255287070000001,20692,157,12,7
18884,2014/03/31,2012/09/25,82,10,0.936198192,13825,82,7,3
18885,2014/03/31,2013/01/27,8,13,0.643904478,20100,8,0,13
18886,2014/03/31,2011/09/29,211,13,0.931483374,13894,211,10,3
18887,2014/03/31,2005/10/09,124,8,0.628354535,20596,124,4,4
18888,2014/03/31,2011/09/04,5,15,0.820386712,15774,5,2,13
18889,2014/03/31,2010/04/15,36,13,0.695211131,18614,36,9,4
18890,2014/03/31,2007/06/29,216,19,0.664044235,19487,216,11,8
18891,2014/03/31,2011/07/26,28,16,0.6948332709999999,18623,28,6,10
18892,2014/03/31,2011/10/08,37,13,0.604729635,21397,37,9,4
18893,2014/03/31,2009/02/12,388,3,0.8046359059999999,16081,388,3,0
18894,2014/03/31,2007/12/11,44,17,0.6410865579999999,20183,44,7,10
18895,2014/03/31,2005/07/01,35,15,0.80636273,16045,35,4,11
18896,2014/03/31,2008/05/17,48,7,0.924939234,13988,48,1,6
18897,2014/03/31,2007/05/23,7,12,0.826589355,15651,7,2,10
18898,2014/03/31,2012/03/16,22,13,0.675286594,19156,22,5,8
18899,2014/03/31,2011/10/25,2,11,0.901550739,14348,2,0,11
18900,2014/03/31,2008/09/26,153,20,0.6612632279999999,19561,153,13,7
18901,2014/03/31,2013/02/02,6,16,0.7041976590000001,18365,6,9,7
18902,2014/03/31,2012/07/25,221,6,0.7277871570000001,17769,221,4,2
18903,2014/03/31,2010/07/18,66,8,0.651899985,19837,66,3,5
18904,2014/03/31,2008/04/04,182,17,0.689054191,18767,182,7,10
18905,2014/03/31,2008/07/16,33,16,0.673679083,19195,33,5,11
18906,2014/03/31,2010/02/06,126,13,0.789284581,16382,126,1,12
18907,2014/03/31,2007/11/01,31,22,0.93217175,13869,31,6,16
18908,2014/03/31,2012/04/28,5,24,0.710834662,18187,5,12,12
18909,2014/03/31,2007/03/13,102,13,0.581616502,22227,102,8,5
18910,2014/03/31,2009/11/22,23,20,0.696553155,18559,23,9,11
18911,2014/03/31,2013/01/06,291,2,0.85,15208,291,1,1
18912,2014/03/31,2012/05/09,120,11,0.731202693,17677,120,6,5
18913,2014/03/31,2013/03/03,25,19,0.7804540790000001,16561,25,3,16
18914,2014/03/31,2008/08/19,17,8,0.618434704,20897,17,0,8
18915,2014/03/31,2011/08/20,8,3,0.53,24381,8,2,1
18916,2014/03/31,2008/01/21,592,8,0.55,23492,592,8,0
18917,2014/03/31,2012/09/01,44,15,0.5759057679999999,22434,44,7,8
18918,2014/03/31,2012/07/20,16,20,0.613746971,21049,16,6,14
18919,2014/03/31,2012/05/27,242,2,0.84989802,15199,242,0,2
18920,2014/03/31,2007/05/23,95,15,0.771377045,16746,95,7,8
18921,2014/03/31,2012/07/23,306,11,0.689426772,18736,306,7,4
18922,2014/03/31,2006/04/28,67,9,0.5525778579999999,23376,67,8,1
18923,2014/03/31,2012/10/10,63,12,0.726117826,17789,63,5,7
18924,2014/03/31,2007/09/13,191,7,1.022486542,12632,191,5,2
18925,2014/03/31,2006/12/25,41,11,0.7901976140000001,16345,41,7,4
18926,2014/03/31,2009/12/13,27,17,0.5619711079999999,22982,27,11,6
18927,2014/03/31,2010/07/14,141,14,0.5640049779999999,22899,141,10,4
18928,2014/03/31,2011/08/19,74,10,0.809112893,15962,74,5,5
18929,2014/03/31,2012/11/20,19,9,0.607314837,21265,19,2,7
18930,2014/03/31,2008/03/01,17,20,0.55341661,23336,17,5,15
18931,2014/03/31,2010/08/17,43,21,0.566844577,22783,43,9,12
18932,2014/03/31,2011/12/04,102,12,0.796512058,16213,102,9,3
18933,2014/03/31,2008/12/28,32,14,0.676889448,19077,32,0,14
18934,2014/03/31,2006/01/19,100,17,0.7020191370000001,18394,100,9,8
18935,2014/03/31,2010/09/10,19,17,0.693602278,18616,19,10,7
18936,2014/03/31,2008/09/17,120,10,0.640590395,20156,120,2,8
18937,2014/03/31,2005/12/01,42,15,0.822659446,15695,42,12,3
18938,2014/03/31,2007/12/07,38,18,0.735304402,17559,38,13,5
18939,2014/03/31,2012/10/25,8,12,0.480391113,26872,8,4,8
18940,2014/03/31,2011/04/30,1,17,0.7302262829999999,17677,1,6,11
18941,2014/03/31,2012/03/28,157,12,0.801343515,16107,157,8,4
18942,2014/03/31,2011/07/19,130,16,0.722331542,17868,130,14,2
18943,2014/03/31,2005/03/24,135,12,0.6944017,18586,135,6,6
18944,2014/03/31,2012/12/08,8,12,0.699740837,18444,8,2,10
18945,2014/03/31,2006/07/20,21,10,0.64510198,20004,21,3,7
18946,2014/03/31,2010/10/29,20,9,0.7284819920000001,17714,20,0,9
18947,2014/03/31,2010/12/21,182,13,0.47625489,27094,182,6,7
18948,2014/03/31,2008/03/18,5,12,0.59296264,21761,5,11,1
18949,2014/03/31,2011/07/14,51,12,0.796622623,16196,51,11,1
18950,2014/03/31,2010/10/14,206,11,0.716876702,17997,206,9,2
18951,2014/03/31,2012/09/10,72,9,0.623971755,20676,72,2,7
18952,2014/03/31,2012/07/19,156,9,0.6982463740000001,18476,156,4,5
18953,2014/03/31,2012/02/14,194,11,0.782555205,16484,194,7,4
18954,2014/03/31,2010/09/08,6,12,0.6515501570000001,19798,6,2,10
18955,2014/03/31,2012/03/02,122,3,0.747183735,17264,122,0,3
18956,2014/03/31,2013/01/01,149,13,0.705266554,18289,149,3,10
18957,2014/03/31,2010/08/07,216,8,0.8387540640000001,15378,216,5,3
18958,2014/03/31,2011/12/29,69,13,0.8458344809999999,15249,69,2,11
18959,2014/03/31,2010/03/25,19,12,0.83321274,15479,19,8,4
18960,2014/03/31,2011/06/07,19,12,0.6979697990000001,18476,19,4,8
18961,2014/03/31,2011/09/26,103,15,0.528575176,24396,103,10,5
18962,2014/03/31,2009/01/28,21,10,0.7013370320000001,18384,21,4,6
18963,2014/03/31,2012/04/18,212,12,0.792506762,16268,212,6,6
18964,2014/03/31,2013/01/12,46,11,0.857363836,15037,46,3,8
18965,2014/03/31,2013/02/28,18,24,0.7197281,17911,18,7,17
18966,2014/03/31,2006/03/17,30,14,0.6097526129999999,21141,30,7,7
18967,2014/03/31,2009/10/16,215,10,0.972113122,13260,215,6,4
18968,2014/03/31,2011/12/13,274,13,0.68061731,18937,274,9,4
18969,2014/03/31,2006/11/15,26,10,0.726503382,17740,26,2,8
18970,2014/03/31,2012/02/07,68,10,0.7913071779999999,16287,68,8,2
18971,2014/03/31,2012/09/10,469,7,0.792857143,16254,469,7,0
18972,2014/03/31,2007/09/04,170,13,0.709971899,18149,170,10,3
18973,2014/03/31,2006/03/12,294,20,0.956131641,13476,294,18,2
18974,2014/03/31,2012/05/23,433,21,0.969503386,13290,433,21,0
18975,2014/03/31,2005/12/20,78,9,0.8078,15950,78,4,5
18976,2014/03/31,2009/09/23,4,14,0.639573095,20145,4,5,9
18977,2014/03/31,2012/08/04,173,14,0.620202667,20773,173,9,5
18978,2014/03/31,2011/11/08,22,12,0.6951888629999999,18532,22,6,6
18979,2014/03/31,2011/06/13,87,13,0.643737757,20012,87,7,6
18980,2014/03/31,2012/11/17,27,26,0.76238208,16897,27,0,26
18981,2014/03/31,2011/01/05,300,14,0.70452308,18284,300,12,2
18982,2014/03/31,2013/01/05,163,7,0.790534037,16291,163,2,5
18983,2014/03/31,2005/10/10,122,9,0.998792462,12894,122,3,6
18984,2014/03/31,2013/01/31,118,8,0.7414428000000001,17369,118,3,5
18985,2014/03/31,2011/03/03,18,19,0.7398299340000001,17405,18,10,9
18986,2014/03/31,2008/05/21,122,13,0.753323387,17091,122,10,3
18987,2014/03/31,2011/01/04,4,18,0.713033677,18054,4,7,11
18988,2014/03/31,2006/12/24,455,4,1.1875,10840,455,4,0
18989,2014/03/31,2008/01/11,151,10,0.788137399,16332,151,3,7
18990,2014/03/31,2007/02/18,10,18,0.6758081290000001,19044,10,8,10
18991,2014/03/31,2010/07/21,373,18,0.702398625,18323,373,18,0
18992,2014/03/31,2012/08/08,33,17,0.582005608,22113,33,9,8
18993,2014/03/31,2007/08/15,65,12,0.746138683,17248,65,3,9
18994,2014/03/31,2011/04/13,34,5,0.59501572,21628,34,1,4
18995,2014/03/31,2005/07/10,24,16,0.656920721,19589,24,8,8
18996,2014/03/31,2011/07/21,414,27,0.8877225059999999,14494,414,27,0
18997,2014/03/31,2012/05/23,7,12,0.660038479,19491,7,0,12
18998,2014/03/31,2005/07/12,87,21,0.585813826,21958,87,15,6
18999,2014/03/31,2012/04/25,417,13,0.553106992,23254,417,13,0
19000,2014/03/31,2012/10/22,4,16,0.4957197920000001,25945,4,4,12
19001,2014/03/31,2008/07/18,83,13,0.799920383,16077,83,4,9
19002,2014/03/31,2012/01/10,514,9,1.274819074,10087,514,9,0
19003,2014/03/31,2012/04/23,20,36,0.565553747,22736,20,11,25
19004,2014/03/31,2004/11/28,7,8,1.016250395,12652,7,5,3
19005,2014/03/31,2012/11/23,214,12,0.549903768,23381,214,3,9
19006,2014/03/31,2011/05/09,68,14,0.6937761709999999,18532,68,10,4
19007,2014/03/31,2006/08/09,38,20,0.562387472,22861,38,7,13
19008,2014/03/31,2010/05/07,137,8,0.853235548,15067,137,7,1
19009,2014/03/31,2005/06/19,90,12,0.643358523,19982,90,4,8
19010,2014/03/31,2012/06/26,141,23,0.7755061529999999,16576,141,16,7
19011,2014/03/31,2012/06/14,166,15,0.909729653,14130,166,12,3
19012,2014/03/31,2010/11/29,83,15,0.476326243,26986,83,6,9
19013,2014/03/31,2005/01/12,101,7,1.321035971,9730,101,3,4
19014,2014/03/31,2007/07/22,85,13,0.641558772,20035,85,5,8
19015,2014/03/31,2012/12/10,2,12,1.018656574,12617,2,9,3
19016,2014/03/31,2010/12/26,25,13,0.551493306,23304,25,5,8
19017,2014/03/31,2007/06/16,11,17,0.719744624,17856,11,11,6
19018,2014/03/31,2009/11/25,113,10,0.709526833,18112,113,2,8
19019,2014/03/31,2008/09/21,5,21,0.51754169,24826,5,9,12
19020,2014/03/31,2006/08/27,244,7,0.6983140390000001,18399,244,6,1
19021,2014/03/31,2007/01/18,43,11,0.7249416009999999,17723,43,7,4
19022,2014/03/31,2005/07/12,55,17,0.634471111,20250,55,7,10
19023,2014/03/31,2011/08/06,108,8,0.668316687,19224,108,2,6
19024,2014/03/31,2006/02/21,11,19,0.638902372,20107,11,7,12
19025,2014/03/31,2005/01/21,86,17,0.759151991,16922,86,14,3
19026,2014/03/31,2012/01/18,246,12,0.6884066670000001,18659,246,6,6
19027,2014/03/31,2007/08/08,44,10,0.817172668,15718,44,1,9
19028,2014/03/31,2011/08/06,94,11,0.6385813029999999,20110,94,7,4
19029,2014/03/31,2008/03/15,118,7,0.8079696740000001,15894,118,2,5
19030,2014/03/31,2011/04/10,109,10,0.6399825570000001,20065,109,4,6
19031,2014/03/31,2012/02/07,383,18,0.974002579,13184,383,18,0
19032,2014/03/31,2008/09/06,21,16,0.885250603,14505,21,12,4
19033,2014/03/31,2007/09/21,209,11,0.673495935,19065,209,9,2
19034,2014/03/31,2010/05/17,107,18,0.608086668,21115,107,10,8
19035,2014/03/31,2012/03/23,125,11,0.7521310999999999,17071,125,6,5
19036,2014/03/31,2012/12/20,21,8,0.729953946,17588,21,4,4
19037,2014/03/31,2013/01/03,73,13,0.689616459,18616,73,4,9
19038,2014/03/31,2011/01/18,74,11,0.6762487490000001,18983,74,8,3
19039,2014/03/31,2008/11/16,127,13,0.5779084320000001,22213,127,7,6
19040,2014/03/31,2011/10/16,116,16,0.719112095,17851,116,8,8
19041,2014/03/31,2012/06/08,135,14,0.5449229529999999,23557,135,7,7
19042,2014/03/31,2011/07/14,85,17,0.8763073459999999,14648,85,10,7
19043,2014/03/31,2011/01/06,68,25,0.698063306,18387,68,18,7
19044,2014/03/31,2009/07/21,2,18,0.702674915,18266,2,8,10
19045,2014/03/31,2009/08/05,257,13,0.70943124,18092,257,10,3
19046,2014/03/31,2009/07/03,312,12,0.780085699,16453,312,10,2
19047,2014/03/31,2011/01/15,115,21,0.8738271940000001,14687,115,6,15
19048,2014/03/31,2010/10/22,38,10,0.979358925,13103,38,6,4
19049,2014/03/31,2012/08/18,8,10,0.692193451,18537,8,1,9
19050,2014/03/31,2009/10/13,275,11,0.628485353,20414,275,6,5
19051,2014/03/31,2010/10/30,115,13,0.670905716,19123,115,7,6
19052,2014/03/31,2011/07/31,100,10,0.7094436759999999,18083,100,6,4
19053,2014/03/31,2011/01/11,33,20,0.708667477,18101,33,13,7
19054,2014/03/31,2006/08/22,25,9,0.7210500870000001,17789,25,6,3
19055,2014/03/31,2007/02/10,124,6,1.237322979,10366,124,0,6
19056,2014/03/31,2007/09/13,133,9,0.606388009,21149,133,5,4
19057,2014/03/31,2013/01/21,25,10,0.633982104,20228,25,2,8
19058,2014/03/31,2008/03/26,98,15,0.927803343,13821,98,13,2
19059,2014/03/31,2012/01/15,223,9,0.8710413690000001,14721,223,3,6
19060,2014/03/31,2007/11/20,59,7,0.680900112,18831,59,5,2
19061,2014/03/31,2009/10/14,69,19,0.689700882,18588,69,13,6
19062,2014/03/31,2012/09/07,6,18,0.627575268,20427,6,9,9
19063,2014/03/31,2008/04/17,60,4,1.211206538,10584,60,0,4
19064,2014/03/31,2011/01/26,197,12,0.8378607840000001,15300,197,9,3
19065,2014/03/31,2008/12/17,489,12,0.616950621,20778,489,12,0
19066,2014/03/31,2012/10/07,49,16,0.480974823,26651,49,1,15
19067,2014/03/31,2006/03/31,69,5,0.902,14210,69,0,5
19068,2014/03/31,2010/11/23,46,7,0.644285714,19894,46,4,3
19069,2014/03/31,2011/02/24,143,12,0.639334032,20046,143,2,10
19070,2014/03/31,2008/07/02,73,8,0.77125,16616,73,2,6
19071,2014/03/31,2008/02/27,20,25,0.928035055,13807,20,13,12
19072,2014/03/31,2011/11/16,100,15,0.776250454,16506,100,7,8
19073,2014/03/31,2013/01/10,22,20,0.618656205,20710,22,2,18
19074,2014/03/31,2007/11/14,33,18,0.83588243,15327,33,13,5
19075,2014/03/31,2010/05/06,282,12,0.8563473490000001,14959,282,9,3
19076,2014/03/31,2012/07/04,18,12,0.618620273,20707,18,6,6
19077,2014/03/31,2006/08/01,297,12,0.535373652,23926,297,9,3
19078,2014/03/31,2011/11/17,12,12,0.719979203,17791,12,9,3
19079,2014/03/31,2012/07/12,4,12,0.769429258,16645,4,7,5
19080,2014/03/31,2011/08/18,2,24,0.80851127,15839,2,13,11
19081,2014/03/31,2009/08/02,16,16,0.612916766,20893,16,0,16
19082,2014/03/31,2011/11/18,97,12,0.791765906,16173,97,6,6
19083,2014/03/31,2010/09/26,32,17,0.6600917620000001,19398,32,9,8
19084,2014/03/31,2011/11/14,394,6,0.811414628,15778,394,6,0
19085,2014/03/31,2010/04/06,50,13,0.6677508870000001,19172,50,7,6
19086,2014/03/31,2005/11/14,161,11,0.7829951070000001,16350,161,9,2
19087,2014/03/31,2009/12/19,78,24,0.8181151729999999,15646,78,9,15
19088,2014/03/31,2011/10/11,193,12,0.928082947,13792,193,5,7
19089,2014/03/31,2013/01/23,150,7,1.030151308,12425,150,0,7
19090,2014/03/31,2005/10/20,225,3,0.739712155,17301,225,0,3
19091,2014/03/31,2013/02/25,18,8,1.085566206,11789,18,1,7
19092,2014/03/31,2012/04/28,116,12,0.8332354470000001,15358,116,5,7
19093,2014/03/31,2011/03/08,251,8,0.72224969,17718,251,7,1
19094,2014/03/31,2011/03/17,16,18,0.698693421,18315,16,11,7
19095,2014/03/31,2006/11/01,18,12,0.560485326,22830,18,7,5
19096,2014/03/31,2012/08/23,62,10,0.6756875790000001,18936,62,4,6
19097,2014/03/31,2007/04/28,4,13,0.580779846,22030,4,5,8
19098,2014/03/31,2012/02/26,169,15,0.665331253,19230,169,9,6
19099,2014/03/31,2010/05/24,69,18,0.79095456,16175,69,14,4
19100,2014/03/31,2005/11/01,12,13,0.62135017,20590,12,4,9
19101,2014/03/31,2007/10/19,79,12,0.554973104,23052,79,3,9
19102,2014/03/31,2009/11/16,207,9,0.790862389,16176,207,8,1
19103,2014/03/31,2010/12/13,24,18,0.961206702,13309,24,6,12
19104,2014/03/31,2011/11/29,153,12,0.7419301709999999,17242,153,10,2
19105,2014/03/31,2010/08/31,26,21,0.649474433,19693,26,3,18
19106,2014/03/31,2012/07/04,339,8,0.830186291,15406,339,7,1
19107,2014/03/31,2013/02/05,234,6,0.495014708,25836,234,4,2
19108,2014/03/31,2011/05/27,14,8,0.909157543,14066,14,4,4
19109,2014/03/31,2011/11/10,21,12,0.835111996,15313,21,5,7
19110,2014/03/31,2011/06/21,37,11,0.587414791,21770,37,1,10
19111,2014/03/31,2010/04/23,488,13,0.7076923079999999,18070,488,13,0
19112,2014/03/31,2006/11/02,132,16,0.555364371,23026,132,10,6
19113,2014/03/31,2007/10/28,149,14,0.662395234,19305,149,12,2
19114,2014/03/31,2006/02/28,112,19,0.568358594,22499,112,15,4
19115,2014/03/31,2012/08/31,45,13,0.656637568,19474,45,2,11
19116,2014/03/31,2010/03/23,17,16,0.77987375,16396,17,6,10
19117,2014/03/31,2006/08/08,87,6,0.795654636,16070,87,1,5
19118,2014/03/31,2010/01/10,7,18,0.7679608379999999,16649,7,1,17
19119,2014/03/31,2007/05/31,275,9,0.8505408459999999,15032,275,7,2
19120,2014/03/31,2012/02/15,59,9,0.790468093,16172,59,3,6
19121,2014/03/31,2011/07/28,67,11,0.537304023,23791,67,6,5
19122,2014/03/31,2012/09/09,568,2,1.029555412,12416,568,2,0
19123,2014/03/31,2006/04/29,27,14,0.7454951590000001,17146,27,9,5
19124,2014/03/31,2009/08/01,26,14,0.701071056,18225,26,5,9
19125,2014/03/31,2006/10/16,74,12,0.724747859,17629,74,0,12
19126,2014/03/31,2012/11/16,9,15,0.8093019570000001,15787,9,6,9
19127,2014/03/31,2009/12/16,24,23,0.515531211,24783,24,13,10
19128,2014/03/31,2008/03/02,96,17,0.815757885,15662,96,9,8
19129,2014/03/31,2010/11/12,9,7,0.790988793,16151,9,6,1
19130,2014/03/31,2011/11/27,73,15,0.628573116,20324,73,7,8
19131,2014/03/31,2008/10/17,9,13,0.820850093,15563,9,6,7
19132,2014/03/31,2009/11/27,34,13,0.847155647,15079,34,6,7
19133,2014/03/31,2009/09/28,21,8,0.9745243,13107,21,5,3
19134,2014/03/31,2007/05/01,58,10,0.6401207839999999,19953,58,2,8
19135,2014/03/31,2011/06/18,4,16,0.747048605,17097,4,10,6
19136,2014/03/31,2009/09/03,34,14,0.879835354,14516,34,3,11
19137,2014/03/31,2010/11/29,21,12,0.626766294,20376,21,9,3
19138,2014/03/31,2012/12/19,215,8,0.8851351540000001,14428,215,2,6
19139,2014/03/31,2011/05/09,74,9,0.712447693,17923,74,1,8
19140,2014/03/31,2012/03/15,20,8,0.8864648709999999,14404,20,4,4
19141,2014/03/31,2010/10/22,347,13,0.850502897,15013,347,12,1
19142,2014/03/31,2011/10/24,142,12,0.809405388,15775,142,6,6
19143,2014/03/31,2011/07/23,63,12,0.602813164,21179,63,7,5
19144,2014/03/31,2011/11/07,202,5,1.019323698,12524,202,2,3
19145,2014/03/31,2004/12/02,2,15,0.637055095,20038,2,2,13
19146,2014/03/31,2006/08/24,3,15,0.59088784,21603,3,3,12
19147,2014/03/31,2012/12/28,144,12,0.685476318,18622,144,1,11
19148,2014/03/31,2010/06/18,114,18,0.670086107,19046,114,10,8
19149,2014/03/31,2012/03/02,452,6,0.691081388,18467,452,6,0
19150,2014/03/31,2012/05/01,346,11,0.7691892709999999,16590,346,10,1
19151,2014/03/31,2006/11/26,42,16,0.591362035,21578,42,5,11
19152,2014/03/31,2012/11/28,71,12,0.689597881,18502,71,6,6
19153,2014/03/31,2006/08/16,34,28,0.551758218,23120,34,13,15
19154,2014/03/31,2011/09/12,3,10,0.793698357,16072,3,2,8
19155,2014/03/31,2006/08/20,111,15,0.6843050270000001,18641,111,9,6
19156,2014/03/31,2007/03/05,286,8,0.898183354,14202,286,6,2
19157,2014/03/31,2010/04/10,119,14,0.709459339,17978,119,9,5
19158,2014/03/31,2007/02/11,19,16,0.5605414670000001,22753,19,7,9
19159,2014/03/31,2012/08/01,6,15,0.654181883,19496,6,4,11
19160,2014/03/31,2011/07/17,261,13,0.950913361,13412,261,9,4
19161,2014/03/31,2010/09/08,33,18,0.630393456,20231,33,9,9
19162,2014/03/31,2012/09/11,84,13,0.636738566,20028,84,7,6
19163,2014/03/31,2011/07/24,77,10,0.728176679,17512,77,5,5
19164,2014/03/31,2008/12/02,69,18,0.53223609,23957,69,6,12
19165,2014/03/31,2012/07/21,42,15,0.7719831659999999,16514,42,5,10
19166,2014/03/31,2007/11/23,68,14,0.641583291,19870,68,2,12
19167,2014/03/31,2012/06/05,19,17,0.7735163829999999,16480,19,5,12
19168,2014/03/31,2009/03/13,150,27,0.666457179,19126,150,17,10
19169,2014/03/31,2013/01/01,94,11,0.716759264,17783,94,5,6
19170,2014/03/31,2012/04/13,163,14,0.6496442410000001,19620,163,8,6
19171,2014/03/31,2005/07/28,345,7,1.04130719,12240,345,6,1
19172,2014/03/31,2010/04/28,73,13,0.614020042,20756,73,5,8
19173,2014/03/31,2012/05/01,141,12,0.8541769440000001,14920,141,8,4
19174,2014/03/31,2011/08/05,60,20,0.594092117,21451,60,14,6
19175,2014/03/31,2008/05/16,13,10,0.78904526,16151,13,4,6
19176,2014/03/31,2011/07/19,39,10,0.715033666,17822,39,1,9
19177,2014/03/31,2012/10/04,185,9,0.80325643,15864,185,3,6
19178,2014/03/31,2009/01/17,93,10,0.605025877,21061,93,6,4
19179,2014/03/31,2011/01/15,10,17,0.624775914,20394,10,7,10
19180,2014/03/31,2012/04/10,168,10,0.978298526,13024,168,6,4
19181,2014/03/31,2007/10/29,2,12,0.7292786809999999,17468,2,3,9
19182,2014/03/31,2012/04/30,9,14,0.714655259,17825,9,3,11
19183,2014/03/31,2010/12/22,158,15,0.7792340170000001,16345,158,7,8
19184,2014/03/31,2009/11/27,494,5,0.751147087,16956,494,5,0
19185,2014/03/31,2011/09/21,15,22,0.710935529,17915,15,11,11
19186,2014/03/31,2005/12/01,569,2,0.996553991,12780,569,2,0
19187,2014/03/31,2012/05/09,492,8,0.649067326,19621,492,8,0
19188,2014/03/31,2008/06/12,435,12,0.589835101,21589,435,12,0
19189,2014/03/31,2009/08/16,29,12,0.708975501,17960,29,9,3
19190,2014/03/31,2009/12/22,8,15,0.748453354,17011,8,9,6
19191,2014/03/31,2011/05/23,8,7,1.465614136,8687,8,4,3
19192,2014/03/31,2010/11/10,120,13,0.658194696,19343,120,6,7
19193,2014/03/31,2006/09/26,31,11,0.434739286,29285,31,4,7
19194,2014/03/31,2008/06/11,138,8,0.820356383,15517,138,5,3
19195,2014/03/31,2011/04/07,38,23,0.813969178,15638,38,7,16
19196,2014/03/31,2007/02/15,139,12,0.536143802,23741,139,5,7
19197,2014/03/31,2011/04/26,6,20,0.7994234029999999,15921,6,10,10
19198,2014/03/31,2005/12/25,5,10,1.035302205,12293,5,5,5
19199,2014/03/31,2011/04/22,390,13,0.703093752,18101,390,13,0
19200,2014/03/31,2011/08/07,282,9,0.915762395,13897,282,8,1
19201,2014/03/31,2011/11/30,102,17,0.78340495,16244,102,13,4
19202,2014/03/31,2013/02/01,41,11,0.645900924,19702,41,0,11
19203,2014/03/31,2011/09/02,35,8,0.685,18576,35,3,5
19204,2014/03/31,2009/11/09,97,9,0.685669559,18557,97,3,6
19205,2014/03/31,2009/10/01,23,10,0.7794009190000001,16325,23,3,7
19206,2014/03/31,2012/12/12,147,13,0.786819615,16171,147,3,10
19207,2014/03/31,2012/10/12,58,3,0.630256588,20188,58,1,2
19208,2014/03/31,2011/01/13,74,8,0.840488208,15137,74,0,8
19209,2014/03/31,2007/07/03,13,15,0.786000742,16183,13,6,9
19210,2014/03/31,2011/11/18,93,12,0.7359497770000001,17283,93,9,3
19211,2014/03/31,2007/06/30,77,17,0.72695759,17496,77,8,9
19212,2014/03/31,2008/01/28,101,14,0.6814520709999999,18663,101,8,6
19213,2014/03/31,2007/12/08,159,14,0.635610256,20008,159,12,2
19214,2014/03/31,2007/10/22,70,8,1.3727396369999998,9264,70,5,3
19215,2014/03/31,2007/05/14,27,16,0.755200428,16839,27,11,5
19216,2014/03/31,2012/12/15,185,14,0.7602857829999999,16726,185,4,10
19217,2014/03/31,2011/03/02,9,19,0.755124109,16840,9,10,9
19218,2014/03/31,2012/08/01,116,4,0.691508511,18389,116,2,2
19219,2014/03/31,2010/04/11,237,12,0.8028690490000001,15838,237,7,5
19220,2014/03/31,2008/12/30,177,11,0.8157220759999999,15587,177,7,4
19221,2014/03/31,2010/01/29,15,10,0.7790459559999999,16320,15,6,4
19222,2014/03/31,2011/07/11,44,9,0.852521961,14913,44,2,7
19223,2014/03/31,2005/08/30,32,24,0.591181395,21500,32,8,16
19224,2014/03/31,2006/09/29,17,10,0.7386052190000001,17207,17,4,6
19225,2014/03/31,2008/04/11,72,11,0.958669382,13257,72,2,9
19226,2014/03/31,2012/02/03,136,10,0.923746911,13758,136,6,4
19227,2014/03/31,2012/03/02,102,7,1.038154412,12240,102,5,2
19228,2014/03/31,2009/11/20,49,9,0.717777778,17703,49,4,5
19229,2014/03/31,2011/02/05,68,15,0.684274328,18569,68,12,3
19230,2014/03/31,2007/05/06,43,12,0.633117744,20069,43,3,9
19231,2014/03/31,2012/02/17,223,8,1.194064468,10641,223,3,5
19232,2014/03/31,2011/11/28,35,19,0.690502147,18401,35,11,8
19233,2014/03/31,2009/09/19,8,18,0.756368615,16798,8,8,10
19234,2014/03/31,2012/04/09,130,12,0.5376598539999999,23631,130,5,7
19235,2014/03/31,2012/12/11,49,12,0.56405967,22524,49,1,11
19236,2014/03/31,2010/08/12,13,9,0.527215952,24098,13,4,5
19237,2014/03/31,2012/07/03,132,8,0.8874029059999999,14316,132,5,3
19238,2014/03/31,2008/03/24,232,6,0.915745801,13871,232,1,5
19239,2014/03/31,2009/12/03,51,2,0.835,15212,51,1,1
19240,2014/03/31,2006/03/22,21,12,0.762525665,16657,21,4,8
19241,2014/03/31,2012/05/13,189,12,0.679325524,18696,189,8,4
19242,2014/03/31,2007/09/23,146,9,0.494363176,25690,146,6,3
19243,2014/03/31,2009/03/31,29,6,0.518659642,24486,29,0,6
19244,2014/03/31,2006/10/23,22,17,0.6004595739999999,21150,22,10,7
19245,2014/03/31,2010/06/14,648,5,0.867595819,14637,648,5,0
19246,2014/03/31,2011/11/26,170,15,0.615791388,20622,170,11,4
19247,2014/03/31,2011/07/06,269,12,0.799661188,15879,269,10,2
19248,2014/03/31,2012/10/08,91,14,0.5863361810000001,21655,91,6,8
19249,2014/03/31,2012/07/30,24,12,0.766171253,16572,24,6,6
19250,2014/03/31,2008/06/07,66,8,0.926513427,13704,66,4,4
19251,2014/03/31,2012/07/21,2,13,0.7117439320000001,17839,2,2,11
19252,2014/03/31,2012/09/20,23,8,0.635875989,19966,23,4,4
19253,2014/03/31,2009/01/21,34,14,0.729375503,17406,34,6,8
19254,2014/03/31,2006/12/15,29,11,0.616016304,20609,29,5,6
19255,2014/03/31,2011/05/08,38,20,0.78910368,16088,38,8,12
19256,2014/03/31,2008/08/17,340,12,0.589177961,21544,340,7,5
19257,2014/03/31,2011/12/03,252,7,0.80402293,15787,252,4,3
19258,2014/03/31,2011/07/25,23,8,0.705222537,17997,23,4,4
19259,2014/03/31,2011/11/29,114,11,0.670586526,18925,114,6,5
19260,2014/03/31,2012/09/11,51,16,0.710853126,17852,51,4,12
19261,2014/03/31,2008/03/24,74,16,0.638387584,19877,74,5,11
19262,2014/03/31,2012/11/17,137,11,0.989228191,12827,137,2,9
19263,2014/03/31,2010/04/25,45,14,0.8706422840000001,14573,45,8,6
19264,2014/03/31,2011/09/30,59,25,0.6834967409999999,18563,59,15,10
19265,2014/03/31,2011/04/22,27,21,0.697157224,18197,27,11,10
19266,2014/03/31,2011/03/26,169,13,0.5820672720000001,21792,169,6,7
19267,2014/03/31,2007/11/12,25,18,0.72275416,17548,25,7,11
19268,2014/03/31,2012/12/04,15,19,0.727813612,17426,15,7,12
19269,2014/03/31,2008/08/07,19,8,0.573824993,22102,19,1,7
19270,2014/03/31,2010/03/03,7,11,0.6062507770000001,20919,7,3,8
19271,2014/03/31,2010/02/08,117,20,0.654387223,19379,117,14,6
19272,2014/03/31,2011/03/22,129,9,1.237780381,10245,129,2,7
19273,2014/03/31,2011/04/12,90,17,0.52901506,23971,90,11,6
19274,2014/03/31,2011/02/04,10,12,0.639733111,19821,10,3,9
19275,2014/03/31,2006/07/07,25,17,0.620487888,20435,25,4,13
19276,2014/03/31,2011/11/22,13,18,0.649277374,19526,13,7,11
19277,2014/03/31,2009/07/01,65,8,0.867849808,14608,65,4,4
19278,2014/03/31,2011/04/07,100,13,0.580014641,21857,100,6,7
19279,2014/03/31,2012/10/13,153,10,1.423916657,8903,153,2,8
19280,2014/03/31,2005/11/02,63,14,0.80228783,15801,63,11,3
19281,2014/03/31,2011/03/02,74,15,0.763069468,16612,74,4,11
19282,2014/03/31,2006/12/25,15,19,0.8937227670000001,14183,15,8,11
19283,2014/03/31,2012/08/05,15,10,0.637893916,19871,15,4,6
19284,2014/03/31,2013/03/13,89,12,0.8225887470000001,15409,89,2,10
19285,2014/03/31,2006/09/04,34,14,0.7873148609999999,16096,34,6,8
19286,2014/03/31,2011/10/26,237,8,0.79875,15864,237,4,4
19287,2014/03/31,2006/09/16,8,9,0.790527202,16028,8,3,6
19288,2014/03/31,2006/08/31,195,9,0.8202667359999999,15446,195,7,2
19289,2014/03/31,2011/03/29,24,15,0.7805662,16231,24,8,7
19290,2014/03/31,2007/08/27,23,13,0.842611588,15033,23,8,5
19291,2014/03/31,2011/06/01,4,14,0.70048941,18083,4,0,14
19292,2014/03/31,2012/09/29,65,2,0.835,15168,65,1,1
19293,2014/03/31,2010/10/22,49,2,0.835,15168,49,1,1
19294,2014/03/31,2010/07/22,10,13,0.518787122,24413,10,9,4
19295,2014/03/31,2009/12/10,133,13,0.68566192,18469,133,12,1
19296,2014/03/31,2009/02/24,120,14,0.664304076,19061,120,10,4
19297,2014/03/31,2008/08/19,347,3,0.7695393220000001,16454,347,2,1
19298,2014/03/31,2008/04/26,175,7,0.52362561,24178,175,2,5
19299,2014/03/31,2012/01/12,42,15,0.751335905,16850,42,5,10
19300,2014/03/31,2012/03/24,23,13,0.7162381170000001,17672,23,6,7
19301,2014/03/31,2006/03/03,19,11,0.79361402,15949,19,0,11
19302,2014/03/31,2011/10/27,31,19,0.43964674,28789,31,13,6
19303,2014/03/31,2010/03/01,102,10,0.649688398,19480,102,3,7
19304,2014/03/31,2013/01/10,18,40,0.877905105,14416,18,4,36
19305,2014/03/31,2010/09/20,3,15,0.7062908809999999,17918,3,4,11
19306,2014/03/31,2012/08/21,84,12,0.759481486,16663,84,5,7
19307,2014/03/31,2009/12/31,98,15,0.654892362,19324,98,7,8
19308,2014/03/31,2008/03/29,39,8,0.68125,18576,39,3,5
19309,2014/03/31,2007/12/26,114,9,0.802675082,15764,114,3,6
19310,2014/03/31,2010/11/19,33,15,0.775132933,16324,33,6,9
19311,2014/03/31,2011/09/08,68,9,0.519861123,24338,68,5,4
19312,2014/03/31,2012/07/02,458,12,0.7927304629999999,15957,458,12,0
19313,2014/03/31,2010/05/25,18,8,0.703444,17982,18,1,7
19314,2014/03/31,2011/05/04,76,13,0.809708725,15621,76,8,5
19315,2014/03/31,2005/11/25,29,12,0.526034024,24042,29,7,5
19316,2014/03/31,2012/05/18,96,13,0.779720698,16219,96,6,7
19317,2014/03/31,2009/09/30,106,12,0.596997923,21182,106,5,7
19318,2014/03/31,2006/04/27,81,14,0.617939696,20463,81,4,10
19319,2014/03/31,2012/10/13,40,16,0.575261386,21979,40,1,15
19320,2014/03/31,2007/06/08,141,8,0.7912058820000001,15980,141,6,2
19321,2014/03/31,2013/03/25,2,14,0.532479363,23744,2,1,13
19322,2014/03/31,2008/01/03,289,7,0.64,19754,289,6,1
19323,2014/03/31,2012/09/19,5,16,0.644039735,19630,5,7,9
19324,2014/03/31,2006/04/11,87,10,0.747855072,16905,87,2,8
19325,2014/03/31,2011/03/18,17,9,0.8284894159999999,15259,17,5,4
19326,2014/03/31,2012/03/16,215,14,0.80067773,15788,215,12,2
19327,2014/03/31,2006/10/17,128,13,0.72275659,17489,128,6,7
19328,2014/03/31,2011/10/10,356,10,0.958313116,13190,356,9,1
19329,2014/03/31,2011/06/21,97,11,0.74371205,16996,97,9,2
19330,2014/03/31,2005/05/09,36,13,0.7042249829999999,17948,36,5,8
19331,2014/03/31,2012/01/26,227,15,0.645550335,19579,227,11,4
19332,2014/03/31,2013/02/28,26,11,0.765323968,16514,26,1,10
19333,2014/03/31,2010/03/19,85,11,0.5895418920000001,21436,85,6,5
19334,2014/03/31,2011/09/17,50,7,0.784614716,16105,50,2,5
19335,2014/03/31,2012/06/25,14,16,0.548509355,23037,14,6,10
19336,2014/03/31,2005/03/22,1,23,0.733617627,17224,1,15,8
19337,2014/03/31,2012/06/11,123,7,0.816035262,15484,123,6,1
19338,2014/03/31,2012/11/06,3,11,0.593066091,21304,3,1,10
19339,2014/03/31,2010/07/16,71,19,0.7516747979999999,16808,71,11,8
19340,2014/03/31,2010/10/08,2,16,0.6794181229999999,18595,2,7,9
19341,2014/03/31,2010/08/25,90,13,0.721598698,17508,90,9,4
19342,2014/03/31,2012/11/16,75,13,0.815140018,15498,75,3,10
19343,2014/03/31,2012/10/01,79,11,0.622062241,20308,79,7,4
19344,2014/03/31,2007/09/21,24,18,0.735444276,17174,24,13,5
19345,2014/03/31,2012/09/11,10,10,0.769986588,16403,10,5,5
19346,2014/03/31,2007/05/16,63,12,0.79520811,15881,63,5,7
19347,2014/03/31,2006/04/30,18,7,0.963922601,13101,18,2,5
19348,2014/03/31,2012/03/21,274,11,0.735222403,17176,274,6,5
19349,2014/03/31,2010/07/29,408,13,0.866663235,14571,408,13,0
19350,2014/03/31,2011/04/01,73,6,0.575164905,21952,73,2,4
19351,2014/03/31,2007/10/14,96,24,0.7500065340000001,16834,96,5,19
19352,2014/03/31,2010/09/03,61,14,0.675758176,18683,61,7,7
19353,2014/03/31,2012/03/01,35,17,0.6951731729999999,18161,35,8,9
19354,2014/03/31,2012/12/04,108,16,0.675655874,18685,108,4,12
19355,2014/03/31,2010/02/14,1,15,0.6788116359999999,18597,1,6,9
19356,2014/03/31,2009/09/16,217,11,0.588822706,21439,217,5,6
19357,2014/03/31,2011/11/14,487,11,0.673676486,18738,487,11,0
19358,2014/03/31,2008/06/19,8,13,0.623404119,20249,8,3,10
19359,2014/03/31,2012/09/08,123,12,0.607115718,20792,123,9,3
19360,2014/03/31,2007/07/16,13,10,0.6543582170000001,19290,13,2,8
19361,2014/03/31,2012/08/06,58,10,0.770115931,16389,58,5,5
19362,2014/03/31,2013/03/10,100,13,1.257487297,10037,100,0,13
19363,2014/03/31,2010/05/20,95,20,0.538999359,23415,95,8,12
19364,2014/03/31,2010/03/31,54,9,0.574889537,21953,54,3,6
19365,2014/03/31,2006/09/13,101,12,0.568610948,22195,101,9,3
19366,2014/03/31,2009/11/11,88,19,0.618663594,20398,88,13,6
19367,2014/03/31,2010/01/01,25,17,0.681721679,18511,25,12,5
19368,2014/03/31,2008/03/10,230,11,0.785660565,16062,230,8,3
19369,2014/03/31,2005/12/27,459,11,0.944096962,13366,459,11,0
19370,2014/03/31,2013/01/14,430,2,0.625,20188,430,2,0
19371,2014/03/31,2009/05/31,175,21,0.583550416,21620,175,11,10
19372,2014/03/31,2011/05/07,77,17,0.5866917779999999,21504,77,9,8
19373,2014/03/31,2008/08/06,171,10,0.720703348,17502,171,3,7
19374,2014/03/31,2008/08/18,127,12,0.6673076920000001,18902,127,3,9
19375,2014/03/31,2013/01/04,28,19,0.544092399,23182,28,4,15
19376,2014/03/31,2009/03/23,111,12,0.852439849,14796,111,3,9
19377,2014/03/31,2012/09/08,536,4,0.701510095,17979,536,4,0
19378,2014/03/31,2009/01/01,90,16,0.7542129190000001,16720,90,9,7
19379,2014/03/31,2012/01/01,34,8,0.7775514859999999,16218,34,1,7
19380,2014/03/31,2006/01/08,144,8,0.8441036279999999,14938,144,6,2
19381,2014/03/31,2010/08/09,482,11,0.65080795,19370,482,11,0
19382,2014/03/31,2009/10/24,110,8,0.719747059,17514,110,5,3
19383,2014/03/31,2007/05/14,71,17,0.584339623,21571,71,7,10
19384,2014/03/31,2008/03/08,327,13,0.7564668109999999,16662,327,11,2
19385,2014/03/31,2012/07/10,382,12,0.70187949,17957,382,12,0
19386,2014/03/31,2009/07/06,5,15,0.639705106,19702,5,5,10
19387,2014/03/31,2012/03/22,145,13,0.5947187620000001,21192,145,7,6
19388,2014/03/31,2007/04/01,333,6,1.5,8402,333,5,1
19389,2014/03/31,2012/04/15,15,19,0.7793685840000001,16170,15,11,8
19390,2014/03/31,2012/08/28,4,14,0.6778526090000001,18590,4,6,8
19391,2014/03/31,2009/10/08,28,13,0.6128719420000001,20561,28,6,7
19392,2014/03/31,2010/09/12,22,11,0.863257519,14597,22,4,7
19393,2014/03/31,2012/04/25,136,9,0.780924698,16135,136,6,3
19394,2014/03/31,2011/07/20,166,11,0.735511384,17130,166,7,4
19395,2014/03/31,2011/12/27,62,15,0.730066647,17255,62,12,3
19396,2014/03/31,2009/03/28,4,15,0.78751938,15996,4,3,12
19397,2014/03/31,2009/08/19,85,16,0.71230095,17684,85,13,3
19398,2014/03/31,2007/10/22,47,16,0.8146568790000001,15461,47,12,4
19399,2014/03/31,2008/09/04,276,12,0.723957579,17397,276,9,3
19400,2014/03/31,2008/05/22,402,6,1.105398051,11393,402,6,0
19401,2014/03/31,2008/11/12,80,18,0.648734803,19412,80,8,10
19402,2014/03/31,2011/07/19,69,11,0.725565543,17355,69,6,5
19403,2014/03/31,2011/09/09,176,15,0.6920000000000001,18195,176,11,4
19404,2014/03/31,2007/03/21,123,10,0.7480061790000001,16832,123,1,9
19405,2014/03/31,2008/02/26,5,12,0.648019455,19429,5,4,8
19406,2014/03/31,2009/03/14,96,16,0.749547538,16797,96,10,6
19407,2014/03/31,2009/04/21,128,12,0.849817065,14814,128,8,4
19408,2014/03/31,2012/06/08,50,6,1.00455075,12532,50,3,3
19409,2014/03/31,2010/09/27,46,19,0.464533009,27099,46,5,14
19410,2014/03/31,2007/07/30,119,16,0.712488255,17667,119,12,4
19411,2014/03/31,2010/09/26,216,14,0.774759648,16247,216,10,4
19412,2014/03/31,2005/03/02,141,12,0.8086028140000001,15567,141,7,5
19413,2014/03/31,2012/08/13,4,15,0.637262556,19752,4,9,6
19414,2014/03/31,2008/10/09,16,18,0.546714155,23023,16,8,10
19415,2014/03/31,2007/05/28,231,16,0.7860019979999999,16013,231,11,5
19416,2014/03/31,2012/10/16,46,9,0.683768675,18407,46,2,7
19417,2014/03/31,2011/08/05,9,8,1.424876033,8833,9,0,8
19418,2014/03/31,2010/05/04,142,10,0.742352247,16954,142,5,5
19419,2014/03/31,2007/09/19,11,9,0.773146157,16277,11,0,9
19420,2014/03/31,2012/04/12,34,8,0.850526529,14795,34,4,4
19421,2014/03/31,2008/06/17,28,18,0.655072102,19209,28,7,11
19422,2014/03/31,2010/11/16,16,9,0.6941523690000001,18127,16,4,5
19423,2014/03/31,2012/02/14,82,22,0.609851687,20632,82,12,10
19424,2014/03/31,2008/09/04,97,13,0.70236184,17914,97,6,7
19425,2014/03/31,2013/03/21,25,15,0.69354115,18141,25,0,15
19426,2014/03/31,2007/03/08,69,12,0.8824028620000001,14258,69,9,3
19427,2014/03/31,2011/09/07,6,11,0.670033019,18777,6,3,8
19428,2014/03/31,2012/01/13,472,14,0.734273958,17134,472,14,0
19429,2014/03/31,2011/07/21,82,14,0.706081491,17818,82,5,9
19430,2014/03/31,2012/04/22,39,10,0.681648244,18456,39,8,2
19431,2014/03/31,2012/03/14,18,27,0.738334898,17038,18,14,13
19432,2014/03/31,2012/09/10,44,5,0.520017362,24191,44,1,4
19433,2014/03/31,2012/06/26,8,6,0.622060627,20222,8,0,6
19434,2014/03/31,2013/01/01,2,14,0.6069040379999999,20727,2,0,14
19435,2014/03/31,2012/06/16,14,26,0.705810561,17821,14,7,19
19436,2014/03/31,2008/02/19,49,20,0.60177042,20899,49,9,11
19437,2014/03/31,2005/12/13,1,9,0.7107120659999999,17695,1,3,6
19438,2014/03/31,2008/02/09,37,9,0.717317477,17532,37,2,7
19439,2014/03/31,2012/12/03,10,8,0.93890996,13394,10,3,5
19440,2014/03/31,2011/10/12,162,6,0.46382635,27112,162,3,3
19441,2014/03/31,2008/07/11,33,19,0.707135868,17782,33,8,11
19442,2014/03/31,2006/06/25,94,13,0.575187777,21861,94,10,3
19443,2014/03/31,2012/08/31,51,16,0.554920334,22657,51,9,7
19444,2014/03/31,2012/11/13,115,12,0.671095452,18732,115,4,8
19445,2014/03/31,2010/03/09,9,26,0.863336538,14560,9,0,26
19446,2014/03/31,2013/01/05,57,9,0.911415416,13791,57,1,8
19447,2014/03/31,2013/03/05,4,9,0.81750374,15375,4,0,9
19448,2014/03/31,2011/08/11,46,8,0.8320508409999999,15106,46,0,8
19449,2014/03/31,2013/01/01,129,9,0.632063364,19885,129,0,9
19450,2014/03/31,2009/11/06,149,18,0.826121738,15213,149,16,2
19451,2014/03/31,2010/02/16,13,13,0.63369403,19832,13,4,9
19452,2014/03/31,2011/03/19,68,14,0.769786217,16325,68,8,6
19453,2014/03/31,2012/02/12,25,10,0.64371171,19522,25,5,5
19454,2014/03/31,2009/01/28,260,6,0.936610271,13417,260,4,2
19455,2014/03/31,2012/12/28,94,10,0.962057878,13062,94,4,6
19456,2014/03/31,2011/08/24,186,11,0.942783405,13329,186,9,2
19457,2014/03/31,2010/10/20,66,18,0.472450276,26597,66,13,5
19458,2014/03/31,2011/08/15,41,11,1.015822754,12367,41,5,6
19459,2014/03/31,2006/04/04,103,17,0.8569738729999999,14659,103,12,5
19460,2014/03/31,2005/10/24,275,4,0.541682118,23191,275,2,2
19461,2014/03/31,2013/03/06,3,9,0.8598302529999999,14610,3,1,8
19462,2014/03/31,2012/11/04,67,15,0.59010241,21287,67,4,11
19463,2014/03/31,2012/06/16,27,16,0.7609189479999999,16508,27,10,6
19464,2014/03/31,2006/04/04,462,14,0.814697107,15418,462,14,0
19465,2014/03/31,2012/12/28,143,9,0.70813846,17738,143,4,5
19466,2014/03/31,2008/09/01,275,14,0.360508309,34841,275,10,4
19467,2014/03/31,2006/04/05,46,8,0.5875,21376,46,4,4
19468,2014/03/31,2012/08/24,7,28,0.6758688979999999,18581,7,4,24
19469,2014/03/31,2013/01/16,79,11,0.587167773,21386,79,3,8
19470,2014/03/31,2009/02/08,18,14,0.609937339,20587,18,5,9
19471,2014/03/31,2011/11/01,216,11,0.797727937,15739,216,8,3
19472,2014/03/31,2012/03/21,114,13,0.59621664,21058,114,10,3
19473,2014/03/31,2012/05/05,614,6,0.791666667,15858,614,6,0
19474,2014/03/31,2006/07/23,144,11,0.635727452,19747,144,8,3
19475,2014/03/31,2012/12/08,179,18,0.689017455,18218,179,7,11
19476,2014/03/31,2012/03/22,47,12,0.714554822,17566,47,7,5
19477,2014/03/31,2012/09/22,26,4,0.767758747,16348,26,1,3
19478,2014/03/31,2011/12/03,46,7,0.954102623,13155,46,5,2
19479,2014/03/31,2011/09/23,18,6,1.099189,11418,18,2,4
19480,2014/03/31,2012/08/08,373,7,0.773203722,16228,373,7,0
19481,2014/03/31,2006/05/04,132,10,0.7886511629999999,15910,132,6,4
19482,2014/03/31,2007/12/30,26,16,0.760295098,16503,26,10,6
19483,2014/03/31,2012/04/07,15,8,0.6492997979999999,19323,15,5,3
19484,2014/03/31,2012/12/18,35,9,0.812322585,15444,35,0,9
19485,2014/03/31,2010/04/12,44,12,0.634749039,19764,44,6,6
19486,2014/03/31,2010/08/03,7,19,0.641844973,19545,7,5,14
19487,2014/03/31,2012/12/08,74,10,0.825447486,15196,74,4,6
19488,2014/03/31,2009/08/30,492,2,0.825,15204,492,2,0
19489,2014/03/31,2006/01/22,127,12,0.885477266,14164,127,8,4
19490,2014/03/31,2009/11/02,280,14,0.905212935,13854,280,12,2
19491,2014/03/31,2010/02/01,259,8,0.776805005,16144,259,4,4
19492,2014/03/31,2012/01/10,79,14,0.764907283,16394,79,11,3
19493,2014/03/31,2013/01/01,426,5,0.620262182,20215,426,5,0
19494,2014/03/31,2012/02/06,62,18,0.6856075690000001,18286,62,8,10
19495,2014/03/31,2010/12/06,41,8,0.542623788,23104,41,1,7
19496,2014/03/31,2009/04/21,338,13,0.7326028520000001,17112,338,10,3
19497,2014/03/31,2010/06/26,5,16,0.624980556,20058,5,9,7
19498,2014/03/31,2010/12/09,571,6,1.419637599,8830,571,6,0
19499,2014/03/31,2012/10/30,225,11,0.601076532,20854,225,5,6
19500,2014/03/31,2005/11/16,26,14,0.848984015,14764,26,9,5
19501,2014/03/31,2009/09/30,100,20,0.842400699,14879,100,15,5
19502,2014/03/31,2013/03/20,358,4,0.767357497,16333,358,0,4
19503,2014/03/31,2006/02/02,271,9,0.694191315,18054,271,7,2
19504,2014/03/31,2007/04/20,39,15,0.774563041,16180,39,8,7
19505,2014/03/31,2007/09/06,23,12,0.889814683,14084,23,5,7
19506,2014/03/31,2012/06/15,8,11,0.6545847260000001,19144,8,3,8
19507,2014/03/31,2012/08/18,184,10,0.76725447,16332,184,7,3
19508,2014/03/31,2010/05/18,30,14,0.6875248290000001,18225,30,6,8
19509,2014/03/31,2012/08/26,250,13,0.669628541,18710,250,12,1
19510,2014/03/31,2012/03/16,501,9,0.677185017,18501,501,9,0
19511,2014/03/31,2010/01/16,127,3,0.7952910559999999,15753,127,0,3
19512,2014/03/31,2009/03/20,245,19,0.757079052,16546,245,15,4
19513,2014/03/31,2012/01/17,11,12,0.643178784,19476,11,6,6
19514,2014/03/31,2010/08/16,93,20,0.489266464,25602,93,16,4
19515,2014/03/31,2011/09/26,70,13,0.735223924,17037,70,5,8
19516,2014/03/31,2012/03/19,382,12,0.870206336,14394,382,12,0
19517,2014/03/31,2011/01/06,49,21,0.566595793,22105,49,4,17
19518,2014/03/31,2012/07/28,91,10,0.603,20770,91,1,9
19519,2014/03/31,2009/11/18,35,24,0.5751892160000001,21774,35,11,13
19520,2014/03/31,2006/05/14,10,15,0.61020808,20521,10,2,13
19521,2014/03/31,2012/12/24,62,21,0.6748129979999999,18556,62,5,16
19522,2014/03/31,2008/07/12,18,14,0.646923792,19355,18,8,6
19523,2014/03/31,2012/07/21,154,8,0.75938315,16487,154,3,5
19524,2014/03/31,2009/08/05,12,17,0.5963597389999999,20993,12,0,17
19525,2014/03/31,2007/04/22,170,10,1.074741994,11647,170,4,6
19526,2014/03/31,2011/10/20,498,10,0.670365808,18671,498,10,0
19527,2014/03/31,2009/08/10,32,16,0.739062888,16935,32,11,5
19528,2014/03/31,2012/02/02,125,6,1.024189853,12220,125,4,2
19529,2014/03/31,2006/11/25,1,18,0.855907537,14622,1,10,8
19530,2014/03/31,2012/10/23,299,12,0.687220605,18209,299,9,3
19531,2014/03/31,2011/08/05,41,11,0.8596276709999999,14557,41,4,7
19532,2014/03/31,2012/10/26,40,13,0.8679434000000001,14417,40,4,9
19533,2014/03/31,2007/06/10,35,10,0.814668229,15357,35,6,4
19534,2014/03/31,2012/11/17,191,14,0.651004371,19216,191,4,10
19535,2014/03/31,2012/12/03,10,11,0.871961522,14346,10,0,11
19536,2014/03/31,2006/04/07,84,14,0.641063906,19513,84,10,4
19537,2014/03/31,2012/06/07,84,18,0.545004575,22951,84,8,10
19538,2014/03/31,2011/08/28,36,14,0.516317593,24226,36,6,8
19539,2014/03/31,2013/02/28,12,13,0.544562236,22969,12,2,11
19540,2014/03/31,2005/10/30,19,19,0.754532786,16577,19,9,10
19541,2014/03/31,2005/08/26,6,14,0.7000884359999999,17866,6,9,5
19542,2014/03/31,2012/11/02,61,16,0.738614621,16934,61,8,8
19543,2014/03/31,2008/04/16,81,9,0.8032312140000001,15570,81,5,4
19544,2014/03/31,2008/05/12,72,18,0.661224026,18913,72,7,11
19545,2014/03/31,2012/11/05,9,6,0.7203237140000001,17361,9,0,6
19546,2014/03/31,2005/04/01,6,24,0.598210305,20903,6,7,17
19547,2014/03/31,2008/06/25,138,10,0.79423998,15743,138,8,2
19548,2014/03/31,2012/12/28,44,15,0.550057636,22729,44,2,13
19549,2014/03/31,2011/06/06,31,10,0.653663268,19125,31,3,7
19550,2014/03/31,2008/09/15,90,14,0.6976727309999999,17918,90,9,5
19551,2014/03/31,2010/07/14,227,15,0.811881535,15397,227,11,4
19552,2014/03/31,2011/09/11,4,17,0.62152496,20112,4,7,10
19553,2014/03/31,2009/01/19,486,12,0.7268477059999999,17197,486,12,0
19554,2014/03/31,2011/12/26,73,13,0.8335234090000001,14994,73,6,7
19555,2014/03/31,2012/02/13,253,16,0.541040738,23099,253,13,3
19556,2014/03/31,2007/02/28,114,15,0.699667432,17861,114,6,9
19557,2014/03/31,2012/04/30,14,12,0.642496658,19450,14,4,8
19558,2014/03/31,2007/11/22,216,7,1.098609108,11374,216,5,2
19559,2014/03/31,2006/08/17,342,3,0.8434807259999999,14813,342,2,1
19560,2014/03/31,2012/01/24,36,19,0.7192303259999999,17371,36,7,12
19561,2014/03/31,2006/08/14,419,6,1.425328009,8765,419,6,0
19562,2014/03/31,2009/08/10,168,13,0.6799994559999999,18371,168,8,5
19563,2014/03/31,2012/02/08,23,13,0.734615385,17004,23,8,5
19564,2014/03/31,2012/06/08,35,16,0.5857857710000001,21323,35,10,6
19565,2014/03/31,2007/09/21,20,11,0.8537573479999999,14630,20,0,11
19566,2014/03/31,2013/02/09,34,10,0.688822037,18133,34,1,9
19567,2014/03/31,2010/05/24,5,14,0.794526718,15720,5,5,9
19568,2014/03/31,2011/06/17,12,16,0.764722018,16332,12,9,7
19569,2014/03/31,2012/03/31,400,12,0.819178801,15246,400,12,0
19570,2014/03/31,2011/08/07,87,5,1.357786475,9198,87,0,5
19571,2014/03/31,2006/02/06,8,19,0.430939959,28980,8,5,14
19572,2014/03/31,2011/01/13,96,12,0.777090411,16071,96,5,7
19573,2014/03/31,2010/08/31,3,9,0.804445017,15523,3,1,8
19574,2014/03/31,2011/09/16,59,26,0.6450446870000001,19357,59,8,18
19575,2014/03/31,2007/03/24,166,11,0.762132699,16383,166,9,2
19576,2014/03/31,2012/08/25,100,13,0.787164744,15861,100,5,8
19577,2014/03/31,2008/02/15,49,11,0.68737129,18161,49,6,5
19578,2014/03/31,2011/12/21,48,12,0.682327412,18295,48,5,7
19579,2014/03/31,2005/10/28,108,8,0.8121600520000001,15370,108,6,2
19580,2014/03/31,2012/10/22,357,13,0.7107858770000001,17560,357,9,4
19581,2014/03/31,2011/04/25,141,22,0.630092901,19806,141,13,9
19582,2014/03/31,2012/05/05,6,14,0.673776998,18520,6,0,14
19583,2014/03/31,2012/09/15,373,5,1.0,12478,373,5,0
19584,2014/03/31,2005/08/31,11,10,0.708251788,17618,11,6,4
19585,2014/03/31,2013/01/07,106,9,0.624637565,19976,106,4,5
19586,2014/03/31,2013/01/25,118,7,0.574877678,21705,118,2,5
19587,2014/03/31,2011/11/03,243,7,0.998991193,12490,243,2,5
19588,2014/03/31,2006/01/21,18,12,0.769620628,16211,18,1,11
19589,2014/03/31,2013/03/29,123,7,0.6522498170000001,19126,123,2,5
19590,2014/03/31,2012/10/18,11,16,0.6471867379999999,19273,11,4,12
19591,2014/03/31,2005/08/15,12,8,0.72844595,17123,12,5,3
19592,2014/03/31,2009/11/18,17,13,0.715384615,17433,17,7,6
19593,2014/03/31,2012/10/09,94,11,0.669307106,18632,94,8,3
19594,2014/03/31,2004/12/24,69,13,0.810251462,15390,69,4,9
19595,2014/03/31,2008/03/28,31,17,0.587140032,21238,31,12,5
19596,2014/03/31,2012/10/19,263,11,0.7409090909999999,16830,263,9,2
19597,2014/03/31,2007/03/16,191,8,0.6840402659999999,18229,191,5,3
19598,2014/03/31,2011/06/26,6,13,0.602940039,20680,6,8,5
19599,2014/03/31,2005/05/01,57,13,0.8260192120000001,15095,57,7,6
19600,2014/03/31,2012/08/04,205,11,0.606129989,20571,205,6,5
19601,2014/03/31,2008/11/15,187,12,0.557950508,22347,187,9,3
19602,2014/03/31,2006/11/06,136,13,0.740403824,16839,136,10,3
19603,2014/03/31,2005/10/11,112,17,0.841374005,14818,112,5,12
19604,2014/03/31,2011/08/03,17,14,0.7571620309999999,16466,17,4,10
19605,2014/03/31,2009/04/09,202,9,0.801742765,15550,202,4,5
19606,2014/03/31,2012/05/15,19,15,0.929063268,13419,19,4,11
19607,2014/03/31,2011/06/27,244,12,0.713668422,17468,244,9,3
19608,2014/03/31,2011/09/21,122,15,0.673091253,18520,122,10,5
19609,2014/03/31,2011/09/01,188,8,0.8889289029999999,14023,188,4,4
19610,2014/03/31,2008/08/13,387,11,0.848383584,14693,387,11,0
19611,2014/03/31,2011/04/01,4,17,0.642924489,19388,4,8,9
19612,2014/03/31,2009/12/08,14,11,0.680356422,18321,14,5,6
19613,2014/03/31,2007/06/07,125,10,0.856640088,14548,125,5,5
19614,2014/03/31,2010/10/12,45,9,0.668261033,18649,45,8,1
19615,2014/03/31,2013/02/05,226,9,0.787236892,15830,226,2,7
19616,2014/03/31,2008/01/07,8,14,0.7388254479999999,16866,8,4,10
19617,2014/03/31,2011/11/07,22,14,0.558114949,22323,22,5,9
19618,2014/03/31,2009/09/15,20,16,0.947863664,13144,20,8,8
19619,2014/03/31,2012/06/01,4,20,0.473282176,26324,4,11,9
19620,2014/03/31,2013/03/20,32,11,0.700924384,17774,32,0,11
19621,2014/03/31,2011/07/17,45,14,0.652011305,19107,45,7,7
19622,2014/03/31,2009/06/20,32,12,0.783540474,15899,32,10,2
19623,2014/03/31,2009/04/10,146,10,0.85876327,14506,146,5,5
19624,2014/03/31,2013/01/28,12,14,0.69014072,18050,12,3,11
19625,2014/03/31,2011/09/15,188,9,0.683558178,18220,188,7,2
19626,2014/03/31,2012/07/28,1,17,0.849363705,14663,1,6,11
19627,2014/03/31,2006/07/15,32,16,0.60196413,20686,32,6,10
19628,2014/03/31,2012/04/23,31,12,0.54072871,23027,31,8,4
19629,2014/03/31,2008/08/22,175,14,0.7982114240000001,15599,175,11,3
19630,2014/03/31,2011/01/03,90,13,0.7151780590000001,17410,90,7,6
19631,2014/03/31,2013/02/25,58,8,0.7581683109999999,16422,58,1,7
19632,2014/03/31,2011/07/01,50,18,0.616240471,20202,50,7,11
19633,2014/03/31,2007/01/20,58,12,0.798684464,15583,58,10,2
19634,2014/03/31,2011/10/25,161,15,0.88562798,14053,161,9,6
19635,2014/03/31,2012/03/26,232,9,0.73217202,16998,232,6,3
19636,2014/03/31,2012/07/10,283,12,0.7699010079999999,16163,283,6,6
19637,2014/03/31,2008/07/20,12,20,0.788101843,15789,12,4,16
19638,2014/03/31,2012/12/12,27,10,0.737631158,16869,27,2,8
19639,2014/03/31,2007/07/31,141,8,0.650376333,19132,141,5,3
19640,2014/03/31,2013/02/04,167,11,0.734479665,16941,167,5,6
19641,2014/03/31,2007/10/19,208,14,0.648995358,19171,208,9,5
19642,2014/03/31,2011/05/28,221,7,0.613758449,20269,221,3,4
19643,2014/03/31,2011/06/13,98,14,0.932822436,13336,98,6,8
19644,2014/03/31,2011/01/16,382,11,0.717018272,17349,382,11,0
19645,2014/03/31,2006/05/26,140,9,0.902178297,13786,140,7,2
19646,2014/03/31,2006/12/22,368,10,0.8821854159999999,14098,368,10,0
19647,2014/03/31,2013/03/15,1,13,0.846477435,14691,1,2,11
19648,2014/03/31,2006/07/30,330,9,0.748846802,16606,330,8,1
19649,2014/03/31,2011/03/24,9,12,0.745648498,16677,9,2,10
19650,2014/03/31,2010/08/24,172,9,0.754095209,16490,172,5,4
19651,2014/03/31,2009/02/06,76,12,0.8020608909999999,15503,76,6,6
19652,2014/03/31,2011/04/05,132,8,0.720142477,17266,132,3,5
19653,2014/03/31,2011/08/01,27,9,0.790880351,15721,27,3,6
19654,2014/03/31,2012/04/30,40,21,0.7154304290000001,17378,40,16,5
19655,2014/03/31,2011/11/12,202,11,0.6612099779999999,18802,202,4,7
19656,2014/03/31,2007/01/13,161,14,0.606992188,20480,161,9,5
19657,2014/03/31,2010/03/21,157,16,0.68189797,18230,157,10,6
19658,2014/03/31,2011/06/22,280,7,0.661306661,18796,280,5,2
19659,2014/03/31,2010/10/29,28,17,0.6963555379999999,17849,28,4,13
19660,2014/03/31,2007/06/30,375,9,1.102594925,11272,375,9,0
19661,2014/03/31,2009/05/21,7,16,0.7252608540000001,17136,7,5,11
19662,2014/03/31,2012/12/05,99,4,0.699344438,17771,99,2,2
19663,2014/03/31,2012/06/13,173,14,0.715896889,17360,173,9,5
19664,2014/03/31,2008/11/29,292,13,0.871426367,14260,292,12,1
19665,2014/03/31,2011/12/15,207,10,0.7375601070000001,16845,207,6,4
19666,2014/03/31,2006/01/25,522,3,1.0249851490000002,12120,522,3,0
19667,2014/03/31,2012/04/03,677,6,0.8916666670000001,13932,677,6,0
19668,2014/03/31,2005/11/26,2,15,0.622493987,19956,2,2,13
19669,2014/03/31,2012/10/29,116,11,0.84675392,14670,116,8,3
19670,2014/03/31,2008/08/24,95,10,0.631646072,19665,95,4,6
19671,2014/03/31,2005/07/09,32,14,0.707183443,17564,32,4,10
19672,2014/03/31,2012/08/03,29,8,0.851994787,14578,29,6,2
19673,2014/03/31,2009/09/30,9,17,0.740234831,16778,9,7,10
19674,2014/03/31,2008/06/01,33,9,0.747230982,16616,33,3,6
19675,2014/03/31,2006/05/17,102,11,0.782902005,15858,102,3,8
19676,2014/03/31,2012/08/09,135,15,0.6124893929999999,20270,135,5,10
19677,2014/03/31,2008/02/08,32,16,0.550185251,22564,32,0,16
19678,2014/03/31,2009/09/17,151,16,0.608065733,20416,151,11,5
19679,2014/03/31,2009/10/04,85,10,0.631,19670,85,6,4
19680,2014/03/31,2007/05/21,103,12,0.634683201,19555,103,4,8
19681,2014/03/31,2007/09/10,138,7,0.557996133,22242,138,3,4
19682,2014/03/31,2012/01/05,191,16,0.557588283,22258,191,11,5
19683,2014/03/31,2011/11/07,48,15,0.74951987,16558,48,8,7
19684,2014/03/31,2007/10/29,11,19,0.694523476,17869,11,5,14
19685,2014/03/31,2008/06/27,104,12,1.097055339,11312,104,9,3
19686,2014/03/31,2012/07/24,90,22,0.763284326,16256,90,8,14
19687,2014/03/31,2012/01/23,153,9,0.927447302,13378,153,4,5
19688,2014/03/31,2012/05/14,512,13,0.85385383,14531,512,13,0
19689,2014/03/31,2010/03/27,125,10,0.539204694,23010,125,9,1
19690,2014/03/31,2004/12/02,100,13,0.644475557,19249,100,2,11
19691,2014/03/31,2008/01/31,367,13,0.6889453520000001,18006,367,13,0
19692,2014/03/31,2012/11/11,9,17,0.575345116,21558,9,3,14
19693,2014/03/31,2013/01/04,43,14,0.772868893,16048,43,5,9
19694,2014/03/31,2010/11/19,525,3,0.835237069,14848,525,3,0
19695,2014/03/31,2005/01/03,105,19,0.765371228,16203,105,10,9
19696,2014/03/31,2012/02/27,49,7,0.819962312,15124,49,1,6
19697,2014/03/31,2009/07/20,219,14,0.778143198,15936,219,10,4
19698,2014/03/31,2012/04/12,9,15,0.61831106,20054,9,5,10
19699,2014/03/31,2010/06/11,45,12,0.798418545,15530,45,2,10
19700,2014/03/31,2008/10/01,521,4,0.669604666,18516,521,4,0
19701,2014/03/31,2008/01/26,9,16,0.666956475,18587,9,8,8
19702,2014/03/31,2009/03/03,27,11,0.919732156,13478,27,5,6
19703,2014/03/31,2008/03/11,13,6,1.351842077,9169,13,2,4
19704,2014/03/31,2007/05/19,20,14,0.591250239,20964,20,10,4
19705,2014/03/31,2011/11/28,78,7,0.666750941,18590,78,2,5
19706,2014/03/31,2012/10/16,157,12,0.598518447,20708,157,8,4
19707,2014/03/31,2005/04/15,19,14,0.716684016,17292,19,4,10
19708,2014/03/31,2007/09/26,46,20,0.6387362129999999,19402,46,15,5
19709,2014/03/31,2007/09/20,19,18,0.700838801,17680,19,9,9
19710,2014/03/31,2005/02/20,47,11,0.733309855,16895,47,1,10
19711,2014/03/31,2006/07/09,92,14,0.621451216,19935,92,5,9
19712,2014/03/31,2012/02/28,9,12,0.67425049,18372,9,7,5
19713,2014/03/31,2006/03/29,90,10,0.576974242,21469,90,7,3
19714,2014/03/31,2011/11/01,18,8,0.588885614,21034,18,4,4
19715,2014/03/31,2008/10/09,172,14,0.56633882,21870,172,7,7
19716,2014/03/31,2011/10/25,7,23,0.615075731,20137,7,18,5
19717,2014/03/31,2011/05/12,18,11,0.776019424,15960,18,8,3
19718,2014/03/31,2010/03/12,23,10,0.621283235,19934,23,6,4
19719,2014/03/31,2012/06/08,117,12,0.5286753470000001,23425,117,7,5
19720,2014/03/31,2005/05/20,9,12,0.6907725779999999,17927,9,3,9
19721,2014/03/31,2009/08/18,41,13,0.7674380270000001,16136,41,11,2
19722,2014/03/31,2009/12/30,90,8,0.709124957,17462,90,1,7
19723,2014/03/31,2010/05/12,60,15,0.752203658,16459,60,8,7
19724,2014/03/31,2007/12/12,205,13,0.65215772,18983,205,5,8
19725,2014/03/31,2011/10/15,42,12,0.7349620040000001,16844,42,4,8
19726,2014/03/31,2006/04/16,75,11,0.550967555,22469,75,9,2
19727,2014/03/31,2013/03/23,21,10,0.856,14460,21,1,9
19728,2014/03/31,2009/09/01,93,14,0.611428571,20244,93,9,5
19729,2014/03/31,2011/09/06,159,13,0.7249437740000001,17074,159,10,3
19730,2014/03/31,2010/12/01,9,13,0.666175996,18580,9,5,8
19731,2014/03/31,2008/04/25,67,11,0.7572170559999999,16346,67,6,5
19732,2014/03/31,2009/01/31,64,16,0.68062689,18185,64,8,8
19733,2014/03/31,2011/07/07,165,11,0.5883857929999999,21032,165,7,4
19734,2014/03/31,2013/01/10,341,8,0.731632472,16913,341,4,4
19735,2014/03/31,2009/08/21,340,16,0.7483910970000001,16533,340,15,1
19736,2014/03/31,2010/12/10,32,12,0.751251442,16469,32,6,6
19737,2014/03/31,2011/09/05,107,16,0.85770452,14424,107,7,9
19738,2014/03/31,2005/04/17,106,12,0.6148441929999999,20121,106,6,6
19739,2014/03/31,2012/09/30,46,17,0.6319530010000001,19575,46,4,13
19740,2014/03/31,2012/05/17,93,13,0.544208975,22730,93,11,2
19741,2014/03/31,2006/11/17,134,12,0.733125296,16872,134,9,3
19742,2014/03/31,2007/09/10,21,12,0.8306493859999999,14891,21,0,12
19743,2014/03/31,2011/10/02,67,17,0.644894416,19179,67,5,12
19744,2014/03/31,2007/07/11,14,13,0.727568092,16999,14,6,7
19745,2014/03/31,2009/02/18,363,11,0.773477173,15990,363,10,1
19746,2014/03/31,2010/11/15,97,7,0.63783268,19388,97,1,6
19747,2014/03/31,2005/04/07,76,17,0.407268386,30363,76,8,9
19748,2014/03/31,2009/09/09,28,16,0.695625,17776,28,8,8
19749,2014/03/31,2013/01/17,111,7,0.9227192,13401,111,3,4
19750,2014/03/31,2008/01/26,61,9,0.728830602,16966,61,7,2
19751,2014/03/31,2012/07/22,37,11,0.777666038,15900,37,3,8
19752,2014/03/31,2009/06/18,14,6,1.266894149,9759,14,1,5
19753,2014/03/31,2013/02/24,34,17,0.8764504470000001,14106,34,1,16
19754,2014/03/31,2006/04/08,25,16,0.682350149,18118,25,8,8
19755,2014/03/31,2006/12/13,4,16,0.575905321,21462,4,6,10
19756,2014/03/31,2012/04/19,8,11,0.719956312,17167,8,5,6
19757,2014/03/31,2011/09/28,125,12,0.66624097,18550,125,7,5
19758,2014/03/31,2012/02/14,1,14,0.71125518,17376,1,4,10
19759,2014/03/31,2011/03/15,4,8,0.713843577,17312,4,2,6
19760,2014/03/31,2012/05/30,32,19,0.7554260909999999,16358,32,2,17
19761,2014/03/31,2008/04/28,549,7,1.003549094,12313,549,7,0
19762,2014/03/31,2006/03/31,198,3,0.658302611,18770,198,0,3
19763,2014/03/31,2010/01/27,74,16,0.7116485229999999,17361,74,8,8
19764,2014/03/31,2011/10/21,153,10,0.960250291,12865,153,6,4
19765,2014/03/31,2011/10/03,23,9,0.697777778,17703,23,0,9
19766,2014/03/31,2012/04/27,258,10,0.6934203440000001,17814,258,9,1
19767,2014/03/31,2012/06/13,7,5,0.564670141,21873,7,1,4
19768,2014/03/31,2007/09/15,67,8,0.8878132409999999,13911,67,0,8
19769,2014/03/31,2007/06/30,242,15,0.770081063,16037,242,12,3
19770,2014/03/31,2010/12/16,16,12,0.685916463,18004,16,7,5
19771,2014/03/31,2010/08/15,112,12,0.782141364,15789,112,5,7
19772,2014/03/31,2006/05/10,40,9,0.715057325,17270,40,8,1
19773,2014/03/31,2012/09/14,1,14,0.623010091,19820,1,9,5
19774,2014/03/31,2012/07/28,47,18,0.65387365,18884,47,10,8
19775,2014/03/31,2007/04/28,4,11,0.743064332,16617,4,0,11
19776,2014/03/31,2010/12/11,4,16,0.612396092,20162,4,4,12
19777,2014/03/31,2008/08/22,32,20,0.8222183000000001,15016,32,4,16
19778,2014/03/31,2006/07/18,60,16,0.7687129509999999,16060,60,8,8
19779,2014/03/31,2008/02/20,11,22,0.925364318,13340,11,8,14
19780,2014/03/31,2012/06/28,62,14,0.601501316,20522,62,2,12
19781,2014/03/31,2013/02/01,17,7,0.7116546559999999,17345,17,3,4
19782,2014/03/31,2012/06/01,550,5,0.77,16030,550,5,0
19783,2014/03/31,2011/06/29,48,11,0.783921245,15745,48,4,7
19784,2014/03/31,2012/07/26,1,14,0.483731039,25513,1,2,12
19785,2014/03/31,2012/07/10,5,11,0.47460713,26001,5,5,6
19786,2014/03/31,2012/05/19,17,11,0.911778484,13534,17,2,9
19787,2014/03/31,2006/09/30,55,10,0.7140437470000001,17281,55,5,5
19788,2014/03/31,2005/02/02,33,12,0.699105382,17650,33,2,10
19789,2014/03/31,2010/12/06,186,10,0.864687785,14269,186,3,7
19790,2014/03/31,2006/02/22,176,15,0.561951175,21956,176,13,2
19791,2014/03/31,2011/03/14,6,10,0.590791515,20884,6,4,6
19792,2014/03/31,2012/02/07,98,12,0.609502025,20242,98,2,10
19793,2014/03/31,2006/05/20,250,9,0.784688335,15722,250,7,2
19794,2014/03/31,2008/02/18,220,15,0.6880612420000001,17929,220,11,4
19795,2014/03/31,2007/08/17,117,11,0.653781205,18867,117,9,2
19796,2014/03/31,2005/03/11,49,12,0.76552349,16113,49,5,7
19797,2014/03/31,2011/02/08,32,13,0.6243159389999999,19757,32,0,13
19798,2014/03/31,2006/01/01,87,14,0.623425322,19785,87,5,9
19799,2014/03/31,2007/07/10,134,16,0.58634769,21036,134,7,9
19800,2014/03/31,2007/05/10,80,17,0.63640163,19381,80,8,9
19801,2014/03/31,2012/04/14,246,16,0.729772781,16900,246,11,5
19802,2014/03/31,2011/05/05,187,15,0.775106851,15910,187,14,1
19803,2014/03/31,2006/06/13,6,17,0.692122692,17817,6,10,7
19804,2014/03/31,2012/11/07,178,14,0.86016183,14336,178,12,2
19805,2014/03/31,2008/05/13,107,13,0.647847835,19032,107,6,7
19806,2014/03/31,2011/10/05,40,15,0.5830809610000001,21146,40,8,7
19807,2014/03/31,2009/02/27,167,8,0.795095118,15507,167,4,4
19808,2014/03/31,2010/01/19,396,10,0.7048536470000001,17492,396,10,0
19809,2014/03/31,2008/02/27,41,21,0.599001117,20583,41,7,14
19810,2014/03/31,2006/09/22,139,16,0.859210398,14349,139,12,4
19811,2014/03/31,2011/06/04,105,13,0.696810423,17692,105,7,6
19812,2014/03/31,2005/08/01,12,17,0.725213248,16999,12,11,6
19813,2014/03/31,2013/01/31,124,8,0.64214189,19198,124,0,8
19814,2014/03/31,2005/04/22,183,10,0.780457107,15795,183,5,5
19815,2014/03/31,2010/11/01,20,12,0.951380827,12956,20,6,6
19816,2014/03/31,2012/03/24,331,7,0.826028682,14922,331,5,2
19817,2014/03/31,2007/07/26,1,15,0.609803097,20213,1,7,8
19818,2014/03/31,2011/11/27,148,9,0.705555556,17469,148,6,3
19819,2014/03/31,2012/03/23,122,13,0.869845437,14169,122,9,4
19820,2014/03/31,2012/09/11,42,12,0.745502057,16532,42,0,12
19821,2014/03/31,2011/01/21,3,22,0.6472941179999999,19040,3,10,12
19822,2014/03/31,2008/11/26,42,17,0.879678801,14010,42,12,5
19823,2014/03/31,2010/04/18,27,15,0.706040676,17455,27,10,5
19824,2014/03/31,2010/01/08,28,15,0.635603693,19389,28,9,6
19825,2014/03/31,2005/09/26,52,10,0.73473885,16772,52,3,7
19826,2014/03/31,2011/09/24,6,17,0.803423094,15337,6,7,10
19827,2014/03/31,2011/09/25,28,22,0.538349353,22888,28,2,20
19828,2014/03/31,2006/11/09,28,18,0.621305466,19832,28,8,10
19829,2014/03/31,2006/09/02,159,7,0.98052841,12566,159,5,2
19830,2014/03/31,2009/04/10,72,17,0.787876327,15638,72,11,6
19831,2014/03/31,2010/05/08,201,11,0.637622399,19322,201,3,8
19832,2014/03/31,2010/12/25,161,11,0.73399428,16784,161,4,7
19833,2014/03/31,2011/09/15,27,19,0.7941529140000001,15512,27,14,5
19834,2014/03/31,2011/01/14,560,5,1.458006865,8449,560,5,0
19835,2014/03/31,2011/03/01,49,15,0.563517544,21859,49,9,6
19836,2014/03/31,2007/07/11,26,10,0.786785897,15656,26,4,6
19837,2014/03/31,2010/04/26,87,13,0.654750159,18812,87,7,6
19838,2014/03/31,2008/04/23,64,8,0.8098408840000001,15209,64,3,5
19839,2014/03/31,2006/12/03,79,9,0.488971773,25189,79,4,5
19840,2014/03/31,2012/04/05,185,9,0.795227273,15488,185,6,3
19841,2014/03/31,2009/12/09,34,27,0.881357521,13974,34,11,16
19842,2014/03/31,2012/07/27,3,11,0.682528404,18043,3,5,6
19843,2014/03/31,2008/05/20,543,5,0.692815752,17775,543,5,0
19844,2014/03/31,2008/12/31,12,13,0.6892175079999999,17866,12,11,2
19845,2014/03/31,2008/04/11,132,9,0.905697683,13595,132,5,4
19846,2014/03/31,2008/04/08,125,12,0.8730397790000001,14103,125,9,3
19847,2014/03/31,2009/11/25,4,25,0.645006811,19088,4,14,11
19848,2014/03/31,2010/12/24,12,14,0.7823365320000001,15737,12,4,10
19849,2014/03/31,2012/11/09,277,6,0.621660859,19803,277,4,2
19850,2014/03/31,2012/05/19,578,4,0.7260882390000001,16954,578,4,0
19851,2014/03/31,2007/12/05,45,7,0.571009464,21556,45,3,4
19852,2014/03/31,2010/08/17,1,13,0.83609945,14721,1,7,6
19853,2014/03/31,2011/10/12,314,5,1.5,8205,314,4,1
19854,2014/03/31,2012/02/27,26,10,0.747690018,16459,26,3,7
19855,2014/03/31,2006/08/07,90,14,0.7317162229999999,16816,90,12,2
19856,2014/03/31,2011/07/31,238,12,0.606340117,20293,238,8,4
19857,2014/03/31,2011/12/30,106,9,0.8839916659999999,13919,106,3,6
19858,2014/03/31,2008/11/20,184,10,0.804636714,15291,184,6,4
19859,2014/03/31,2009/11/27,185,11,0.502945793,24462,185,6,5
19860,2014/03/31,2012/02/15,34,13,0.8671967290000001,14187,34,5,8
19861,2014/03/31,2012/03/07,29,9,0.7312536409999999,16823,29,3,6
19862,2014/03/31,2012/03/23,186,10,0.644961724,19072,186,7,3
19863,2014/03/31,2010/11/23,158,12,0.793518937,15499,158,10,2
19864,2014/03/31,2011/03/02,76,17,0.658826271,18667,76,13,4
19865,2014/03/31,2010/02/03,33,12,0.528002061,23289,33,7,5
19866,2014/03/31,2011/10/25,70,10,0.706352042,17407,70,3,7
19867,2014/03/31,2008/11/11,8,12,0.6695327560000001,18363,8,5,7
19868,2014/03/31,2010/05/08,37,14,0.901793235,13629,37,9,5
19869,2014/03/31,2009/10/29,282,6,0.775,15858,282,5,1
19870,2014/03/31,2012/11/26,160,10,0.793866029,15481,160,2,8
19871,2014/03/31,2011/10/04,8,15,0.596192209,20613,8,8,7
19872,2014/03/31,2008/11/29,85,11,0.6496336629999999,18917,85,1,10
19873,2014/03/31,2011/12/15,88,27,0.7919119729999999,15518,88,18,9
19874,2014/03/31,2009/07/21,136,13,0.672285136,18279,136,6,7
19875,2014/03/31,2006/06/07,14,18,0.7993677229999999,15373,14,7,11
19876,2014/03/31,2011/09/14,208,10,0.8314066309999999,14780,208,9,1
19877,2014/03/31,2005/05/14,139,9,0.657171355,18698,139,3,6
19878,2014/03/31,2010/01/18,61,10,0.7019181990000001,17506,61,5,5
19879,2014/03/31,2011/04/05,81,10,1.138663701,10791,81,4,6
19880,2014/03/31,2008/04/07,44,22,0.61092681,20112,44,9,13
19881,2014/03/31,2011/10/26,343,27,0.561111111,21897,343,24,3
19882,2014/03/31,2012/10/01,82,7,0.622454532,19739,82,0,7
19883,2014/03/31,2012/12/19,49,2,0.81,15168,49,1,1
19884,2014/03/31,2009/12/08,27,10,0.831061354,14783,27,6,4
19885,2014/03/31,2010/08/24,34,13,0.888523072,13826,34,4,9
19886,2014/03/31,2012/07/03,68,11,0.8911643090000001,13785,68,9,2
19887,2014/03/31,2012/10/17,11,19,0.677877049,18121,11,6,13
19888,2014/03/31,2011/10/09,6,9,0.920280962,13347,6,2,7
19889,2014/03/31,2011/09/16,21,8,0.7574432659999999,16216,21,4,4
19890,2014/03/31,2010/10/27,107,13,0.664214255,18492,107,5,8
19891,2014/03/31,2009/03/04,70,15,0.6200762360000001,19807,70,6,9
19892,2014/03/31,2011/10/31,35,15,0.810666667,15150,35,3,12
19893,2014/03/31,2012/01/15,118,12,0.934008214,13148,118,8,4
19894,2014/03/31,2012/03/01,168,16,0.837380839,14665,168,1,15
19895,2014/03/31,2012/08/16,105,18,0.6269966810000001,19585,105,4,14
19896,2014/03/31,2007/09/23,125,14,0.587397149,20904,125,9,5
19897,2014/03/31,2007/09/19,124,14,0.562071965,21844,124,2,12
19898,2014/03/31,2013/03/18,118,5,0.555534139,22101,118,2,3
19899,2014/03/31,2008/05/11,58,14,0.603283208,20349,58,5,9
19900,2014/03/31,2010/08/20,263,12,0.79406818,15459,263,9,3
19901,2014/03/31,2005/12/20,36,13,0.54788386,22404,36,7,6
19902,2014/03/31,2007/07/05,132,7,0.642393364,19107,132,2,5
19903,2014/03/31,2012/01/09,460,13,0.6972335829999999,17604,460,13,0
19904,2014/03/31,2011/08/24,71,13,0.8231468809999999,14910,71,5,8
19905,2014/03/31,2012/03/01,79,11,0.721574646,17007,79,4,7
19906,2014/03/31,2011/06/25,86,2,0.755,16254,86,0,2
19907,2014/03/31,2012/12/22,38,12,0.6934742309999999,17696,38,2,10
19908,2014/03/31,2012/03/01,27,19,0.79056887,15522,27,5,14
19909,2014/03/31,2006/11/15,28,16,0.8284174990000001,14812,28,3,13
19910,2014/03/31,2012/06/22,131,15,0.815587238,15045,131,9,6
19911,2014/03/31,2005/08/01,530,10,0.701864775,17482,530,10,0
19912,2014/03/31,2012/11/22,37,23,0.547162861,22424,37,5,18
19913,2014/03/31,2007/07/20,14,9,0.574310522,21364,14,2,7
19914,2014/03/31,2010/06/28,132,11,0.671488779,18270,132,6,5
19915,2014/03/31,2007/01/05,46,12,0.614445557,19966,46,4,8
19916,2014/03/31,2010/02/26,25,13,0.76307477,16076,25,4,9
19917,2014/03/31,2013/01/01,64,11,0.602097978,20372,64,2,9
19918,2014/03/31,2005/02/02,99,11,0.687445628,17840,99,7,4
19919,2014/03/31,2008/03/24,99,12,0.668707127,18339,99,2,10
19920,2014/03/31,2007/03/30,11,14,0.68172893,17988,11,6,8
19921,2014/03/31,2010/06/18,12,15,0.679469164,18047,12,7,8
19922,2014/03/31,2006/06/27,42,19,0.7315380029999999,16762,42,7,12
19923,2014/03/31,2007/10/30,139,14,0.740327255,16562,139,7,7
19924,2014/03/31,2006/03/29,20,8,0.809499538,15146,20,2,6
19925,2014/03/31,2007/09/14,32,10,0.605701863,20239,32,4,6
19926,2014/03/31,2010/11/25,127,5,0.73905583,16586,127,2,3
19927,2014/03/31,2011/07/09,39,19,0.602422589,20346,39,9,10
19928,2014/03/31,2009/03/11,21,13,0.679514886,18037,21,7,6
19929,2014/03/31,2008/06/14,70,13,0.7500807829999999,16340,70,10,3
19930,2014/03/31,2011/10/31,8,9,0.787363485,15566,8,8,1
19931,2014/03/31,2012/07/07,131,12,0.905656222,13532,131,7,5
19932,2014/03/31,2010/12/31,269,20,0.754774897,16237,269,17,3
19933,2014/03/31,2013/03/02,62,5,0.736376637,16642,62,0,5
19934,2014/03/31,2009/08/01,11,13,0.753883967,16254,11,8,5
19935,2014/03/31,2010/03/12,250,13,0.597024946,20524,250,8,5
19936,2014/03/31,2008/05/29,5,16,0.6579600489999999,18623,5,4,12
19937,2014/03/31,2011/12/18,17,17,0.740936083,16537,17,9,8
19938,2014/03/31,2009/07/27,1,12,0.749675722,16344,1,8,4
19939,2014/03/31,2010/04/20,6,15,0.719421056,17031,6,10,5
19940,2014/03/31,2008/05/07,69,14,0.821499262,14914,69,2,12
19941,2014/03/31,2010/09/06,27,10,0.790876638,15491,27,7,3
19942,2014/03/31,2008/04/06,224,14,0.780916045,15687,224,4,10
19943,2014/03/31,2012/09/25,120,14,0.769511245,15918,120,6,8
19944,2014/03/31,2008/06/28,44,9,0.798917949,15332,44,3,6
19945,2014/03/31,2008/02/27,100,13,0.7904872540000001,15495,100,2,11
19946,2014/03/31,2005/03/01,141,17,0.598801701,20454,141,11,6
19947,2014/03/31,2012/08/29,280,9,0.681829316,17963,280,4,5
19948,2014/03/31,2011/06/30,58,19,0.620481787,19739,58,1,18
19949,2014/03/31,2007/06/10,81,14,0.869106585,14092,81,4,10
19950,2014/03/31,2011/10/11,11,16,0.757149923,16175,11,9,7
19951,2014/03/31,2006/03/01,413,11,0.666189751,18382,413,11,0
19952,2014/03/31,2008/11/29,100,11,0.6941907140000001,17639,100,1,10
19953,2014/03/31,2010/04/08,7,14,0.770402668,15894,7,6,8
19954,2014/03/31,2010/01/06,243,12,0.58667577,20871,243,9,3
19955,2014/03/31,2005/10/21,38,15,0.755609726,16204,38,9,6
19956,2014/03/31,2007/06/11,233,9,0.607676081,20147,233,6,3
19957,2014/03/31,2009/03/26,5,15,0.694395848,17628,5,5,10
19958,2014/03/31,2010/03/09,114,12,0.508246481,24083,114,4,8
19959,2014/03/31,2010/08/17,14,7,0.707640631,17297,14,4,3
19960,2014/03/31,2010/08/29,500,10,0.8,15300,500,10,0
19961,2014/03/31,2008/08/18,79,18,0.648988704,18857,79,7,11
19962,2014/03/31,2009/11/13,193,12,1.07758894,11356,193,8,4
19963,2014/03/31,2012/12/07,6,11,0.7154338170000001,17104,6,2,9
19964,2014/03/31,2012/10/13,206,13,0.6021084489999999,20323,206,9,4
19965,2014/03/31,2012/09/03,477,10,0.763352468,16027,477,10,0
19966,2014/03/31,2013/03/24,84,12,0.711127063,17204,84,0,12
19967,2014/03/31,2012/05/22,3,12,0.622151249,19663,3,8,4
19968,2014/03/31,2012/12/06,80,6,1.41,8676,80,0,6
19969,2014/03/31,2008/02/12,275,10,0.722033528,16941,275,6,4
19970,2014/03/31,2008/06/24,30,21,0.723949455,16896,30,8,13
19971,2014/03/31,2012/07/27,521,4,0.681316845,17952,521,4,0
19972,2014/03/31,2011/04/25,213,7,0.753435594,16233,213,0,7
19973,2014/03/31,2010/08/13,60,12,0.727983333,16800,60,9,3
19974,2014/03/31,2012/09/07,161,12,0.6612057960000001,18494,161,8,4
19975,2014/03/31,2009/11/05,163,19,0.7236681070000001,16897,163,13,6
19976,2014/03/31,2012/11/28,81,19,0.711029309,17196,81,12,7
19977,2014/03/31,2007/08/16,160,28,0.5591398,21867,160,17,11
19978,2014/03/31,2010/06/29,472,7,0.900077297,13584,472,7,0
19979,2014/03/31,2007/09/04,24,8,0.6342397679999999,19277,24,6,2
19980,2014/03/31,2007/04/02,16,14,0.666133602,18353,16,6,8
19981,2014/03/31,2006/07/28,473,12,0.636152885,19217,473,12,0
19982,2014/03/31,2006/05/18,258,12,0.8630377690000001,14165,258,8,4
19983,2014/03/31,2011/12/05,5,8,1.182428903,10338,5,0,8
19984,2014/03/31,2011/12/16,22,15,0.7511749520000001,16273,22,8,7
19985,2014/03/31,2012/03/03,99,9,0.68331619,17888,99,6,3
19986,2014/03/31,2011/01/14,18,16,0.6726679870000001,18171,18,10,6
19987,2014/03/31,2011/08/18,139,10,0.973128981,12560,139,5,5
19988,2014/03/31,2011/01/13,213,12,0.5759058570000001,21223,213,7,5
19989,2014/03/31,2012/08/15,221,9,0.63502494,19246,221,1,8
19990,2014/03/31,2012/10/17,304,7,0.8685714290000001,14070,304,6,1
19991,2014/03/31,2011/09/04,1,13,0.7034190990000001,17373,1,7,6
19992,2014/03/31,2013/03/24,4,5,0.7010302890000001,17432,4,1,4
19993,2014/03/31,2012/06/11,99,17,0.919099729,13296,99,13,4
19994,2014/03/31,2012/06/01,159,20,0.9025,13540,159,11,9
19995,2014/03/31,2010/09/16,208,15,0.72120765,16942,208,11,4
19996,2014/03/31,2011/04/11,21,18,0.846375476,14435,21,5,13
19997,2014/03/31,2006/01/04,153,8,0.859635519,14212,153,4,4
19998,2014/03/31,2006/12/01,1,20,0.814467333,15000,1,7,13
19999,2014/03/31,2012/11/17,37,18,0.505568614,24164,37,2,16
20000,2014/03/31,2009/08/27,3,27,0.731397354,16703,3,17,10
20001,2014/03/31,2010/01/15,10,17,0.6734149159999999,18141,10,9,8
20002,2014/03/31,2013/03/19,33,18,0.591097886,20667,33,2,16
20003,2014/03/31,2006/03/04,238,11,0.8945555070000001,13656,238,9,2
20004,2014/03/31,2005/03/25,19,13,0.583426156,20936,19,1,12
20005,2014/03/31,2010/05/17,109,11,0.7553608759999999,16169,109,2,9
20006,2014/03/31,2005/05/12,39,13,0.855023103,14284,39,3,10
20007,2014/03/31,2009/02/01,4,13,0.75588228,16157,4,6,7
20008,2014/03/31,2011/12/06,151,11,0.8184191129999999,14922,151,8,3
20009,2014/03/31,2011/03/14,111,8,0.7064639859999999,17285,111,7,1
20010,2014/03/31,2012/08/29,11,23,0.677062933,18035,11,6,17
20011,2014/03/31,2011/08/15,12,12,0.643622371,18971,12,1,11
20012,2014/03/31,2010/10/09,130,20,0.686131842,17794,130,8,12
20013,2014/03/31,2011/11/30,10,11,0.8028903059999999,15206,10,5,6
20014,2014/03/31,2012/11/16,12,23,0.577535361,21139,12,9,14
20015,2014/03/31,2008/06/28,63,14,0.750667773,16263,63,6,8
20016,2014/03/31,2012/08/23,82,21,0.58291983,20943,82,7,14
20017,2014/03/31,2012/05/08,16,5,0.636525185,19178,16,3,2
20018,2014/03/31,2008/05/18,82,16,0.602193497,20269,82,8,8
20019,2014/03/31,2011/10/26,54,20,0.70681376,17268,54,15,5
20020,2014/03/31,2012/05/17,38,15,0.7725973290000001,15797,38,8,7
20021,2014/03/31,2009/08/18,85,8,0.7667144109999999,15918,85,6,2
20022,2014/03/31,2010/01/12,3,14,0.812866658,15014,3,7,7
20023,2014/03/31,2010/03/17,27,15,0.680877594,17924,27,10,5
20024,2014/03/31,2008/10/20,197,15,0.872,13995,197,10,5
20025,2014/03/31,2011/10/18,25,14,0.8724846270000001,13986,25,10,4
20026,2014/03/31,2008/02/27,49,11,0.557184803,21899,49,5,6
20027,2014/03/31,2006/07/31,242,10,0.751996918,16225,242,8,2
20028,2014/03/31,2011/07/06,107,12,0.6916274590000001,17641,107,6,6
20029,2014/03/31,2012/05/05,228,4,0.69789269,17482,228,2,2
20030,2014/03/31,2012/10/25,8,28,0.582456434,20945,8,5,23
20031,2014/03/31,2013/02/26,51,16,0.8427930920000001,14475,51,0,16
20032,2014/03/31,2005/08/20,119,17,0.56857569,21456,119,4,13
20033,2014/03/31,2012/05/27,100,11,0.6494547970000001,18782,100,5,6
20034,2014/03/31,2011/01/14,13,14,0.651843104,18713,13,5,9
20035,2014/03/31,2012/01/18,26,12,0.7668884,15905,26,9,3
20036,2014/03/31,2010/07/01,136,12,0.597013216,20430,136,6,6
20037,2014/03/31,2012/05/29,241,7,1.149029584,10614,241,3,4
20038,2014/03/31,2012/12/26,13,17,0.548633767,22229,13,7,10
20039,2014/03/31,2012/11/19,75,11,0.913184065,13354,75,2,9
20040,2014/03/31,2012/10/01,38,10,0.796256367,15314,38,4,6
20041,2014/03/31,2011/10/16,166,18,0.79438241,15350,166,13,5
20042,2014/03/31,2012/03/06,120,12,0.660526002,18460,120,3,9
20043,2014/03/31,2009/11/14,58,14,0.7015439059999999,17378,58,5,9
20044,2014/03/31,2009/07/30,37,15,0.8806775990000001,13843,37,11,4
20045,2014/03/31,2012/08/06,529,2,0.75,16254,529,2,0
20046,2014/03/31,2007/01/06,296,2,0.75,16254,296,0,2
20047,2014/03/31,2010/09/03,584,2,0.75,16254,584,2,0
20048,2014/03/31,2012/08/13,135,7,0.75,16254,135,2,5
20049,2014/03/31,2012/04/05,71,8,0.683469388,17836,71,3,5
20050,2014/03/31,2010/04/08,5,10,0.786012638,15509,5,3,7
20051,2014/03/31,2009/01/10,70,8,1.0714063459999998,11377,70,4,4
20052,2014/03/31,2010/01/31,80,14,0.85573294,14244,80,9,5
20053,2014/03/31,2008/01/23,249,10,0.693976315,17564,249,8,2
20054,2014/03/31,2007/09/07,30,17,0.8630574240000001,14123,30,2,15
20055,2014/03/31,2008/06/05,78,14,0.823004457,14808,78,7,7
20056,2014/03/31,2012/11/05,29,5,1.036746916,11755,29,2,3
20057,2014/03/31,2012/07/20,181,12,0.870053545,14007,181,3,9
20058,2014/03/31,2010/06/27,192,8,0.8837273390000001,13790,192,5,3
20059,2014/03/31,2011/10/23,85,11,0.7305509259999999,16681,85,4,7
20060,2014/03/31,2009/09/09,64,16,0.7507978559999999,16231,64,4,12
20061,2014/03/31,2007/09/06,341,10,0.943404041,12917,341,7,3
20062,2014/03/31,2006/03/09,128,16,0.486848582,25030,128,9,7
20063,2014/03/31,2010/04/24,4,11,0.7324032220000001,16636,4,7,4
20064,2014/03/31,2010/10/30,29,10,0.71898141,16945,29,2,8
20065,2014/03/31,2011/08/16,507,3,0.726836108,16761,507,3,0
20066,2014/03/31,2011/05/18,193,11,0.623936492,19525,193,1,10
20067,2014/03/31,2009/08/21,13,12,0.671822092,18133,13,1,11
20068,2014/03/31,2012/04/28,406,11,0.8307700179999999,14662,406,11,0
20069,2014/03/31,2013/03/07,2,18,0.600268579,20292,2,1,17
20070,2014/03/31,2011/06/01,4,14,0.488921045,24913,4,7,7
20071,2014/03/31,2007/06/22,124,13,0.8852220359999999,13759,124,9,4
20072,2014/03/31,2008/12/04,21,13,0.4299897620000001,28325,21,4,9
20073,2014/03/31,2008/06/04,205,11,0.849524275,14336,205,8,3
20074,2014/03/31,2011/09/27,24,10,0.815891733,14926,24,5,5
20075,2014/03/31,2012/09/04,510,4,0.532458135,22871,510,4,0
20076,2014/03/31,2012/04/04,125,14,0.6997000520000001,17403,125,6,8
20077,2014/03/31,2012/06/01,41,22,0.622626815,19556,41,10,12
20078,2014/03/31,2011/12/17,20,14,0.737703587,16504,20,6,8
20079,2014/03/31,2009/01/15,232,11,0.874058439,13929,232,6,5
20080,2014/03/31,2007/10/03,33,5,1.431986591,8502,33,1,4
20081,2014/03/31,2008/02/07,69,16,0.593515016,20512,69,10,6
20082,2014/03/31,2009/11/14,20,13,0.7333759040000001,16600,20,5,8
20083,2014/03/31,2012/12/25,118,14,0.7193694970000001,16923,118,4,10
20084,2014/03/31,2012/05/22,8,10,1.447168331,8412,8,4,6
20085,2014/03/31,2011/07/03,94,14,0.808357793,15059,94,11,3
20086,2014/03/31,2007/11/09,57,13,0.826254158,14731,57,7,6
20087,2014/03/31,2009/09/27,159,16,0.629734051,19327,159,8,8
20088,2014/03/31,2008/12/16,43,12,0.664198865,18324,43,8,4
20089,2014/03/31,2008/06/13,81,16,0.6620187129999999,18383,81,4,12
20090,2014/03/31,2009/09/16,196,16,0.6832320909999999,17812,196,15,1
20091,2014/03/31,2010/01/19,11,15,0.752876145,16164,11,2,13
20092,2014/03/31,2006/03/23,6,15,0.7401885640000001,16440,6,7,8
20093,2014/03/31,2009/10/01,242,14,0.691751563,17590,242,9,5
20094,2014/03/31,2011/09/05,115,11,0.8400876890000001,14483,115,6,5
20095,2014/03/31,2006/12/20,423,2,0.8,15208,423,2,0
20096,2014/03/31,2012/08/05,21,16,0.59541526,20433,21,7,9
20097,2014/03/31,2007/04/17,194,8,0.548844627,22166,194,5,3
20098,2014/03/31,2006/08/15,14,9,0.770962672,15779,14,1,8
20099,2014/03/31,2007/06/09,2,22,0.6897431540000001,17637,2,1,21
20100,2014/03/31,2012/04/21,235,7,1.315693273,9246,235,5,2
20101,2014/03/31,2012/02/05,475,9,0.5569479420000001,21841,475,9,0
20102,2014/03/31,2012/01/25,84,16,0.605445993,20090,84,11,5
20103,2014/03/31,2011/05/09,27,13,0.85494412,14227,27,2,11
20104,2014/03/31,2012/02/26,154,13,0.680736595,17866,154,9,4
20105,2014/03/31,2013/01/29,67,19,0.769445147,15806,67,6,13
20106,2014/03/31,2013/01/05,73,17,0.6941201990000001,17521,73,0,17
20107,2014/03/31,2006/12/28,96,14,0.917782809,13251,96,8,6
20108,2014/03/31,2008/01/19,68,8,0.6981811920000001,17418,68,4,4
20109,2014/03/31,2011/04/17,394,2,0.8,15199,394,2,0
20110,2014/03/31,2012/03/19,41,22,0.738609525,16462,41,9,13
20111,2014/03/31,2012/07/08,164,16,0.767803738,15836,164,7,9
20112,2014/03/31,2012/08/12,382,5,0.710720758,17107,382,5,0
20113,2014/03/31,2007/08/24,121,15,0.5730751829999999,21215,121,7,8
20114,2014/03/31,2012/12/15,14,11,0.6397300429999999,19003,14,4,7
20115,2014/03/31,2012/08/14,93,16,0.5101850920000001,23826,93,4,12
20116,2014/03/31,2012/03/19,414,11,0.58074865,20931,414,11,0
20117,2014/03/31,2007/03/08,73,11,0.457661057,26559,73,7,4
20118,2014/03/31,2008/01/16,530,4,0.785143079,15481,530,4,0
20119,2014/03/31,2012/09/10,3,19,0.905559529,13422,3,3,16
20120,2014/03/31,2006/03/31,158,7,0.76481027,15891,158,3,4
20121,2014/03/31,2011/09/25,1,13,0.675192778,18000,1,8,5
20122,2014/03/31,2008/04/14,98,14,0.7215020190000001,16844,98,5,9
20123,2014/03/31,2006/06/11,17,15,0.653934029,18584,17,5,10
20124,2014/03/31,2011/09/02,151,3,1.136389227,10693,151,1,2
20125,2014/03/31,2011/02/19,499,4,1.05,11572,499,4,0
20126,2014/03/31,2008/04/18,113,19,0.840282888,14458,113,5,14
20127,2014/03/31,2011/10/01,331,5,1.044689999,11629,331,3,2
20128,2014/03/31,2009/03/12,146,12,0.576477316,21072,146,5,7
20129,2014/03/31,2012/08/28,191,5,0.896806202,13545,191,0,5
20130,2014/03/31,2012/07/21,22,12,0.5690630560000001,21346,22,8,4
20131,2014/03/31,2010/09/02,108,15,0.5984396710000001,20297,108,0,15
20132,2014/03/31,2011/09/20,153,8,0.656607201,18498,153,3,5
20133,2014/03/31,2010/06/06,261,14,0.6439285339999999,18862,261,8,6
20134,2014/03/31,2007/08/01,40,14,0.8425334720000001,14415,40,4,10
20135,2014/03/31,2010/11/01,1,13,0.652213449,18618,1,4,9
20136,2014/03/31,2009/06/21,140,12,0.746975886,16256,140,4,8
20137,2014/03/31,2010/06/26,90,8,0.71125,17072,90,4,4
20138,2014/03/31,2010/11/08,259,12,0.63025122,19266,259,11,1
20139,2014/03/31,2012/03/21,263,12,0.81105003,14971,263,8,4
20140,2014/03/31,2012/05/07,73,10,0.70938537,17116,73,7,3
20141,2014/03/31,2012/06/13,3,20,0.576587995,21058,3,0,20
20142,2014/03/31,2006/04/06,364,6,0.780695775,15551,364,5,1
20143,2014/03/31,2010/04/02,102,18,1.025541945,11837,102,13,5
20144,2014/03/31,2007/04/17,75,13,0.707080615,17168,75,6,7
20145,2014/03/31,2006/04/24,30,20,0.610216659,19893,30,11,9
20146,2014/03/31,2009/06/29,26,15,0.733694772,16545,26,10,5
20147,2014/03/31,2012/05/19,153,10,0.7342257440000001,16532,153,3,7
20148,2014/03/31,2008/06/21,104,9,0.830217525,14619,104,4,5
20149,2014/03/31,2011/12/16,194,10,0.661042484,18360,194,2,8
20150,2014/03/31,2008/05/25,9,17,0.736667678,16475,9,10,7
20151,2014/03/31,2008/11/23,131,9,0.815989107,14872,131,0,9
20152,2014/03/31,2006/06/23,188,9,0.886641578,13685,188,3,6
20153,2014/03/31,2011/10/11,290,11,0.683056916,17763,290,8,3
20154,2014/03/31,2010/04/04,41,16,0.912750527,13292,41,14,2
20155,2014/03/31,2008/09/24,29,8,0.455465706,26637,29,2,6
20156,2014/03/31,2007/08/24,13,18,0.6378229329999999,19021,13,9,9
20157,2014/03/31,2012/10/22,65,13,0.784454575,15465,65,11,2
20158,2014/03/31,2007/05/04,245,5,0.528558606,22950,245,3,2
20159,2014/03/31,2007/02/24,2,8,0.7557869159999999,16050,2,4,4
20160,2014/03/31,2009/07/30,208,13,0.773609056,15680,208,8,5
20161,2014/03/31,2013/03/16,143,6,0.926810819,13088,143,1,5
20162,2014/03/31,2008/10/24,110,11,0.6145792170000001,19737,110,9,2
20163,2014/03/31,2012/04/28,4,14,0.853540464,14210,4,5,9
20164,2014/03/31,2005/04/16,74,11,0.943182207,12859,74,1,10
20165,2014/03/31,2010/07/18,58,12,0.7107977259999999,17061,58,10,2
20166,2014/03/31,2011/03/09,14,17,0.437079113,27745,14,11,6
20167,2014/03/31,2005/01/27,131,16,0.703348414,17241,131,9,7
20168,2014/03/31,2010/03/09,35,9,1.162027791,10435,35,4,5
20169,2014/03/31,2012/10/07,6,9,0.606999399,19976,6,2,7
20170,2014/03/31,2007/05/18,33,28,0.737946564,16431,33,15,13
20171,2014/03/31,2006/04/26,175,16,0.638642613,18985,175,10,6
20172,2014/03/31,2006/06/05,70,12,0.57187161,21201,70,4,8
20173,2014/03/31,2010/09/16,339,4,0.688818817,17601,339,0,4
20174,2014/03/31,2005/06/29,11,19,0.588743687,20592,11,5,14
20175,2014/03/31,2008/09/01,33,11,0.73913791,16402,33,2,9
20176,2014/03/31,2006/12/04,49,12,0.7674438179999999,15797,49,9,3
20177,2014/03/31,2008/08/01,500,9,0.7353958140000001,16485,500,9,0
20178,2014/03/31,2006/08/28,153,15,0.653105436,18561,153,12,3
20179,2014/03/31,2010/06/01,257,11,0.691666667,17526,257,7,4
20180,2014/03/31,2010/10/15,241,17,0.746328818,16240,241,14,3
20181,2014/03/31,2010/03/28,3,14,0.749821208,16164,3,7,7
20182,2014/03/31,2011/01/26,18,14,0.95916271,12636,18,8,6
20183,2014/03/31,2007/06/12,68,7,1.220507553,9930,68,3,4
20184,2014/03/31,2012/08/05,9,18,0.6197810739999999,19550,9,4,14
20185,2014/03/31,2006/11/20,77,13,0.642775744,18849,77,5,8
20186,2014/03/31,2008/08/01,117,13,0.4908288770000001,24684,117,7,6
20187,2014/03/31,2006/07/08,5,18,0.680308833,17809,5,10,8
20188,2014/03/31,2009/03/02,202,8,0.595278105,20352,202,4,4
20189,2014/03/31,2012/04/06,523,4,1.141136021,10616,523,4,0
20190,2014/03/31,2011/10/21,11,11,0.891726905,13585,11,6,5
20191,2014/03/31,2007/05/10,77,11,0.7093582009999999,17077,77,3,8
20192,2014/03/31,2012/06/30,44,13,0.719239995,16842,44,6,7
20193,2014/03/31,2011/08/07,123,14,0.476376829,25428,123,8,6
20194,2014/03/31,2005/12/04,34,11,0.8206252959999999,14761,34,6,5
20195,2014/03/31,2007/08/07,64,11,0.825954313,14665,64,5,6
20196,2014/03/31,2012/05/01,399,6,0.8086193079999999,14978,399,6,0
20197,2014/03/31,2013/01/13,21,11,0.779452954,15538,21,4,7
20198,2014/03/31,2011/03/12,16,11,0.6892266109999999,17572,16,1,10
20199,2014/03/31,2012/09/26,6,15,0.618074214,19592,6,3,12
20200,2014/03/31,2010/05/01,11,9,0.6477777779999999,18693,11,6,3
20201,2014/03/31,2009/12/22,6,9,0.959284582,12622,6,0,9
20202,2014/03/31,2006/11/10,102,8,0.962532994,12578,102,4,4
20203,2014/03/31,2008/04/24,228,14,0.64381355,18804,228,10,4
20204,2014/03/31,2008/02/04,12,6,0.510838503,23697,12,0,6
20205,2014/03/31,2010/11/01,8,14,0.538370469,22485,8,6,8
20206,2014/03/31,2008/05/22,78,9,0.979811397,12354,78,4,5
20207,2014/03/31,2010/01/09,450,12,0.599316663,20195,450,12,0
20208,2014/03/31,2010/11/26,118,15,0.522003795,23186,118,9,6
20209,2014/03/31,2010/03/06,372,5,1.128681339,10723,372,5,0
20210,2014/03/31,2011/08/25,93,4,1.2375,9780,93,3,1
20211,2014/03/31,2011/06/16,74,16,0.625559289,19346,74,9,7
20212,2014/03/31,2008/03/18,176,9,0.525017787,23050,176,6,3
20213,2014/03/31,2012/06/14,463,8,0.7918788040000001,15281,463,8,0
20214,2014/03/31,2012/01/15,324,10,0.574081981,21078,324,9,1
20215,2014/03/31,2012/10/09,9,12,0.6265097860000001,19314,9,4,8
20216,2014/03/31,2012/04/15,123,11,0.831908691,14544,123,4,7
20217,2014/03/31,2008/04/01,27,8,0.701565762,17244,27,2,6
20218,2014/03/31,2007/08/14,114,18,0.7158465,16899,114,10,8
20219,2014/03/31,2012/02/04,166,19,0.8511645090000001,14212,166,8,11
20220,2014/03/31,2006/07/10,218,11,0.78835028,15342,218,7,4
20221,2014/03/31,2012/03/03,109,18,0.627613513,19271,109,7,11
20222,2014/03/31,2009/02/16,192,10,0.517052587,23390,192,4,6
20223,2014/03/31,2008/10/01,114,7,0.510741679,23676,114,6,1
20224,2014/03/31,2013/02/22,8,11,0.630068779,19192,8,1,10
20225,2014/03/31,2011/11/16,82,10,0.648210035,18654,82,6,4
20226,2014/03/31,2010/09/26,17,13,0.571780006,21146,17,9,4
20227,2014/03/31,2009/02/13,92,2,0.794980274,15208,92,0,2
20228,2014/03/31,2012/03/22,60,4,1.440475396,8393,60,0,4
20229,2014/03/31,2012/09/22,11,9,0.790988745,15282,11,5,4
20230,2014/03/31,2010/11/08,34,11,0.6671356039999999,18119,34,4,7
20231,2014/03/31,2006/12/06,150,14,0.864475755,13982,150,11,3
20232,2014/03/31,2011/07/06,353,8,0.728471553,16592,353,6,2
20233,2014/03/31,2006/12/29,240,5,1.486078938,8133,240,2,3
20234,2014/03/31,2013/02/02,24,12,0.66098939,18284,24,3,9
20235,2014/03/31,2006/03/03,82,12,0.772684954,15639,82,8,4
20236,2014/03/31,2009/06/19,270,11,0.792696799,15244,270,9,2
20237,2014/03/31,2007/03/17,6,13,0.718720557,16812,6,4,9
20238,2014/03/31,2011/01/19,306,10,0.518484744,23303,306,8,2
20239,2014/03/31,2012/06/08,229,16,0.6957682559999999,17364,229,8,8
20240,2014/03/31,2008/02/16,48,2,0.794847029,15199,48,0,2
20241,2014/03/31,2008/08/11,49,2,0.794847029,15199,49,0,2
20242,2014/03/31,2010/12/25,80,11,0.7283225809999999,16585,80,7,4
20243,2014/03/31,2012/06/06,424,5,1.034135274,11680,424,5,0
20244,2014/03/31,2011/06/04,42,12,0.549771507,21970,42,6,6
20245,2014/03/31,2012/08/11,3,10,0.91413078,13213,3,0,10
20246,2014/03/31,2009/03/23,228,15,0.7307750479999999,16528,228,11,4
20247,2014/03/31,2005/06/02,450,3,0.733967424,16454,450,3,0
20248,2014/03/31,2007/11/16,118,13,0.7852636709999999,15379,118,4,9
20249,2014/03/31,2012/06/19,17,18,0.747567166,16154,17,11,7
20250,2014/03/31,2009/02/27,30,10,0.75028891,16095,30,3,7
20251,2014/03/31,2011/11/13,146,15,0.792018102,15247,146,12,3
20252,2014/03/31,2012/06/04,518,8,0.66743312,18092,518,8,0
20253,2014/03/31,2011/01/22,379,5,0.9149731,13197,379,5,0
20254,2014/03/31,2011/04/07,127,12,0.86495702,13960,127,8,4
20255,2014/03/31,2010/02/01,189,8,0.815966347,14798,189,4,4
20256,2014/03/31,2012/03/08,18,12,0.71380927,16914,18,9,3
20257,2014/03/31,2007/01/14,42,12,0.631021795,19133,42,5,7
20258,2014/03/31,2011/09/28,516,7,0.882479351,13681,516,7,0
20259,2014/03/31,2008/08/09,70,11,0.674629226,17895,70,6,5
20260,2014/03/31,2010/12/11,27,13,0.654779236,18436,27,5,8
20261,2014/03/31,2006/01/25,25,19,0.497818789,24248,25,8,11
20262,2014/03/31,2009/01/30,98,5,0.715546268,16869,98,1,4
20263,2014/03/31,2009/09/24,91,31,0.43343759,27848,91,4,27
20264,2014/03/31,2006/02/20,95,12,0.7938531870000001,15203,95,7,5
20265,2014/03/31,2011/11/28,176,14,0.725210624,16641,176,9,5
20266,2014/03/31,2010/08/15,12,14,0.822072207,14680,12,5,9
20267,2014/03/31,2011/09/22,120,28,0.906231601,13316,120,14,14
20268,2014/03/31,2007/03/24,597,8,0.848130316,14227,597,8,0
20269,2014/03/31,2009/10/11,52,6,1.170738405,10306,52,0,6
20270,2014/03/31,2012/02/28,11,16,0.649723165,18567,11,10,6
20271,2014/03/31,2011/01/27,192,17,0.4482357970000001,26913,192,8,9
20272,2014/03/31,2010/06/25,38,13,0.578410529,20856,38,1,12
20273,2014/03/31,2008/09/29,132,16,0.493764224,24430,132,9,7
20274,2014/03/31,2010/10/07,262,13,0.7015138120000001,17195,262,12,1
20275,2014/03/31,2012/07/01,60,11,0.778665591,15490,60,9,2
20276,2014/03/31,2013/03/14,187,16,0.589782396,20450,187,2,14
20277,2014/03/31,2013/02/07,57,10,0.5611445589999999,21493,57,0,10
20278,2014/03/31,2011/05/05,248,7,0.702636332,17164,248,5,2
20279,2014/03/31,2012/11/23,83,12,0.821188206,14686,83,5,7
20280,2014/03/31,2012/03/08,186,14,0.66467894,18143,186,9,5
20281,2014/03/31,2012/04/17,76,15,0.7076989440000001,17040,76,7,8
20282,2014/03/31,2012/01/24,37,12,0.593123586,20326,37,3,9
20283,2014/03/31,2011/01/22,9,13,0.8137246029999999,14815,9,4,9
20284,2014/03/31,2006/09/03,221,21,0.578220453,20848,221,14,7
20285,2014/03/31,2013/01/13,18,21,0.7859205890000001,15338,18,9,12
20286,2014/03/31,2009/09/01,25,14,0.824652802,14617,25,7,7
20287,2014/03/31,2009/08/31,26,12,0.635036089,18981,26,6,6
20288,2014/03/31,2006/08/04,257,12,0.598291969,20146,257,8,4
20289,2014/03/31,2008/03/07,230,12,0.730747545,16494,230,10,2
20290,2014/03/31,2012/03/01,98,12,0.6453263370000001,18677,98,6,6
20291,2014/03/31,2011/07/07,87,15,0.822328375,14654,87,6,9
20292,2014/03/31,2013/03/12,6,5,0.848,14210,6,2,3
20293,2014/03/31,2012/01/18,18,22,0.555736556,21682,18,9,13
20294,2014/03/31,2009/08/23,31,10,0.603101256,19979,31,6,4
20295,2014/03/31,2009/03/06,348,10,0.6761616159999999,17820,348,8,2
20296,2014/03/31,2012/09/14,131,12,0.7977931540000001,15103,131,3,9
20297,2014/03/31,2012/09/19,159,14,0.805104918,14964,159,10,4
20298,2014/03/31,2006/02/24,240,8,0.646620505,18630,240,4,4
20299,2014/03/31,2007/08/21,249,18,0.74228295,16229,249,10,8
20300,2014/03/31,2008/04/09,45,10,0.81988361,14692,45,8,2
20301,2014/03/31,2011/06/06,9,10,0.585151324,20585,9,3,7
20302,2014/03/31,2008/04/08,238,16,0.563728821,21366,238,10,6
20303,2014/03/31,2012/05/09,75,18,0.7621007340000001,15804,75,2,16
20304,2014/03/31,2012/03/29,201,15,0.71346188,16881,201,10,5
20305,2014/03/31,2012/08/11,25,9,0.484881614,24834,25,1,8
20306,2014/03/31,2012/06/18,60,9,0.8088888890000001,14886,60,4,5
20307,2014/03/31,2010/06/14,122,14,0.670250487,17965,122,10,4
20308,2014/03/31,2011/08/16,14,13,0.7738331509999999,15559,14,1,12
20309,2014/03/31,2012/05/07,16,16,0.754055239,15967,16,1,15
20310,2014/03/31,2006/04/30,48,10,0.7376528609999999,16322,48,4,6
20311,2014/03/31,2008/05/19,69,13,0.859382584,14010,69,3,10
20312,2014/03/31,2008/10/18,18,15,0.855577743,14072,18,6,9
20313,2014/03/31,2010/06/07,159,14,0.913073948,13185,159,3,11
20314,2014/03/31,2007/08/09,423,6,0.929057652,12957,423,6,0
20315,2014/03/31,2012/02/25,312,12,0.649508957,18532,312,10,2
20316,2014/03/31,2012/04/19,76,15,0.5529284760000001,21769,76,10,5
20317,2014/03/31,2009/01/15,21,12,0.756445227,15911,21,8,4
20318,2014/03/31,2005/04/22,124,17,0.8443721059999999,14254,124,6,11
20319,2014/03/31,2013/02/11,105,12,0.678978337,17726,105,1,11
20320,2014/03/31,2005/07/22,69,11,0.658396521,18279,69,6,5
20321,2014/03/31,2009/09/16,110,9,0.630721136,19081,110,4,5
20322,2014/03/31,2005/04/06,100,14,0.690862277,17419,100,6,8
20323,2014/03/31,2010/09/08,32,8,0.715529524,16817,32,6,2
20324,2014/03/31,2012/12/02,14,13,0.688335908,17481,14,3,10
20325,2014/03/31,2012/11/08,276,13,0.674502495,17839,276,5,8
20326,2014/03/31,2009/11/15,43,12,0.682954932,17618,43,7,5
20327,2014/03/31,2008/04/17,1,13,0.796819205,15100,1,5,8
20328,2014/03/31,2011/09/22,35,13,0.759261643,15846,35,6,7
20329,2014/03/31,2009/07/06,38,13,0.7316767009999999,16443,38,7,6
20330,2014/03/31,2009/01/20,124,21,0.6715534470000001,17915,124,14,7
20331,2014/03/31,2008/11/12,167,12,0.777801772,15467,167,10,2
20332,2014/03/31,2013/03/03,62,13,0.949263,12673,62,4,9
20333,2014/03/31,2013/03/03,35,15,0.7009993590000001,17161,35,0,15
20334,2014/03/31,2013/02/03,11,24,0.6856734879999999,17543,11,6,18
20335,2014/03/31,2005/10/25,13,13,0.698807297,17213,13,8,5
20336,2014/03/31,2009/10/22,328,6,0.6889907209999999,17458,328,5,1
20337,2014/03/31,2007/09/13,20,11,0.785096606,15320,20,0,11
20338,2014/03/31,2012/06/30,67,24,0.76360127,15750,67,12,12
20339,2014/03/31,2011/01/23,85,10,0.881052747,13650,85,8,2
20340,2014/03/31,2010/07/03,11,11,0.800559846,15022,11,5,6
20341,2014/03/31,2007/09/05,33,10,0.846010975,14214,33,4,6
20342,2014/03/31,2006/05/27,18,11,0.6109958839999999,19681,18,7,4
20343,2014/03/31,2005/12/07,4,2,0.80677402,14904,4,1,1
20344,2014/03/31,2013/01/09,32,10,0.7642819909999999,15731,32,1,9
20345,2014/03/31,2012/04/12,35,10,0.643722225,18677,35,6,4
20346,2014/03/31,2012/11/13,37,10,0.631715006,19032,37,3,7
20347,2014/03/31,2007/08/15,22,10,0.764494468,15726,22,1,9
20348,2014/03/31,2007/06/01,613,3,0.695898935,17276,613,3,0
20349,2014/03/31,2011/03/08,137,9,1.047765383,11474,137,3,6
20350,2014/03/31,2013/01/16,66,6,1.003900626,11975,66,2,4
20351,2014/03/31,2011/03/06,14,13,0.742038272,16200,14,2,11
20352,2014/03/31,2011/01/21,207,6,0.719033377,16718,207,4,2
20353,2014/03/31,2011/08/30,18,14,0.564023463,21310,18,7,7
20354,2014/03/31,2009/06/18,65,15,0.5944729679999999,20217,65,10,5
20355,2014/03/31,2011/10/17,29,10,0.67652612,17764,29,6,4
20356,2014/03/31,2011/08/15,3,12,0.7202505240000001,16685,3,6,6
20357,2014/03/31,2010/02/12,27,10,1.334667925,9004,27,4,6
20358,2014/03/31,2010/11/30,176,8,0.8235341279999999,14592,176,1,7
20359,2014/03/31,2011/11/20,82,9,0.6272267460000001,19158,82,0,9
20360,2014/03/31,2008/06/06,25,18,0.80716464,14887,25,0,18
20361,2014/03/31,2007/03/21,5,2,0.7900157809999999,15208,5,1,1
20362,2014/03/31,2006/08/25,137,15,0.77062925,15590,137,5,10
20363,2014/03/31,2012/07/20,72,12,0.7398540370000001,16237,72,7,5
20364,2014/03/31,2006/01/02,39,13,0.582094781,20637,39,4,9
20365,2014/03/31,2010/11/15,4,2,0.868923533,13823,4,1,1
20366,2014/03/31,2012/08/17,4,12,0.745538175,16110,4,7,5
20367,2014/03/31,2006/07/15,377,12,0.7760661670000001,15476,377,12,0
20368,2014/03/31,2012/12/22,388,4,0.607531995,19769,388,4,0
20369,2014/03/31,2005/10/06,153,6,0.716666667,16758,153,3,3
20370,2014/03/31,2010/07/26,185,13,0.7170908220000001,16747,185,7,6
20371,2014/03/31,2008/11/30,32,10,1.475136961,8141,32,7,3
20372,2014/03/31,2012/10/07,33,13,0.6196294960000001,19379,33,6,7
20373,2014/03/31,2013/02/16,81,11,0.704921921,17034,81,1,10
20374,2014/03/31,2009/10/10,196,11,0.819853885,14646,196,3,8
20375,2014/03/31,2011/12/06,102,6,0.989335091,12137,102,3,3
20376,2014/03/31,2010/09/11,137,6,1.4549781869999998,8252,137,2,4
20377,2014/03/31,2007/10/11,555,17,0.786946975,15257,555,17,0
20378,2014/03/31,2006/12/04,104,11,0.7373096290000001,16284,104,4,7
20379,2014/03/31,2010/12/01,6,31,0.702903226,17081,6,6,25
20380,2014/03/31,2011/04/04,16,16,0.656034973,18300,16,9,7
20381,2014/03/31,2011/02/03,47,4,0.910161486,13190,47,2,2
20382,2014/03/31,2009/10/23,301,9,0.8031303940000001,14947,301,8,1
20383,2014/03/31,2011/03/28,77,11,0.7411409520000001,16197,77,6,5
20384,2014/03/31,2008/08/18,216,3,1.116914488,10747,216,0,3
20385,2014/03/31,2006/08/11,68,13,0.5066618829999999,23690,68,8,5
20386,2014/03/31,2011/03/12,29,11,0.70652696,16988,29,5,6
20387,2014/03/31,2007/01/03,388,8,0.432686761,27736,388,8,0
20388,2014/03/31,2013/01/06,252,5,0.7343980659999999,16339,252,0,5
20389,2014/03/31,2012/10/02,244,6,0.7566666670000001,15858,244,4,2
20390,2014/03/31,2005/10/12,56,4,0.738899975,16236,56,1,3
20391,2014/03/31,2012/05/17,128,6,0.586888454,20440,128,1,5
20392,2014/03/31,2008/12/21,200,20,0.64151674,18698,200,14,6
20393,2014/03/31,2012/08/26,230,12,0.721321787,16629,230,4,8
20394,2014/03/31,2007/03/02,87,3,0.751386418,15962,87,0,3
20395,2014/03/31,2010/02/01,172,11,1.383351021,8669,172,5,6
20396,2014/03/31,2010/12/28,326,18,0.7697843109999999,15578,326,16,2
20397,2014/03/31,2008/10/02,13,17,0.889634246,13479,13,7,10
20398,2014/03/31,2013/01/21,65,12,0.539968926,22205,65,2,10
20399,2014/03/31,2011/12/30,147,13,0.618988074,19369,147,9,4
20400,2014/03/31,2011/03/24,210,5,1.306539887,9176,210,0,5
20401,2014/03/31,2007/05/03,211,8,0.8063509790000001,14867,211,7,1
20402,2014/03/31,2009/04/11,114,9,0.8713257740000001,13758,114,8,1
20403,2014/03/31,2009/08/24,165,13,0.599259148,20004,165,8,5
20404,2014/03/31,2011/04/14,100,2,0.49,24464,100,0,2
20405,2014/03/31,2013/02/28,144,7,0.535436433,22386,144,3,4
20406,2014/03/31,2009/01/05,43,16,0.700005256,17123,43,6,10
20407,2014/03/31,2006/12/26,264,14,0.918985585,13042,264,12,2
20408,2014/03/31,2012/05/10,4,17,0.727173108,16481,4,8,9
20409,2014/03/31,2007/06/11,37,12,0.852711876,14053,37,5,7
20410,2014/03/31,2013/01/30,50,11,0.643763296,18614,50,2,9
20411,2014/03/31,2012/07/06,14,18,0.715340577,16751,14,7,11
20412,2014/03/31,2007/07/10,371,6,1.0,11982,371,6,0
20413,2014/03/31,2006/12/04,77,10,0.7031107329999999,17041,77,4,6
20414,2014/03/31,2012/10/19,2,18,0.723724555,16555,2,4,14
20415,2014/03/31,2009/11/04,319,16,0.887485185,13500,319,15,1
20416,2014/03/31,2011/03/22,39,20,0.7976045270000001,15020,39,0,20
20417,2014/03/31,2008/06/04,147,10,0.5559892329999999,21547,147,6,4
20418,2014/03/31,2011/09/14,221,9,0.71681247,16712,221,3,6
20419,2014/03/31,2012/04/30,91,12,0.760347848,15754,91,8,4
20420,2014/03/31,2005/07/08,19,12,0.8024815759999999,14926,19,7,5
20421,2014/03/31,2006/06/22,33,20,0.615502055,19460,33,8,12
20422,2014/03/31,2011/06/07,153,10,0.612710902,19547,153,9,1
20423,2014/03/31,2007/06/29,240,9,0.5755466379999999,20809,240,7,2
20424,2014/03/31,2011/01/04,293,9,0.7659980809999999,15635,293,7,2
20425,2014/03/31,2012/04/12,151,14,0.7018430609999999,17064,151,7,7
20426,2014/03/31,2012/09/25,33,17,0.6408449270000001,18688,33,6,11
20427,2014/03/31,2012/08/26,6,10,0.63868633,18749,6,1,9
20428,2014/03/31,2009/11/22,72,22,0.58133903,20597,72,16,6
20429,2014/03/31,2010/12/20,44,12,0.678072262,17658,44,9,3
20430,2014/03/31,2008/01/27,116,18,0.7336916290000001,16318,116,9,9
20431,2014/03/31,2011/10/24,122,8,0.7516977459999999,15927,122,3,5
20432,2014/03/31,2008/09/15,186,11,0.83756821,14294,186,9,2
20433,2014/03/31,2009/06/03,21,9,0.7064668040000001,16945,21,1,8
20434,2014/03/31,2007/01/19,42,9,0.676498446,17695,42,4,5
20435,2014/03/31,2012/12/22,8,12,0.680930087,17579,8,2,10
20436,2014/03/31,2006/10/18,4,13,0.829620183,14428,4,4,9
20437,2014/03/31,2012/05/19,60,23,0.653451439,18317,60,12,11
20438,2014/03/31,2012/04/04,243,10,0.507169492,23600,243,9,1
20439,2014/03/31,2012/04/21,360,9,0.650391241,18403,360,7,2
20440,2014/03/31,2012/04/01,500,7,0.835714286,14322,500,7,0
20441,2014/03/31,2008/12/22,11,18,0.62181941,19248,11,5,13
20442,2014/03/31,2012/11/10,99,11,0.841425056,14224,99,3,8
20443,2014/03/31,2011/06/27,101,11,0.7383335390000001,16208,101,7,4
20444,2014/03/31,2013/03/13,84,10,0.667868066,17918,84,1,9
20445,2014/03/31,2012/09/20,197,9,0.630540626,18978,197,4,5
20446,2014/03/31,2009/07/16,239,14,0.7324680170000001,16337,239,5,9
20447,2014/03/31,2011/09/12,74,12,0.7530042159999999,15891,74,3,9
20448,2014/03/31,2013/01/21,17,11,0.697272727,17160,17,1,10
20449,2014/03/31,2012/11/25,167,13,0.617868836,19365,167,1,12
20450,2014/03/31,2011/10/12,137,17,0.646671171,18502,137,10,7
20451,2014/03/31,2008/02/11,460,8,0.8165256259999999,14653,460,8,0
20452,2014/03/31,2007/07/28,404,12,0.615569047,19436,404,12,0
20453,2014/03/31,2013/03/23,5,17,0.5481694460000001,21824,5,1,16
20454,2014/03/31,2011/04/10,104,9,0.8742644159999999,13683,104,5,4
20455,2014/03/31,2011/04/23,104,11,0.7112194540000001,16819,104,3,8
20456,2014/03/31,2011/07/23,175,9,1.081659432,11058,175,5,4
20457,2014/03/31,2010/11/03,84,11,0.651209234,18367,84,4,7
20458,2014/03/31,2011/11/10,61,13,0.620649196,19270,61,5,8
20459,2014/03/31,2008/06/05,225,9,0.825952348,14480,225,6,3
20460,2014/03/31,2008/11/18,231,9,0.687932125,17385,231,7,2
20461,2014/03/31,2006/11/22,35,7,0.571619102,20919,35,1,6
20462,2014/03/31,2008/05/20,9,10,0.669319339,17865,9,0,10
20463,2014/03/31,2008/08/29,169,8,0.752658315,15886,169,5,3
20464,2014/03/31,2005/04/30,99,16,0.5359967720000001,22307,99,4,12
20465,2014/03/31,2009/03/05,25,17,0.577701005,20696,25,9,8
20466,2014/03/31,2011/10/10,76,15,0.593178368,20155,76,9,6
20467,2014/03/31,2010/07/24,209,17,0.684971353,17454,209,9,8
20468,2014/03/31,2013/02/01,111,12,0.7778910720000001,15368,111,4,8
20469,2014/03/31,2012/03/15,76,16,0.7723919359999999,15477,76,10,6
20470,2014/03/31,2012/06/14,87,10,0.6345511970000001,18839,87,7,3
20471,2014/03/31,2008/08/27,330,7,0.68685647,17404,330,3,4
20472,2014/03/31,2012/06/27,374,6,1.052615358,11356,374,6,0
20473,2014/03/31,2006/09/04,104,12,0.558601271,21398,104,8,4
20474,2014/03/31,2006/10/22,3,16,0.806695012,14817,3,10,6
20475,2014/03/31,2008/02/26,226,17,0.840366308,14223,226,14,3
20476,2014/03/31,2011/11/21,372,6,0.890625931,13420,372,6,0
20477,2014/03/31,2008/02/09,553,10,0.7693164259999999,15536,553,10,0
20478,2014/03/31,2012/10/18,39,3,1.47,8130,39,2,1
20479,2014/03/31,2005/10/27,101,5,0.729744153,16377,101,2,3
20480,2014/03/31,2010/04/04,75,17,0.602540339,19832,75,6,11
20481,2014/03/31,2012/05/11,177,15,0.642711919,18592,177,7,8
20482,2014/03/31,2007/11/22,14,8,0.567753386,21045,14,0,8
20483,2014/03/31,2011/07/03,103,10,0.618409503,19321,103,6,4
20484,2014/03/31,2012/07/18,62,14,0.6347922420000001,18820,62,6,8
20485,2014/03/31,2005/12/18,18,10,0.615923902,19396,18,5,5
20486,2014/03/31,2011/01/24,1,6,0.7533333329999999,15858,1,0,6
20487,2014/03/31,2012/07/25,63,8,0.540333363,22108,63,4,4
20488,2014/03/31,2012/11/27,234,5,0.663955311,17991,234,4,1
20489,2014/03/31,2006/04/15,128,9,0.580228796,20586,128,4,5
20490,2014/03/31,2006/06/23,32,12,0.660802766,18075,32,9,3
20491,2014/03/31,2013/02/13,28,15,0.588365025,20300,28,1,14
20492,2014/03/31,2012/05/08,6,14,0.753824402,15843,6,9,5
20493,2014/03/31,2007/11/22,17,14,0.83177671,14358,17,5,9
20494,2014/03/31,2008/10/15,164,5,0.94631458,12620,164,3,2
20495,2014/03/31,2011/01/02,82,15,0.633888004,18840,82,6,9
20496,2014/03/31,2011/07/21,239,6,0.8326887940000001,14341,239,5,1
20497,2014/03/31,2011/07/06,148,11,0.491842333,24279,148,6,5
20498,2014/03/31,2006/03/08,192,9,0.751481435,15890,192,2,7
20499,2014/03/31,2008/07/02,8,12,0.854284897,13977,8,9,3
20500,2014/03/31,2012/09/30,38,26,0.339656085,35154,38,7,19
20501,2014/03/31,2006/11/16,136,11,0.62711187,19040,136,6,5
20502,2014/03/31,2013/02/07,4,13,0.67549785,17676,4,2,11
20503,2014/03/31,2008/11/02,547,9,1.5,7959,547,9,0
20504,2014/03/31,2012/10/14,165,2,0.785003945,15208,165,1,1
20505,2014/03/31,2008/07/18,293,2,0.784996055,15208,293,1,1
20506,2014/03/31,2011/01/31,421,11,0.520420263,22938,421,11,0
20507,2014/03/31,2010/03/19,43,11,0.8844650270000001,13496,43,6,5
20508,2014/03/31,2008/10/25,6,10,0.703109095,16976,6,6,4
20509,2014/03/31,2010/12/07,45,13,0.7397787140000001,16133,45,10,3
20510,2014/03/31,2012/03/23,3,24,0.563850043,21166,3,12,12
20511,2014/03/31,2012/04/10,179,9,0.51249066,23287,179,8,1
20512,2014/03/31,2011/04/28,70,11,0.559892564,21315,70,6,5
20513,2014/03/31,2009/11/26,54,14,0.666887225,17894,54,9,5
20514,2014/03/31,2010/11/22,51,9,0.693787209,17200,51,5,4
20515,2014/03/31,2011/11/14,268,7,0.7280754209999999,16388,268,6,1
20516,2014/03/31,2005/09/09,127,14,0.7674541709999999,15547,127,9,5
20517,2014/03/31,2008/11/01,22,9,0.726823221,16416,22,7,2
20518,2014/03/31,2013/02/03,30,12,0.6460569629999999,18468,30,0,12
20519,2014/03/31,2007/04/12,115,9,0.786409597,15171,115,6,3
20520,2014/03/31,2010/01/30,43,13,0.5916270770000001,20165,43,6,7
20521,2014/03/31,2011/02/10,43,2,0.784928614,15199,43,1,1
20522,2014/03/31,2011/06/14,249,10,0.782982145,15234,249,7,3
20523,2014/03/31,2010/06/26,35,21,0.7654890259999999,15582,35,8,13
20524,2014/03/31,2011/12/27,22,3,0.583058271,20456,22,0,3
20525,2014/03/31,2009/09/24,23,16,0.8714759609999999,13686,23,7,9
20526,2014/03/31,2009/07/12,139,11,0.609090909,19580,139,8,3
20527,2014/03/31,2008/08/01,33,5,0.663880198,17963,33,2,3
20528,2014/03/31,2012/02/13,262,10,0.6972199490000001,17104,262,7,3
20529,2014/03/31,2011/01/16,158,14,0.631533655,18883,158,9,5
20530,2014/03/31,2012/09/01,240,9,0.7854555040000001,15181,240,4,5
20531,2014/03/31,2010/10/01,71,10,0.545331351,21865,71,5,5
20532,2014/03/31,2011/02/08,104,17,0.7239710970000001,16469,104,10,7
20533,2014/03/31,2011/11/20,449,4,0.70363234,16945,449,4,0
20534,2014/03/31,2010/09/01,21,11,0.887387226,13434,21,2,9
20535,2014/03/31,2011/11/19,46,13,0.5283365839999999,22562,46,8,5
20536,2014/03/31,2012/08/11,4,12,0.718337351,16594,4,4,8
20537,2014/03/31,2005/02/26,34,14,0.7527977770000001,15834,34,6,8
20538,2014/03/31,2011/03/08,298,11,0.7898760690000001,15089,298,10,1
20539,2014/03/31,2011/02/21,59,10,0.660532705,18040,59,6,4
20540,2014/03/31,2008/12/11,42,9,0.6943313329999999,17161,42,5,4
20541,2014/03/31,2009/01/05,7,15,0.818512641,14556,7,9,6
20542,2014/03/31,2010/02/13,35,9,0.758896745,15699,35,6,3
20543,2014/03/31,2012/03/16,611,9,0.950965837,12528,611,9,0
20544,2014/03/31,2007/03/01,70,7,0.793451215,15015,70,3,4
20545,2014/03/31,2006/11/09,9,8,0.8445572490000001,14105,9,0,8
20546,2014/03/31,2011/11/09,47,21,0.7658116359999999,15555,47,3,18
20547,2014/03/31,2010/06/03,390,7,0.752333733,15833,390,7,0
20548,2014/03/31,2012/12/31,90,17,0.579355058,20560,90,3,14
20549,2014/03/31,2006/01/30,2,20,0.486286029,24494,2,6,14
20550,2014/03/31,2010/05/27,248,9,0.633291684,18808,248,8,1
20551,2014/03/31,2011/08/25,115,2,0.59,20188,115,1,1
20552,2014/03/31,2006/02/18,70,20,0.970093663,12278,70,15,5
20553,2014/03/31,2013/01/13,8,16,0.640403807,18598,8,7,9
20554,2014/03/31,2012/01/19,412,8,0.8888134329999999,13400,412,8,0
20555,2014/03/31,2009/01/16,327,16,0.5478563870000001,21739,327,14,2
20556,2014/03/31,2008/11/05,247,10,0.650476269,18309,247,6,4
20557,2014/03/31,2012/11/14,19,13,0.7601736240000001,15666,19,9,4
20558,2014/03/31,2006/05/18,534,8,0.7566113859999999,15738,534,8,0
20559,2014/03/31,2011/07/26,32,2,0.785,15168,32,1,1
20560,2014/03/31,2006/07/05,71,2,0.785,15168,71,1,1
20561,2014/03/31,2011/02/15,43,18,0.710081107,16768,43,17,1
20562,2014/03/31,2009/10/11,33,11,0.635088814,18747,33,4,7
20563,2014/03/31,2012/03/31,76,14,0.640099462,18600,76,1,13
20564,2014/03/31,2011/10/24,20,12,0.637798671,18666,20,1,11
20565,2014/03/31,2008/07/04,94,20,0.67656797,17596,94,17,3
20566,2014/03/31,2010/04/19,90,9,0.691527826,17214,90,3,6
20567,2014/03/31,2011/07/30,71,20,0.7993949370000001,14891,71,9,11
20568,2014/03/31,2012/02/20,31,17,0.860328876,13835,31,4,13
20569,2014/03/31,2007/12/06,116,9,1.040010486,11444,116,3,6
20570,2014/03/31,2012/05/31,104,21,0.7824521729999999,15211,104,14,7
20571,2014/03/31,2012/01/01,4,18,0.733048968,16235,4,10,8
20572,2014/03/31,2006/11/01,12,14,0.714817707,16649,12,9,5
20573,2014/03/31,2008/11/30,73,13,0.749279733,15883,73,8,5
20574,2014/03/31,2006/12/18,180,12,0.854145554,13933,180,6,6
20575,2014/03/31,2006/05/18,139,13,0.7474002890000001,15921,139,5,8
20576,2014/03/31,2010/09/17,557,8,0.6298592,18892,557,8,0
20577,2014/03/31,2006/07/11,8,17,0.739774932,16084,8,9,8
20578,2014/03/31,2009/01/03,6,19,0.6441343660000001,18472,6,5,14
20579,2014/03/31,2012/12/08,129,13,0.828157583,14367,129,5,8
20580,2014/03/31,2008/02/05,48,15,0.653393573,18205,48,9,6
20581,2014/03/31,2007/02/08,102,14,0.541377725,21971,102,7,7
20582,2014/03/31,2008/06/23,2,13,0.673318992,17665,2,3,10
20583,2014/03/31,2008/10/22,542,8,0.973637033,12216,542,8,0
20584,2014/03/31,2008/10/10,261,8,0.611622442,19446,261,6,2
20585,2014/03/31,2010/02/03,580,6,0.75,15858,580,6,0
20586,2014/03/31,2009/11/27,302,6,0.75,15858,302,4,2
20587,2014/03/31,2008/11/20,78,14,0.565087903,21046,78,12,2
20588,2014/03/31,2013/03/29,2,8,0.6078833570000001,19564,2,0,8
20589,2014/03/31,2007/07/21,70,8,0.849335095,14002,70,6,2
20590,2014/03/31,2010/12/21,24,22,0.812818182,14630,24,10,12
20591,2014/03/31,2013/01/12,106,14,0.671524735,17708,106,4,10
20592,2014/03/31,2006/03/04,10,18,0.753248448,15786,10,8,10
20593,2014/03/31,2008/03/26,6,11,0.6507164360000001,18271,6,5,6
20594,2014/03/31,2012/01/25,39,14,1.132523338,10498,39,10,4
20595,2014/03/31,2006/09/01,100,19,0.6265932329999999,18974,100,11,8
20596,2014/03/31,2005/11/10,139,11,0.551931755,21540,139,5,6
20597,2014/03/31,2012/02/04,31,22,0.788620804,15074,31,11,11
20598,2014/03/31,2011/12/12,325,10,0.828239967,14352,325,9,1
20599,2014/03/31,2008/04/14,229,14,0.8318860659999999,14289,229,7,7
20600,2014/03/31,2011/03/07,111,11,0.651120241,18255,111,5,6
20601,2014/03/31,2012/09/27,3,19,0.7170272059999999,16577,3,9,10
20602,2014/03/31,2011/08/04,40,10,0.904392026,13142,40,3,7
20603,2014/03/31,2011/01/17,28,12,0.559320343,21246,28,7,5
20604,2014/03/31,2012/10/31,71,15,0.635085244,18711,71,1,14
20605,2014/03/31,2008/04/02,5,12,0.745574172,15936,5,3,9
20606,2014/03/31,2010/08/25,68,8,0.647490871,18349,68,0,8
20607,2014/03/31,2007/01/18,123,15,0.800136045,14848,123,9,6
20608,2014/03/31,2013/01/13,4,9,0.780195048,15227,4,2,7
20609,2014/03/31,2010/10/25,416,16,0.664269738,17884,416,16,0
20610,2014/03/31,2008/09/30,52,10,0.669564874,17742,52,7,3
20611,2014/03/31,2012/02/24,180,16,0.643609471,18457,180,10,6
20612,2014/03/31,2011/08/07,107,14,0.7382437390000001,16091,107,8,6
20613,2014/03/31,2012/07/04,135,11,0.850436028,13967,135,7,4
20614,2014/03/31,2012/03/16,319,11,0.836363636,14201,319,9,2
20615,2014/03/31,2012/01/15,90,13,0.6698071170000001,17731,90,3,10
20616,2014/03/31,2005/08/21,45,8,1.077565336,11020,45,3,5
20617,2014/03/31,2006/06/22,32,10,0.811672705,14629,32,6,4
20618,2014/03/31,2012/04/19,210,16,0.579579733,20487,210,6,10
20619,2014/03/31,2012/11/10,19,10,0.669879267,17725,19,6,4
20620,2014/03/31,2012/01/21,68,14,0.808158862,14692,68,6,8
20621,2014/03/31,2007/12/16,100,11,0.560304374,21191,100,7,4
20622,2014/03/31,2012/03/21,79,14,0.86968576,13652,79,9,5
20623,2014/03/31,2011/01/01,67,11,0.754630053,15732,67,4,7
20624,2014/03/31,2007/11/09,328,13,0.637639665,18616,328,12,1
20625,2014/03/31,2008/06/18,46,11,0.964195435,12311,46,8,3
20626,2014/03/31,2010/03/18,17,14,0.6671307329999999,17792,17,4,10
20627,2014/03/31,2012/02/11,142,13,0.67118023,17683,142,9,4
20628,2014/03/31,2009/05/18,95,12,0.714077617,16620,95,7,5
20629,2014/03/31,2011/09/05,122,19,0.651331431,18221,122,9,10
20630,2014/03/31,2011/11/08,164,10,0.913992144,12983,164,7,3
20631,2014/03/31,2012/01/20,24,17,0.737063793,16099,24,9,8
20632,2014/03/31,2009/10/05,226,13,0.7745365540000001,15320,226,12,1
20633,2014/03/31,2011/01/14,59,14,0.8565961590000001,13852,59,4,10
20634,2014/03/31,2007/11/01,190,10,0.735764341,16125,190,7,3
20635,2014/03/31,2010/10/17,10,13,0.551609169,21508,10,5,8
20636,2014/03/31,2012/06/23,2,13,0.7214290059999999,16445,2,11,2
20637,2014/03/31,2010/08/25,7,20,0.592185285,20034,7,4,16
20638,2014/03/31,2012/09/06,91,23,0.800838396,14814,91,18,5
20639,2014/03/31,2008/06/05,57,11,0.7438397390000001,15949,57,0,11
20640,2014/03/31,2011/08/19,4,8,0.7186671509999999,16506,4,1,7
20641,2014/03/31,2011/02/02,20,12,0.7432698329999999,15958,20,4,8
20642,2014/03/31,2011/10/15,113,11,0.471844367,25136,113,7,4
20643,2014/03/31,2009/05/21,76,13,0.7118560540000001,16659,76,8,5
20644,2014/03/31,2011/03/14,18,7,0.839054695,14133,18,6,1
20645,2014/03/31,2012/01/03,39,8,0.433567824,27350,39,4,4
20646,2014/03/31,2011/05/18,39,12,0.745499811,15906,39,3,9
20647,2014/03/31,2010/08/03,349,25,0.58001125,20444,349,23,2
20648,2014/03/31,2012/03/30,279,15,0.776230034,15276,279,13,2
20649,2014/03/31,2012/07/28,501,8,0.743093507,15956,501,8,0
20650,2014/03/31,2012/09/22,3,16,0.7715206920000001,15368,3,7,9
20651,2014/03/31,2012/09/29,7,14,0.68417162,17329,7,6,8
20652,2014/03/31,2009/01/08,144,16,0.8104450059999999,14629,144,8,8
20653,2014/03/31,2008/11/25,24,18,0.8593063209999999,13796,24,10,8
20654,2014/03/31,2005/10/15,40,23,0.460834273,25723,40,15,8
20655,2014/03/31,2009/02/27,400,10,0.8370630609999999,14161,400,10,0
20656,2014/03/31,2013/03/26,71,15,0.6048907720000001,19592,71,1,14
20657,2014/03/31,2012/01/20,8,16,0.7190340390000001,16481,8,11,5
20658,2014/03/31,2011/11/18,103,17,0.7765615990000001,15260,103,7,10
20659,2014/03/31,2010/05/13,74,15,0.7350778579999999,16119,74,3,12
20660,2014/03/31,2009/12/25,22,13,0.874294569,13552,22,5,8
20661,2014/03/31,2012/06/23,195,15,0.586789163,20191,195,7,8
20662,2014/03/31,2012/05/23,111,11,0.7564993609999999,15660,111,6,5
20663,2014/03/31,2012/01/12,2,10,0.8635394040000001,13717,2,5,5
20664,2014/03/31,2007/11/06,242,5,1.4310825180000002,8277,242,4,1
20665,2014/03/31,2012/09/14,49,14,0.579837967,20428,49,4,10
20666,2014/03/31,2011/09/06,6,16,0.660335062,17937,6,0,16
20667,2014/03/31,2008/01/21,45,10,0.741729709,15968,45,2,8
20668,2014/03/31,2005/11/19,30,9,1.003707627,11800,30,3,6
20669,2014/03/31,2006/12/29,177,12,0.81281724,14571,177,5,7
20670,2014/03/31,2013/01/06,11,18,0.715526618,16549,11,1,17
20671,2014/03/31,2012/12/31,283,13,0.6297085729999999,18804,283,9,4
20672,2014/03/31,2011/05/28,337,9,0.605030659,19570,337,7,2
20673,2014/03/31,2010/05/22,57,10,0.754455843,15694,57,1,9
20674,2014/03/31,2010/04/01,8,18,0.692728762,17092,8,12,6
20675,2014/03/31,2011/09/14,16,17,0.584747629,20248,16,9,8
20676,2014/03/31,2006/07/26,20,14,0.570163255,20765,20,7,7
20677,2014/03/31,2008/01/11,2,16,0.642190822,18436,2,0,16
20678,2014/03/31,2011/06/29,10,17,0.576788951,20526,10,4,13
20679,2014/03/31,2011/07/09,43,14,0.683979893,17307,43,6,8
20680,2014/03/31,2008/12/15,73,12,0.636508039,18597,73,8,4
20681,2014/03/31,2006/05/15,33,8,0.7405098529999999,15985,33,0,8
20682,2014/03/31,2011/04/04,198,10,0.7368604870000001,16063,198,2,8
20683,2014/03/31,2005/05/17,39,10,0.7234798290000001,16360,39,3,7
20684,2014/03/31,2008/10/17,58,14,0.809833048,14615,58,5,9
20685,2014/03/31,2012/10/12,66,9,0.595796124,19865,66,5,4
20686,2014/03/31,2010/11/16,184,14,0.7916134859999999,14949,184,11,3
20687,2014/03/31,2010/07/13,73,11,0.6567036629999999,18020,73,5,6
20688,2014/03/31,2010/10/29,148,16,0.585831477,20199,148,10,6
20689,2014/03/31,2008/03/01,24,14,0.6982950720000001,16945,24,5,9
20690,2014/03/31,2008/04/06,379,12,0.8077206640000001,14649,379,12,0
20691,2014/03/31,2010/04/26,20,13,0.83777172,14123,20,5,8
20692,2014/03/31,2012/08/19,21,11,0.678547915,17437,21,4,7
20693,2014/03/31,2012/08/06,593,7,1.206624171,9805,593,7,0
20694,2014/03/31,2009/06/21,64,11,0.631613902,18731,64,4,7
20695,2014/03/31,2012/04/30,50,21,0.898184648,13171,50,8,13
20696,2014/03/31,2013/02/02,59,11,0.810130813,14601,59,2,9
20697,2014/03/31,2010/09/22,170,8,0.8075646890000001,14647,170,5,3
20698,2014/03/31,2010/04/19,35,33,0.871783608,13568,35,13,20
20699,2014/03/31,2012/05/23,142,16,0.7991358690000001,14801,142,11,5
20700,2014/03/31,2011/11/29,34,19,0.8067687590000001,14660,34,13,6
20701,2014/03/31,2012/10/30,183,11,0.708574425,16688,183,7,4
20702,2014/03/31,2010/08/19,25,12,0.79262117,14917,25,8,4
20703,2014/03/31,2012/10/25,207,9,0.597921598,19770,207,5,4
20704,2014/03/31,2008/08/11,487,5,0.581611062,20322,487,5,0
20705,2014/03/31,2013/03/10,13,13,0.894619985,13210,13,1,12
20706,2014/03/31,2010/05/26,127,11,0.649573462,18193,127,7,4
20707,2014/03/31,2010/02/27,167,12,0.758686998,15575,167,4,8
20708,2014/03/31,2011/05/10,147,11,0.757974213,15589,147,7,4
20709,2014/03/31,2013/03/13,16,20,0.615409375,19200,16,0,20
20710,2014/03/31,2008/04/01,43,21,0.666525639,17727,43,5,16
20711,2014/03/31,2011/07/18,325,15,0.918939099,12857,325,14,1
20712,2014/03/31,2012/11/24,68,18,0.669384703,17650,68,6,12
20713,2014/03/31,2009/01/01,591,9,0.8655700470000001,13648,591,9,0
20714,2014/03/31,2008/04/09,36,17,0.811512674,14557,36,8,9
20715,2014/03/31,2011/03/08,60,9,0.5743059939999999,20569,60,5,4
20716,2014/03/31,2012/10/08,74,15,0.7968443070000001,14824,74,6,9
20717,2014/03/31,2004/11/26,18,22,0.77319018,15275,18,17,5
20718,2014/03/31,2009/03/13,153,11,0.707612942,16690,153,5,6
20719,2014/03/31,2012/07/13,279,10,0.897602797,13157,279,8,2
20720,2014/03/31,2013/03/28,214,7,0.6342330829999999,18620,214,0,7
20721,2014/03/31,2011/10/21,29,7,0.69,17115,29,4,3
20722,2014/03/31,2010/10/03,49,10,0.832231463,14188,49,6,4
20723,2014/03/31,2010/03/02,2,14,0.660635631,17872,2,3,11
20724,2014/03/31,2011/06/08,82,10,0.723712762,16314,82,6,4
20725,2014/03/31,2012/08/26,9,11,0.708632135,16661,9,3,8
20726,2014/03/31,2012/09/12,133,12,0.765039207,15431,133,3,9
20727,2014/03/31,2012/06/14,108,6,1.040472413,11346,108,3,3
20728,2014/03/31,2012/08/10,15,15,0.7745433070000001,15240,15,2,13
20729,2014/03/31,2010/11/20,450,9,1.427672956,8268,450,9,0
20730,2014/03/31,2012/09/06,15,15,0.851617,13859,15,4,11
20731,2014/03/31,2012/04/25,236,4,1.479912226,7975,236,3,1
20732,2014/03/31,2011/09/24,41,9,0.666666667,17703,41,6,3
20733,2014/03/31,2005/05/09,299,11,0.609723586,19355,299,9,2
20734,2014/03/31,2012/11/13,174,7,0.688266651,17146,174,4,3
20735,2014/03/31,2006/08/17,48,13,0.463311609,25471,48,9,4
20736,2014/03/31,2013/02/09,9,17,0.7123883120000001,16564,9,3,14
20737,2014/03/31,2011/05/27,208,12,0.916217098,12879,208,11,1
20738,2014/03/31,2012/07/18,342,3,0.743797277,15864,342,1,2
20739,2014/03/31,2012/04/06,484,5,0.69,17100,484,5,0
20740,2014/03/31,2012/01/23,75,11,0.7129482140000001,16549,75,5,6
20741,2014/03/31,2008/04/11,66,9,0.6311111110000001,18693,66,5,4
20742,2014/03/31,2010/10/29,172,12,0.699008118,16877,172,8,4
20743,2014/03/31,2012/08/09,69,12,0.741615844,15905,69,5,7
20744,2014/03/31,2011/12/07,117,7,0.818882872,14403,117,4,3
20745,2014/03/31,2010/03/04,106,8,0.6878177679999999,17143,106,4,4
20746,2014/03/31,2006/08/10,30,12,0.511083611,23071,30,8,4
20747,2014/03/31,2012/07/18,162,16,0.5443354420000001,21661,162,9,7
20748,2014/03/31,2010/02/11,54,13,0.7302396879999999,16146,54,8,5
20749,2014/03/31,2011/12/10,356,19,0.802494725,14691,356,18,1
20750,2014/03/31,2010/06/12,31,14,0.7918692909999999,14888,31,6,8
20751,2014/03/31,2012/08/06,188,2,0.775,15212,188,1,1
20752,2014/03/31,2012/11/27,8,16,0.74715001,15779,8,5,11
20753,2014/03/31,2012/06/15,269,5,0.875997622,13457,269,3,2
20754,2014/03/31,2008/09/09,50,6,0.6222181170000001,18944,50,4,2
20755,2014/03/31,2008/01/24,1,10,0.7435768359999999,15852,1,4,6
20756,2014/03/31,2010/10/23,276,9,0.643046538,18329,276,7,2
20757,2014/03/31,2007/03/12,44,11,0.818215203,14405,44,4,7
20758,2014/03/31,2011/08/09,71,15,0.6846535,17215,71,2,13
20759,2014/03/31,2012/12/01,419,2,0.775006575,15208,419,2,0
20760,2014/03/31,2010/07/04,446,2,0.774993425,15208,446,2,0
20761,2014/03/31,2009/03/09,251,10,0.851778099,13835,251,4,6
20762,2014/03/31,2012/08/12,412,2,0.725,16254,412,2,0
20763,2014/03/31,2011/07/03,2,10,0.6180024120000001,19068,2,5,5
20764,2014/03/31,2013/02/15,6,20,0.820029228,14370,6,1,19
20765,2014/03/31,2007/11/07,222,10,0.5360856310000001,21978,222,3,7
20766,2014/03/31,2012/03/26,47,11,0.656841724,17937,47,5,6
20767,2014/03/31,2013/02/08,14,10,0.62799403,18759,14,0,10
20768,2014/03/31,2011/11/14,687,2,0.77505099,15199,687,2,0
20769,2014/03/31,2007/10/31,73,12,0.595547523,19780,73,1,11
20770,2014/03/31,2010/01/08,71,6,0.975316718,12077,71,4,2
20771,2014/03/31,2012/02/07,352,8,0.8540787470000001,13791,352,5,3
20772,2014/03/31,2009/12/03,64,10,0.673223778,17495,64,6,4
20773,2014/03/31,2005/08/18,19,20,0.815427543,14443,19,11,9
20774,2014/03/31,2010/08/31,9,12,0.688676686,17101,9,2,10
20775,2014/03/31,2010/03/10,148,15,0.637328174,18478,148,10,5
20776,2014/03/31,2010/09/27,13,18,0.613416502,19198,13,7,11
20777,2014/03/31,2013/02/26,75,12,0.654053213,18003,75,4,8
20778,2014/03/31,2007/08/20,252,13,0.647967753,18172,252,8,5
20779,2014/03/31,2012/02/02,29,17,0.7487464220000001,15723,29,4,13
20780,2014/03/31,2008/02/07,147,13,0.6906982340000001,17043,147,7,6
20781,2014/03/31,2013/02/09,67,14,0.7543120790000001,15605,67,0,14
20782,2014/03/31,2012/04/08,69,17,0.6625370110000001,17765,69,13,4
20783,2014/03/31,2012/01/09,51,8,0.6194720770000001,18999,51,5,3
20784,2014/03/31,2010/04/13,10,22,0.5451378020000001,21589,10,6,16
20785,2014/03/31,2009/01/06,38,10,0.7637047370000001,15410,38,5,5
20786,2014/03/31,2010/04/16,10,14,0.6738985279999999,17463,10,10,4
20787,2014/03/31,2006/04/27,31,12,0.591845295,19883,31,6,6
20788,2014/03/31,2007/02/25,7,12,0.6796753879999999,17313,7,4,8
20789,2014/03/31,2009/01/12,12,14,0.636559372,18485,12,6,8
20790,2014/03/31,2012/02/24,76,14,0.66304463,17746,76,7,7
20791,2014/03/31,2010/02/12,76,10,0.68217893,17247,76,4,6
20792,2014/03/31,2010/10/06,67,16,0.540755229,21755,67,4,12
20793,2014/03/31,2009/08/01,152,8,0.710826686,16548,152,4,4
20794,2014/03/31,2008/02/09,127,6,1.16002663,10139,127,2,4
20795,2014/03/31,2012/12/06,50,11,0.672602082,17486,50,6,5
20796,2014/03/31,2010/05/13,91,12,0.724268383,16238,91,7,5
20797,2014/03/31,2009/01/23,41,12,0.659299249,17838,41,9,3
20798,2014/03/31,2008/01/05,139,12,0.6169513670000001,19061,139,6,6
20799,2014/03/31,2012/10/19,37,8,0.975086235,12060,37,5,3
20800,2014/03/31,2011/08/11,254,10,0.8564843409999999,13730,254,9,1
20801,2014/03/31,2008/11/27,18,13,0.6684883460000001,17590,18,5,8
20802,2014/03/31,2008/01/09,35,5,0.71027907,16555,35,3,2
20803,2014/03/31,2013/03/31,177,11,0.500909091,23474,177,1,10
20804,2014/03/31,2012/12/23,29,11,0.697252995,16862,29,1,10
20805,2014/03/31,2006/11/12,31,9,0.760477361,15460,31,6,3
20806,2014/03/31,2012/12/16,84,11,0.64582784,18204,84,4,7
20807,2014/03/31,2013/02/26,137,12,0.695656213,16900,137,1,11
20808,2014/03/31,2012/01/20,68,21,0.768061544,15306,68,10,11
20809,2014/03/31,2008/03/08,652,2,0.775,15168,652,2,0
20810,2014/03/31,2011/08/24,436,2,0.775,15168,436,2,0
20811,2014/03/31,2012/07/13,93,19,0.8167461090000001,14392,93,8,11
20812,2014/03/31,2007/02/17,111,23,0.653224767,17992,111,12,11
20813,2014/03/31,2012/08/04,39,17,0.824761738,14249,39,6,11
20814,2014/03/31,2011/04/28,140,7,0.924753286,12707,140,5,2
20815,2014/03/31,2010/01/19,112,15,0.7637332640000001,15386,112,10,5
20816,2014/03/31,2004/12/08,79,10,0.728362983,16133,79,5,5
20817,2014/03/31,2009/10/14,166,6,1.4133461630000002,8314,166,5,1
20818,2014/03/31,2007/10/01,197,14,0.855386183,13737,197,11,3
20819,2014/03/31,2012/04/19,192,11,0.884506173,13284,192,10,1
20820,2014/03/31,2011/07/23,33,7,0.7228571429999999,16254,33,3,4
20821,2014/03/31,2012/04/17,54,17,0.715195714,16427,54,9,8
20822,2014/03/31,2012/06/19,264,11,0.556555024,21109,264,9,2
20823,2014/03/31,2008/12/04,70,17,0.772746169,15203,70,10,7
20824,2014/03/31,2011/06/14,143,8,1.301838431,9024,143,5,3
20825,2014/03/31,2009/07/08,180,16,0.960100531,12235,180,7,9
20826,2014/03/31,2012/08/25,578,4,0.7187737120000001,16342,578,4,0
20827,2014/03/31,2012/09/15,71,16,0.6954337140000001,16889,71,9,7
20828,2014/03/31,2012/12/12,128,7,0.839584674,13989,128,2,5
20829,2014/03/31,2007/01/16,34,15,0.830140656,14148,34,8,7
20830,2014/03/31,2010/05/20,173,13,0.675845658,17377,173,3,10
20831,2014/03/31,2008/10/10,21,13,0.534428214,21975,21,1,12
20832,2014/03/31,2010/07/05,18,19,0.8957894740000001,13110,18,0,19
20833,2014/03/31,2012/10/29,37,7,0.904646021,12981,37,1,6
20834,2014/03/31,2007/12/11,269,6,0.604600731,19423,269,0,6
20835,2014/03/31,2008/05/04,180,7,0.512909806,22895,180,5,2
20836,2014/03/31,2011/02/13,41,2,0.48,24464,41,0,2
20837,2014/03/31,2008/04/28,46,13,0.8283483840000001,14174,46,1,12
20838,2014/03/31,2008/08/07,93,10,0.6328918,18549,93,1,9
20839,2014/03/31,2011/11/06,224,12,0.6694343070000001,17536,224,8,4
20840,2014/03/31,2005/01/13,18,14,0.8109928829999999,14473,18,1,13
20841,2014/03/31,2005/09/24,188,8,0.723449424,16223,188,3,5
20842,2014/03/31,2012/12/12,77,9,0.8731150959999999,13441,77,2,7
20843,2014/03/31,2008/05/12,31,8,0.749154804,15665,31,2,6
20844,2014/03/31,2008/11/20,22,10,0.6875451140000001,17068,22,5,5
20845,2014/03/31,2012/07/14,128,6,0.74,15858,128,4,2
20846,2014/03/31,2006/08/29,135,9,0.743284348,15787,135,5,4
20847,2014/03/31,2011/11/09,301,15,0.911879857,12868,301,13,2
20848,2014/03/31,2010/11/17,6,15,0.589561875,19903,6,5,10
20849,2014/03/31,2005/07/13,44,8,0.857424918,13685,44,1,7
20850,2014/03/31,2008/05/23,195,10,0.63404161,18505,195,7,3
20851,2014/03/31,2010/07/12,236,9,0.787294994,14902,236,4,5
20852,2014/03/31,2007/11/15,12,17,0.5017398000000001,23382,12,7,10
20853,2014/03/31,2011/06/25,95,5,0.609468544,19249,95,0,5
20854,2014/03/31,2011/05/24,9,4,1.05,11172,9,0,4
20855,2014/03/31,2006/06/06,157,16,0.548259955,21396,157,8,8
20856,2014/03/31,2011/12/25,34,20,0.52824687,22206,34,10,10
20857,2014/03/31,2011/03/06,120,13,0.7756179329999999,15123,120,10,3
20858,2014/03/31,2011/10/01,50,11,0.733956573,15981,50,5,6
20859,2014/03/31,2009/08/31,16,18,0.573976705,20434,16,11,7
20860,2014/03/31,2012/04/30,27,13,0.7361555359999999,15932,27,2,11
20861,2014/03/31,2007/08/13,357,9,0.711622474,16481,357,8,1
20862,2014/03/31,2012/11/23,404,4,0.7197330470000001,16295,404,4,0
20863,2014/03/31,2012/08/23,44,12,0.702897812,16685,44,4,8
20864,2014/03/31,2009/04/28,35,13,0.889817906,13180,35,9,4
20865,2014/03/31,2012/05/15,182,12,0.6221417579999999,18849,182,7,5
20866,2014/03/31,2013/02/03,5,14,0.7512274179999999,15610,5,4,10
20867,2014/03/31,2008/12/18,173,12,0.8491274440000001,13810,173,6,6
20868,2014/03/31,2011/01/15,92,16,0.6755043490000001,17359,92,8,8
20869,2014/03/31,2006/10/14,30,22,0.773909313,15151,30,17,5
20870,2014/03/31,2009/10/29,6,11,0.522615556,22435,6,8,3
20871,2014/03/31,2012/02/24,396,6,0.666606005,17584,396,6,0
20872,2014/03/31,2013/03/09,6,12,0.939525489,12476,6,0,12
20873,2014/03/31,2010/02/19,35,17,0.589517678,19883,35,0,17
20874,2014/03/31,2013/02/01,40,9,0.733801415,15973,40,1,8
20875,2014/03/31,2011/10/18,7,12,0.7457788240000001,15716,7,0,12
20876,2014/03/31,2005/06/09,26,11,0.805894245,14543,26,5,6
20877,2014/03/31,2012/02/23,376,17,0.666538702,17583,376,17,0
20878,2014/03/31,2007/12/04,247,8,0.71996314,16278,247,3,5
20879,2014/03/31,2010/07/12,7,26,0.67638751,17326,7,12,14
20880,2014/03/31,2012/12/15,3,11,0.67142415,17449,3,0,11
20881,2014/03/31,2012/10/23,111,17,0.776360504,15090,111,3,14
20882,2014/03/31,2007/09/22,41,12,0.6210454329999999,18863,41,8,4
20883,2014/03/31,2007/09/17,26,4,1.41,8308,26,0,4
20884,2014/03/31,2010/08/01,30,15,0.78414848,14938,30,11,4
20885,2014/03/31,2009/12/17,248,15,0.771222098,15187,248,13,2
20886,2014/03/31,2012/09/06,7,7,1.1777043740000002,9945,7,2,5
20887,2014/03/31,2010/08/21,24,9,0.7131388909999999,16423,24,3,6
20888,2014/03/31,2008/07/20,16,13,0.4150866620000001,28213,16,7,6
20889,2014/03/31,2009/12/21,113,16,0.6957376270000001,16831,113,8,8
20890,2014/03/31,2007/07/08,340,9,0.859494275,13624,340,8,1
20891,2014/03/31,2005/06/21,50,9,0.797788376,14677,50,4,5
20892,2014/03/31,2013/02/23,262,7,0.85451394,13702,262,3,4
20893,2014/03/31,2011/05/07,104,14,0.749466137,15622,104,12,2
20894,2014/03/31,2006/04/14,178,15,0.632113163,18522,178,8,7
20895,2014/03/31,2006/12/19,77,14,0.583033669,20078,77,12,2
20896,2014/03/31,2011/08/16,178,15,0.791700933,14786,178,10,5
20897,2014/03/31,2013/01/07,65,11,0.706377021,16572,65,3,8
20898,2014/03/31,2005/12/14,34,14,0.779565768,15015,34,6,8
20899,2014/03/31,2009/10/07,43,13,0.7651843620000001,15296,43,4,9
20900,2014/03/31,2012/12/26,235,7,0.910893524,12848,235,4,3
20901,2014/03/31,2010/02/13,248,13,0.648243505,18053,248,10,3
20902,2014/03/31,2012/10/22,8,9,0.644475409,18157,8,5,4
20903,2014/03/31,2013/01/31,1,7,0.634033272,18454,1,1,6
20904,2014/03/31,2012/04/14,8,19,0.5672588000000001,20626,8,3,16
20905,2014/03/31,2005/05/07,78,12,0.766719528,15260,78,5,7
20906,2014/03/31,2009/11/18,30,10,0.558973771,20931,30,1,9
20907,2014/03/31,2012/04/03,17,9,0.6790585640000001,17229,17,0,9
20908,2014/03/31,2012/04/01,17,15,0.709225873,16496,17,11,4
20909,2014/03/31,2012/12/08,69,3,0.965928831,12112,69,0,3
20910,2014/03/31,2013/01/09,107,6,0.7818184859999999,14963,107,1,5
20911,2014/03/31,2008/03/20,47,12,0.703607485,16621,47,3,9
20912,2014/03/31,2007/04/28,320,12,0.705283474,16580,320,10,2
20913,2014/03/31,2012/02/23,165,6,0.96896586,12068,165,2,4
20914,2014/03/31,2005/05/14,413,4,1.401558192,8343,413,4,0
20915,2014/03/31,2006/07/08,283,5,0.7421414059999999,15756,283,2,3
20916,2014/03/31,2011/09/03,172,13,0.6006442,19466,172,7,6
20917,2014/03/31,2008/04/19,49,13,0.626640047,18658,49,0,13
20918,2014/03/31,2011/06/04,154,11,0.620607283,18838,154,4,7
20919,2014/03/31,2012/03/15,10,13,0.73237612,15963,10,6,7
20920,2014/03/31,2006/04/09,22,17,0.7908821540000001,14782,22,7,10
20921,2014/03/31,2012/06/02,68,13,0.657912094,17769,68,7,6
20922,2014/03/31,2007/07/10,259,11,0.927691453,12601,259,8,3
20923,2014/03/31,2007/02/22,34,21,0.8333791970000001,14027,34,5,16
20924,2014/03/31,2011/10/01,176,5,0.64,18265,176,4,1
20925,2014/03/31,2006/03/13,131,15,0.820364236,14249,131,8,7
20926,2014/03/31,2010/01/19,42,17,0.603112842,19381,42,6,11
20927,2014/03/31,2011/12/02,43,13,0.702745145,16633,43,8,5
20928,2014/03/31,2012/05/19,9,14,0.6887230409999999,16970,9,4,10
20929,2014/03/31,2012/03/15,264,8,0.669493584,17456,264,5,3
20930,2014/03/31,2011/05/11,120,15,0.793614941,14725,120,10,5
20931,2014/03/31,2009/06/18,144,18,0.878452748,13301,144,6,12
20932,2014/03/31,2012/01/13,196,13,0.795384615,14690,196,5,8
20933,2014/03/31,2007/06/14,38,17,0.558999569,20901,38,10,7
20934,2014/03/31,2011/12/15,280,11,0.7669377709999999,15234,280,8,3
20935,2014/03/31,2010/08/02,4,16,0.650574674,17958,4,8,8
20936,2014/03/31,2009/11/21,37,12,0.655923306,17811,37,5,7
20937,2014/03/31,2008/12/20,12,16,0.543033515,21513,12,10,6
20938,2014/03/31,2008/11/01,196,13,0.93589569,12482,196,9,4
20939,2014/03/31,2012/10/15,92,17,0.726349335,16082,92,8,9
20940,2014/03/31,2010/10/21,470,15,0.664704376,17573,470,15,0
20941,2014/03/31,2012/06/09,72,8,0.6665764989999999,17523,72,5,3
20942,2014/03/31,2009/07/21,42,11,0.638876429,18281,42,1,10
20943,2014/03/31,2011/08/12,155,13,0.599148925,19493,155,10,3
20944,2014/03/31,2009/04/02,12,16,0.7693807640000001,15180,12,4,12
20945,2014/03/31,2012/09/16,354,4,0.7441789329999999,15693,354,3,1
20946,2014/03/31,2007/07/16,46,10,0.6227936,18750,46,2,8
20947,2014/03/31,2013/02/21,197,12,0.6072303689999999,19230,197,3,9
20948,2014/03/31,2011/03/30,214,8,0.74505998,15672,214,4,4
20949,2014/03/31,2011/10/08,2,14,0.617248216,18915,2,6,8
20950,2014/03/31,2008/11/27,79,15,0.472573973,24705,79,3,12
20951,2014/03/31,2012/03/05,30,8,0.702730994,16613,30,5,3
20952,2014/03/31,2007/04/17,62,12,0.7409501140000001,15756,62,7,5
20953,2014/03/31,2012/02/20,106,15,0.801839538,14558,106,10,5
20954,2014/03/31,2008/02/23,29,12,0.843005705,13847,29,7,5
20955,2014/03/31,2012/03/21,293,4,0.4375,26680,293,2,2
20956,2014/03/31,2007/08/13,126,14,0.739916323,15775,126,12,2
20957,2014/03/31,2008/11/29,1,15,0.6149051729999999,18982,1,7,8
20958,2014/03/31,2007/10/20,73,9,0.7853646879999999,14862,73,6,3
20959,2014/03/31,2007/06/19,209,10,0.660698556,17665,209,5,5
20960,2014/03/31,2012/02/10,10,11,0.506827775,23028,10,2,9
20961,2014/03/31,2006/12/22,262,6,1.069506048,10912,262,1,5
20962,2014/03/31,2012/06/15,643,4,0.672395713,17356,643,4,0
20963,2014/03/31,2012/05/24,43,9,0.661531746,17640,43,3,6
20964,2014/03/31,2012/11/16,68,14,0.596952985,19547,68,3,11
20965,2014/03/31,2013/02/12,52,9,0.7516789070000001,15522,52,2,7
20966,2014/03/31,2011/09/19,157,17,0.702114702,16617,157,14,3
20967,2014/03/31,2005/05/10,17,17,0.671224901,17381,17,12,5
20968,2014/03/31,2008/02/01,217,14,0.732666583,15923,217,13,1
20969,2014/03/31,2009/12/31,136,18,0.4754540270000001,24536,136,14,4
20970,2014/03/31,2012/09/16,69,9,0.74675949,15621,69,4,5
20971,2014/03/31,2011/07/30,217,11,0.581486614,20059,217,8,3
20972,2014/03/31,2007/11/27,18,14,0.746708707,15620,18,7,7
20973,2014/03/31,2012/05/31,375,17,0.978292233,11922,375,17,0
20974,2014/03/31,2008/08/13,66,13,0.922555969,12641,66,2,11
20975,2014/03/31,2012/12/07,111,9,0.808804883,14417,111,5,4
20976,2014/03/31,2005/12/15,105,13,0.680375773,17138,105,6,7
20977,2014/03/31,2010/10/26,443,8,0.53666636,21727,443,8,0
20978,2014/03/31,2013/02/08,83,9,0.68926874,16916,83,0,9
20979,2014/03/31,2007/03/11,256,13,0.7461538459999999,15626,256,9,4
20980,2014/03/31,2012/01/14,73,11,0.925615275,12596,73,7,4
20981,2014/03/31,2009/11/28,214,6,0.827745829,14085,214,3,3
20982,2014/03/31,2012/10/21,208,10,0.762,15300,208,6,4
20983,2014/03/31,2012/09/12,13,14,0.5855160460000001,19911,13,6,8
20984,2014/03/31,2007/07/07,10,11,0.7129717329999999,16344,10,2,9
20985,2014/03/31,2010/12/22,13,20,0.711228713,16383,13,9,11
20986,2014/03/31,2011/10/25,4,20,0.6701501120000001,17387,4,7,13
20987,2014/03/31,2012/02/27,15,8,0.6825,17072,15,3,5
20988,2014/03/31,2011/09/11,382,9,0.8141728979999999,14309,382,9,0
20989,2014/03/31,2012/02/22,155,8,1.27819289,9114,155,3,5
20990,2014/03/31,2012/09/01,106,9,0.654227939,17803,106,2,7
20991,2014/03/31,2009/10/26,81,17,0.6697780210000001,17389,81,7,10
20992,2014/03/31,2010/01/27,48,14,0.662957418,17566,48,8,6
20993,2014/03/31,2012/12/04,18,16,0.732847253,15889,18,8,8
20994,2014/03/31,2012/12/11,48,13,0.551731671,21101,48,5,8
20995,2014/03/31,2005/07/06,170,9,0.63935025,18207,170,3,6
20996,2014/03/31,2012/12/02,364,6,0.7627383529999999,15261,364,5,1
20997,2014/03/31,2012/02/14,479,11,0.682263642,17061,479,11,0
20998,2014/03/31,2011/07/12,29,9,0.892708797,13039,29,1,8
20999,2014/03/31,2013/03/12,1,15,0.698096209,16672,1,0,15
21000,2014/03/31,2009/09/25,109,5,0.816722105,14250,109,3,2
21001,2014/03/31,2012/01/08,32,13,0.657662184,17696,32,7,6
21002,2014/03/31,2012/05/23,33,14,0.7705634640000001,15103,33,1,13
21003,2014/03/31,2007/08/11,15,13,0.725947227,16031,15,6,7
21004,2014/03/31,2012/08/28,70,12,0.804365496,14468,70,6,6
21005,2014/03/31,2012/04/10,8,10,0.639663057,18193,8,4,6
21006,2014/03/31,2008/07/03,25,9,0.721499442,16126,25,1,8
21007,2014/03/31,2007/11/29,76,13,0.873292802,13323,76,10,3
21008,2014/03/31,2010/03/22,283,4,0.7285821640000001,15968,283,0,4
21009,2014/03/31,2007/09/06,129,12,0.782995894,14857,129,7,5
21010,2014/03/31,2011/09/05,138,10,0.673144097,17280,138,2,8
21011,2014/03/31,2006/04/20,132,12,0.655681511,17740,132,6,6
21012,2014/03/31,2010/05/29,424,10,0.736814266,15786,424,10,0
21013,2014/03/31,2009/07/31,5,11,0.788403037,14753,5,0,11
21014,2014/03/31,2013/01/23,100,8,0.8266709309999999,14070,100,1,7
21015,2014/03/31,2007/12/09,10,8,0.68125,17072,10,2,6
21016,2014/03/31,2011/04/22,125,8,0.8278658879999999,14048,125,0,8
21017,2014/03/31,2011/06/08,310,5,1.111063342,10467,310,3,2
21018,2014/03/31,2012/12/04,399,3,0.7284895379999999,15962,399,3,0
21019,2014/03/31,2008/07/23,430,10,0.7810077259999999,14885,430,10,0
21020,2014/03/31,2012/07/31,3,9,0.568312799,20454,3,4,5
21021,2014/03/31,2008/09/11,251,5,1.279148234,9087,251,4,1
21022,2014/03/31,2008/07/08,178,11,0.84042664,13829,178,5,6
21023,2014/03/31,2008/07/07,638,10,0.740695303,15691,638,10,0
21024,2014/03/31,2006/05/02,61,12,0.619028392,18773,61,6,6
21025,2014/03/31,2005/05/10,48,28,0.825757124,14073,48,17,11
21026,2014/03/31,2013/01/23,371,2,0.475,24464,371,2,0
21027,2014/03/31,2008/02/05,377,3,0.7039619559999999,16507,377,3,0
21028,2014/03/31,2010/05/22,25,11,0.653102518,17792,25,3,8
21029,2014/03/31,2011/07/20,87,10,0.7345791970000001,15815,87,4,6
21030,2014/03/31,2011/04/28,4,17,0.7609288009999999,15267,4,5,12
21031,2014/03/31,2006/09/03,95,10,0.917641808,12658,95,6,4
21032,2014/03/31,2008/11/01,31,12,0.776013495,14968,31,6,6
21033,2014/03/31,2011/07/01,196,10,0.467438023,24848,196,9,1
21034,2014/03/31,2012/08/22,34,22,0.582329406,19945,34,6,16
21035,2014/03/31,2008/12/01,123,12,0.503018279,23086,123,4,8
21036,2014/03/31,2011/03/18,422,12,0.732101879,15862,422,12,0
21037,2014/03/31,2012/04/08,14,14,0.727377388,15965,14,6,8
21038,2014/03/31,2009/08/12,28,11,0.74860744,15511,28,7,4
21039,2014/03/31,2012/04/01,101,11,0.700775545,16569,101,4,7
21040,2014/03/31,2012/07/28,34,11,0.665848483,17437,34,9,2
21041,2014/03/31,2013/01/25,55,7,0.7142857140000001,16254,55,2,5
21042,2014/03/31,2012/04/12,31,8,0.587303723,19768,31,3,5
21043,2014/03/31,2011/09/26,28,16,0.581197116,19973,28,4,12
21044,2014/03/31,2012/09/03,31,12,0.619944456,18724,31,2,10
21045,2014/03/31,2007/08/03,49,13,0.577910775,20084,49,6,7
21046,2014/03/31,2009/12/25,115,16,0.750781422,15459,115,13,3
21047,2014/03/31,2005/10/25,3,14,0.737823268,15730,3,8,6
21048,2014/03/31,2009/03/04,11,17,0.704262395,16479,11,11,6
21049,2014/03/31,2005/04/06,23,16,0.654724103,17724,23,8,8
21050,2014/03/31,2009/01/16,179,6,0.726462155,15973,179,2,4
21051,2014/03/31,2010/11/01,90,12,0.65097223,17825,90,4,8
21052,2014/03/31,2011/06/12,80,12,0.632146009,18355,80,4,8
21053,2014/03/31,2005/05/18,13,16,0.524182065,22135,13,2,14
21054,2014/03/31,2011/01/13,201,13,0.5284781820000001,21954,201,11,2
21055,2014/03/31,2008/07/09,176,14,0.834509818,13903,176,7,7
21056,2014/03/31,2006/04/26,148,10,0.783172674,14814,148,8,2
21057,2014/03/31,2011/07/25,44,12,0.717697495,16165,44,9,3
21058,2014/03/31,2011/07/14,12,11,0.798337462,14532,12,0,11
21059,2014/03/31,2007/05/13,68,10,0.8060369620000001,14393,68,6,4
21060,2014/03/31,2009/11/21,19,14,0.924784758,12544,19,1,13
21061,2014/03/31,2006/01/25,7,14,0.665421065,17432,7,6,8
21062,2014/03/31,2009/10/10,85,17,0.379106629,30592,85,6,11
21063,2014/03/31,2012/07/03,96,13,0.572439289,20260,96,2,11
21064,2014/03/31,2012/04/30,129,6,0.573467016,20222,129,2,4
21065,2014/03/31,2009/12/21,243,13,0.7692636820000001,15075,243,11,2
21066,2014/03/31,2012/01/18,23,7,0.473622514,24483,23,2,5
21067,2014/03/31,2006/05/15,200,8,0.64050047,18103,200,6,2
21068,2014/03/31,2010/03/15,73,10,0.866121611,13387,73,2,8
21069,2014/03/31,2004/12/01,141,14,0.6075216139999999,19085,141,11,3
21070,2014/03/31,2006/08/04,208,3,0.729391042,15896,208,1,2
21071,2014/03/31,2010/08/03,63,12,0.7728984729999999,15001,63,8,4
21072,2014/03/31,2006/02/01,43,17,0.854681902,13565,43,6,11
21073,2014/03/31,2012/12/06,259,3,0.867397875,13366,259,2,1
21074,2014/03/31,2010/04/29,306,13,0.725553887,15978,306,10,3
21075,2014/03/31,2008/06/11,15,11,0.630298516,18391,15,5,6
21076,2014/03/31,2012/08/14,97,7,0.828148042,13996,97,6,1
21077,2014/03/31,2007/09/19,44,13,0.673377876,17212,44,1,12
21078,2014/03/31,2012/11/12,57,9,0.753450787,15382,57,2,7
21079,2014/03/31,2013/03/18,83,8,0.7103996570000001,16314,83,3,5
21080,2014/03/31,2012/04/14,6,17,0.7456537129999999,15542,6,8,9
21081,2014/03/31,2010/10/18,4,8,0.803511302,14422,4,0,8
21082,2014/03/31,2013/02/12,32,6,0.6939017959999999,16700,32,3,3
21083,2014/03/31,2011/01/13,11,17,0.908850196,12750,11,5,12
21084,2014/03/31,2010/09/27,78,11,0.549804043,21076,78,7,4
21085,2014/03/31,2012/04/01,15,12,0.8464840379999999,13689,15,1,11
21086,2014/03/31,2007/12/04,68,8,0.77,15048,68,6,2
21087,2014/03/31,2011/05/19,35,17,0.9005098309999999,12867,35,11,6
21088,2014/03/31,2011/12/22,2,15,0.7053031409999999,16428,2,7,8
21089,2014/03/31,2012/06/12,598,6,0.894480043,12953,598,6,0
21090,2014/03/31,2011/01/17,12,15,0.8206304459999999,14117,12,4,11
21091,2014/03/31,2010/04/04,8,8,0.767256409,15097,8,0,8
21092,2014/03/31,2012/07/05,25,17,0.517013839,22400,25,5,12
21093,2014/03/31,2012/02/08,258,11,0.7194055159999999,16098,258,5,6
21094,2014/03/31,2010/05/29,105,10,0.561675802,20617,105,7,3
21095,2014/03/31,2010/01/16,48,9,0.870576735,13299,48,5,4
21096,2014/03/31,2005/12/02,177,10,0.648134028,17862,177,6,4
21097,2014/03/31,2008/11/29,216,13,0.628716124,18413,216,11,2
21098,2014/03/31,2007/04/09,19,16,0.566608585,20431,19,1,15
21099,2014/03/31,2012/07/30,224,2,0.883346051,13105,224,1,1
21100,2014/03/31,2007/03/04,353,7,0.742038462,15600,353,5,2
21101,2014/03/31,2012/06/30,62,11,0.602519779,19212,62,6,5
21102,2014/03/31,2012/06/07,178,17,0.5912724770000001,19576,178,7,10
21103,2014/03/31,2009/10/01,173,9,0.708670789,16333,173,3,6
21104,2014/03/31,2012/08/19,27,11,0.550909091,21010,27,1,10
21105,2014/03/31,2012/02/05,84,11,0.639634706,18095,84,4,7
21106,2014/03/31,2009/12/16,16,15,0.567870743,20378,16,4,11
21107,2014/03/31,2011/10/08,10,6,0.660381828,17521,10,0,6
21108,2014/03/31,2011/03/03,7,9,0.749077312,15444,7,5,4
21109,2014/03/31,2011/12/27,75,15,0.73776148,15680,75,4,11
21110,2014/03/31,2012/07/04,618,3,0.733718128,15766,618,3,0
21111,2014/03/31,2012/01/16,232,19,0.655331143,17651,232,16,3
21112,2014/03/31,2010/09/04,29,16,0.653816065,17691,29,10,6
21113,2014/03/31,2011/06/30,74,11,0.65502152,17658,74,9,2
21114,2014/03/31,2012/12/26,271,11,0.705158222,16401,271,6,5
21115,2014/03/31,2011/08/13,1,12,0.601594964,19223,1,8,4
21116,2014/03/31,2010/09/26,20,9,0.84138616,13743,20,0,9
21117,2014/03/31,2008/03/03,76,8,0.903219809,12802,76,4,4
21118,2014/03/31,2006/01/21,41,7,0.694591218,16647,41,3,4
21119,2014/03/31,2012/06/14,296,11,0.6739418309999999,17157,296,5,6
21120,2014/03/31,2007/06/04,380,11,0.775350365,14913,380,11,0
21121,2014/03/31,2005/08/23,173,11,0.865529685,13357,173,5,6
21122,2014/03/31,2011/06/07,177,15,0.812243378,14233,177,11,4
21123,2014/03/31,2010/02/01,329,9,0.7031232890000001,16441,329,8,1
21124,2014/03/31,2007/10/19,112,18,0.6289852,18378,112,10,8
21125,2014/03/31,2006/11/05,7,11,0.908031267,12729,7,5,6
21126,2014/03/31,2006/05/08,177,2,0.76000263,15208,177,0,2
21127,2014/03/31,2012/07/10,166,11,0.6835701190000001,16907,166,7,4
21128,2014/03/31,2013/01/31,28,16,0.500154938,23106,28,1,15
21129,2014/03/31,2009/09/18,155,12,0.596314187,19377,155,8,4
21130,2014/03/31,2009/11/02,7,8,0.8221017429999999,14055,7,4,4
21131,2014/03/31,2011/10/31,16,19,0.58023104,19910,16,11,8
21132,2014/03/31,2011/10/06,63,18,0.6647971460000001,17377,63,10,8
21133,2014/03/31,2008/01/13,204,9,1.053597227,10964,204,0,9
21134,2014/03/31,2006/10/15,239,10,0.659089924,17526,239,6,4
21135,2014/03/31,2012/12/23,37,15,0.66102724,17474,37,4,11
21136,2014/03/31,2011/08/31,103,6,0.6399700779999999,18047,103,1,5
21137,2014/03/31,2010/12/20,2,20,0.642237113,17983,2,10,10
21138,2014/03/31,2010/04/29,139,14,0.605871892,19062,139,9,5
21139,2014/03/31,2010/04/20,577,3,1.09946687,10504,577,3,0
21140,2014/03/31,2011/09/15,340,14,0.567877164,20336,340,13,1
21141,2014/03/31,2013/01/01,67,9,0.763404072,15126,67,0,9
21142,2014/03/31,2013/01/01,1,10,0.969762265,11904,1,0,10
21143,2014/03/31,2012/01/25,16,13,0.791373826,14587,16,6,7
21144,2014/03/31,2012/08/18,1,11,0.764783358,15094,1,6,5
21145,2014/03/31,2008/03/24,21,18,0.564194037,20460,21,6,12
21146,2014/03/31,2011/01/09,13,21,0.507999736,22722,13,10,11
21147,2014/03/31,2007/02/14,128,8,0.540012164,21375,128,4,4
21148,2014/03/31,2012/01/13,17,15,0.719035071,16053,17,1,14
21149,2014/03/31,2008/05/07,46,10,0.683959469,16876,46,5,5
21150,2014/03/31,2009/11/20,11,12,0.551716457,20921,11,4,8
21151,2014/03/31,2006/07/14,28,11,0.7819483770000001,14761,28,4,7
21152,2014/03/31,2008/01/03,134,19,0.798267515,14459,134,6,13
21153,2014/03/31,2008/12/05,17,3,0.645835711,17871,17,0,3
21154,2014/03/31,2010/01/12,37,3,0.7004661329999999,16476,37,2,1
21155,2014/03/31,2010/02/26,372,6,0.879714896,13118,372,6,0
21156,2014/03/31,2006/08/02,124,15,0.664938919,17354,124,8,7
21157,2014/03/31,2008/09/02,115,12,0.694025021,16626,115,9,3
21158,2014/03/31,2010/07/06,75,14,0.6206659139999999,18591,75,9,5
21159,2014/03/31,2012/12/04,1,14,0.8209021059999999,14056,1,3,11
21160,2014/03/31,2012/04/22,342,4,0.741120175,15569,342,3,1
21161,2014/03/31,2007/09/01,136,13,0.619750765,18617,136,11,2
21162,2014/03/31,2005/04/12,319,23,0.6969854409999999,16553,319,20,3
21163,2014/03/31,2012/08/13,235,7,0.7469575909999999,15445,235,4,3
21164,2014/03/31,2012/11/09,276,13,0.666351874,17313,276,6,7
21165,2014/03/31,2011/05/10,114,10,0.604820174,19074,114,5,5
21166,2014/03/31,2011/07/31,26,3,0.8223253490000001,14028,26,2,1
21167,2014/03/31,2005/03/31,14,11,0.570749097,20211,14,2,9
21168,2014/03/31,2012/11/29,406,3,0.737004025,15651,406,3,0
21169,2014/03/31,2011/09/21,242,5,0.812194057,14202,242,2,3
21170,2014/03/31,2012/02/03,78,4,1.455636042,7924,78,1,3
21171,2014/03/31,2010/03/02,112,17,0.760581602,15165,112,10,7
21172,2014/03/31,2008/09/30,164,12,0.712040375,16198,164,6,6
21173,2014/03/31,2011/02/26,160,7,0.7940096390000001,14525,160,0,7
21174,2014/03/31,2010/02/01,65,20,0.479420447,24053,65,5,15
21175,2014/03/31,2012/04/25,175,9,0.759200632,15187,175,6,3
21176,2014/03/31,2008/11/25,45,16,0.80752942,14276,45,9,7
21177,2014/03/31,2010/11/25,262,5,0.814336677,14156,262,4,1
21178,2014/03/31,2010/10/24,168,2,0.76,15168,168,1,1
21179,2014/03/31,2010/07/30,164,14,0.627899123,18359,164,9,5
21180,2014/03/31,2012/02/15,107,9,0.635173573,18148,107,0,9
21181,2014/03/31,2008/12/07,16,19,0.653090827,17649,16,10,9
21182,2014/03/31,2012/05/14,298,7,0.820742007,14043,298,5,2
21183,2014/03/31,2012/01/13,13,15,0.628860697,18327,13,5,10
21184,2014/03/31,2012/08/07,9,15,1.055069584,10922,9,7,8
21185,2014/03/31,2011/05/20,42,6,0.8293579959999999,13894,42,4,2
21186,2014/03/31,2012/12/28,45,12,0.751715702,15329,45,2,10
21187,2014/03/31,2007/08/10,104,10,0.5305147570000001,21719,104,6,4
21188,2014/03/31,2012/10/22,197,12,0.671957777,17147,197,3,9
21189,2014/03/31,2009/04/01,71,15,0.7478793979999999,15406,71,12,3
21190,2014/03/31,2011/04/29,177,8,0.630895302,18262,177,3,5
21191,2014/03/31,2006/02/19,117,9,0.62780654,18350,117,6,3
21192,2014/03/31,2008/10/04,458,3,0.739017193,15588,458,3,0
21193,2014/03/31,2013/02/16,56,11,0.64283817,17920,56,2,9
21194,2014/03/31,2007/01/01,271,12,0.7900960220000001,14580,271,8,4
21195,2014/03/31,2011/08/30,38,14,0.577070935,19962,38,4,10
21196,2014/03/31,2011/01/30,385,10,0.6454583660000001,17846,385,10,0
21197,2014/03/31,2012/10/01,7,18,0.548632466,20994,7,5,13
21198,2014/03/31,2007/12/17,288,15,0.73618728,15645,288,10,5
21199,2014/03/31,2010/03/20,459,15,0.538587999,21381,459,15,0
21200,2014/03/31,2006/07/01,174,17,0.634419527,18149,174,15,2
21201,2014/03/31,2012/09/26,144,8,0.839667445,13712,144,0,8
21202,2014/03/31,2012/01/31,1,15,0.459887757,25035,1,4,11
21203,2014/03/31,2012/08/11,103,12,0.726925748,15838,103,7,5
21204,2014/03/31,2010/07/13,16,11,0.6973870109999999,16506,16,4,7
21205,2014/03/31,2012/04/30,125,7,0.7126806609999999,16149,125,3,4
21206,2014/03/31,2006/09/22,158,12,0.8415457740000001,13676,158,7,5
21207,2014/03/31,2011/07/31,369,10,0.683994056,16825,369,10,0
21208,2014/03/31,2006/11/07,74,10,0.743095699,15486,74,3,7
21209,2014/03/31,2011/01/19,199,8,0.794260077,14488,199,5,3
21210,2014/03/31,2010/11/07,225,12,0.745152182,15442,225,10,2
21211,2014/03/31,2012/05/20,540,7,0.481907275,23877,540,7,0
21212,2014/03/31,2008/03/04,8,20,0.682822978,16851,8,9,11
21213,2014/03/31,2012/03/13,282,16,0.705421214,16310,282,14,2
21214,2014/03/31,2011/01/30,32,13,0.6479452520000001,17754,32,6,7
21215,2014/03/31,2010/05/08,36,26,0.630252027,18252,36,25,1
21216,2014/03/31,2007/07/16,89,9,0.598422641,19222,89,5,4
21217,2014/03/31,2010/04/22,19,16,0.762879029,15078,19,2,14
21218,2014/03/31,2005/12/13,7,15,0.635949353,18086,7,5,10
21219,2014/03/31,2013/03/31,23,14,0.628364838,18304,23,1,13
21220,2014/03/31,2012/07/01,19,14,0.70998395,16199,19,4,10
21221,2014/03/31,2011/09/24,20,5,1.333715644,8623,20,1,4
21222,2014/03/31,2011/04/04,254,7,0.797035831,14429,254,3,4
21223,2014/03/31,2011/04/19,38,19,0.7395093559999999,15551,38,3,16
21224,2014/03/31,2007/05/05,26,26,0.522840775,21994,26,9,17
21225,2014/03/31,2006/03/31,114,9,0.62918249,18275,114,5,4
21226,2014/03/31,2011/02/08,93,21,0.669694799,17169,93,15,6
21227,2014/03/31,2010/03/31,13,14,0.786209655,14624,13,0,14
21228,2014/03/31,2006/07/02,550,15,0.622831681,18459,550,15,0
21229,2014/03/31,2007/02/13,18,7,0.7650741999999999,15027,18,0,7
21230,2014/03/31,2012/05/23,41,8,0.613836831,18729,41,6,2
21231,2014/03/31,2012/09/20,188,4,0.658673008,17453,188,2,2
21232,2014/03/31,2012/09/20,188,4,0.658673008,17453,188,2,2
21233,2014/03/31,2007/09/20,41,18,0.781542593,14709,41,11,7
21234,2014/03/31,2009/10/16,62,16,0.683342052,16822,62,9,7
21235,2014/03/31,2012/04/01,381,4,0.7875,14596,381,4,0
21236,2014/03/31,2011/10/22,252,12,0.781990747,14698,252,8,4
21237,2014/03/31,2006/06/08,256,14,0.827574885,13888,256,10,4
21238,2014/03/31,2010/05/01,63,14,0.87403833,13149,63,6,8
21239,2014/03/31,2011/11/28,23,9,0.7175755490000001,16016,23,2,7
21240,2014/03/31,2008/11/09,10,19,0.507936003,22626,10,4,15
21241,2014/03/31,2012/08/26,28,8,0.741151242,15505,28,5,3
21242,2014/03/31,2012/07/13,254,16,0.64312458,17868,254,8,8
21243,2014/03/31,2012/08/13,571,4,0.6370253339999999,18039,571,4,0
21244,2014/03/31,2010/06/04,107,21,0.7863042290000001,14614,107,14,7
21245,2014/03/31,2011/09/10,2,17,0.6845475129999999,16785,2,11,6
21246,2014/03/31,2012/12/03,1,24,0.6292933829999999,18256,1,7,17
21247,2014/03/31,2012/04/16,101,16,0.84371181,13616,101,6,10
21248,2014/03/31,2011/01/29,60,9,0.805068685,14268,60,4,5
21249,2014/03/31,2011/02/03,123,13,0.5461123,21033,123,6,7
21250,2014/03/31,2012/08/02,66,9,0.721254003,15925,66,5,4
21251,2014/03/31,2010/10/24,88,14,0.618116995,18582,88,7,7
21252,2014/03/31,2012/07/06,3,7,0.581428571,19754,3,2,5
21253,2014/03/31,2011/03/31,25,13,0.6628231760000001,17328,25,8,5
21254,2014/03/31,2012/01/11,224,7,0.755873371,15194,224,6,1
21255,2014/03/31,2011/08/24,61,11,0.79424234,14459,61,3,8
21256,2014/03/31,2012/07/01,44,13,0.673345256,17054,44,5,8
21257,2014/03/31,2010/10/20,52,16,0.503705475,22796,52,6,10
21258,2014/03/31,2010/05/14,69,11,0.795770324,14429,69,0,11
21259,2014/03/31,2013/01/17,10,14,0.598149615,19196,10,0,14
21260,2014/03/31,2008/02/09,92,11,0.6437874960000001,17835,92,7,4
21261,2014/03/31,2005/09/08,23,13,0.704591593,16295,23,9,4
21262,2014/03/31,2013/03/26,115,13,0.8010290940000001,14333,115,0,13
21263,2014/03/31,2009/02/14,39,21,0.915991703,12534,39,9,12
21264,2014/03/31,2012/08/24,9,13,0.76798515,14949,9,7,6
21265,2014/03/31,2009/03/24,67,12,0.78663903,14594,67,2,10
21266,2014/03/31,2008/09/19,272,10,0.8430674890000001,13617,272,7,3
21267,2014/03/31,2011/10/20,136,12,0.8748597770000001,13122,136,7,5
21268,2014/03/31,2007/05/01,28,4,0.75395245,15226,28,0,4
21269,2014/03/31,2012/01/06,107,13,0.598203137,19189,107,10,3
21270,2014/03/31,2010/05/21,276,12,0.62889382,18252,276,8,4
21271,2014/03/31,2012/06/10,10,16,0.522721435,21959,10,4,12
21272,2014/03/31,2012/09/21,23,10,0.596062211,19257,23,6,4
21273,2014/03/31,2012/04/07,40,14,0.7607568929999999,15088,40,8,6
21274,2014/03/31,2013/03/31,351,4,0.6862690579999999,16725,351,1,3
21275,2014/03/31,2007/07/09,108,11,0.739719,15516,108,4,7
21276,2014/03/31,2010/09/13,87,20,0.509928026,22508,87,12,8
21277,2014/03/31,2009/07/01,1,12,0.91538167,12537,1,9,3
21278,2014/03/31,2012/05/02,164,7,0.819882832,13997,164,3,4
21279,2014/03/31,2005/03/07,58,12,0.73826031,15543,58,6,6
21280,2014/03/31,2012/07/31,133,19,0.7465181190000001,15371,133,15,4
21281,2014/03/31,2006/03/03,140,8,0.947667272,12106,140,4,4
21282,2014/03/31,2008/12/06,32,14,0.602339599,19046,32,6,8
21283,2014/03/31,2010/03/07,21,13,0.531693242,21574,21,6,7
21284,2014/03/31,2012/11/24,2,16,0.4838137420000001,23709,2,0,16
21285,2014/03/31,2012/12/14,2,12,0.692879758,16550,2,0,12
21286,2014/03/31,2011/05/19,31,15,0.771036315,14870,31,9,6
21287,2014/03/31,2005/10/30,18,15,0.497573022,23041,18,9,6
21288,2014/03/31,2011/02/21,122,16,0.581686032,19709,122,10,6
21289,2014/03/31,2008/02/10,103,6,0.75072032,15271,103,5,1
21290,2014/03/31,2008/12/24,323,14,0.592704994,19342,323,0,14
21291,2014/03/31,2005/12/15,16,13,0.692073171,16564,16,4,9
21292,2014/03/31,2013/02/02,20,8,0.882479791,12989,20,2,6
21293,2014/03/31,2007/09/02,339,10,0.774680635,14795,339,7,3
21294,2014/03/31,2010/09/13,11,25,0.755125198,15176,11,12,13
21295,2014/03/31,2011/09/05,133,16,0.724863685,15809,133,6,10
21296,2014/03/31,2006/10/25,10,10,0.8652385990000001,13244,10,5,5
21297,2014/03/31,2011/09/05,410,6,0.857151406,13368,410,6,0
21298,2014/03/31,2011/07/19,42,15,0.753042192,15216,42,5,10
21299,2014/03/31,2004/12/13,95,6,0.676666667,16932,95,4,2
21300,2014/03/31,2009/01/16,179,8,0.753314485,15209,179,4,4
21301,2014/03/31,2008/04/19,120,7,1.42318882,8050,120,4,3
21302,2014/03/31,2010/01/31,26,10,0.8838654420000001,12961,26,5,5
21303,2014/03/31,2010/03/11,277,12,0.775619202,14769,277,11,1
21304,2014/03/31,2010/04/10,100,9,0.566168751,20231,100,2,7
21305,2014/03/31,2007/01/15,143,9,0.738644483,15507,143,1,8
21306,2014/03/31,2011/07/12,233,11,0.594574336,19264,233,4,7
21307,2014/03/31,2009/08/18,123,8,0.388998777,29444,123,0,8
21308,2014/03/31,2008/07/16,266,14,0.618417927,18520,266,13,1
21309,2014/03/31,2010/03/03,554,4,1.418993929,8071,554,4,0
21310,2014/03/31,2010/07/19,22,16,0.6591010589999999,17376,22,3,13
21311,2014/03/31,2012/11/16,244,12,0.5237640060000001,21865,244,10,2
21312,2014/03/31,2008/08/26,6,13,0.680249495,16834,6,11,2
21313,2014/03/31,2009/01/21,199,15,0.53158921,21539,199,8,7
21314,2014/03/31,2011/11/27,163,16,0.7059112209999999,16220,163,14,2
21315,2014/03/31,2010/10/08,90,9,0.779720104,14684,90,5,4
21316,2014/03/31,2007/04/04,12,7,0.903278107,12675,12,0,7
21317,2014/03/31,2012/01/15,106,11,0.604257666,18947,106,5,6
21318,2014/03/31,2009/08/22,37,13,0.625873606,18292,37,2,11
21319,2014/03/31,2008/11/01,105,4,1.455,7868,105,2,2
21320,2014/03/31,2005/11/23,1,8,0.7275,15736,1,0,8
21321,2014/03/31,2008/06/02,144,8,0.87173774,13132,144,7,1
21322,2014/03/31,2009/06/30,128,16,0.46012702,24878,128,7,9
21323,2014/03/31,2012/03/22,2,17,0.8508169179999999,13453,2,10,7
21324,2014/03/31,2012/04/22,14,15,0.8553815109999999,13381,14,7,8
21325,2014/03/31,2009/09/05,119,15,0.804168775,14232,119,10,5
21326,2014/03/31,2007/06/01,3,14,0.601224522,19036,3,4,10
21327,2014/03/31,2010/06/23,227,12,0.686864534,16661,227,7,5
21328,2014/03/31,2010/09/20,287,9,0.696271372,16435,287,8,1
21329,2014/03/31,2012/01/18,2,9,0.6162564629999999,18568,2,0,9
21330,2014/03/31,2011/04/15,170,7,0.722614462,15835,170,6,1
21331,2014/03/31,2011/07/17,11,14,0.671246627,17046,11,3,11
21332,2014/03/31,2012/07/03,106,15,0.644501211,17753,106,7,8
21333,2014/03/31,2007/02/22,345,9,0.82132601,13929,345,8,1
21334,2014/03/31,2008/06/06,85,14,0.786290467,14549,85,0,14
21335,2014/03/31,2013/01/20,37,7,0.801428571,14273,37,1,6
21336,2014/03/31,2011/01/24,4,17,0.760895423,15032,4,9,8
21337,2014/03/31,2010/08/23,195,11,0.608795976,18787,195,3,8
21338,2014/03/31,2011/03/18,49,13,0.705780932,16205,49,6,7
21339,2014/03/31,2012/03/08,17,18,0.502317727,22768,17,12,6
21340,2014/03/31,2012/08/06,7,10,0.799217975,14309,7,1,9
21341,2014/03/31,2006/01/24,192,11,0.907915046,12595,192,6,5
21342,2014/03/31,2011/07/03,275,9,0.712128667,16057,275,3,6
21343,2014/03/31,2007/12/28,23,14,0.812517587,14073,23,0,14
21344,2014/03/31,2012/05/15,94,15,0.736573048,15524,94,10,5
21345,2014/03/31,2007/03/06,6,9,0.608119449,18803,6,3,6
21346,2014/03/31,2012/03/26,33,11,0.8662661009999999,13198,33,7,4
21347,2014/03/31,2013/02/10,70,14,0.589757519,19383,70,0,14
21348,2014/03/31,2009/11/10,116,11,0.68788362,16618,116,1,10
21349,2014/03/31,2010/06/10,82,10,0.608395252,18788,82,9,1
21350,2014/03/31,2009/06/17,2,9,0.7666910379999999,14908,2,3,6
21351,2014/03/31,2008/08/01,292,11,1.056846047,10815,292,8,3
21352,2014/03/31,2012/10/12,93,11,0.611475199,18689,93,3,8
21353,2014/03/31,2012/01/06,268,15,0.8908005920000001,12828,268,10,5
21354,2014/03/31,2007/06/12,284,10,0.7325939220000001,15598,284,8,2
21355,2014/03/31,2010/03/26,109,14,0.7848485470000001,14559,109,9,5
21356,2014/03/31,2010/12/05,152,8,0.7651804729999999,14933,152,7,1
21357,2014/03/31,2012/09/22,76,15,0.8596448990000001,13292,76,13,2
21358,2014/03/31,2012/05/19,634,3,0.6656239079999999,17166,634,3,0
21359,2014/03/31,2010/06/21,14,17,0.57870618,19740,14,10,7
21360,2014/03/31,2008/11/07,140,14,0.7734667209999999,14769,140,7,7
21361,2014/03/31,2012/06/13,235,10,0.815094192,14014,235,8,2
21362,2014/03/31,2012/11/11,119,9,0.7140560140000001,15996,119,3,6
21363,2014/03/31,2008/01/25,74,28,0.538659624,21203,74,10,18
21364,2014/03/31,2012/05/07,32,10,0.661495511,17265,32,4,6
21365,2014/03/31,2013/03/05,21,4,0.686973051,16624,21,2,2
21366,2014/03/31,2012/04/22,65,13,0.501682116,22763,65,11,2
21367,2014/03/31,2011/06/24,205,14,0.8407834470000001,13581,205,8,6
21368,2014/03/31,2012/05/10,80,14,1.24493185,9171,80,7,7
21369,2014/03/31,2009/08/02,37,16,0.7429131959999999,15368,37,8,8
21370,2014/03/31,2012/06/02,489,13,0.779449717,14647,489,13,0
21371,2014/03/31,2010/04/03,79,9,0.721758978,15816,79,3,6
21372,2014/03/31,2005/03/13,12,9,0.6361396570000001,17944,12,0,9
21373,2014/03/31,2005/09/17,13,8,1.149842853,9927,13,0,8
21374,2014/03/31,2008/09/16,70,13,0.6632175020000001,17209,70,9,4
21375,2014/03/31,2005/01/01,560,11,0.855554723,13340,560,11,0
21376,2014/03/31,2005/04/27,160,8,0.8313138529999999,13723,160,3,5
21377,2014/03/31,2008/05/14,30,12,0.616663964,18498,30,3,9
21378,2014/03/31,2012/06/26,38,7,0.7289691970000001,15648,38,4,3
21379,2014/03/31,2010/11/01,434,32,0.791252775,14416,434,32,0
21380,2014/03/31,2011/04/26,15,3,0.7005939440000001,16281,15,1,2
21381,2014/03/31,2006/10/27,36,11,0.668399648,17065,36,5,6
21382,2014/03/31,2009/01/10,444,2,0.750013151,15208,444,2,0
21383,2014/03/31,2011/11/16,402,2,0.75,15208,402,2,0
21384,2014/03/31,2011/12/02,353,2,0.75,15208,353,1,1
21385,2014/03/31,2009/03/01,412,2,0.75,15208,412,2,0
21386,2014/03/31,2010/06/09,252,15,0.628078194,18160,252,14,1
21387,2014/03/31,2010/12/21,160,11,0.742987428,15351,160,5,6
21388,2014/03/31,2013/02/03,157,12,0.68229062,16716,157,4,8
21389,2014/03/31,2012/08/13,113,7,0.921937753,12370,113,3,4
21390,2014/03/31,2011/01/29,8,13,1.085295013,10508,8,2,11
21391,2014/03/31,2011/05/12,32,5,1.466527778,7776,32,3,2
21392,2014/03/31,2009/12/01,65,11,0.768999258,14829,65,5,6
21393,2014/03/31,2007/10/10,19,15,0.802704491,14206,19,12,3
21394,2014/03/31,2013/02/16,11,10,0.7284540690000001,15654,11,3,7
21395,2014/03/31,2006/07/06,83,6,0.924229211,12338,83,3,3
21396,2014/03/31,2006/08/19,75,9,0.7878718990000001,14473,75,4,5
21397,2014/03/31,2011/11/23,60,15,0.921754244,12370,60,7,8
21398,2014/03/31,2013/03/06,49,6,1.227606589,9288,49,0,6
21399,2014/03/31,2008/11/20,281,10,0.73061643,15606,281,6,4
21400,2014/03/31,2012/04/18,13,22,0.623627413,18283,13,15,7
21401,2014/03/31,2010/02/14,38,14,0.602617865,18920,38,4,10
21402,2014/03/31,2012/11/06,1,14,0.6503548000000001,17531,1,3,11
21403,2014/03/31,2008/07/24,66,9,0.810896871,14060,66,7,2
21404,2014/03/31,2012/11/13,161,14,0.7763189429999999,14686,161,5,9
21405,2014/03/31,2012/07/25,27,11,0.584545455,19503,27,1,10
21406,2014/03/31,2008/04/08,13,15,0.7548976890000001,15101,13,4,11
21407,2014/03/31,2012/03/27,702,2,0.75,15199,702,2,0
21408,2014/03/31,2010/08/25,613,2,0.75,15199,613,2,0
21409,2014/03/31,2009/08/25,109,7,0.790447958,14421,109,2,5
21410,2014/03/31,2005/11/26,21,17,0.803643542,14184,21,10,7
21411,2014/03/31,2010/04/18,93,6,0.7427432070000001,15347,93,4,2
21412,2014/03/31,2010/04/01,16,15,0.629369996,18111,16,7,8
21413,2014/03/31,2009/07/22,121,10,0.830668319,13721,121,8,2
21414,2014/03/31,2012/09/23,260,8,0.681237372,16729,260,6,2
21415,2014/03/31,2005/08/12,94,9,0.774194973,14720,94,0,9
21416,2014/03/31,2012/01/26,211,14,0.688612605,16549,211,11,3
21417,2014/03/31,2013/01/22,195,20,0.938653213,12140,195,10,10
21418,2014/03/31,2009/10/23,41,10,0.6935826890000001,16429,41,7,3
21419,2014/03/31,2010/06/20,325,13,0.866656526,13148,325,12,1
21420,2014/03/31,2007/06/20,550,10,0.859184135,13262,550,10,0
21421,2014/03/31,2012/07/17,287,27,0.650606978,17513,287,21,6
21422,2014/03/31,2011/10/15,79,14,0.824045708,13827,79,7,7
21423,2014/03/31,2012/08/28,97,10,0.816369564,13957,97,4,6
21424,2014/03/31,2012/04/11,35,18,0.5339649439999999,21337,35,12,6
21425,2014/03/31,2010/07/08,233,9,0.8497165870000001,13408,233,7,2
21426,2014/03/31,2007/06/14,176,14,0.577250203,19736,176,10,4
21427,2014/03/31,2012/11/30,28,9,0.52611342,21654,28,2,7
21428,2014/03/31,2006/06/26,19,8,0.7472732040000001,15245,19,3,5
21429,2014/03/31,2008/11/07,76,16,0.7105870609999999,16029,76,1,15
21430,2014/03/31,2007/08/10,7,14,0.863340661,13192,7,7,7
21431,2014/03/31,2012/12/12,34,13,0.6869363009999999,16578,34,5,8
21432,2014/03/31,2010/04/10,493,5,0.723001714,15751,493,5,0
21433,2014/03/31,2012/02/06,37,27,0.843943077,13492,37,16,11
21434,2014/03/31,2013/03/26,121,9,0.718642934,15843,121,2,7
21435,2014/03/31,2013/03/25,96,11,0.7045611540000001,16156,96,2,9
21436,2014/03/31,2012/04/12,15,26,0.5884650779999999,19343,15,8,18
21437,2014/03/31,2012/06/10,1,24,0.66471114,17119,1,9,15
21438,2014/03/31,2008/03/23,100,6,0.6983129790000001,16295,100,2,4
21439,2014/03/31,2010/05/20,26,17,0.890717025,12775,26,3,14
21440,2014/03/31,2012/11/22,241,4,0.6831900329999999,16655,241,0,4
21441,2014/03/31,2005/04/09,108,13,0.52107712,21836,108,8,5
21442,2014/03/31,2011/04/29,30,9,0.617123176,18437,30,4,5
21443,2014/03/31,2012/07/13,584,2,0.7,16254,584,2,0
21444,2014/03/31,2012/10/24,6,13,0.8519131409999999,13355,6,2,11
21445,2014/03/31,2007/09/01,20,7,1.183983765,9609,20,4,3
21446,2014/03/31,2010/07/15,159,13,0.687046319,16559,159,9,4
21447,2014/03/31,2013/01/02,2,17,0.6895133040000001,16499,2,4,13
21448,2014/03/31,2007/02/03,27,5,1.003178131,11340,27,3,2
21449,2014/03/31,2008/09/16,172,2,0.75,15168,172,1,1
21450,2014/03/31,2005/03/03,277,2,0.75,15168,277,1,1
21451,2014/03/31,2012/01/06,258,2,0.75,15168,258,1,1
21452,2014/03/31,2011/10/17,79,11,0.739713877,15378,79,2,9
21453,2014/03/31,2011/02/01,148,7,0.626130133,18166,148,3,4
21454,2014/03/31,2010/11/16,87,14,0.7489082770000001,15187,87,4,10
21455,2014/03/31,2009/10/10,49,7,0.880067322,12923,49,0,7
21456,2014/03/31,2009/11/15,122,13,0.517324418,21984,122,5,8
21457,2014/03/31,2011/10/06,17,14,0.6319610999999999,17995,17,9,5
21458,2014/03/31,2010/12/06,75,16,0.7716761670000001,14736,75,6,10
21459,2014/03/31,2009/07/27,85,13,0.73572205,15456,85,7,6
21460,2014/03/31,2010/05/16,129,12,0.66347377,17137,129,8,4
21461,2014/03/31,2007/03/19,47,11,0.7830188029999999,14519,47,4,7
21462,2014/03/31,2006/11/05,151,11,0.92920631,12234,151,9,2
21463,2014/03/31,2006/07/31,79,11,0.640354346,17751,79,4,7
21464,2014/03/31,2006/11/01,140,11,0.852395951,13335,140,5,6
21465,2014/03/31,2009/11/29,6,27,0.727037037,15633,6,9,18
21466,2014/03/31,2006/10/23,44,15,0.941463011,12071,44,6,9
21467,2014/03/31,2007/05/24,9,18,0.572640464,19845,9,5,13
21468,2014/03/31,2007/03/12,200,15,0.6199847239999999,18329,200,12,3
21469,2014/03/31,2006/03/01,1,15,0.698769373,16260,1,12,3
21470,2014/03/31,2006/07/01,13,13,0.673495554,16870,13,4,9
21471,2014/03/31,2012/12/28,67,17,0.481098124,23613,67,10,7
21472,2014/03/31,2012/03/21,84,12,0.634218401,17912,84,8,4
21473,2014/03/31,2009/12/09,81,12,0.73796336,15393,81,6,6
21474,2014/03/31,2011/08/08,153,9,0.938718182,12100,153,7,2
21475,2014/03/31,2009/01/27,13,13,0.833214731,13631,13,4,9
21476,2014/03/31,2008/11/02,5,16,0.747076043,15202,5,6,10
21477,2014/03/31,2012/12/12,76,11,0.8567783309999999,13254,76,2,9
21478,2014/03/31,2012/04/27,48,17,0.7665289590000001,14814,48,12,5
21479,2014/03/31,2012/08/04,107,11,0.775796666,14636,107,9,2
21480,2014/03/31,2009/01/11,8,19,0.469253213,24197,8,10,9
21481,2014/03/31,2010/07/01,33,9,0.550485333,20625,33,4,5
21482,2014/03/31,2010/12/10,22,13,0.7953657,14274,22,8,5
21483,2014/03/31,2011/08/16,10,13,0.688139775,16498,10,8,5
21484,2014/03/31,2011/07/03,29,9,0.558533825,20325,29,5,4
21485,2014/03/31,2007/10/29,114,8,0.8086663820000001,14037,114,5,3
21486,2014/03/31,2013/02/16,14,11,0.6820374929999999,16643,14,0,11
21487,2014/03/31,2009/01/10,137,16,0.947873549,11973,137,9,7
21488,2014/03/31,2012/09/15,57,8,0.858256825,13223,57,7,1
21489,2014/03/31,2012/05/19,229,10,0.859164837,13207,229,8,2
21490,2014/03/31,2013/01/19,174,4,0.590730945,19208,174,2,2
21491,2014/03/31,2008/02/08,99,16,0.788841769,14384,99,10,6
21492,2014/03/31,2008/05/31,193,13,0.753885714,15050,193,10,3
21493,2014/03/31,2012/11/07,17,8,0.554879194,20446,17,5,3
21494,2014/03/31,2007/01/31,61,11,0.71844975,15791,61,8,3
21495,2014/03/31,2008/01/28,88,17,0.85593691,13251,88,13,4
21496,2014/03/31,2006/02/18,38,18,0.746074201,15202,38,10,8
21497,2014/03/31,2007/08/22,261,10,0.835536727,13573,261,9,1
21498,2014/03/31,2011/04/25,29,19,0.652494822,17380,29,12,7
21499,2014/03/31,2005/01/29,120,13,0.68551203,16542,120,8,5
21500,2014/03/31,2011/09/30,122,5,0.7979999999999999,14210,122,4,1
21501,2014/03/31,2011/11/11,135,8,0.778401758,14566,135,7,1
21502,2014/03/31,2008/11/16,27,16,0.7897408570000001,14355,27,8,8
21503,2014/03/31,2008/01/14,47,12,0.8186467359999999,13848,47,3,9
21504,2014/03/31,2005/04/20,9,22,0.617327779,18363,9,9,13
21505,2014/03/31,2005/08/16,1,13,0.983076923,11531,1,6,7
21506,2014/03/31,2013/01/22,7,26,0.507088981,22353,7,7,19
21507,2014/03/31,2010/07/04,75,13,0.672158107,16862,75,3,10
21508,2014/03/31,2006/10/20,43,13,0.736662116,15384,43,4,9
21509,2014/03/31,2011/10/15,336,4,0.645709402,17550,336,2,2
21510,2014/03/31,2005/04/15,84,10,0.773519252,14648,84,6,4
21511,2014/03/31,2011/12/26,224,22,0.561835854,20165,224,17,5
21512,2014/03/31,2005/08/10,109,17,0.5510458220000001,20558,109,9,8
21513,2014/03/31,2009/04/14,16,10,0.709655453,15963,16,7,3
21514,2014/03/31,2012/03/10,695,3,0.717883397,15780,695,3,0
21515,2014/03/31,2012/03/11,375,9,0.769725488,14717,375,9,0
21516,2014/03/31,2010/03/27,8,18,0.7294635840000001,15529,8,17,1
21517,2014/03/31,2007/09/12,95,8,0.844097615,13420,95,4,4
21518,2014/03/31,2010/05/06,60,14,0.575507291,19683,60,8,6
21519,2014/03/31,2007/05/19,220,3,0.769362179,14722,220,0,3
21520,2014/03/31,2008/01/07,44,8,0.91670255,12355,44,3,5
21521,2014/03/31,2012/12/13,127,7,0.731722445,15478,127,1,6
21522,2014/03/31,2010/06/29,85,10,0.7637793359999999,14828,85,3,7
21523,2014/03/31,2011/12/16,257,18,0.7878469570000001,14375,257,10,8
21524,2014/03/31,2008/11/10,355,11,0.655489958,17277,355,9,2
21525,2014/03/31,2009/02/22,34,12,0.620816472,18237,34,6,6
21526,2014/03/31,2011/08/31,13,13,0.641826531,17640,13,4,9
21527,2014/03/31,2005/10/01,72,9,1.093989757,10349,72,3,6
21528,2014/03/31,2008/06/19,102,11,0.6177454029999999,18327,102,3,8
21529,2014/03/31,2007/12/15,207,9,0.750043063,15094,207,7,2
21530,2014/03/31,2012/12/29,40,13,0.5146565439999999,21997,40,4,9
21531,2014/03/31,2012/12/03,38,10,0.566286272,19988,38,4,6
21532,2014/03/31,2010/03/28,135,11,0.715779788,15812,135,4,7
21533,2014/03/31,2008/09/03,165,12,0.682616405,16580,165,10,2
21534,2014/03/31,2012/07/20,5,25,0.7441389970000001,15209,5,0,25
21535,2014/03/31,2010/06/02,130,12,0.832237094,13598,130,3,9
21536,2014/03/31,2012/03/18,30,21,0.57711102,19609,30,0,21
21537,2014/03/31,2007/05/14,128,9,0.818484016,13826,128,5,4
21538,2014/03/31,2011/03/22,320,4,0.7375,15344,320,3,1
21539,2014/03/31,2007/10/23,65,9,0.8370522970000001,13519,65,1,8
21540,2014/03/31,2011/06/03,72,10,0.714616988,15835,72,6,4
21541,2014/03/31,2008/10/28,190,11,0.7092497179999999,15954,190,8,3
21542,2014/03/31,2011/05/31,33,14,0.585490298,19325,33,11,3
21543,2014/03/31,2008/06/07,5,14,0.6022479510000001,18786,5,5,9
21544,2014/03/31,2011/03/24,484,5,1.188278542,9521,484,5,0
21545,2014/03/31,2012/03/25,1,18,0.600192583,18849,1,7,11
21546,2014/03/31,2012/05/06,163,12,0.8530706579999999,13261,163,9,3
21547,2014/03/31,2010/08/29,291,15,0.7466666670000001,15150,291,8,7
21548,2014/03/31,2012/07/03,68,15,0.740244764,15280,68,8,7
21549,2014/03/31,2006/01/02,12,6,0.958333333,11802,12,0,6
21550,2014/03/31,2013/01/01,23,8,0.8359753120000001,13529,23,0,8
21551,2014/03/31,2012/04/09,42,6,0.8614068090000001,13129,42,1,5
21552,2014/03/31,2012/06/15,72,12,0.522107013,21661,72,6,6
21553,2014/03/31,2011/07/28,242,7,0.711680302,15890,242,2,5
21554,2014/03/31,2010/03/31,278,14,0.651638239,17354,278,10,4
21555,2014/03/31,2010/04/17,20,34,0.56139715,20141,20,10,24
21556,2014/03/31,2013/02/22,65,12,0.61415698,18410,65,0,12
21557,2014/03/31,2011/01/14,192,12,0.596390442,18958,192,1,11
21558,2014/03/31,2012/10/30,25,5,0.782964887,14439,25,0,5
21559,2014/03/31,2008/12/25,4,10,0.779228701,14508,4,5,5
21560,2014/03/31,2012/08/21,500,4,0.875,12920,500,4,0
21561,2014/03/31,2009/12/22,540,4,0.875,12920,540,4,0
21562,2014/03/31,2011/06/06,145,10,0.632024602,17885,145,6,4
21563,2014/03/31,2007/02/14,91,9,0.719708392,15706,91,5,4
21564,2014/03/31,2010/03/30,11,10,0.6658687329999999,16973,11,4,6
21565,2014/03/31,2010/09/07,25,7,0.610379132,18516,25,2,5
21566,2014/03/31,2012/09/17,100,10,0.654840355,17257,100,2,8
21567,2014/03/31,2007/09/03,278,12,0.763139056,14807,278,9,3
21568,2014/03/31,2011/08/17,77,13,0.748414812,15096,77,7,6
21569,2014/03/31,2012/05/27,2,9,0.84366699,13387,2,3,6
21570,2014/03/31,2010/03/23,208,16,0.518632836,21775,208,12,4
21571,2014/03/31,2007/11/19,12,11,0.510042907,22141,12,3,8
21572,2014/03/31,2008/06/27,36,23,0.7755885990000001,14560,36,13,10
21573,2014/03/31,2012/07/19,144,7,0.723829242,15601,144,2,5
21574,2014/03/31,2006/09/06,104,12,0.664179754,17001,104,8,4
21575,2014/03/31,2012/03/10,126,15,0.5610319979999999,20126,126,11,4
21576,2014/03/31,2012/07/21,3,8,0.7175,15736,3,0,8
21577,2014/03/31,2008/07/27,190,10,0.7039506170000001,16038,190,8,2
21578,2014/03/31,2008/02/12,11,15,0.778714995,14498,11,9,6
21579,2014/03/31,2005/12/07,214,16,0.6599111529999999,17108,214,7,9
21580,2014/03/31,2008/02/28,50,8,0.7439147340000001,15176,50,3,5
21581,2014/03/31,2012/04/06,16,8,0.8848169920000001,12759,16,6,2
21582,2014/03/31,2010/09/08,22,22,0.433356493,26051,22,7,15
21583,2014/03/31,2009/06/02,43,13,0.572150423,19731,43,7,6
21584,2014/03/31,2012/05/23,28,13,0.5673144379999999,19899,28,11,2
21585,2014/03/31,2012/06/16,471,4,0.6534676389999999,17274,471,4,0
21586,2014/03/31,2012/08/29,11,16,0.690596513,16345,11,11,5
21587,2014/03/31,2008/09/10,5,9,0.851202021,13261,5,4,5
21588,2014/03/31,2007/07/06,32,17,0.552531206,20429,32,10,7
21589,2014/03/31,2011/05/10,342,14,0.7161484770000001,15760,342,12,2
21590,2014/03/31,2012/10/04,34,17,0.874705882,12903,34,6,11
21591,2014/03/31,2010/06/16,109,8,1.050889282,10739,109,4,4
21592,2014/03/31,2006/05/30,438,18,0.614099146,18377,438,18,0
21593,2014/03/31,2010/07/15,42,18,0.495973718,22753,42,10,8
21594,2014/03/31,2008/10/27,59,15,0.71392699,15806,59,9,6
21595,2014/03/31,2011/10/27,16,14,0.672569896,16775,16,5,9
21596,2014/03/31,2007/12/17,152,11,0.956316013,11797,152,3,8
21597,2014/03/31,2006/07/30,514,22,0.827400425,13633,514,22,0
21598,2014/03/31,2008/01/05,30,12,0.64399372,17515,30,5,7
21599,2014/03/31,2011/07/27,208,12,0.8238623909999999,13691,208,10,2
21600,2014/03/31,2010/08/05,4,14,0.66930394,16852,4,3,11
21601,2014/03/31,2011/05/19,9,11,0.600098451,18791,9,5,6
21602,2014/03/31,2012/02/04,11,14,0.554042647,20353,11,9,5
21603,2014/03/31,2010/04/27,19,14,0.638445816,17662,19,8,6
21604,2014/03/31,2006/06/29,17,4,1.412686044,7982,17,1,3
21605,2014/03/31,2011/03/04,137,10,0.764885362,14742,137,6,4
21606,2014/03/31,2008/02/01,50,15,0.791440303,14247,50,4,11
21607,2014/03/31,2011/12/30,48,9,0.446533053,25247,48,6,3
21608,2014/03/31,2012/06/25,6,15,0.81963208,13753,6,6,9
21609,2014/03/31,2013/01/16,36,8,0.640291411,17604,36,2,6
21610,2014/03/31,2008/09/01,202,9,0.509337491,22128,202,1,8
21611,2014/03/31,2010/12/16,149,13,0.817778826,13781,149,9,4
21612,2014/03/31,2012/08/26,111,11,0.853748485,13200,111,2,9
21613,2014/03/31,2006/11/30,48,18,0.840154339,13412,48,13,5
21614,2014/03/31,2007/01/30,4,8,0.66,17072,4,1,7
21615,2014/03/31,2012/03/28,247,8,0.774056338,14555,247,7,1
21616,2014/03/31,2011/01/15,56,21,0.764071211,14745,56,11,10
21617,2014/03/31,2011/08/16,5,16,0.893131441,12614,5,2,14
21618,2014/03/31,2011/06/17,136,15,0.6796356179999999,16576,136,10,5
21619,2014/03/31,2012/07/10,11,11,0.52946609,21277,11,1,10
21620,2014/03/31,2010/05/07,377,11,0.7803685229999999,14436,377,11,0
21621,2014/03/31,2011/11/13,180,8,0.7220562779999999,15601,180,6,2
21622,2014/03/31,2012/03/07,172,16,0.868125,12976,172,13,3
21623,2014/03/31,2006/02/17,124,17,0.479699757,23481,124,13,4
21624,2014/03/31,2012/11/16,37,14,0.486332743,23159,37,3,11
21625,2014/03/31,2010/09/12,1,18,0.594718555,18938,1,8,10
21626,2014/03/31,2007/12/02,98,8,0.745525915,15107,98,3,5
21627,2014/03/31,2010/11/18,31,14,0.667844521,16864,31,9,5
21628,2014/03/31,2007/07/06,125,14,0.808323405,13933,125,6,8
21629,2014/03/31,2007/11/01,114,13,0.853487685,13195,114,4,9
21630,2014/03/31,2012/09/08,238,7,0.692857143,16254,238,4,3
21631,2014/03/31,2013/01/18,324,5,0.97,11610,324,4,1
21632,2014/03/31,2012/01/21,376,3,1.449369369,7770,376,3,0
21633,2014/03/31,2009/03/02,4,8,0.694428686,16217,4,4,4
21634,2014/03/31,2007/10/18,170,11,0.812727338,13856,170,9,2
21635,2014/03/31,2008/12/28,2,16,0.513703974,21917,2,6,10
21636,2014/03/31,2009/07/21,9,8,0.89246849,12615,9,3,5
21637,2014/03/31,2012/05/17,81,10,0.8156466920000001,13801,81,6,4
21638,2014/03/31,2008/10/21,48,16,0.845980761,13306,48,6,10
21639,2014/03/31,2011/03/09,74,10,0.7416841270000001,15177,74,0,10
21640,2014/03/31,2011/03/08,67,16,0.846069603,13304,67,14,2
21641,2014/03/31,2012/06/16,38,17,0.560578216,20079,38,8,9
21642,2014/03/31,2012/10/08,8,16,0.5481761070000001,20533,8,5,11
21643,2014/03/31,2011/05/19,81,17,0.809092085,13911,81,5,12
21644,2014/03/31,2008/06/23,238,10,0.817712874,13764,238,4,6
21645,2014/03/31,2011/11/19,11,19,0.582632151,19315,11,8,11
21646,2014/03/31,2012/02/07,71,14,0.576422681,19523,71,6,8
21647,2014/03/31,2011/07/18,111,24,0.81516337,13803,111,12,12
21648,2014/03/31,2008/03/11,1,29,0.63339338,17764,1,17,12
21649,2014/03/31,2008/02/25,341,10,0.754577158,14911,341,9,1
21650,2014/03/31,2008/02/27,252,12,0.698903591,16098,252,9,3
21651,2014/03/31,2005/10/05,134,16,0.759346608,14815,134,12,4
21652,2014/03/31,2007/12/06,30,9,0.7063422290000001,15925,30,6,3
21653,2014/03/31,2012/03/29,29,16,0.697396453,16128,29,7,9
21654,2014/03/31,2013/03/06,40,11,0.655454545,17160,40,0,11
21655,2014/03/31,2013/02/28,40,3,0.682199915,16487,40,2,1
21656,2014/03/31,2009/11/28,12,13,0.662017188,16989,12,10,3
21657,2014/03/31,2007/04/30,20,15,0.8568165190000001,13124,20,7,8
21658,2014/03/31,2012/09/13,59,11,0.49890146,22539,59,4,7
21659,2014/03/31,2006/10/31,150,14,0.508760521,22098,150,9,5
21660,2014/03/31,2008/05/06,228,16,0.730878299,15382,228,10,6
21661,2014/03/31,2010/03/24,51,6,0.941935484,11935,51,5,1
21662,2014/03/31,2006/09/22,43,8,0.626033859,17957,43,1,7
21663,2014/03/31,2012/11/10,31,14,0.791714205,14199,31,6,8
21664,2014/03/31,2012/11/21,340,8,0.7455959409999999,15077,340,4,4
21665,2014/03/31,2011/10/13,34,17,0.491913618,22852,34,5,12
21666,2014/03/31,2012/05/17,16,10,0.565438632,19880,16,4,6
21667,2014/03/31,2010/07/08,121,29,0.79942599,14059,121,12,17
21668,2014/03/31,2006/03/12,539,7,0.805324257,13955,539,7,0
21669,2014/03/31,2007/10/17,644,8,0.873895801,12860,644,8,0
21670,2014/03/31,2009/08/24,78,8,0.884576445,12702,78,2,6
21671,2014/03/31,2008/01/11,124,4,1.486508336,7558,124,3,1
21672,2014/03/31,2010/04/24,75,7,0.7171879990000001,15665,75,4,3
21673,2014/03/31,2012/09/11,112,15,0.750579236,14968,112,11,4
21674,2014/03/31,2012/01/24,126,7,0.935119028,12014,126,4,3
21675,2014/03/31,2011/11/07,80,7,0.6611517179999999,16992,80,4,3
21676,2014/03/31,2007/02/16,29,9,0.615933439,18239,29,5,4
21677,2014/03/31,2010/03/30,103,7,0.72735755,15444,103,2,5
21678,2014/03/31,2013/02/13,14,17,0.732082899,15344,14,1,16
21679,2014/03/31,2010/05/27,4,19,0.701789441,16005,4,12,7
21680,2014/03/31,2012/12/06,39,13,0.88635101,12672,39,3,10
21681,2014/03/31,2012/04/06,202,16,0.54375,20656,202,8,8
21682,2014/03/31,2012/08/01,2,16,0.610999891,18382,2,9,7
21683,2014/03/31,2006/11/11,153,15,0.8849302659999999,12691,153,12,3
21684,2014/03/31,2008/02/08,177,18,0.710933722,15797,177,11,7
21685,2014/03/31,2013/01/13,3,15,0.550153334,20413,3,2,13
21686,2014/03/31,2005/12/20,22,18,0.75481718,14878,22,9,9
21687,2014/03/31,2008/10/02,41,15,0.652232547,17218,41,9,6
21688,2014/03/31,2009/12/17,26,19,0.568537363,19752,26,9,10
21689,2014/03/31,2012/08/21,103,17,0.490543008,22891,103,1,16
21690,2014/03/31,2007/07/07,46,9,0.6691917510000001,16777,46,5,4
21691,2014/03/31,2012/03/31,329,6,0.714800076,15706,329,5,1
21692,2014/03/31,2008/08/05,227,18,0.7324256259999999,15328,227,12,6
21693,2014/03/31,2007/10/21,13,11,0.636213306,17646,13,7,4
21694,2014/03/31,2013/02/16,156,10,0.6072930870000001,18486,156,4,6
21695,2014/03/31,2011/08/26,216,12,0.664113819,16904,216,8,4
21696,2014/03/31,2011/04/19,16,11,0.908110338,12362,16,7,4
21697,2014/03/31,2010/03/28,284,8,0.991449519,11321,284,7,1
21698,2014/03/31,2008/04/19,49,10,0.714657752,15705,49,4,6
21699,2014/03/31,2011/06/27,688,4,1.5,7482,688,4,0
21700,2014/03/31,2010/11/29,21,19,0.687680005,16319,21,5,14
21701,2014/03/31,2012/03/18,99,14,0.58841741,19070,99,6,8
21702,2014/03/31,2011/09/07,199,8,0.854777177,13127,199,6,2
21703,2014/03/31,2009/08/04,306,10,0.562831126,19932,306,8,2
21704,2014/03/31,2006/01/28,20,15,0.7667969920000001,14630,20,7,8
21705,2014/03/31,2006/12/18,33,10,0.8093946609999999,13860,33,0,10
21706,2014/03/31,2012/01/12,1,11,0.6702904439999999,16733,1,9,2
21707,2014/03/31,2009/03/26,34,8,0.532804276,21050,34,5,3
21708,2014/03/31,2005/11/05,135,14,0.67025638,16733,135,6,8
21709,2014/03/31,2012/05/14,137,10,0.518311304,21638,137,3,7
21710,2014/03/31,2010/07/22,9,12,0.687050787,16323,9,5,7
21711,2014/03/31,2012/05/01,253,7,0.746846067,15013,253,6,1
21712,2014/03/31,2011/08/31,274,10,0.695624767,16118,274,8,2
21713,2014/03/31,2009/11/30,86,21,0.408149618,27470,86,6,15
21714,2014/03/31,2006/04/06,138,8,0.726954153,15421,138,2,6
21715,2014/03/31,2007/01/11,62,17,0.792972552,14136,62,8,9
21716,2014/03/31,2010/01/02,2,12,0.7199338470000001,15570,2,0,12
21717,2014/03/31,2010/06/01,64,9,0.6818078959999999,16439,64,2,7
21718,2014/03/31,2012/12/08,5,16,0.70325218,15937,5,1,15
21719,2014/03/31,2010/01/10,83,13,0.665758584,16834,83,9,4
21720,2014/03/31,2012/06/29,224,8,0.862431705,12995,224,7,1
21721,2014/03/31,2012/08/13,146,13,0.833733075,13442,146,6,7
21722,2014/03/31,2006/02/02,7,9,0.634583805,17660,7,2,7
21723,2014/03/31,2007/03/19,273,13,0.623850351,17962,273,9,4
21724,2014/03/31,2011/04/02,10,11,0.579051729,19351,10,4,7
21725,2014/03/31,2005/04/24,16,16,0.6833967670000001,16395,16,12,4
21726,2014/03/31,2007/06/12,77,17,0.8382066440000001,13366,77,11,6
21727,2014/03/31,2008/06/16,38,8,0.412979947,27128,38,0,8
21728,2014/03/31,2008/03/01,123,11,0.743882728,15059,123,6,5
21729,2014/03/31,2009/09/16,166,4,1.460308956,7671,166,2,2
21730,2014/03/31,2011/01/08,11,10,0.775817577,14439,11,6,4
21731,2014/03/31,2012/05/25,13,11,0.721681165,15519,13,3,8
21732,2014/03/31,2008/04/12,25,15,0.616298294,18170,25,5,10
21733,2014/03/31,2010/07/17,103,12,0.745309505,15024,103,2,10
21734,2014/03/31,2010/12/10,193,10,0.777841612,14395,193,7,3
21735,2014/03/31,2011/09/29,165,6,0.638536641,17535,165,0,6
21736,2014/03/31,2010/08/01,11,15,0.551444543,20304,11,7,8
21737,2014/03/31,2008/02/20,11,14,0.747365154,14980,11,6,8
21738,2014/03/31,2012/02/04,45,12,0.46621356,24012,45,5,7
21739,2014/03/31,2012/04/26,42,18,0.774292433,14458,42,5,13
21740,2014/03/31,2010/01/02,71,11,0.61468702,18212,71,7,4
21741,2014/03/31,2012/01/01,185,18,0.654315525,17108,185,9,9
21742,2014/03/31,2011/10/21,96,9,0.881166654,12703,96,7,2
21743,2014/03/31,2007/07/10,121,12,0.66211535,16905,121,2,10
21744,2014/03/31,2012/02/10,160,24,0.506241972,22110,160,16,8
21745,2014/03/31,2005/04/16,1,10,0.854075092,13104,1,5,5
21746,2014/03/31,2008/04/26,135,7,1.025788268,10910,135,3,4
21747,2014/03/31,2004/11/30,19,6,1.288257166,8687,19,3,3
21748,2014/03/31,2010/05/14,146,11,0.734598923,15234,146,6,5
21749,2014/03/31,2010/05/08,24,20,0.725670838,15421,24,12,8
21750,2014/03/31,2009/07/15,97,14,0.943783419,11857,97,9,5
21751,2014/03/31,2008/05/18,396,7,0.60667733,18443,396,7,0
21752,2014/03/31,2011/10/08,63,8,0.619816641,18052,63,5,3
21753,2014/03/31,2007/07/24,93,12,0.8269076129999999,13530,93,6,6
21754,2014/03/31,2011/09/27,69,10,0.778558107,14370,69,3,7
21755,2014/03/31,2011/07/03,251,5,0.901674861,12407,251,3,2
21756,2014/03/31,2009/04/13,51,7,0.918311443,12182,51,5,2
21757,2014/03/31,2012/12/29,92,7,0.724314297,15444,92,1,6
21758,2014/03/31,2007/09/15,11,12,0.701349386,15948,11,6,6
21759,2014/03/31,2005/09/21,4,8,0.897712497,12459,4,2,6
21760,2014/03/31,2010/03/11,104,9,0.8708533829999999,12843,104,2,7
21761,2014/03/31,2010/09/17,40,17,0.689835317,16213,40,11,6
21762,2014/03/31,2011/09/08,141,12,0.839519592,13322,141,8,4
21763,2014/03/31,2006/07/27,108,15,0.7283002279999999,15355,108,5,10
21764,2014/03/31,2012/08/18,109,9,0.768953448,14543,109,6,3
21765,2014/03/31,2010/04/21,74,7,0.885138515,12634,74,2,5
21766,2014/03/31,2010/09/01,191,22,0.621986983,17977,191,15,7
21767,2014/03/31,2012/10/05,40,4,0.6845925429999999,16333,40,0,4
21768,2014/03/31,2011/04/11,356,3,0.754942606,14810,356,2,1
21769,2014/03/31,2010/07/13,115,16,0.9005469190000001,12415,115,11,5
21770,2014/03/31,2006/06/05,49,9,0.737601108,15157,49,6,3
21771,2014/03/31,2009/03/31,6,13,0.58286757,19180,6,4,9
21772,2014/03/31,2005/07/23,92,16,0.58178932,19214,92,11,5
21773,2014/03/31,2009/11/18,242,18,0.985907567,11338,242,17,1
21774,2014/03/31,2013/01/02,32,8,1.12464433,9939,32,2,6
21775,2014/03/31,2012/10/04,32,12,0.662687496,16867,32,4,8
21776,2014/03/31,2012/09/29,49,9,0.7863730390000001,14213,49,3,6
21777,2014/03/31,2012/02/07,175,5,1.095322423,10204,175,3,2
21778,2014/03/31,2007/04/06,14,15,0.6804182390000001,16426,14,0,15
21779,2014/03/31,2010/09/11,18,12,0.740239767,15098,18,8,4
21780,2014/03/31,2008/01/09,238,11,0.69440164,16094,238,7,4
21781,2014/03/31,2011/12/20,48,11,1.120482254,9974,48,4,7
21782,2014/03/31,2013/01/12,86,13,0.937807989,11916,86,4,9
21783,2014/03/31,2007/08/25,110,9,1.266818955,8821,110,4,5
21784,2014/03/31,2012/03/06,459,12,0.83308977,13412,459,12,0
21785,2014/03/31,2013/02/08,97,15,0.685446012,16300,97,3,12
21786,2014/03/31,2008/03/10,9,9,0.6272921229999999,17811,9,1,8
21787,2014/03/31,2011/11/18,142,11,0.516363636,21637,142,7,4
21788,2014/03/31,2007/05/22,267,15,0.735550728,15189,267,10,5
21789,2014/03/31,2011/10/21,8,9,0.813881402,13727,8,1,8
21790,2014/03/31,2009/09/22,246,8,0.982197995,11374,246,6,2
21791,2014/03/31,2011/11/11,86,8,0.769880083,14510,86,2,6
21792,2014/03/31,2013/02/12,170,7,0.781719505,14289,170,3,4
21793,2014/03/31,2005/08/30,76,14,0.767595354,14551,76,3,11
21794,2014/03/31,2011/03/06,249,10,0.586860551,19032,249,8,2
21795,2014/03/31,2012/03/17,252,21,0.741116862,15069,252,17,4
21796,2014/03/31,2011/04/16,25,11,0.69303649,16114,25,5,6
21797,2014/03/31,2006/04/24,11,13,0.677600267,16481,11,7,6
21798,2014/03/31,2007/09/13,19,14,0.613791019,18193,19,10,4
21799,2014/03/31,2007/07/27,32,5,0.90641854,12319,32,1,4
21800,2014/03/31,2005/02/28,21,14,0.681853322,16376,21,10,4
21801,2014/03/31,2006/10/19,175,4,0.765,14596,175,0,4
21802,2014/03/31,2009/12/20,39,18,0.699125806,15969,39,5,13
21803,2014/03/31,2007/02/14,492,4,0.658784302,16945,492,4,0
21804,2014/03/31,2006/10/16,323,8,0.7955740859999999,14031,323,6,2
21805,2014/03/31,2010/09/30,5,10,0.485357221,22997,5,3,7
21806,2014/03/31,2008/12/10,102,14,0.844412165,13218,102,8,6
21807,2014/03/31,2010/09/24,5,14,0.8368453809999999,13336,5,9,5
21808,2014/03/31,2012/03/29,4,20,0.52580899,21224,4,9,11
21809,2014/03/31,2012/12/30,96,2,0.995509367,11210,96,0,2
21810,2014/03/31,2009/07/23,106,9,0.764474135,14595,106,7,2
21811,2014/03/31,2012/03/31,65,8,0.714483222,15616,65,2,6
21812,2014/03/31,2012/01/28,133,9,0.6506467979999999,17146,133,4,5
21813,2014/03/31,2010/05/11,331,13,0.710073202,15710,331,11,2
21814,2014/03/31,2012/09/26,221,10,0.81999706,13604,221,4,6
21815,2014/03/31,2013/03/11,32,12,0.771633232,14456,32,0,12
21816,2014/03/31,2012/09/01,28,20,0.628636159,17744,28,13,7
21817,2014/03/31,2010/10/26,140,15,0.621801305,17937,140,9,6
21818,2014/03/31,2005/06/09,146,7,0.895733676,12451,146,5,2
21819,2014/03/31,2011/04/10,21,12,0.738600954,15096,21,6,6
21820,2014/03/31,2010/04/09,47,9,0.76876991,14503,47,3,6
21821,2014/03/31,2009/07/01,42,16,0.676439146,16482,42,7,9
21822,2014/03/31,2012/03/16,120,13,0.665297768,16758,120,4,9
21823,2014/03/31,2008/08/04,2,19,0.8282771170000001,13460,2,0,19
21824,2014/03/31,2011/03/28,123,2,0.735,15168,123,1,1
21825,2014/03/31,2011/12/19,28,18,0.666841539,16717,28,9,9
21826,2014/03/31,2012/12/26,4,12,0.712388165,15648,4,2,10
21827,2014/03/31,2006/04/10,149,11,0.760327422,14660,149,2,9
21828,2014/03/31,2011/01/14,504,4,1.37097171,8130,504,4,0
21829,2014/03/31,2011/04/11,550,3,0.867902196,12842,550,3,0
21830,2014/03/31,2011/06/28,29,10,0.900405558,12378,29,8,2
21831,2014/03/31,2012/03/09,344,11,0.830461997,13420,344,10,1
21832,2014/03/31,2009/09/13,131,8,0.788776102,14127,131,2,6
21833,2014/03/31,2006/08/29,134,5,1.492177581,7467,134,4,1
21834,2014/03/31,2007/03/03,109,13,0.601952023,18509,109,3,10
21835,2014/03/31,2012/11/22,294,10,0.860077196,12954,294,6,4
21836,2014/03/31,2008/04/30,4,12,0.7149233140000001,15583,4,2,10
21837,2014/03/31,2010/10/28,100,8,0.6876709879999999,16200,100,2,6
21838,2014/03/31,2008/03/01,88,9,0.729597197,15268,88,5,4
21839,2014/03/31,2012/07/23,90,13,0.769917058,14468,90,7,6
21840,2014/03/31,2008/05/05,23,7,0.7628304340000001,14602,23,1,6
21841,2014/03/31,2010/10/29,27,12,0.6778957940000001,16429,27,2,10
21842,2014/03/31,2012/09/25,368,6,0.8151881129999999,13662,368,6,0
21843,2014/03/31,2013/03/05,120,9,0.643316966,17311,120,3,6
21844,2014/03/31,2011/03/07,249,18,0.7542908429999999,14764,249,16,2
21845,2014/03/31,2010/02/24,309,10,0.763858975,14579,309,3,7
21846,2014/03/31,2012/03/18,234,8,0.671955105,16572,234,6,2
21847,2014/03/31,2008/11/12,22,13,0.723492301,15391,22,4,9
21848,2014/03/31,2006/03/08,34,13,0.626557506,17772,34,8,5
21849,2014/03/31,2009/11/12,107,13,0.70324239,15834,107,9,4
21850,2014/03/31,2009/12/26,164,11,0.720016166,15465,164,6,5
21851,2014/03/31,2007/11/01,15,10,0.723124635,15397,15,0,10
21852,2014/03/31,2011/08/28,72,13,0.776583665,14337,72,3,10
21853,2014/03/31,2012/05/25,74,13,0.662369251,16807,74,1,12
21854,2014/03/31,2012/12/27,29,9,0.74743588,14894,29,0,9
21855,2014/03/31,2007/03/29,6,16,0.7031118129999999,15830,6,8,8
21856,2014/03/31,2009/01/27,113,13,0.597470876,18627,113,7,6
21857,2014/03/31,2012/02/05,79,5,1.028789868,10817,79,2,3
21858,2014/03/31,2011/08/06,353,16,0.678486068,16401,353,12,4
21859,2014/03/31,2009/07/31,5,9,0.721675854,15419,5,3,6
21860,2014/03/31,2011/06/25,131,10,0.834540614,13333,131,5,5
21861,2014/03/31,2011/06/05,249,8,0.862450578,12899,249,6,2
21862,2014/03/31,2013/01/27,20,15,0.558218676,19929,20,2,13
21863,2014/03/31,2007/12/13,99,18,0.698867948,15918,99,12,6
21864,2014/03/31,2008/06/14,24,9,0.622455512,17870,24,5,4
21865,2014/03/31,2008/05/06,20,18,0.5171596620000001,21508,20,12,6
21866,2014/03/31,2005/10/17,3,19,0.674301303,16495,3,7,12
21867,2014/03/31,2008/06/06,22,23,0.717675829,15498,22,9,14
21868,2014/03/31,2010/08/17,13,11,0.7481641440000001,14865,13,5,6
21869,2014/03/31,2009/03/23,19,16,0.640641742,17359,19,3,13
21870,2014/03/31,2007/11/02,128,11,0.755987084,14710,128,5,6
21871,2014/03/31,2009/01/24,60,12,0.868248751,12808,60,3,9
21872,2014/03/31,2013/03/13,7,7,0.790458487,14068,7,2,5
21873,2014/03/31,2008/11/09,68,11,0.73425279,15143,68,3,8
21874,2014/03/31,2012/06/17,13,9,0.875298378,12702,13,6,3
21875,2014/03/31,2005/02/13,123,12,0.5215278170000001,21318,123,5,7
21876,2014/03/31,2012/06/12,64,18,0.73603059,15103,64,8,10
21877,2014/03/31,2007/05/28,31,12,0.4397752720000001,25275,31,6,6
21878,2014/03/31,2010/04/09,117,10,0.71406527,15566,117,5,5
21879,2014/03/31,2011/11/12,218,8,0.668686079,16622,218,5,3
21880,2014/03/31,2009/02/08,17,12,0.514530346,21601,17,5,7
21881,2014/03/31,2012/06/14,33,13,0.625595272,17765,33,5,8
21882,2014/03/31,2012/04/28,17,11,0.7053081170000001,15757,17,2,9
21883,2014/03/31,2005/01/20,185,10,0.8743745079999999,12710,185,8,2
21884,2014/03/31,2013/01/28,174,10,0.62853911,17681,174,6,4
21885,2014/03/31,2009/04/04,197,6,0.651666667,17052,197,3,3
21886,2014/03/31,2010/11/11,11,10,0.774627396,14345,11,3,7
21887,2014/03/31,2007/06/03,12,12,0.800625405,13879,12,5,7
21888,2014/03/31,2008/01/25,36,11,0.677274168,16406,36,7,4
21889,2014/03/31,2010/03/28,105,9,0.803612558,13824,105,2,7
21890,2014/03/31,2009/06/29,313,12,0.541042813,20531,313,10,2
21891,2014/03/31,2006/03/26,1,16,0.590822297,18801,1,6,10
21892,2014/03/31,2011/10/01,476,19,0.706972378,15712,476,19,0
21893,2014/03/31,2011/10/06,73,17,0.7039440990000001,15778,73,12,5
21894,2014/03/31,2011/02/20,9,13,0.737043599,15069,9,8,5
21895,2014/03/31,2011/08/27,30,15,0.643155334,17266,30,9,6
21896,2014/03/31,2009/08/27,42,21,0.68821309,16134,42,4,17
21897,2014/03/31,2012/12/12,425,2,0.55,20188,425,2,0
21898,2014/03/31,2009/09/13,439,2,0.55,20188,439,2,0
21899,2014/03/31,2011/03/23,468,12,0.655710742,16933,468,12,0
21900,2014/03/31,2012/12/03,11,11,0.760051342,14608,11,5,6
21901,2014/03/31,2007/03/09,192,11,0.6733236290000001,16488,192,7,4
21902,2014/03/31,2012/11/16,387,4,1.05,10572,387,4,0
21903,2014/03/31,2009/11/17,140,12,0.615345086,18039,140,7,5
21904,2014/03/31,2005/07/06,2,8,0.965518921,11495,2,4,4
21905,2014/03/31,2005/01/21,196,7,0.628983281,17645,196,0,7
21906,2014/03/31,2010/06/08,153,14,0.7842329159999999,14151,153,8,6
21907,2014/03/31,2011/05/20,226,13,0.7201083779999999,15409,226,6,7
21908,2014/03/31,2011/09/07,222,8,0.7238180040000001,15330,222,3,5
21909,2014/03/31,2011/09/21,166,8,0.896628687,12375,166,6,2
21910,2014/03/31,2012/05/22,152,11,0.686004205,16172,152,6,5
21911,2014/03/31,2007/06/07,198,6,0.764353038,14514,198,4,2
21912,2014/03/31,2012/12/20,89,8,0.591273851,18762,89,3,5
21913,2014/03/31,2008/06/20,11,16,0.531937077,20851,11,7,9
21914,2014/03/31,2007/10/11,156,13,0.8242137340000001,13456,156,8,5
21915,2014/03/31,2008/06/03,18,12,0.738198096,15023,18,8,4
21916,2014/03/31,2013/01/19,85,7,0.789493058,14045,85,0,7
21917,2014/03/31,2011/12/01,17,13,0.686588235,16150,17,5,8
21918,2014/03/31,2012/12/05,305,11,0.371482176,29848,305,4,7
21919,2014/03/31,2010/09/27,132,9,0.6537555279999999,16959,132,6,3
21920,2014/03/31,2011/06/23,422,5,1.5,7391,422,5,0
21921,2014/03/31,2011/10/17,150,14,0.663796779,16701,150,9,5
21922,2014/03/31,2005/07/11,52,7,0.876151901,12653,52,1,6
21923,2014/03/31,2005/09/05,44,10,0.8468344659999999,13091,44,8,2
21924,2014/03/31,2012/07/25,207,6,0.7079879920000001,15656,207,4,2
21925,2014/03/31,2006/01/03,41,16,0.733309295,15115,41,8,8
21926,2014/03/31,2010/05/25,13,14,0.663643494,16701,13,3,11
21927,2014/03/31,2013/01/01,24,12,0.74007946,14976,24,1,11
21928,2014/03/31,2006/11/28,211,10,1.070091725,10357,211,7,3
21929,2014/03/31,2011/04/06,237,18,0.555158559,19961,237,13,5
21930,2014/03/31,2007/01/30,50,16,0.470787663,23538,50,8,8
21931,2014/03/31,2010/12/13,76,12,0.8881293579999999,12477,76,7,5
21932,2014/03/31,2012/06/09,15,13,0.73044298,15170,15,5,8
21933,2014/03/31,2005/07/13,93,6,1.299433564,8527,93,1,5
21934,2014/03/31,2008/11/09,76,14,0.435512579,25440,76,8,6
21935,2014/03/31,2012/07/24,258,7,0.500359498,22142,258,5,2
21936,2014/03/31,2013/03/23,27,12,0.7802979290000001,14198,27,1,11
21937,2014/03/31,2005/09/22,136,12,0.7039933909999999,15736,136,7,5
21938,2014/03/31,2011/08/27,135,14,0.636906227,17393,135,7,7
21939,2014/03/31,2009/08/11,14,14,0.733379676,15105,14,11,3
21940,2014/03/31,2010/08/07,492,4,0.665031522,16655,492,4,0
21941,2014/03/31,2011/04/10,160,9,0.569913554,19434,160,6,3
21942,2014/03/31,2011/05/23,5,6,1.406524003,7874,5,2,4
21943,2014/03/31,2007/04/06,28,8,0.806512272,13731,28,5,3
21944,2014/03/31,2008/05/03,155,12,0.760733668,14557,155,7,5
21945,2014/03/31,2012/03/20,45,10,0.634372637,17454,45,6,4
21946,2014/03/31,2005/06/12,102,12,0.840813335,13168,102,7,5
21947,2014/03/31,2013/01/17,4,8,0.8705417520000001,12718,4,2,6
21948,2014/03/31,2013/03/19,44,14,0.757702573,14612,44,0,14
21949,2014/03/31,2006/02/13,28,9,0.661787913,16729,28,5,4
21950,2014/03/31,2006/09/29,120,12,0.733265333,15098,120,7,5
21951,2014/03/31,2009/07/23,323,11,0.847000306,13068,323,8,3
21952,2014/03/31,2012/04/01,169,13,0.7380921579999999,14996,169,8,5
21953,2014/03/31,2012/08/12,7,8,0.608578655,18187,7,3,5
21954,2014/03/31,2010/04/06,328,8,0.717873127,15417,328,4,4
21955,2014/03/31,2008/05/02,25,11,0.647396747,17094,25,5,6
21956,2014/03/31,2005/09/06,417,8,0.967223145,11441,417,8,0
21957,2014/03/31,2009/10/11,326,3,0.695306315,15915,326,1,2
21958,2014/03/31,2008/10/28,210,9,0.573571799,19290,210,6,3
21959,2014/03/31,2012/01/03,2,9,0.751334375,14726,2,7,2
21960,2014/03/31,2008/08/01,232,10,0.806357075,13717,232,9,1
21961,2014/03/31,2008/07/17,63,11,0.581305513,19027,63,5,6
21962,2014/03/31,2011/04/30,144,12,0.751329664,14718,144,6,6
21963,2014/03/31,2012/02/27,135,12,0.6140224329999999,18009,135,6,6
21964,2014/03/31,2007/06/13,185,4,0.841673771,13138,185,2,2
21965,2014/03/31,2006/03/18,4,22,0.670218208,16498,4,7,15
21966,2014/03/31,2009/06/07,45,9,0.909222926,12161,45,4,5
21967,2014/03/31,2011/10/18,165,16,0.707196035,15635,165,6,10
21968,2014/03/31,2011/08/10,348,7,0.69544311,15899,348,6,1
21969,2014/03/31,2013/01/24,95,13,0.745082895,14838,95,0,13
21970,2014/03/31,2008/02/09,390,7,0.923986628,11965,390,7,0
21971,2014/03/31,2011/03/24,55,14,0.817351767,13526,55,0,14
21972,2014/03/31,2009/10/24,35,11,0.777454993,14220,35,3,8
21973,2014/03/31,2012/06/12,6,12,0.8426442559999999,13119,6,10,2
21974,2014/03/31,2006/05/27,6,14,0.62354149,17727,6,7,7
21975,2014/03/31,2008/03/10,100,15,0.676640955,16335,100,8,7
21976,2014/03/31,2006/12/23,76,10,0.677956204,16303,76,6,4
21977,2014/03/31,2011/03/02,494,9,0.938888889,11772,494,9,0
21978,2014/03/31,2006/06/03,163,10,0.775180951,14258,163,9,1
21979,2014/03/31,2006/10/23,28,16,0.5530392789999999,19985,28,6,10
21980,2014/03/31,2011/11/11,139,10,0.7069359690000001,15633,139,7,3
21981,2014/03/31,2007/06/17,315,7,0.7592367409999999,14556,315,6,1
21982,2014/03/31,2011/05/06,314,8,0.82890039,13332,314,6,2
21983,2014/03/31,2007/10/12,102,26,0.6687690629999999,16524,102,18,8
21984,2014/03/31,2005/09/06,107,14,0.646654573,17089,107,7,7
21985,2014/03/31,2011/02/18,10,3,0.644911001,17135,10,1,2
21986,2014/03/31,2011/01/17,70,14,0.6128606289999999,18031,70,10,4
21987,2014/03/31,2011/09/15,23,23,0.669141335,16514,23,17,6
21988,2014/03/31,2012/01/09,114,16,0.6219826620000001,17764,114,10,6
21989,2014/03/31,2012/05/02,50,10,0.739121622,14948,50,4,6
21990,2014/03/31,2007/11/22,94,7,0.7846683240000001,14080,94,1,6
21991,2014/03/31,2011/03/10,108,11,0.7601554970000001,14534,108,6,5
21992,2014/03/31,2011/05/28,5,20,0.791690434,13955,5,11,9
21993,2014/03/31,2012/11/15,80,12,0.609009923,18140,80,4,8
21994,2014/03/31,2007/06/24,12,13,0.805124262,13721,12,9,4
21995,2014/03/31,2006/03/12,188,9,0.662729618,16669,188,7,2
21996,2014/03/31,2010/05/17,38,17,0.596510962,18518,38,11,6
21997,2014/03/31,2012/09/29,187,13,0.751113831,14706,187,5,8
21998,2014/03/31,2012/04/10,358,7,0.724175572,15253,358,5,2
21999,2014/03/31,2012/10/24,33,17,0.644859595,17129,33,5,12
22000,2014/03/31,2010/01/05,111,12,0.6275755679999999,17600,111,6,6
22001,2014/03/31,2012/06/20,30,7,0.59950228,18424,30,2,5
22002,2014/03/31,2011/04/04,97,9,0.729083768,15149,97,4,5
22003,2014/03/31,2004/11/09,32,21,0.399742309,27630,32,14,7
22004,2014/03/31,2005/04/16,18,13,0.7559126690000001,14611,18,6,7
22005,2014/03/31,2010/10/14,354,12,0.823974187,13404,354,10,2
22006,2014/03/31,2006/02/20,192,10,0.7150323709999999,15446,192,5,5
22007,2014/03/31,2007/02/01,184,11,0.907505341,12170,184,6,5
22008,2014/03/31,2006/08/16,5,12,0.672120253,16432,5,6,6
22009,2014/03/31,2011/03/13,67,13,0.696166793,15864,67,7,6
22010,2014/03/31,2012/05/20,265,4,1.4825268530000002,7448,265,3,1
22011,2014/03/31,2007/12/20,245,13,0.895241223,12333,245,11,2
22012,2014/03/31,2007/02/23,247,8,0.584416684,18892,247,4,4
22013,2014/03/31,2013/01/09,87,5,0.741972579,14879,87,2,3
22014,2014/03/31,2011/09/19,3,5,0.461598227,23914,3,2,3
22015,2014/03/31,2010/05/23,46,17,0.762802847,14471,46,12,5
22016,2014/03/31,2010/11/01,551,7,0.6859557540000001,16092,551,7,0
22017,2014/03/31,2011/10/13,514,3,0.668321628,16516,514,3,0
22018,2014/03/31,2010/10/02,3,10,0.768675999,14358,3,0,10
22019,2014/03/31,2008/05/27,12,19,0.486277758,22696,12,8,11
22020,2014/03/31,2009/11/03,16,9,0.630619965,17501,16,6,3
22021,2014/03/31,2009/01/05,1,13,0.729494315,15128,1,4,9
22022,2014/03/31,2008/09/06,401,5,0.781810131,14115,401,5,0
22023,2014/03/31,2009/05/12,6,17,0.694732435,15884,6,13,4
22024,2014/03/31,2010/08/05,301,13,0.738673182,14938,301,10,3
22025,2014/03/31,2006/04/15,2,8,0.833835865,13233,2,2,6
22026,2014/03/31,2012/12/29,165,15,0.611877114,18033,165,5,10
22027,2014/03/31,2010/12/17,573,12,0.489505789,22541,573,12,0
22028,2014/03/31,2012/10/02,83,10,0.764094183,14440,83,5,5
22029,2014/03/31,2005/05/17,181,10,0.614541049,17954,181,5,5
22030,2014/03/31,2006/06/09,159,10,0.962745201,11460,159,8,2
22031,2014/03/31,2009/01/07,113,8,0.6972748529999999,15823,113,0,8
22032,2014/03/31,2011/08/04,164,16,0.548175494,20126,164,12,4
22033,2014/03/31,2013/03/29,47,9,0.671835455,16421,47,0,9
22034,2014/03/31,2011/09/26,41,14,0.661911562,16667,41,10,4
22035,2014/03/31,2008/03/09,166,9,0.945560127,11667,166,4,5
22036,2014/03/31,2011/10/27,148,9,0.728892633,15135,148,5,4
22037,2014/03/31,2011/07/19,16,16,0.7606474520000001,14503,16,12,4
22038,2014/03/31,2006/05/31,6,8,0.921207516,11975,6,6,2
22039,2014/03/31,2013/02/06,67,8,1.271183452,8678,67,2,6
22040,2014/03/31,2008/09/27,75,9,0.7552851759999999,14605,75,4,5
22041,2014/03/31,2012/07/07,149,10,0.655728808,16822,149,7,3
22042,2014/03/31,2007/08/08,1,11,0.8134129790000001,13560,1,4,7
22043,2014/03/31,2012/03/10,179,11,0.7038248990000001,15671,179,4,7
22044,2014/03/31,2012/10/23,73,8,0.712817165,15473,73,4,4
22045,2014/03/31,2008/06/28,537,12,0.916900823,12029,537,12,0
22046,2014/03/31,2008/12/27,19,7,0.7585714290000001,14539,19,0,7
22047,2014/03/31,2011/05/09,213,11,0.734730495,15009,213,6,5
22048,2014/03/31,2009/08/07,103,9,0.954840665,11548,103,8,1
22049,2014/03/31,2011/09/11,211,7,0.60919337,18100,211,3,4
22050,2014/03/31,2011/04/15,31,10,0.729794811,15108,31,3,7
22051,2014/03/31,2008/07/03,236,10,1.038963438,10612,236,8,2
22052,2014/03/31,2012/11/13,79,16,0.59832854,18427,79,5,11
22053,2014/03/31,2010/12/23,500,11,0.935749448,11782,500,11,0
22054,2014/03/31,2011/06/12,46,12,0.580085245,19004,46,6,6
22055,2014/03/31,2013/02/13,94,5,1.087142012,10140,94,2,3
22056,2014/03/31,2005/01/10,107,17,0.685922215,16070,107,14,3
22057,2014/03/31,2009/03/20,140,13,0.541349705,20360,140,2,11
22058,2014/03/31,2012/03/23,30,16,0.6631291739999999,16621,30,5,11
22059,2014/03/31,2005/09/17,24,11,0.629813704,17499,24,2,9
22060,2014/03/31,2008/06/19,172,22,0.5398412929999999,20415,172,16,6
22061,2014/03/31,2007/01/11,314,11,0.763636364,14432,314,9,2
22062,2014/03/31,2008/08/03,47,12,0.741735092,14858,47,4,8
22063,2014/03/31,2009/12/16,375,2,0.72505099,15199,375,2,0
22064,2014/03/31,2011/03/05,94,10,0.754653472,14602,94,7,3
22065,2014/03/31,2013/03/14,172,13,0.924493666,11919,172,3,10
22066,2014/03/31,2010/03/12,29,11,0.719350437,15318,29,5,6
22067,2014/03/31,2006/07/26,11,14,0.843571429,13062,11,2,12
22068,2014/03/31,2009/07/13,624,2,0.72494901,15199,624,2,0
22069,2014/03/31,2011/01/30,697,2,0.72494901,15199,697,2,0
22070,2014/03/31,2006/06/21,30,9,0.641152168,17185,30,4,5
22071,2014/03/31,2013/03/11,69,14,0.748756202,14713,69,1,13
22072,2014/03/31,2011/12/13,121,18,0.8478719309999999,12993,121,10,8
22073,2014/03/31,2008/05/05,104,12,0.792691948,13897,104,5,7
22074,2014/03/31,2011/01/23,102,11,0.521848501,21109,102,9,2
22075,2014/03/31,2006/08/02,60,9,0.878507058,12539,60,2,7
22076,2014/03/31,2010/10/19,67,18,0.602721602,18276,67,10,8
22077,2014/03/31,2009/07/01,231,7,0.5702997670000001,19315,231,6,1
22078,2014/03/31,2012/02/22,443,9,0.622222222,17703,443,9,0
22079,2014/03/31,2012/03/07,586,9,0.622222222,17703,586,9,0
22080,2014/03/31,2006/06/30,196,7,0.8,13769,196,2,5
22081,2014/03/31,2008/07/26,166,10,0.630537616,17466,166,1,9
22082,2014/03/31,2008/09/10,45,8,0.669917265,16438,45,3,5
22083,2014/03/31,2011/11/22,151,12,0.788464127,13966,151,7,5
22084,2014/03/31,2011/08/26,4,12,0.765119511,14392,4,9,3
22085,2014/03/31,2011/01/06,153,10,0.664298383,16576,153,4,6
22086,2014/03/31,2010/12/01,274,7,1.141484553,9646,274,5,2
22087,2014/03/31,2009/05/21,11,4,0.7178912359999999,15336,11,2,2
22088,2014/03/31,2010/03/02,85,15,0.672454801,16372,85,3,12
22089,2014/03/31,2006/01/28,169,17,0.597796481,18416,169,9,8
22090,2014/03/31,2009/09/12,385,2,0.45,24464,385,2,0
22091,2014/03/31,2012/06/07,513,6,0.7333333329999999,15012,513,6,0
22092,2014/03/31,2006/03/20,367,2,0.45,24464,367,2,0
22093,2014/03/31,2011/11/01,205,7,0.969843186,11351,205,4,3
22094,2014/03/31,2011/12/29,37,9,1.178351354,9341,37,5,4
22095,2014/03/31,2004/11/30,117,11,0.953693787,11541,117,7,4
22096,2014/03/31,2010/03/23,27,12,0.8445146929999999,13033,27,3,9
22097,2014/03/31,2010/05/06,105,11,0.621958745,17695,105,2,9
22098,2014/03/31,2011/09/11,379,3,0.55,20010,379,3,0
22099,2014/03/31,2011/03/14,5,15,0.672040181,16376,5,6,9
22100,2014/03/31,2013/03/09,299,3,1.475397506,7459,299,2,1
22101,2014/03/31,2013/01/23,89,13,0.785284002,14014,89,2,11
22102,2014/03/31,2010/12/11,385,10,0.822175732,13384,385,10,0
22103,2014/03/31,2007/02/28,330,8,0.73125,15048,330,6,2
22104,2014/03/31,2005/09/24,38,9,0.878060809,12531,38,5,4
22105,2014/03/31,2009/05/31,85,28,0.6775,16240,85,18,10
22106,2014/03/31,2011/09/25,1,6,0.590392252,18636,1,1,5
22107,2014/03/31,2012/08/15,252,10,0.820343722,13412,252,8,2
22108,2014/03/31,2011/04/20,20,6,0.957476936,11490,20,0,6
22109,2014/03/31,2009/09/15,112,8,0.659393431,16684,112,3,5
22110,2014/03/31,2009/07/29,289,10,0.7778026020000001,14144,289,9,1
22111,2014/03/31,2009/09/07,341,15,0.6179989889999999,17801,341,13,2
22112,2014/03/31,2011/05/03,73,13,0.490204982,22441,73,5,8
22113,2014/03/31,2008/04/08,120,11,0.906444994,12135,120,5,6
22114,2014/03/31,2012/08/09,502,3,1.5,7333,502,3,0
22115,2014/03/31,2005/04/02,180,15,0.6162151260000001,17850,180,13,2
22116,2014/03/31,2007/05/23,17,18,0.55220493,19919,17,7,11
22117,2014/03/31,2012/09/29,61,9,0.672417314,16357,61,2,7
22118,2014/03/31,2010/04/30,276,6,0.85,12939,276,4,2
22119,2014/03/31,2006/10/14,14,10,0.926802629,11866,14,3,7
22120,2014/03/31,2009/09/16,2,11,0.535485709,20537,2,7,4
22121,2014/03/31,2008/06/14,162,7,0.77054162,14272,162,4,3
22122,2014/03/31,2004/11/01,256,15,0.674364383,16307,256,9,6
22123,2014/03/31,2012/05/27,395,2,0.725,15168,395,2,0
22124,2014/03/31,2011/05/25,379,2,0.725,15168,379,2,0
22125,2014/03/31,2012/10/17,118,14,0.845101445,13012,118,3,11
22126,2014/03/31,2011/07/23,71,11,1.009668534,10891,71,8,3
22127,2014/03/31,2009/01/11,23,11,0.790715518,13906,23,5,6
22128,2014/03/31,2010/02/16,32,11,0.5581228429999999,19700,32,9,2
22129,2014/03/31,2008/11/20,155,8,0.6351684089999999,17309,155,1,7
22130,2014/03/31,2009/11/06,184,5,0.5048952879999999,21774,184,2,3
22131,2014/03/31,2010/10/21,3,11,0.673647895,16319,3,8,3
22132,2014/03/31,2012/07/21,355,11,0.7759652709999999,14167,355,10,1
22133,2014/03/31,2011/08/22,16,13,0.717976618,15311,16,10,3
22134,2014/03/31,2009/11/29,112,12,0.7494934209999999,14667,112,6,6
22135,2014/03/31,2011/06/15,69,12,1.256848845,8746,69,0,12
22136,2014/03/31,2008/04/11,82,11,0.6605125589999999,16642,82,4,7
22137,2014/03/31,2011/11/04,223,5,0.719904375,15268,223,2,3
22138,2014/03/31,2008/04/12,420,8,0.753031653,14596,420,8,0
22139,2014/03/31,2011/06/21,128,10,0.75576566,14543,128,2,8
22140,2014/03/31,2007/12/02,119,13,0.8568041479999999,12826,119,6,7
22141,2014/03/31,2012/11/12,10,17,0.8033723229999999,13679,10,3,14
22142,2014/03/31,2012/11/25,219,7,0.543960004,20202,219,5,2
22143,2014/03/31,2011/04/03,40,13,0.73076877,15037,40,0,13
22144,2014/03/31,2008/12/09,167,11,0.663799686,16554,167,10,1
22145,2014/03/31,2011/10/17,27,14,0.722498027,15208,27,8,6
22146,2014/03/31,2006/07/20,83,6,0.75503436,14552,83,2,4
22147,2014/03/31,2013/01/30,77,17,0.8160610559999999,13463,77,4,13
22148,2014/03/31,2009/07/25,51,14,0.6942426540000001,15825,51,6,8
22149,2014/03/31,2011/12/20,119,11,0.681995282,16108,119,5,6
22150,2014/03/31,2005/11/30,62,18,0.7319108529999999,15009,62,8,10
22151,2014/03/31,2007/09/14,46,8,0.73,15048,46,4,4
22152,2014/03/31,2012/09/20,108,11,0.688630266,15952,108,5,6
22153,2014/03/31,2010/12/21,413,13,0.802095655,13695,413,13,0
22154,2014/03/31,2010/09/09,23,15,0.718631338,15285,23,6,9
22155,2014/03/31,2010/07/22,11,9,0.628254876,17483,11,1,8
22156,2014/03/31,2012/05/02,310,14,0.618237082,17766,310,12,2
22157,2014/03/31,2008/02/21,90,10,0.691680207,15879,90,7,3
22158,2014/03/31,2006/02/23,5,14,0.7333271020000001,14977,5,0,14
22159,2014/03/31,2011/03/26,108,12,0.607697671,18073,108,5,7
22160,2014/03/31,2008/03/25,242,11,0.546543916,20095,242,9,2
22161,2014/03/31,2012/03/29,61,7,0.673512817,16306,61,1,6
22162,2014/03/31,2010/09/01,535,4,0.85,12920,535,4,0
22163,2014/03/31,2009/07/10,589,5,0.68,16150,589,5,0
22164,2014/03/31,2011/10/11,217,10,0.6171166060000001,17795,217,7,3
22165,2014/03/31,2005/02/06,13,14,0.72102889,15230,13,2,12
22166,2014/03/31,2012/02/24,12,18,0.7587858479999999,14471,12,6,12
22167,2014/03/31,2009/07/25,192,13,0.5984487079999999,18346,192,9,4
22168,2014/03/31,2005/07/03,118,15,0.713794942,15381,118,8,7
22169,2014/03/31,2012/02/13,70,12,0.482183767,22768,70,5,7
22170,2014/03/31,2011/02/23,17,11,0.771354694,14232,17,4,7
22171,2014/03/31,2010/12/16,462,16,0.7281724709999999,15075,462,16,0
22172,2014/03/31,2012/02/09,11,10,0.651342788,16853,11,3,7
22173,2014/03/31,2013/01/10,192,20,0.402223525,27290,192,8,12
22174,2014/03/31,2011/07/12,14,15,0.584833484,18767,14,5,10
22175,2014/03/31,2012/08/17,583,5,1.349440551,8133,583,5,0
22176,2014/03/31,2013/03/23,60,7,1.232428972,8905,60,2,5
22177,2014/03/31,2007/01/17,166,11,0.778673904,14094,166,6,5
22178,2014/03/31,2008/12/15,2,12,0.535149461,20507,2,2,10
22179,2014/03/31,2012/05/20,112,11,0.726283256,15110,112,1,10
22180,2014/03/31,2012/01/20,82,13,0.747437679,14682,82,6,7
22181,2014/03/31,2012/08/15,324,10,0.508882189,21560,324,9,1
22182,2014/03/31,2012/04/30,458,17,0.935294118,11730,458,17,0
22183,2014/03/31,2010/12/30,167,15,0.558037031,19659,167,12,3
22184,2014/03/31,2010/05/23,144,6,0.983856502,11150,144,3,3
22185,2014/03/31,2012/03/03,79,10,0.6588318320000001,16650,79,1,9
22186,2014/03/31,2012/02/10,37,15,0.55259862,19849,37,11,4
22187,2014/03/31,2011/07/19,186,13,0.721275071,15207,186,7,6
22188,2014/03/31,2012/01/15,7,6,0.85012249,12899,7,4,2
22189,2014/03/31,2012/09/16,97,16,0.577191283,18998,97,9,7
22190,2014/03/31,2009/04/07,10,16,0.488127671,22464,10,11,5
22191,2014/03/31,2007/03/24,7,9,0.725738964,15109,7,6,3
22192,2014/03/31,2012/12/19,15,6,0.7990781229999999,13722,15,3,3
22193,2014/03/31,2011/03/15,55,8,0.6919357490000001,15844,55,1,7
22194,2014/03/31,2011/07/27,6,8,0.46125,23768,6,3,5
22195,2014/03/31,2009/09/29,7,8,0.823070801,13319,7,3,5
22196,2014/03/31,2009/12/21,249,14,0.929802375,11790,249,11,3
22197,2014/03/31,2012/03/12,223,12,0.641975403,17075,223,5,7
22198,2014/03/31,2012/02/20,518,10,0.694506748,15783,518,10,0
22199,2014/03/31,2012/11/06,57,12,0.767038488,14290,57,4,8
22200,2014/03/31,2005/03/16,1,15,0.597270993,18351,1,3,12
22201,2014/03/31,2012/06/02,362,6,1.161825506,9433,362,5,1
22202,2014/03/31,2011/09/28,107,11,0.7191560570000001,15238,107,3,8
22203,2014/03/31,2006/09/14,36,8,0.933340431,11741,36,5,3
22204,2014/03/31,2007/10/24,144,12,0.7718991270000001,14196,144,9,3
22205,2014/03/31,2005/03/01,10,19,0.835789474,13110,10,10,9
22206,2014/03/31,2007/05/14,44,9,0.581514862,18840,44,3,6
22207,2014/03/31,2013/02/06,6,18,0.8076408140000001,13564,6,3,15
22208,2014/03/31,2011/04/18,19,8,0.532930816,20554,19,3,5
22209,2014/03/31,2011/10/01,204,6,0.925844814,11831,204,2,4
22210,2014/03/31,2011/11/02,58,12,0.603758889,18141,58,10,2
22211,2014/03/31,2010/08/11,27,9,0.7393944509999999,14813,27,7,2
22212,2014/03/31,2005/11/23,33,9,1.189471112,9208,33,3,6
22213,2014/03/31,2009/07/20,193,6,1.278758903,8565,193,2,4
22214,2014/03/31,2009/09/28,154,6,0.879362454,12454,154,0,6
22215,2014/03/31,2010/09/30,89,10,0.8604934390000001,12727,89,9,1
22216,2014/03/31,2012/08/27,255,9,0.771075981,14201,255,4,5
22217,2014/03/31,2010/08/11,85,2,0.72,15208,85,0,2
22218,2014/03/31,2007/02/26,113,2,0.72,15208,113,0,2
22219,2014/03/31,2008/03/24,122,5,0.805580489,13592,122,3,2
22220,2014/03/31,2009/02/17,129,18,0.617337055,17736,129,11,7
22221,2014/03/31,2012/08/27,69,7,0.7657280740000001,14298,69,4,3
22222,2014/03/31,2011/11/15,154,7,0.740202826,14791,154,5,2
22223,2014/03/31,2010/08/01,191,10,0.6881389059999999,15910,191,5,5
22224,2014/03/31,2008/10/24,165,8,0.9775,11200,165,5,3
22225,2014/03/31,2008/07/17,68,8,0.762376045,14360,68,7,1
22226,2014/03/31,2012/06/23,613,3,1.0,10947,613,3,0
22227,2014/03/31,2010/05/19,124,9,0.8778915709999999,12469,124,2,7
22228,2014/03/31,2010/02/01,3,11,0.679260937,16115,3,4,7
22229,2014/03/31,2008/01/16,201,8,0.65875,16616,201,7,1
22230,2014/03/31,2007/02/09,289,9,0.859970145,12728,289,7,2
22231,2014/03/31,2012/03/19,193,12,0.621944997,17599,193,5,7
22232,2014/03/31,2009/04/16,381,9,0.721614137,15166,381,9,0
22233,2014/03/31,2010/06/11,68,11,0.6749216729999999,16214,68,5,6
22234,2014/03/31,2010/03/05,1,18,0.648859176,16865,1,7,11
22235,2014/03/31,2009/03/12,27,13,0.59683447,18335,27,3,10
22236,2014/03/31,2006/06/17,277,2,1.011164295,10822,277,0,2
22237,2014/03/31,2011/05/20,3,14,0.70744828,15468,3,4,10
22238,2014/03/31,2007/07/13,344,4,1.38091632,7923,344,3,1
22239,2014/03/31,2005/02/01,123,7,1.167121826,9374,123,4,3
22240,2014/03/31,2012/08/07,26,9,0.767978238,14245,26,3,6
22241,2014/03/31,2006/10/13,1,9,0.820871295,13325,1,4,5
22242,2014/03/31,2011/11/12,36,13,0.71859724,15220,36,6,7
22243,2014/03/31,2012/03/01,116,13,0.7030783079999999,15554,116,11,2
22244,2014/03/31,2012/01/05,9,11,0.69510806,15732,9,5,6
22245,2014/03/31,2007/04/11,1,12,0.6231169870000001,17549,1,1,11
22246,2014/03/31,2013/02/05,7,7,0.528343641,20696,7,1,6
22247,2014/03/31,2007/04/02,75,9,0.59094255,18503,75,4,5
22248,2014/03/31,2007/03/04,131,15,0.693912547,15757,131,8,7
22249,2014/03/31,2007/11/26,172,9,0.907502283,12047,172,4,5
22250,2014/03/31,2006/02/22,111,12,0.661881092,16517,111,8,4
22251,2014/03/31,2011/09/14,14,13,0.664010812,16463,14,3,10
22252,2014/03/31,2011/01/14,17,11,0.6522326970000001,16760,17,3,8
22253,2014/03/31,2013/01/22,105,13,0.707535275,15450,105,3,10
22254,2014/03/31,2006/11/01,194,6,0.805660377,13568,194,5,1
22255,2014/03/31,2010/09/01,200,14,0.6854402359999999,15946,200,2,12
22256,2014/03/31,2011/11/10,56,11,0.89193014,12253,56,6,5
22257,2014/03/31,2010/04/08,192,17,0.8650839140000001,12632,192,9,8
22258,2014/03/31,2012/12/21,35,8,1.040202761,10505,35,0,8
22259,2014/03/31,2012/06/06,110,19,0.472125821,23144,110,9,10
22260,2014/03/31,2005/04/01,10,13,0.620115778,17620,10,9,4
22261,2014/03/31,2012/04/14,25,10,0.796829784,13712,25,4,6
22262,2014/03/31,2010/02/08,214,10,0.709096573,15408,214,9,1
22263,2014/03/31,2011/07/12,21,13,0.605303601,18050,21,6,7
22264,2014/03/31,2010/04/27,186,15,0.8354530859999999,13077,186,10,5
22265,2014/03/31,2006/03/14,20,11,0.608394498,17957,20,0,11
22266,2014/03/31,2012/05/23,115,9,0.748335388,14598,115,4,5
22267,2014/03/31,2012/10/03,27,12,0.569277115,19187,27,4,8
22268,2014/03/31,2012/12/30,41,10,0.719115807,15189,41,6,4
22269,2014/03/31,2008/03/23,345,8,0.8984576790000001,12157,345,6,2
22270,2014/03/31,2009/09/10,24,14,0.58921832,18537,24,4,10
22271,2014/03/31,2007/12/02,252,7,0.591908736,18452,252,4,3
22272,2014/03/31,2006/05/17,2,15,0.598479035,18245,2,11,4
22273,2014/03/31,2007/12/17,34,6,0.7482449290000001,14592,34,3,3
22274,2014/03/31,2011/07/29,124,16,0.498507899,21902,124,12,4
22275,2014/03/31,2013/03/16,348,4,0.67746339,16116,348,2,2
22276,2014/03/31,2013/01/19,3,12,0.7272262190000001,15012,3,2,10
22277,2014/03/31,2009/12/22,400,11,0.7562387420000001,14434,400,11,0
22278,2014/03/31,2007/01/23,83,10,0.626188755,17430,83,3,7
22279,2014/03/31,2006/05/06,229,8,0.793832557,13748,229,6,2
22280,2014/03/31,2008/05/21,81,18,0.6380694570000001,17104,81,15,3
22281,2014/03/31,2012/07/18,500,6,0.783333333,13932,500,6,0
22282,2014/03/31,2006/09/21,133,7,0.609094156,17917,133,0,7
22283,2014/03/31,2007/06/17,626,6,1.167335259,9348,626,6,0
22284,2014/03/31,2008/12/31,223,12,0.658941425,16560,223,7,5
22285,2014/03/31,2012/07/05,620,3,0.726851852,15012,620,3,0
22286,2014/03/31,2011/03/24,160,10,0.796743337,13695,160,5,5
22287,2014/03/31,2009/09/26,40,8,0.7230550029999999,15090,40,1,7
22288,2014/03/31,2010/12/07,11,13,0.7198370390000001,15157,11,7,6
22289,2014/03/31,2012/08/15,78,10,0.624027682,17484,78,5,5
22290,2014/03/31,2009/01/01,138,12,0.545056702,20017,138,2,10
22291,2014/03/31,2012/04/06,72,16,0.528125,20656,72,8,8
22292,2014/03/31,2009/11/30,15,11,0.786594318,13868,15,0,11
22293,2014/03/31,2011/08/12,132,11,0.74488596,14644,132,9,2
22294,2014/03/31,2008/03/07,359,14,0.5412225860000001,20154,359,13,1
22295,2014/03/31,2006/01/21,115,5,1.474989858,7395,115,3,2
22296,2014/03/31,2012/04/29,97,9,0.670240875,16274,97,4,5
22297,2014/03/31,2012/04/29,243,8,0.8272716929999999,13184,243,5,3
22298,2014/03/31,2011/10/26,118,17,0.5181935670000001,21047,118,7,10
22299,2014/03/31,2012/04/01,109,14,0.684722466,15926,109,4,10
22300,2014/03/31,2005/07/16,41,5,0.795989926,13698,41,0,5
22301,2014/03/31,2011/01/14,132,15,0.644940258,16906,132,7,8
22302,2014/03/31,2010/04/17,43,5,0.769519373,14169,43,1,4
22303,2014/03/31,2008/10/28,49,15,0.6769224559999999,16107,49,13,2
22304,2014/03/31,2010/09/02,25,6,1.40178452,7778,25,2,4
22305,2014/03/31,2007/09/05,146,9,0.782486184,13933,146,5,4
22306,2014/03/31,2010/12/17,20,12,0.789503223,13809,20,2,10
22307,2014/03/31,2009/07/20,140,8,0.687003592,15869,140,6,2
22308,2014/03/31,2006/01/15,550,15,1.053333333,10350,550,15,0
22309,2014/03/31,2009/03/16,11,11,0.648425028,16813,11,6,5
22310,2014/03/31,2010/03/10,128,4,1.02,10688,128,2,2
22311,2014/03/31,2007/08/01,17,10,0.8472153570000001,12867,17,2,8
22312,2014/03/31,2009/12/01,76,15,0.666263065,16361,76,7,8
22313,2014/03/31,2013/03/08,12,13,0.859195239,12687,12,0,13
22314,2014/03/31,2007/04/26,77,12,0.74015346,14727,77,6,6
22315,2014/03/31,2012/03/23,671,3,0.547638666,19904,671,3,0
22316,2014/03/31,2013/01/01,30,5,0.609268865,17890,30,2,3
22317,2014/03/31,2011/08/12,177,11,0.705524629,15449,177,3,8
22318,2014/03/31,2006/03/24,115,7,0.8812241270000001,12368,115,0,7
22319,2014/03/31,2006/07/23,5,13,0.670787789,16248,5,4,9
22320,2014/03/31,2010/09/15,369,10,0.76814914,14188,369,10,0
22321,2014/03/31,2012/11/16,135,7,0.67374034,16175,135,4,3
22322,2014/03/31,2011/11/23,306,17,0.690079792,15791,306,13,4
22323,2014/03/31,2011/09/13,14,13,0.888025265,12270,14,6,7
22324,2014/03/31,2013/01/03,13,13,0.712938559,15283,13,2,11
22325,2014/03/31,2008/03/07,544,6,0.63591689,17134,544,6,0
22326,2014/03/31,2012/08/31,6,20,0.702719768,15505,6,7,13
22327,2014/03/31,2013/03/24,12,11,0.80708,13500,12,1,10
22328,2014/03/31,2012/09/01,41,12,0.8092913909999999,13463,41,7,5
22329,2014/03/31,2007/05/19,88,14,0.5862338570000001,18584,88,7,7
22330,2014/03/31,2008/10/09,172,12,0.61232983,17791,172,9,3
22331,2014/03/31,2006/03/30,115,13,0.5994815920000001,18171,115,7,6
22332,2014/03/31,2011/04/13,166,4,0.975,11172,166,2,2
22333,2014/03/31,2011/08/08,382,14,0.585147478,18613,382,14,0
22334,2014/03/31,2012/04/04,267,12,0.630893819,17263,267,7,5
22335,2014/03/31,2011/01/22,38,9,0.476473419,22855,38,5,4
22336,2014/03/31,2012/12/15,72,14,0.6562809620000001,16593,72,7,7
22337,2014/03/31,2007/07/04,47,11,0.668441989,16290,47,5,6
22338,2014/03/31,2012/02/05,33,13,0.601622742,18099,33,4,9
22339,2014/03/31,2009/05/06,21,16,0.825137163,13196,21,10,6
22340,2014/03/31,2011/01/13,71,9,0.660147335,16493,71,5,4
22341,2014/03/31,2010/12/17,43,13,0.598657833,18187,43,6,7
22342,2014/03/31,2012/02/14,40,7,0.5683936310000001,19155,40,4,3
22343,2014/03/31,2007/05/05,27,11,0.558762125,19485,27,4,7
22344,2014/03/31,2006/10/23,14,10,0.721339031,15093,14,3,7
22345,2014/03/31,2011/08/22,24,2,0.710738347,15318,24,0,2
22346,2014/03/31,2011/03/24,95,13,0.886346984,12283,95,8,5
22347,2014/03/31,2008/06/14,133,19,0.968507117,11240,133,15,4
22348,2014/03/31,2010/09/18,262,12,0.698975215,15574,262,10,2
22349,2014/03/31,2012/09/19,96,11,0.603592459,18035,96,5,6
22350,2014/03/31,2006/03/28,142,12,0.816116359,13338,142,3,9
22351,2014/03/31,2012/01/05,256,4,0.8425,12920,256,2,2
22352,2014/03/31,2011/08/03,153,14,0.706163877,15414,153,6,8
22353,2014/03/31,2010/10/24,707,2,0.8,13606,707,2,0
22354,2014/03/31,2011/06/02,421,11,0.77711695,14006,421,11,0
22355,2014/03/31,2011/04/14,5,22,0.552772981,19690,5,15,7
22356,2014/03/31,2008/05/02,101,13,0.573721997,18971,101,7,6
22357,2014/03/31,2013/01/08,31,12,0.384434829,28310,31,2,10
22358,2014/03/31,2012/12/29,194,8,1.163533626,9353,194,4,4
22359,2014/03/31,2007/12/07,81,16,0.627227666,17350,81,12,4
22360,2014/03/31,2011/03/05,62,8,0.807406143,13478,62,5,3
22361,2014/03/31,2008/05/22,555,15,0.624609689,17422,555,15,0
22362,2014/03/31,2009/05/29,397,15,0.57529079,18914,397,15,0
22363,2014/03/31,2005/01/13,117,13,0.692462292,15713,117,7,6
22364,2014/03/31,2011/10/22,14,14,0.584332134,18619,14,5,9
22365,2014/03/31,2010/05/12,44,4,0.663429896,16397,44,0,4
22366,2014/03/31,2012/06/04,4,25,0.797550407,13639,4,0,25
22367,2014/03/31,2012/09/19,224,16,0.63933349,17014,224,11,5
22368,2014/03/31,2012/03/12,58,15,0.8424086120000001,12912,58,9,6
22369,2014/03/31,2007/06/24,134,10,0.962775958,11297,134,7,3
22370,2014/03/31,2006/08/19,18,13,0.595281336,18270,18,7,6
22371,2014/03/31,2012/11/16,76,16,0.673957985,16137,76,4,12
22372,2014/03/31,2011/05/29,100,10,0.817684211,13300,100,1,9
22373,2014/03/31,2013/01/01,14,8,0.7382141640000001,14727,14,0,8
22374,2014/03/31,2007/12/11,162,9,0.8859674000000001,12270,162,8,1
22375,2014/03/31,2006/12/24,139,9,0.681790755,15943,139,3,6
22376,2014/03/31,2011/01/14,179,6,0.6512991370000001,16688,179,3,3
22377,2014/03/31,2011/12/29,7,8,0.700757576,15510,7,5,3
22378,2014/03/31,2010/03/31,25,10,0.880477155,12344,25,5,5
22379,2014/03/31,2008/10/19,18,15,0.75005245,14490,18,9,6
22380,2014/03/31,2010/02/11,337,16,0.659903455,16469,337,15,1
22381,2014/03/31,2013/03/13,135,7,0.74,14686,135,1,6
22382,2014/03/31,2005/11/26,239,10,0.55683253,19514,239,6,4
22383,2014/03/31,2007/04/04,140,11,0.736166667,14760,140,3,8
22384,2014/03/31,2010/02/21,59,11,0.760304387,14291,59,9,2
22385,2014/03/31,2011/12/22,158,8,0.558077456,19469,158,6,2
22386,2014/03/31,2007/01/22,200,17,0.515521496,21074,200,14,3
22387,2014/03/31,2011/10/26,219,7,0.704800182,15414,219,3,4
22388,2014/03/31,2011/08/24,19,18,0.7053369690000001,15402,19,7,11
22389,2014/03/31,2012/06/06,41,28,0.8511549009999999,12763,41,12,16
22390,2014/03/31,2011/01/14,17,28,0.6762703109999999,16063,17,7,21
22391,2014/03/31,2009/03/14,20,14,0.454793568,23882,20,5,9
22392,2014/03/31,2013/02/23,91,14,0.6898469159999999,15743,91,5,9
22393,2014/03/31,2011/03/26,48,13,0.703428979,15439,48,8,5
22394,2014/03/31,2012/07/24,99,13,0.650740608,16689,99,4,9
22395,2014/03/31,2007/02/17,10,12,0.788474552,13773,10,5,7
22396,2014/03/31,2006/11/01,44,11,0.491621622,22089,44,4,7
22397,2014/03/31,2013/03/13,11,13,0.607539443,17874,11,0,13
22398,2014/03/31,2011/01/30,168,8,0.73910972,14692,168,2,6
22399,2014/03/31,2009/07/15,127,14,0.615653702,17638,127,7,7
22400,2014/03/31,2009/04/11,410,6,0.918629442,11820,410,6,0
22401,2014/03/31,2009/05/21,43,10,0.552,19670,43,3,7
22402,2014/03/31,2010/05/18,105,16,0.729536993,14881,105,13,3
22403,2014/03/31,2006/04/06,63,11,0.698226138,15548,63,2,9
22404,2014/03/31,2011/10/17,131,6,0.657688719,16506,131,4,2
22405,2014/03/31,2006/05/10,9,10,0.7252205,14966,9,3,7
22406,2014/03/31,2007/04/08,253,6,0.987049836,10996,253,5,1
22407,2014/03/31,2006/11/23,76,8,0.854643673,12699,76,2,6
22408,2014/03/31,2010/11/01,3,9,0.797903095,13601,3,5,4
22409,2014/03/31,2011/03/23,226,12,0.834244311,13008,226,10,2
22410,2014/03/31,2008/05/29,183,9,0.826713905,13125,183,7,2
22411,2014/03/31,2011/09/20,34,17,0.798000294,13597,34,9,8
22412,2014/03/31,2010/05/22,60,13,0.733337389,14793,60,9,4
22413,2014/03/31,2012/10/06,205,8,0.50750269,21375,205,4,4
22414,2014/03/31,2010/09/16,4,17,0.6971132959999999,15561,4,8,9
22415,2014/03/31,2010/10/27,198,9,0.745999587,14541,198,6,3
22416,2014/03/31,2008/04/09,429,22,0.918181818,11814,429,22,0
22417,2014/03/31,2006/06/10,132,16,0.64292988,16871,132,11,5
22418,2014/03/31,2010/01/05,31,19,0.728124455,14897,31,12,7
22419,2014/03/31,2007/01/01,103,13,0.624852238,17359,103,5,8
22420,2014/03/31,2013/03/15,12,4,0.815723526,13296,12,0,4
22421,2014/03/31,2012/10/16,123,2,0.715,15168,123,1,1
22422,2014/03/31,2011/07/15,344,16,0.775573911,13983,344,15,1
22423,2014/03/31,2009/02/11,192,10,0.862785424,12569,192,6,4
22424,2014/03/31,2005/12/20,4,8,0.798079923,13588,4,0,8
22425,2014/03/31,2012/05/29,165,12,0.813081884,13336,165,9,3
22426,2014/03/31,2008/09/05,287,3,0.935219079,11594,287,2,1
22427,2014/03/31,2006/04/05,109,7,0.7548510159999999,14364,109,4,3
22428,2014/03/31,2011/09/05,81,5,1.195549675,9069,81,1,4
22429,2014/03/31,2012/05/15,24,14,0.916252007,11833,24,7,7
22430,2014/03/31,2008/04/02,65,12,0.770683111,14068,65,0,12
22431,2014/03/31,2010/12/20,5,16,0.711973995,15228,5,8,8
22432,2014/03/31,2011/06/02,106,16,0.8748301190000001,12391,106,7,9
22433,2014/03/31,2012/02/11,90,7,0.789757377,13725,90,2,5
22434,2014/03/31,2009/04/25,153,9,0.684515946,15835,153,7,2
22435,2014/03/31,2008/03/18,48,9,0.936588611,11573,48,4,5
22436,2014/03/31,2012/03/13,295,10,0.946456514,11452,295,6,4
22437,2014/03/31,2012/11/26,22,11,0.574261948,18874,22,2,9
22438,2014/03/31,2010/08/27,29,13,0.5752877160000001,18838,29,6,7
22439,2014/03/31,2008/07/19,45,10,0.802188171,13509,45,3,7
22440,2014/03/31,2012/10/14,38,16,0.533510905,20311,38,8,8
22441,2014/03/31,2006/10/06,17,11,0.6874906409999999,15761,17,6,5
22442,2014/03/31,2013/03/02,23,23,1.100656237,9844,23,0,23
22443,2014/03/31,2012/04/27,26,18,0.701390561,15447,26,7,11
22444,2014/03/31,2010/06/01,150,11,0.638327834,16972,150,6,5
22445,2014/03/31,2013/02/27,9,14,0.535239389,20239,9,1,13
22446,2014/03/31,2011/12/08,131,13,0.625980352,17305,131,8,5
22447,2014/03/31,2012/05/31,28,12,0.8606109479999999,12587,28,9,3
22448,2014/03/31,2006/03/02,313,5,1.0,10832,313,3,2
22449,2014/03/31,2006/05/30,30,16,0.817285898,13253,30,9,7
22450,2014/03/31,2012/02/18,21,14,0.586137237,18479,21,7,7
22451,2014/03/31,2011/07/01,284,17,0.93008158,11645,284,11,6
22452,2014/03/31,2012/05/17,306,10,0.6364980020000001,17016,306,7,3
22453,2014/03/31,2006/06/04,5,17,0.545798307,19842,5,7,10
22454,2014/03/31,2012/05/29,4,11,0.771610375,14034,4,1,10
22455,2014/03/31,2010/08/20,21,11,0.791785009,13675,21,0,11
22456,2014/03/31,2012/10/14,14,8,1.258319386,8604,14,3,5
22457,2014/03/31,2009/09/29,80,12,0.885981668,12219,80,11,1
22458,2014/03/31,2009/07/30,340,10,0.8200242440000001,13199,340,9,1
22459,2014/03/31,2008/03/14,25,10,0.8794661140000001,12306,25,3,7
22460,2014/03/31,2011/03/09,229,9,0.818279147,13226,229,7,2
22461,2014/03/31,2012/12/21,139,21,0.773809524,13986,139,5,16
22462,2014/03/31,2008/09/20,118,5,0.975567977,11092,118,3,2
22463,2014/03/31,2012/01/06,360,10,0.700822539,15440,360,9,1
22464,2014/03/31,2010/04/18,7,13,0.7315712259999999,14791,7,5,8
22465,2014/03/31,2013/03/21,223,7,0.665714286,16254,223,2,5
22466,2014/03/31,2010/03/26,529,4,0.8375,12920,529,4,0
22467,2014/03/31,2010/04/10,135,12,0.662006364,16343,135,2,10
22468,2014/03/31,2006/08/11,422,9,0.761183424,14213,422,9,0
22469,2014/03/31,2012/11/20,312,10,0.929284426,11641,312,8,2
22470,2014/03/31,2007/05/08,203,2,1.41,7672,203,0,2
22471,2014/03/31,2011/10/10,7,11,0.7374984659999999,14667,7,5,6
22472,2014/03/31,2008/11/25,2,12,0.7219368620000001,14983,2,10,2
22473,2014/03/31,2010/12/08,5,14,0.6467745020000001,16723,5,9,5
22474,2014/03/31,2012/04/10,284,10,0.70816539,15273,284,9,1
22475,2014/03/31,2007/02/11,275,15,0.75565989,14313,275,14,1
22476,2014/03/31,2012/01/09,48,8,0.5810998279999999,18612,48,4,4
22477,2014/03/31,2009/04/28,45,12,0.6651260760000001,16260,45,7,5
22478,2014/03/31,2006/04/19,49,11,0.544085832,19876,49,6,5
22479,2014/03/31,2011/04/30,96,13,0.541538462,19968,96,7,6
22480,2014/03/31,2010/06/01,17,11,0.782320938,13822,17,7,4
22481,2014/03/31,2011/10/16,4,8,0.498719675,21682,4,6,2
22482,2014/03/31,2011/01/09,48,11,0.762085418,14189,48,4,7
22483,2014/03/31,2009/11/04,137,15,0.579169791,18670,137,8,7
22484,2014/03/31,2008/02/21,128,15,0.66753735,16198,128,9,6
22485,2014/03/31,2007/04/11,237,12,0.679574508,15911,237,11,1
22486,2014/03/31,2005/10/31,26,15,0.655216943,16502,26,2,13
22487,2014/03/31,2011/06/14,64,12,0.631765531,17111,64,1,11
22488,2014/03/31,2008/03/29,312,14,0.599855724,18021,312,13,1
22489,2014/03/31,2011/02/25,10,12,0.7202205340000001,15009,10,3,9
22490,2014/03/31,2012/01/28,425,4,1.5,7206,425,4,0
22491,2014/03/31,2012/07/31,14,14,0.550208715,19644,14,1,13
22492,2014/03/31,2005/02/20,146,15,0.680401637,15885,146,7,8
22493,2014/03/31,2012/10/23,202,14,0.703825215,15356,202,10,4
22494,2014/03/31,2012/05/09,21,11,0.577272727,18722,21,4,7
22495,2014/03/31,2012/10/24,8,7,0.772831808,13984,8,1,6
22496,2014/03/31,2012/04/03,231,7,0.7768293559999999,13912,231,5,2
22497,2014/03/31,2013/02/04,31,13,0.7379888000000001,14643,31,3,10
22498,2014/03/31,2006/08/12,285,8,1.041050096,10380,285,5,3
22499,2014/03/31,2012/05/20,359,7,0.760272286,14213,359,6,1
22500,2014/03/31,2012/03/31,15,12,0.620056235,17427,15,5,7
22501,2014/03/31,2012/08/23,17,16,0.555306573,19457,17,8,8
22502,2014/03/31,2012/04/14,211,9,0.594857678,18163,211,3,6
22503,2014/03/31,2008/12/28,271,3,0.6545211120000001,16507,271,2,1
22504,2014/03/31,2011/03/18,73,14,0.622498271,17356,73,9,5
22505,2014/03/31,2008/11/20,18,12,0.681971973,15842,18,8,4
22506,2014/03/31,2007/05/23,85,3,0.630484972,17135,85,0,3
22507,2014/03/31,2012/05/25,480,11,0.818623068,13196,480,11,0
22508,2014/03/31,2005/10/20,20,19,0.579305518,18647,20,6,13
22509,2014/03/31,2008/06/05,32,7,1.12260237,9622,32,4,3
22510,2014/03/31,2010/12/04,249,12,0.750873192,14384,249,10,2
22511,2014/03/31,2011/07/28,223,14,0.910890613,11857,223,12,2
22512,2014/03/31,2009/03/05,29,7,1.02521929,10534,29,1,6
22513,2014/03/31,2013/03/02,46,10,0.7256161809999999,14882,46,0,10
22514,2014/03/31,2006/05/23,232,8,0.681452101,15846,232,4,4
22515,2014/03/31,2012/01/01,21,13,0.64821107,16658,21,2,11
22516,2014/03/31,2009/05/12,370,14,0.874734667,12343,370,14,0
22517,2014/03/31,2013/03/23,112,7,0.614916557,17557,112,0,7
22518,2014/03/31,2010/08/27,171,21,0.8194929409999999,13174,171,19,2
22519,2014/03/31,2009/02/17,69,12,0.781466522,13815,69,5,7
22520,2014/03/31,2011/01/29,28,13,0.5610310239999999,19243,28,5,8
22521,2014/03/31,2006/08/31,17,13,0.845661914,12766,17,5,8
22522,2014/03/31,2011/10/20,317,9,0.539858479,19997,317,7,2
22523,2014/03/31,2005/05/06,14,14,0.579837791,18618,14,7,7
22524,2014/03/31,2009/08/22,41,9,0.972069338,11105,41,5,4
22525,2014/03/31,2004/11/23,9,10,0.63276804,17059,9,4,6
22526,2014/03/31,2006/07/26,52,7,0.818171,13193,52,3,4
22527,2014/03/31,2007/12/02,1,28,0.6522194689999999,16549,1,11,17
22528,2014/03/31,2006/04/28,46,8,0.715815095,15078,46,5,3
22529,2014/03/31,2012/10/14,34,14,0.785889463,13733,34,6,8
22530,2014/03/31,2009/04/16,1,6,0.829235498,13015,1,4,2
22531,2014/03/31,2013/02/02,65,24,0.767875338,14054,65,2,22
22532,2014/03/31,2012/05/24,131,17,0.704501893,15318,131,10,7
22533,2014/03/31,2011/04/11,3,13,0.740822407,14567,3,6,7
22534,2014/03/31,2006/04/29,70,10,0.744081225,14503,70,6,4
22535,2014/03/31,2006/04/07,84,9,0.522270571,20660,84,6,3
22536,2014/03/31,2011/04/21,83,15,0.469070081,23002,83,13,2
22537,2014/03/31,2007/12/02,262,10,0.644409604,16743,262,9,1
22538,2014/03/31,2009/01/24,412,8,0.973934826,11078,412,8,0
22539,2014/03/31,2005/10/20,10,12,0.635220796,16984,10,0,12
22540,2014/03/31,2008/02/25,108,13,0.571814279,18867,108,7,6
22541,2014/03/31,2012/12/05,30,14,0.6869842079999999,15704,30,12,2
22542,2014/03/31,2012/09/12,71,6,0.965397763,11175,71,4,2
22543,2014/03/31,2008/03/08,133,14,0.6406574420000001,16838,133,11,3
22544,2014/03/31,2008/06/14,118,12,0.710392493,15185,118,1,11
22545,2014/03/31,2007/11/21,390,12,0.7243569940000001,14891,390,12,0
22546,2014/03/31,2009/03/23,106,18,0.6326835989999999,17048,106,16,2
22547,2014/03/31,2011/05/12,17,13,0.62543056,17245,17,5,8
22548,2014/03/31,2007/09/13,29,14,0.757135837,14245,29,5,9
22549,2014/03/31,2012/09/15,190,10,0.8015436640000001,13455,190,5,5
22550,2014/03/31,2006/12/17,112,12,0.750261583,14374,112,6,6
22551,2014/03/31,2009/04/11,64,21,0.912670334,11815,64,12,9
22552,2014/03/31,2010/07/22,612,9,0.622119656,17333,612,9,0
22553,2014/03/31,2008/08/19,117,8,0.8154212040000001,13224,117,2,6
22554,2014/03/31,2009/08/19,76,9,0.762532353,14141,76,2,7
22555,2014/03/31,2010/02/01,40,11,0.664696092,16222,40,2,9
22556,2014/03/31,2011/01/13,46,15,0.8448879490000001,12762,46,8,7
22557,2014/03/31,2008/07/16,18,17,0.8264214,13047,18,3,14
22558,2014/03/31,2009/12/21,29,12,0.701126935,15378,29,6,6
22559,2014/03/31,2012/02/27,148,9,0.774673085,13918,148,5,4
22560,2014/03/31,2011/01/12,7,9,0.742222222,14526,7,8,1
22561,2014/03/31,2011/03/09,30,3,0.8833650140000001,12205,30,0,3
22562,2014/03/31,2012/03/30,16,11,0.8062755220000001,13371,16,2,9
22563,2014/03/31,2011/05/01,4,13,0.641562816,16803,4,4,9
22564,2014/03/31,2008/09/04,20,18,0.736946951,14628,20,6,12
22565,2014/03/31,2009/12/15,93,9,0.6156833629999999,17509,93,5,4
22566,2014/03/31,2011/06/25,173,15,0.5867944039999999,18371,173,10,5
22567,2014/03/31,2010/08/10,125,13,0.719274705,14987,125,5,8
22568,2014/03/31,2012/12/25,37,8,0.6814856490000001,15818,37,4,4
22569,2014/03/31,2008/11/03,70,10,0.642992723,16764,70,2,8
22570,2014/03/31,2008/03/03,62,10,0.5810723529999999,18548,62,5,5
22571,2014/03/31,2012/03/15,22,9,1.058212883,10184,22,1,8
22572,2014/03/31,2012/02/20,214,6,0.841666667,12804,214,4,2
22573,2014/03/31,2010/02/11,169,16,0.829796688,12985,169,9,7
22574,2014/03/31,2013/01/10,427,5,0.8352895570000001,12899,427,5,0
22575,2014/03/31,2012/06/16,101,7,0.929785123,11588,101,6,1
22576,2014/03/31,2012/07/06,345,12,0.6968695429999999,15461,345,11,1
22577,2014/03/31,2011/01/28,3,13,0.6999006109999999,15394,3,8,5
22578,2014/03/31,2007/12/10,26,15,0.907676495,11870,26,6,9
22579,2014/03/31,2010/02/23,73,10,0.7464350059999999,14432,73,7,3
22580,2014/03/31,2007/04/25,249,10,0.736662791,14623,249,8,2
22581,2014/03/31,2010/07/25,230,5,0.843340119,12772,230,3,2
22582,2014/03/31,2006/07/01,111,7,0.773009402,13933,111,5,2
22583,2014/03/31,2010/07/29,18,16,0.665539831,16181,18,7,9
22584,2014/03/31,2013/01/31,60,18,0.517516459,20809,60,7,11
22585,2014/03/31,2012/07/13,20,8,0.7970414509999999,13510,20,2,6
22586,2014/03/31,2012/06/14,3,13,0.491836203,21893,3,8,5
22587,2014/03/31,2013/01/01,16,8,0.6648295879999999,16196,16,1,7
22588,2014/03/31,2005/11/27,33,12,0.846474057,12720,33,8,4
22589,2014/03/31,2012/04/07,4,12,0.7093826590000001,15178,4,10,2
22590,2014/03/31,2011/11/18,157,15,0.741745212,14514,157,12,3
22591,2014/03/31,2008/09/28,81,6,1.323334972,8135,81,0,6
22592,2014/03/31,2008/01/07,1,10,0.738763382,14572,1,0,10
22593,2014/03/31,2010/09/25,85,11,0.794397461,13551,85,5,6
22594,2014/03/31,2010/08/09,11,12,0.927595002,11605,11,3,9
22595,2014/03/31,2012/06/26,1,28,0.581591118,18509,1,1,27
22596,2014/03/31,2010/09/26,55,7,0.714743028,15060,55,3,4
22597,2014/03/31,2007/04/30,212,8,0.904787323,11896,212,3,5
22598,2014/03/31,2011/12/22,86,5,0.588,18305,86,3,2
22599,2014/03/31,2008/04/04,70,11,0.749045863,14369,70,3,8
22600,2014/03/31,2012/07/30,6,7,1.289468009,8346,6,1,6
22601,2014/03/31,2009/03/04,9,11,0.624382616,17234,9,6,5
22602,2014/03/31,2013/02/16,45,6,0.758429659,14188,45,2,4
22603,2014/03/31,2008/10/18,66,11,0.645574754,16668,66,4,7
22604,2014/03/31,2013/01/31,22,8,0.665441277,16169,22,0,8
22605,2014/03/31,2006/03/26,46,8,0.7198059809999999,14947,46,4,4
22606,2014/03/31,2008/05/17,181,11,0.667990811,16106,181,8,3
22607,2014/03/31,2009/04/21,119,8,0.750634245,14332,119,6,2
22608,2014/03/31,2007/01/14,207,10,0.7390169679999999,14557,207,6,4
22609,2014/03/31,2010/08/17,164,3,1.337502176,8043,164,1,2
22610,2014/03/31,2011/11/27,4,16,0.708987675,15173,4,11,5
22611,2014/03/31,2010/06/04,211,14,0.595683039,18059,211,13,1
22612,2014/03/31,2008/01/13,59,11,0.857686174,12542,59,5,6
22613,2014/03/31,2012/11/02,54,11,0.472706099,22756,54,2,9
22614,2014/03/31,2012/04/28,4,11,0.7334119729999999,14666,4,2,9
22615,2014/03/31,2005/10/25,34,14,0.564629921,19050,34,1,13
22616,2014/03/31,2005/11/28,58,12,0.810924306,13264,58,4,8
22617,2014/03/31,2005/05/21,3,17,0.555880924,19349,3,7,10
22618,2014/03/31,2006/05/19,118,9,0.780625635,13778,118,4,5
22619,2014/03/31,2012/05/21,94,18,0.5,21510,94,10,8
22620,2014/03/31,2011/04/05,513,5,1.201675978,8950,513,5,0
22621,2014/03/31,2012/12/02,480,3,1.152255438,9333,480,3,0
22622,2014/03/31,2009/07/19,23,9,0.577465091,18620,23,1,8
22623,2014/03/31,2008/02/24,46,15,0.604759548,17779,46,5,10
22624,2014/03/31,2011/04/11,44,10,0.81024416,13270,44,5,5
22625,2014/03/31,2012/08/27,68,12,0.851627723,12625,68,7,5
22626,2014/03/31,2009/08/01,113,14,0.565375191,19017,113,7,7
22627,2014/03/31,2013/01/23,181,12,0.534004172,20134,181,0,12
22628,2014/03/31,2006/01/27,59,9,0.762989852,14091,59,3,6
22629,2014/03/31,2011/01/03,173,12,0.682663661,15749,173,7,5
22630,2014/03/31,2010/10/24,62,13,0.531065501,20244,62,6,7
22631,2014/03/31,2009/07/12,84,16,0.721507585,14898,84,2,14
22632,2014/03/31,2012/12/27,397,4,0.7875,13648,397,4,0
22633,2014/03/31,2011/06/29,78,17,0.623634887,17233,78,6,11
22634,2014/03/31,2012/05/20,65,16,0.942137472,11406,65,11,5
22635,2014/03/31,2011/03/30,48,10,0.749249059,14342,48,7,3
22636,2014/03/31,2010/03/17,43,8,0.796637752,13488,43,5,3
22637,2014/03/31,2011/09/28,44,16,0.565194655,19008,44,7,9
22638,2014/03/31,2010/05/14,61,8,0.598153675,17960,61,1,7
22639,2014/03/31,2011/11/24,332,9,0.583641204,18406,332,5,4
22640,2014/03/31,2011/01/14,17,12,0.55354084,19405,17,0,12
22641,2014/03/31,2007/04/09,134,9,0.7536577320000001,14252,134,5,4
22642,2014/03/31,2011/01/07,414,3,0.933333333,11508,414,3,0
22643,2014/03/31,2008/05/11,72,15,0.642545465,16716,72,10,5
22644,2014/03/31,2011/11/20,208,11,0.742538025,14464,208,4,7
22645,2014/03/31,2008/08/07,63,10,0.64612418,16621,63,6,4
22646,2014/03/31,2011/08/24,25,9,0.638575251,16817,25,4,5
22647,2014/03/31,2006/04/28,62,3,0.48286119,22239,62,0,3
22648,2014/03/31,2012/08/01,9,15,0.5758849079999999,18646,9,4,11
22649,2014/03/31,2008/03/11,22,12,0.759661101,14134,22,6,6
22650,2014/03/31,2013/02/28,379,4,1.128547404,9514,379,4,0
22651,2014/03/31,2013/01/01,12,7,0.589267248,18219,12,1,6
22652,2014/03/31,2006/11/25,11,7,1.136539276,9446,11,1,6
22653,2014/03/31,2010/07/08,27,5,0.752808555,14260,27,0,5
22654,2014/03/31,2011/04/11,34,9,0.635457936,16891,34,2,7
22655,2014/03/31,2012/03/22,185,12,0.668696654,16051,185,11,1
22656,2014/03/31,2006/01/25,21,10,0.715196588,15006,21,0,10
22657,2014/03/31,2007/09/28,199,7,0.782147803,13721,199,5,2
22658,2014/03/31,2008/05/21,29,12,0.645051391,16637,29,3,9
22659,2014/03/31,2011/11/11,10,7,0.6472172970000001,16581,10,5,2
22660,2014/03/31,2011/08/11,116,12,0.72389436,14824,116,6,6
22661,2014/03/31,2012/03/19,19,9,0.820446586,13077,19,4,5
22662,2014/03/31,2012/12/12,120,13,0.600003356,17880,120,1,12
22663,2014/03/31,2006/05/26,24,10,0.7820944809999999,13717,24,7,3
22664,2014/03/31,2012/05/16,143,10,0.770942149,13915,143,5,5
22665,2014/03/31,2011/10/18,326,6,0.6333333329999999,16932,326,5,1
22666,2014/03/31,2010/05/27,46,18,0.711592674,15069,46,7,11
22667,2014/03/31,2012/03/31,468,12,0.84589776,12676,468,12,0
22668,2014/03/31,2011/04/11,147,9,1.011732402,10598,147,2,7
22669,2014/03/31,2005/12/20,381,12,0.718773882,14917,381,12,0
22670,2014/03/31,2006/05/26,137,13,0.823667512,13017,137,8,5
22671,2014/03/31,2009/12/24,209,15,0.805001502,13318,209,13,2
22672,2014/03/31,2010/04/12,104,11,0.681276055,15736,104,5,6
22673,2014/03/31,2006/10/18,120,12,0.9575,11196,120,6,6
22674,2014/03/31,2007/10/01,647,7,0.7785714290000001,13769,647,7,0
22675,2014/03/31,2006/12/04,216,14,0.521652149,20549,216,8,6
22676,2014/03/31,2012/09/21,91,10,0.683632015,15680,91,4,6
22677,2014/03/31,2006/07/02,117,7,0.935603561,11457,117,6,1
22678,2014/03/31,2006/05/03,329,12,0.692649435,15475,329,10,2
22679,2014/03/31,2006/04/12,275,17,0.6882765040000001,15573,275,7,10
22680,2014/03/31,2012/10/16,131,13,0.6055961129999999,17698,131,7,6
22681,2014/03/31,2010/05/05,84,13,0.759677488,14108,84,10,3
22682,2014/03/31,2008/12/14,464,3,0.6987482070000001,15338,464,3,0
22683,2014/03/31,2011/07/28,38,17,0.64234596,16684,38,11,6
22684,2014/03/31,2008/10/25,44,6,0.775109215,13826,44,4,2
22685,2014/03/31,2007/02/22,64,13,0.596174131,17975,64,3,10
22686,2014/03/31,2012/04/23,32,7,0.798602623,13418,32,3,4
22687,2014/03/31,2013/03/03,17,14,0.564601602,18976,17,2,12
22688,2014/03/31,2011/06/01,126,13,0.766973081,13968,126,10,3
22689,2014/03/31,2005/03/24,61,10,0.977372503,10961,61,6,4
22690,2014/03/31,2009/08/13,36,16,0.6478108370000001,16536,36,12,4
22691,2014/03/31,2010/02/05,19,9,0.710660121,15073,19,5,4
22692,2014/03/31,2007/04/24,54,9,0.72706625,14732,54,6,3
22693,2014/03/31,2011/02/17,264,14,0.675512109,15856,264,13,1
22694,2014/03/31,2006/06/03,139,8,0.909304695,11779,139,3,5
22695,2014/03/31,2011/08/10,343,9,0.781720312,13701,343,7,2
22696,2014/03/31,2009/08/09,213,10,0.7048351429999999,15195,213,4,6
22697,2014/03/31,2007/09/11,20,15,0.89018951,12031,20,7,8
22698,2014/03/31,2011/01/21,102,13,0.528188499,20276,102,8,5
22699,2014/03/31,2009/07/01,128,15,0.757413537,14139,128,7,8
22700,2014/03/31,2012/02/26,15,15,0.5786210620000001,18507,15,6,9
22701,2014/03/31,2007/07/04,15,12,0.851631273,12573,15,2,10
22702,2014/03/31,2013/01/11,15,13,0.6889389359999999,15541,15,3,10
22703,2014/03/31,2012/04/18,116,8,0.945725643,11321,116,6,2
22704,2014/03/31,2013/02/15,40,11,0.7242136240000001,14783,40,1,10
22705,2014/03/31,2009/12/11,345,8,0.651055096,16444,345,4,4
22706,2014/03/31,2011/10/07,109,8,0.699860103,15297,109,4,4
22707,2014/03/31,2007/08/06,128,13,0.691424881,15482,128,3,10
22708,2014/03/31,2007/04/12,116,8,0.669014375,16000,116,3,5
22709,2014/03/31,2011/12/29,15,11,0.7099078129999999,15078,15,7,4
22710,2014/03/31,2007/07/14,56,10,0.8815359909999999,12142,56,6,4
22711,2014/03/31,2009/10/15,5,11,0.588086264,18200,5,5,6
22712,2014/03/31,2007/06/28,157,25,0.797243948,13425,157,22,3
22713,2014/03/31,2006/01/01,17,10,0.7895485059999999,13555,17,6,4
22714,2014/03/31,2012/09/17,62,13,0.5831691370000001,18352,62,8,5
22715,2014/03/31,2008/05/29,197,9,0.539798698,19821,197,6,3
22716,2014/03/31,2012/08/03,8,16,0.619886436,17259,8,4,12
22717,2014/03/31,2006/09/23,27,27,0.722994052,14796,27,0,27
22718,2014/03/31,2011/05/21,12,10,0.614154897,17418,12,3,7
22719,2014/03/31,2008/07/01,13,13,0.831501866,12864,13,8,5
22720,2014/03/31,2009/03/06,177,6,1.002447985,10670,177,3,3
22721,2014/03/31,2011/03/02,304,7,0.767346295,13939,304,6,1
22722,2014/03/31,2008/07/10,237,11,0.720462171,14843,237,8,3
22723,2014/03/31,2005/06/08,17,13,0.689068059,15516,17,11,2
22724,2014/03/31,2008/04/15,32,8,0.824512995,12967,32,2,6
22725,2014/03/31,2006/01/13,94,8,0.765910165,13959,94,3,5
22726,2014/03/31,2008/10/10,24,7,0.8687510159999999,12306,24,2,5
22727,2014/03/31,2010/08/23,154,9,0.695822052,15364,154,6,3
22728,2014/03/31,2012/07/20,422,7,1.04486365,10231,422,7,0
22729,2014/03/31,2012/04/17,9,9,0.8596638520000001,12435,9,4,5
22730,2014/03/31,2011/07/18,27,12,0.677510458,15778,27,6,6
22731,2014/03/31,2010/08/12,9,10,0.813256999,13144,9,0,10
22732,2014/03/31,2005/08/03,81,13,0.591720454,18065,81,8,5
22733,2014/03/31,2006/10/02,121,10,0.820166513,13032,121,7,3
22734,2014/03/31,2006/07/01,596,2,0.824722222,12960,596,2,0
22735,2014/03/31,2010/09/23,15,13,0.513634529,20806,15,5,8
22736,2014/03/31,2012/03/08,223,11,0.792239027,13488,223,8,3
22737,2014/03/31,2013/02/25,3,9,0.808118288,13222,3,0,9
22738,2014/03/31,2011/05/06,20,12,0.916759331,11655,20,3,9
22739,2014/03/31,2012/05/28,75,11,0.72755159,14683,75,8,3
22740,2014/03/31,2006/06/26,56,13,0.7700324390000001,13872,56,10,3
22741,2014/03/31,2008/07/20,26,13,0.64585646,16539,26,6,7
22742,2014/03/31,2011/02/08,262,10,0.66444479,16075,262,9,1
22743,2014/03/31,2006/04/23,116,17,0.6805072329999999,15693,116,8,9
22744,2014/03/31,2013/03/06,178,11,0.6858599870000001,15570,178,2,9
22745,2014/03/31,2011/07/31,8,7,0.760197907,14047,8,0,7
22746,2014/03/31,2006/12/07,9,13,0.755079904,14142,9,0,13
22747,2014/03/31,2008/12/14,105,8,0.720117346,14828,105,1,7
22748,2014/03/31,2006/01/06,210,3,0.861463493,12395,210,2,1
22749,2014/03/31,2006/08/15,31,18,0.473901909,22530,31,12,6
22750,2014/03/31,2012/11/04,240,16,0.8770174140000001,12174,240,10,6
22751,2014/03/31,2010/12/18,48,11,1.019825198,10469,48,8,3
22752,2014/03/31,2012/08/21,3,17,0.7326000140000001,14573,3,9,8
22753,2014/03/31,2008/01/13,102,8,0.6425,16616,102,3,5
22754,2014/03/31,2011/12/15,140,8,0.701578048,15215,140,3,5
22755,2014/03/31,2012/02/26,332,6,0.644864979,16553,332,5,1
22756,2014/03/31,2011/09/12,60,18,0.60961846,17508,60,5,13
22757,2014/03/31,2010/07/20,38,8,0.8621770740000001,12379,38,3,5
22758,2014/03/31,2012/10/14,146,12,0.81327288,13123,146,4,8
22759,2014/03/31,2011/11/26,352,10,0.511527585,20863,352,9,1
22760,2014/03/31,2007/10/11,344,8,0.6774314370000001,15752,344,6,2
22761,2014/03/31,2012/07/03,186,11,0.704773448,15140,186,9,2
22762,2014/03/31,2010/12/05,127,7,0.6303184070000001,16928,127,5,2
22763,2014/03/31,2006/04/24,75,10,0.849253422,12564,75,6,4
22764,2014/03/31,2009/10/13,184,7,0.6875813620000001,15517,184,2,5
22765,2014/03/31,2012/08/02,30,11,0.8307264659999999,12843,30,4,7
22766,2014/03/31,2011/09/05,22,12,0.688626945,15491,22,0,12
22767,2014/03/31,2007/03/22,77,8,0.6893285509999999,15474,77,0,8
22768,2014/03/31,2011/12/12,135,11,0.67982663,15689,135,6,5
22769,2014/03/31,2007/07/25,19,16,0.573520998,18597,19,7,9
22770,2014/03/31,2008/01/10,196,9,0.841401073,12676,196,5,4
22771,2014/03/31,2005/08/06,224,10,0.67755797,15741,224,4,6
22772,2014/03/31,2009/02/13,41,17,0.4418598,24137,41,8,9
22773,2014/03/31,2012/06/16,512,9,0.517145905,20623,512,9,0
22774,2014/03/31,2012/08/10,255,15,0.765333333,13935,255,9,6
22775,2014/03/31,2010/11/18,77,17,0.6780747709999999,15728,77,8,9
22776,2014/03/31,2005/11/17,77,20,0.6886259440000001,15487,77,13,7
22777,2014/03/31,2012/05/14,204,8,0.708691434,15047,204,6,2
22778,2014/03/31,2010/02/09,31,9,0.929458729,11473,31,2,7
22779,2014/03/31,2006/07/04,11,13,0.577783377,18456,11,7,6
22780,2014/03/31,2011/01/17,13,13,0.624040499,17087,13,0,13
22781,2014/03/31,2009/12/25,184,7,0.774844125,13761,184,2,5
22782,2014/03/31,2007/09/15,225,8,0.83314058,12797,225,6,2
22783,2014/03/31,2006/03/07,60,9,0.6022222220000001,17703,60,5,4
22784,2014/03/31,2013/03/16,334,2,0.7,15230,334,1,1
22785,2014/03/31,2010/02/04,80,14,0.57304682,18603,80,9,5
22786,2014/03/31,2011/06/29,123,19,0.705263332,15114,123,10,9
22787,2014/03/31,2010/10/22,16,7,0.472452462,22561,16,0,7
22788,2014/03/31,2010/05/31,418,4,0.825,12920,418,4,0
22789,2014/03/31,2012/05/29,145,10,0.62570917,17034,145,6,4
22790,2014/03/31,2012/03/09,52,11,0.687145896,15511,52,4,7
22791,2014/03/31,2011/12/13,49,5,0.831424782,12816,49,0,5
22792,2014/03/31,2011/04/01,65,13,0.585668664,18193,65,5,8
22793,2014/03/31,2012/11/13,57,9,0.747638762,14251,57,5,4
22794,2014/03/31,2012/08/16,255,10,0.626,17020,255,5,5
22795,2014/03/31,2013/03/28,166,4,0.524931021,20296,166,1,3
22796,2014/03/31,2006/08/08,179,12,0.630982645,16883,179,9,3
22797,2014/03/31,2012/11/06,65,14,0.531429355,20044,65,5,9
22798,2014/03/31,2008/08/26,3,16,0.662348735,16081,3,0,16
22799,2014/03/31,2007/11/01,34,10,0.691367,15406,34,2,8
22800,2014/03/31,2008/11/21,74,13,0.5995895960000001,17763,74,8,5
22801,2014/03/31,2012/09/20,8,10,0.585607302,18187,8,2,8
22802,2014/03/31,2007/12/26,144,13,0.90302018,11794,144,8,5
22803,2014/03/31,2008/12/31,23,18,0.748087946,14236,23,5,13
22804,2014/03/31,2009/03/19,156,7,0.6236919470000001,17075,156,0,7
22805,2014/03/31,2009/01/02,82,12,0.7497458459999999,14204,82,6,6
22806,2014/03/31,2012/12/05,228,4,0.959048991,11104,228,2,2
22807,2014/03/31,2008/07/10,6,18,0.8456316999999999,12593,6,11,7
22808,2014/03/31,2013/02/15,15,13,0.6733617909999999,15813,15,3,10
22809,2014/03/31,2012/08/13,12,12,0.621515381,17131,12,4,8
22810,2014/03/31,2009/10/01,64,13,0.72785602,14627,64,10,3
22811,2014/03/31,2012/10/27,110,6,0.7844661409999999,13571,110,2,4
22812,2014/03/31,2011/07/27,151,10,0.770719612,13813,151,5,5
22813,2014/03/31,2009/12/11,33,13,0.79683009,13360,33,8,5
22814,2014/03/31,2007/12/25,353,2,0.7,15208,353,0,2
22815,2014/03/31,2010/07/14,458,2,0.7,15208,458,2,0
22816,2014/03/31,2012/07/14,607,2,0.7,15208,607,2,0
22817,2014/03/31,2007/12/27,395,2,0.7,15208,395,2,0
22818,2014/03/31,2011/10/28,402,7,0.865799105,12295,402,7,0
22819,2014/03/31,2012/07/08,176,8,0.808772796,13160,176,4,4
22820,2014/03/31,2006/05/11,5,9,0.970830065,10963,5,6,3
22821,2014/03/31,2012/04/21,121,6,1.333001002,7984,121,2,4
22822,2014/03/31,2012/12/10,10,31,0.521107575,20423,10,3,28
22823,2014/03/31,2010/05/20,35,11,0.723215087,14715,35,8,3
22824,2014/03/31,2007/03/19,36,10,0.8167091329999999,13030,36,0,10
22825,2014/03/31,2011/01/04,131,8,0.67625,15736,131,6,2
22826,2014/03/31,2005/03/01,144,6,0.901666667,11802,144,4,2
22827,2014/03/31,2009/12/08,102,9,0.708224958,15025,102,5,4
22828,2014/03/31,2010/03/23,19,11,0.649756961,16376,19,6,5
22829,2014/03/31,2012/02/17,114,7,0.967297273,11000,114,2,5
22830,2014/03/31,2008/04/11,22,14,0.866652277,12277,22,2,12
22831,2014/03/31,2005/06/03,337,2,0.7,15199,337,0,2
22832,2014/03/31,2008/09/23,487,2,0.7,15199,487,2,0
22833,2014/03/31,2010/12/23,708,2,0.7,15199,708,2,0
22834,2014/03/31,2011/07/11,519,2,0.7,15199,519,2,0
22835,2014/03/31,2007/05/19,499,2,0.7,15199,499,2,0
22836,2014/03/31,2009/11/27,616,2,0.7,15199,616,2,0
22837,2014/03/31,2012/05/08,655,2,0.7,15199,655,2,0
22838,2014/03/31,2008/01/26,571,2,0.7,15199,571,2,0
22839,2014/03/31,2009/11/20,370,2,0.7,15199,370,2,0
22840,2014/03/31,2013/01/12,386,2,0.7,15199,386,2,0
22841,2014/03/31,2005/03/03,106,9,0.903925234,11770,106,7,2
22842,2014/03/31,2006/12/01,74,8,0.807889741,13169,74,0,8
22843,2014/03/31,2013/02/15,75,13,0.520223483,20449,75,1,12
22844,2014/03/31,2012/09/09,160,9,0.641054598,16594,160,1,8
22845,2014/03/31,2009/12/01,121,9,0.7321494940000001,14529,121,2,7
22846,2014/03/31,2013/01/15,37,9,0.6874072640000001,15474,37,5,4
22847,2014/03/31,2012/08/10,135,9,0.6713772640000001,15843,135,3,6
22848,2014/03/31,2011/11/28,83,14,0.6939714229999999,15327,83,8,6
22849,2014/03/31,2008/12/28,98,12,0.8445981579999999,12592,98,4,8
22850,2014/03/31,2010/05/09,465,5,0.778137119,13667,465,5,0
22851,2014/03/31,2008/02/20,594,2,0.699694059,15199,594,2,0
22852,2014/03/31,2008/08/18,69,8,0.771391367,13785,69,4,4
22853,2014/03/31,2010/12/29,217,16,0.569039388,18686,217,14,2
22854,2014/03/31,2011/03/09,1,14,0.634158168,16767,1,0,14
22855,2014/03/31,2007/05/01,4,22,0.559675755,18998,4,6,16
22856,2014/03/31,2007/10/16,692,3,0.6647180189999999,15994,692,3,0
22857,2014/03/31,2011/02/11,37,10,0.681518046,15599,37,8,2
22858,2014/03/31,2007/07/23,68,12,0.725446295,14654,68,4,8
22859,2014/03/31,2012/06/13,73,11,0.791231857,13435,73,2,9
22860,2014/03/31,2005/06/09,180,10,0.760801603,13972,180,6,4
22861,2014/03/31,2011/11/22,67,15,0.622672954,17071,67,12,3
22862,2014/03/31,2012/09/07,26,13,0.742725875,14311,26,4,9
22863,2014/03/31,2008/12/01,35,9,0.8397376740000001,12656,35,5,4
22864,2014/03/31,2010/11/11,360,5,0.992537592,10707,360,4,1
22865,2014/03/31,2012/07/13,566,8,0.975383203,10895,566,8,0
22866,2014/03/31,2007/09/14,18,10,0.730761243,14542,18,1,9
22867,2014/03/31,2010/01/30,89,4,0.8225,12920,89,2,2
22868,2014/03/31,2008/03/17,4,10,0.72280302,14702,4,5,5
22869,2014/03/31,2012/08/21,95,11,0.7394655529999999,14370,95,3,8
22870,2014/03/31,2010/05/10,36,12,0.691470033,15367,36,9,3
22871,2014/03/31,2010/06/27,214,10,0.8165434570000001,13013,214,4,6
22872,2014/03/31,2012/07/21,42,12,0.591925348,17950,42,7,5
22873,2014/03/31,2011/06/06,125,14,0.529710326,20057,125,8,6
22874,2014/03/31,2011/08/21,9,14,0.793883575,13382,9,6,8
22875,2014/03/31,2011/09/05,99,10,0.701112724,15152,99,4,6
22876,2014/03/31,2012/03/16,112,15,0.687088157,15461,112,9,6
22877,2014/03/31,2010/08/15,41,14,0.75624119,14047,41,6,8
22878,2014/03/31,2011/05/27,215,17,0.560745355,18944,215,14,3
22879,2014/03/31,2010/12/20,53,8,0.64028692,16590,53,4,4
22880,2014/03/31,2008/01/18,171,12,0.66966839,15862,171,7,5
22881,2014/03/31,2008/11/12,420,13,0.476600709,22287,420,13,0
22882,2014/03/31,2012/05/09,17,8,0.639013356,16622,17,5,3
22883,2014/03/31,2006/11/10,32,10,0.6809199309999999,15599,32,6,4
22884,2014/03/31,2012/07/06,133,6,0.6834189190000001,15540,133,0,6
22885,2014/03/31,2012/06/06,100,9,0.729058832,14567,100,2,7
22886,2014/03/31,2008/05/26,67,17,0.541032146,19629,67,6,11
22887,2014/03/31,2007/09/17,49,10,0.63820012,16640,49,5,5
22888,2014/03/31,2010/01/02,74,9,0.72146837,14717,74,5,4
22889,2014/03/31,2009/10/27,338,2,0.7,15168,338,1,1
22890,2014/03/31,2012/10/09,188,11,0.8857228659999999,11987,188,6,5
22891,2014/03/31,2012/03/13,245,10,0.564553044,18805,245,8,2
22892,2014/03/31,2012/02/21,67,18,0.5294065729999999,20053,67,14,4
22893,2014/03/31,2013/02/02,190,6,0.916767703,11580,190,1,5
22894,2014/03/31,2010/11/29,519,7,1.282280469,8279,519,7,0
22895,2014/03/31,2010/08/25,339,8,0.841187193,12618,339,7,1
22896,2014/03/31,2006/02/21,175,9,0.584019478,18174,175,5,4
22897,2014/03/31,2010/03/01,160,11,0.608111283,17451,160,7,4
22898,2014/03/31,2010/10/20,169,10,0.6619869,16030,169,9,1
22899,2014/03/31,2012/05/12,20,12,0.704362055,15064,20,8,4
22900,2014/03/31,2012/11/30,183,8,0.7787874340000001,13624,183,6,2
22901,2014/03/31,2012/04/09,20,8,0.587282741,18066,20,6,2
22902,2014/03/31,2010/01/01,66,10,0.79542735,13338,66,8,2
22903,2014/03/31,2010/09/29,197,7,0.923832288,11484,197,2,5
22904,2014/03/31,2008/09/14,16,17,0.681233545,15573,16,8,9
22905,2014/03/31,2007/03/08,110,10,0.612600335,17317,110,3,7
22906,2014/03/31,2011/10/16,118,16,0.640511443,16561,118,9,7
22907,2014/03/31,2007/09/21,29,13,0.692312512,15321,29,3,10
22908,2014/03/31,2012/06/11,176,9,0.6279486120000001,16891,176,6,3
22909,2014/03/31,2008/08/06,321,10,0.98134715,10808,321,9,1
22910,2014/03/31,2012/08/07,300,5,0.813559647,13035,300,3,2
22911,2014/03/31,2012/03/27,45,11,1.004854544,10553,45,5,6
22912,2014/03/31,2011/07/27,142,9,0.661865676,16021,142,5,4
22913,2014/03/31,2012/07/06,10,16,0.511589714,20727,10,7,9
22914,2014/03/31,2012/09/06,199,9,0.73557128,14415,199,4,5
22915,2014/03/31,2005/03/09,46,9,0.630838936,16807,46,2,7
22916,2014/03/31,2012/01/01,63,10,0.8407041470000001,12611,63,4,6
22917,2014/03/31,2010/02/12,139,7,0.6764654459999999,15671,139,5,2
22918,2014/03/31,2011/10/18,127,7,0.532857143,19894,127,1,6
22919,2014/03/31,2006/09/28,76,10,0.600141539,17663,76,4,6
22920,2014/03/31,2012/10/08,45,15,0.6279513000000001,16879,45,6,9
22921,2014/03/31,2013/02/13,102,9,0.79286922,13366,102,4,5
22922,2014/03/31,2008/03/19,224,25,0.681150039,15556,224,19,6
22923,2014/03/31,2008/02/24,161,15,0.661780026,16011,161,7,8
22924,2014/03/31,2011/12/23,84,16,0.7108473670000001,14905,84,0,16
22925,2014/03/31,2009/01/11,44,13,0.451029756,23491,44,5,8
22926,2014/03/31,2012/08/24,550,3,0.833333333,12714,550,3,0
22927,2014/03/31,2011/02/21,35,12,0.809598808,13086,35,4,8
22928,2014/03/31,2010/12/08,2,10,0.736198749,14390,2,4,6
22929,2014/03/31,2006/12/01,101,12,0.7916583220000001,13381,101,8,4
22930,2014/03/31,2010/01/26,86,10,0.540778538,19588,86,2,8
22931,2014/03/31,2009/11/07,117,16,0.842354672,12575,117,10,6
22932,2014/03/31,2010/12/05,116,10,0.357423317,29635,116,7,3
22933,2014/03/31,2008/04/16,127,8,0.764701805,13850,127,3,5
22934,2014/03/31,2007/06/29,25,12,0.742342469,14267,25,4,8
22935,2014/03/31,2010/11/04,89,7,0.6852791979999999,15455,89,3,4
22936,2014/03/31,2012/02/16,42,11,0.536548964,19739,42,7,4
22937,2014/03/31,2011/03/16,33,12,0.685958935,15439,33,2,10
22938,2014/03/31,2012/12/12,2,29,0.662758621,15979,2,0,29
22939,2014/03/31,2009/12/02,35,18,0.615899732,17194,35,10,8
22940,2014/03/31,2010/11/25,262,9,0.8090922979999999,13088,262,5,4
22941,2014/03/31,2012/07/08,13,7,0.797528056,13277,13,3,4
22942,2014/03/31,2010/09/25,86,9,0.70133064,15098,86,6,3
22943,2014/03/31,2011/09/28,141,9,0.774259598,13675,141,1,8
22944,2014/03/31,2013/03/23,15,11,0.615841671,17192,15,0,11
22945,2014/03/31,2011/09/23,4,4,1.333799924,7937,4,0,4
22946,2014/03/31,2008/11/11,19,9,0.704301776,15031,19,7,2
22947,2014/03/31,2010/05/21,156,17,0.538398779,19660,156,9,8
22948,2014/03/31,2012/06/20,65,9,0.718281759,14736,65,6,3
22949,2014/03/31,2006/11/09,22,19,0.586268558,18052,22,13,6
22950,2014/03/31,2012/04/05,425,10,0.7485712259999999,14138,425,10,0
22951,2014/03/31,2012/06/05,2,9,0.747723612,14154,2,8,1
22952,2014/03/31,2009/03/11,74,14,0.656928616,16110,74,2,12
22953,2014/03/31,2010/02/23,132,13,0.781442918,13542,132,4,9
22954,2014/03/31,2009/11/17,19,7,0.923079204,11464,19,0,7
22955,2014/03/31,2012/01/12,480,9,0.783345673,13507,480,9,0
22956,2014/03/31,2011/04/08,35,12,0.576003375,18368,35,5,7
22957,2014/03/31,2010/02/24,121,10,0.722910147,14635,121,5,5
22958,2014/03/31,2009/10/07,147,10,0.785913819,13460,147,5,5
22959,2014/03/31,2009/04/29,264,8,0.922488881,11467,264,5,3
22960,2014/03/31,2012/10/11,38,13,0.719244526,14706,38,3,10
22961,2014/03/31,2006/11/07,107,10,0.66447509,15917,107,3,7
22962,2014/03/31,2011/10/18,21,15,0.787934888,13423,21,6,9
22963,2014/03/31,2012/03/07,474,12,0.69809901,15150,474,12,0
22964,2014/03/31,2010/04/10,36,10,0.6689847560000001,15809,36,4,6
22965,2014/03/31,2007/07/27,28,17,0.892169732,11854,28,11,6
22966,2014/03/31,2006/01/27,123,15,0.703281905,15037,123,10,5
22967,2014/03/31,2006/12/07,124,13,0.7086242709999999,14923,124,5,8
22968,2014/03/31,2009/09/26,1,13,0.7537372590000001,14029,1,5,8
22969,2014/03/31,2006/06/10,78,12,0.783141016,13502,78,8,4
22970,2014/03/31,2012/05/07,303,15,0.741623062,14257,303,12,3
22971,2014/03/31,2013/01/14,25,15,0.720842141,14665,25,2,13
22972,2014/03/31,2013/03/27,28,7,0.728105111,14518,28,1,6
22973,2014/03/31,2007/02/19,63,8,0.73198615,14440,63,0,8
22974,2014/03/31,2009/11/06,227,8,0.7386770559999999,14309,227,4,4
22975,2014/03/31,2005/10/18,65,9,0.832372815,12698,65,5,4
22976,2014/03/31,2011/02/05,443,11,0.658416921,16051,443,11,0
22977,2014/03/31,2010/11/08,35,8,0.690957829,15295,35,2,6
22978,2014/03/31,2012/07/06,67,13,0.856584259,12337,67,6,7
22979,2014/03/31,2010/10/16,259,5,1.462758859,7224,259,1,4
22980,2014/03/31,2011/06/01,559,7,0.753608872,14021,559,7,0
22981,2014/03/31,2006/09/20,11,16,0.7087161259999999,14908,11,11,5
22982,2014/03/31,2009/05/08,1,8,0.597781487,17674,1,3,5
22983,2014/03/31,2010/03/20,11,10,0.6398449420000001,16510,11,2,8
22984,2014/03/31,2011/04/16,12,10,0.7857122670000001,13443,12,6,4
22985,2014/03/31,2006/07/30,675,5,0.7542062420000001,14003,675,5,0
22986,2014/03/31,2006/03/16,357,7,1.0,10560,357,6,1
22987,2014/03/31,2005/11/16,518,6,0.8969767240000001,11772,518,6,0
22988,2014/03/31,2010/11/25,141,6,1.012750815,10426,141,1,5
22989,2014/03/31,2011/10/23,199,14,0.623507145,16934,199,11,3
22990,2014/03/31,2012/12/26,12,11,0.713486753,14796,12,1,10
22991,2014/03/31,2012/04/29,12,10,0.73,14460,12,5,5
22992,2014/03/31,2005/11/21,109,10,0.802039359,13161,109,5,5
22993,2014/03/31,2010/12/14,20,11,0.7598056440000001,13892,20,7,4
22994,2014/03/31,2011/08/06,403,8,0.595845094,17714,403,8,0
22995,2014/03/31,2013/01/16,4,8,0.769223089,13721,4,0,8
22996,2014/03/31,2010/03/15,51,8,0.773084023,13651,51,2,6
22997,2014/03/31,2009/01/11,75,13,0.783523647,13469,75,7,6
22998,2014/03/31,2007/11/09,250,14,0.7454221120000001,14155,250,11,3
22999,2014/03/31,2011/08/22,113,12,0.5602315210000001,18832,113,3,9
23000,2014/03/31,2006/03/23,95,11,0.88977313,11857,95,4,7
23001,2014/03/31,2009/02/21,73,19,0.751418293,14038,73,11,8
23002,2014/03/31,2008/05/12,78,14,0.8238783000000002,12802,78,8,6
23003,2014/03/31,2010/02/18,25,9,0.611406957,17250,25,3,6
23004,2014/03/31,2010/03/01,25,13,0.7478832790000001,14102,25,5,8
23005,2014/03/31,2011/11/17,308,8,0.994207202,10608,308,6,2
23006,2014/03/31,2012/04/10,258,16,0.68684142,15355,258,14,2
23007,2014/03/31,2012/12/30,68,14,0.748763933,14085,68,4,10
23008,2014/03/31,2008/10/12,279,4,0.7716280090000001,13667,279,3,1
23009,2014/03/31,2007/06/15,75,12,0.794341669,13276,75,5,7
23010,2014/03/31,2012/01/26,276,13,0.624889192,16876,276,10,3
23011,2014/03/31,2007/05/21,700,3,0.811699507,12992,700,3,0
23012,2014/03/31,2013/03/07,270,5,1.448638549,7279,270,2,3
23013,2014/03/31,2010/11/28,236,9,0.914369959,11531,236,7,2
23014,2014/03/31,2011/12/18,79,10,0.674130435,15640,79,8,2
23015,2014/03/31,2010/10/11,42,14,0.804206712,13110,42,2,12
23016,2014/03/31,2010/08/23,433,14,0.8029436409999999,13130,433,14,0
23017,2014/03/31,2006/03/07,25,8,0.7357788940000001,14328,25,4,4
23018,2014/03/31,2012/02/27,206,13,0.853553036,12350,206,8,5
23019,2014/03/31,2008/08/11,7,14,0.697187459,15118,7,2,12
23020,2014/03/31,2005/07/18,38,14,0.767925683,13725,38,6,8
23021,2014/03/31,2013/02/02,50,3,0.526666667,20010,50,2,1
23022,2014/03/31,2012/08/30,425,7,1.11445643,9456,425,7,0
23023,2014/03/31,2011/08/24,345,9,0.58122449,18130,345,7,2
23024,2014/03/31,2012/08/04,416,11,0.599587435,17573,416,11,0
23025,2014/03/31,2012/09/29,31,7,0.65050568,16196,31,5,2
23026,2014/03/31,2011/03/08,126,13,0.565837585,18619,126,9,4
23027,2014/03/31,2010/03/13,8,16,0.5414122729999999,19458,8,7,9
23028,2014/03/31,2011/04/16,167,8,0.655134026,16079,167,2,6
23029,2014/03/31,2009/09/11,86,9,0.747477823,14091,86,3,6
23030,2014/03/31,2012/04/09,354,16,0.718745735,14654,354,14,2
23031,2014/03/31,2008/07/18,116,16,0.70188004,15005,116,8,8
23032,2014/03/31,2010/10/09,120,10,0.6980989000000001,15086,120,5,5
23033,2014/03/31,2009/12/08,267,9,0.8433295959999999,12488,267,7,2
23034,2014/03/31,2011/10/11,291,11,0.866283623,12157,291,5,6
23035,2014/03/31,2011/10/11,75,5,1.212895646,8682,75,2,3
23036,2014/03/31,2012/01/01,164,15,0.881445672,11946,164,11,4
23037,2014/03/31,2008/05/17,26,8,0.709640715,14835,26,4,4
23038,2014/03/31,2012/07/05,567,6,0.7863161040000001,13388,567,6,0
23039,2014/03/31,2009/11/10,12,16,0.697252616,15098,12,6,10
23040,2014/03/31,2007/02/25,19,18,0.67441853,15607,19,8,10
23041,2014/03/31,2012/05/30,324,10,0.631667867,16662,324,6,4
23042,2014/03/31,2009/09/19,223,6,0.649412491,16204,223,4,2
23043,2014/03/31,2012/03/02,111,9,0.631364455,16666,111,7,2
23044,2014/03/31,2008/06/19,248,17,0.558010502,18854,248,10,7
23045,2014/03/31,2009/09/08,8,11,0.575248537,18287,8,2,9
23046,2014/03/31,2007/03/16,62,8,0.479644355,21932,62,3,5
23047,2014/03/31,2006/04/20,222,14,0.733860053,14334,222,10,4
23048,2014/03/31,2011/02/21,246,11,0.765380585,13742,246,9,2
23049,2014/03/31,2011/08/24,193,9,0.794763848,13233,193,8,1
23050,2014/03/31,2012/04/12,187,7,0.590188563,17819,187,2,5
23051,2014/03/31,2009/09/21,97,7,0.74823408,14055,97,3,4
23052,2014/03/31,2011/09/24,137,8,0.861714192,12204,137,5,3
23053,2014/03/31,2012/01/24,490,8,0.670028672,15695,490,8,0
23054,2014/03/31,2011/02/02,97,13,0.64384215,16332,97,8,5
23055,2014/03/31,2012/12/26,12,12,0.701752653,14983,12,2,10
23056,2014/03/31,2013/01/21,158,9,0.784667861,13398,158,3,6
23057,2014/03/31,2013/02/24,40,10,0.728121493,14437,40,0,10
23058,2014/03/31,2012/07/26,55,14,0.7345779179999999,14310,55,7,7
23059,2014/03/31,2012/08/04,14,10,0.797659736,13178,14,5,5
23060,2014/03/31,2004/12/02,34,8,1.049705383,10013,34,5,3
23061,2014/03/31,2009/12/08,25,10,0.8944243040000001,11751,25,4,6
23062,2014/03/31,2010/11/30,279,9,0.866716147,12126,279,7,2
23063,2014/03/31,2005/07/01,180,8,0.6325,16616,180,4,4
23064,2014/03/31,2011/11/26,104,7,0.7228571429999999,14539,104,2,5
23065,2014/03/31,2012/12/11,116,9,0.75728347,13878,116,2,7
23066,2014/03/31,2013/03/30,16,17,0.951337015,11047,16,0,17
23067,2014/03/31,2011/06/25,70,7,0.767304322,13696,70,5,2
23068,2014/03/31,2012/06/17,5,17,0.560491226,18749,5,3,14
23069,2014/03/31,2012/10/29,140,10,0.7277927829999999,14439,140,0,10
23070,2014/03/31,2011/08/02,120,20,0.450279385,23337,120,16,4
23071,2014/03/31,2007/06/24,154,11,0.6935110879999999,15152,154,4,7
23072,2014/03/31,2006/04/29,180,17,0.724914108,14495,180,13,4
23073,2014/03/31,2009/02/25,383,10,0.69751726,15064,383,10,0
23074,2014/03/31,2010/11/22,2,10,0.809984582,12972,2,3,7
23075,2014/03/31,2007/11/25,123,16,0.89115352,11790,123,6,10
23076,2014/03/31,2012/04/14,110,13,0.643889195,16317,110,5,8
23077,2014/03/31,2009/04/21,47,5,0.6670211420000001,15751,47,3,2
23078,2014/03/31,2011/10/14,214,9,0.764131937,13749,214,6,3
23079,2014/03/31,2009/03/09,66,16,0.504608512,20818,66,6,10
23080,2014/03/31,2012/03/29,207,13,0.607638415,17285,207,11,2
23081,2014/03/31,2006/01/10,101,7,0.719531378,14596,101,3,4
23082,2014/03/31,2011/03/08,627,7,0.8428571429999999,12460,627,7,0
23083,2014/03/31,2007/04/11,37,13,0.87629506,11984,37,6,7
23084,2014/03/31,2005/10/25,3,13,0.724614588,14491,3,5,8
23085,2014/03/31,2011/06/04,243,9,0.827746945,12685,243,7,2
23086,2014/03/31,2012/03/16,10,7,0.702857143,14938,10,3,4
23087,2014/03/31,2008/01/14,11,16,0.713211059,14721,11,7,9
23088,2014/03/31,2011/09/06,220,7,0.7277596009999999,14426,220,2,5
23089,2014/03/31,2012/06/14,23,13,0.818028674,12834,23,7,6
23090,2014/03/31,2009/03/01,93,10,0.596331724,17605,93,8,2
23091,2014/03/31,2006/12/15,56,11,0.707942545,14829,56,3,8
23092,2014/03/31,2011/04/12,31,2,0.52,20188,31,1,1
23093,2014/03/31,2012/06/27,30,14,0.774165069,13558,30,8,6
23094,2014/03/31,2011/11/22,464,6,0.664773879,15788,464,6,0
23095,2014/03/31,2007/03/10,187,13,0.6909737309999999,15189,187,10,3
23096,2014/03/31,2006/07/31,71,13,0.666816824,15739,71,6,7
23097,2014/03/31,2010/02/27,163,14,0.5486354370000001,19127,163,8,6
23098,2014/03/31,2013/01/28,29,7,0.552940402,18977,29,2,5
23099,2014/03/31,2008/08/08,148,13,0.7491645240000001,14004,148,9,4
23100,2014/03/31,2012/12/01,95,4,1.39601996,7515,95,3,1
23101,2014/03/31,2010/04/14,246,11,0.7455251559999999,14072,246,7,4
23102,2014/03/31,2008/04/23,307,7,0.506779866,20701,307,5,2
23103,2014/03/31,2011/05/19,79,12,0.6900618340000001,15202,79,6,6
23104,2014/03/31,2011/09/29,60,8,0.75620098,13872,60,5,3
23105,2014/03/31,2010/12/13,18,13,0.637958402,16443,18,5,8
23106,2014/03/31,2005/04/06,9,11,0.635543169,16505,9,4,7
23107,2014/03/31,2005/10/15,1,13,0.696750581,15055,1,10,3
23108,2014/03/31,2006/11/07,29,13,0.670793681,15636,29,7,6
23109,2014/03/31,2012/10/25,40,15,0.75895868,13819,40,6,9
23110,2014/03/31,2011/01/06,21,12,0.6770516459999999,15490,21,4,8
23111,2014/03/31,2008/05/21,34,9,0.783005301,13393,34,7,2
23112,2014/03/31,2008/08/13,14,7,0.8959765890000001,11704,14,2,5
23113,2014/03/31,2007/07/11,64,15,0.7327538259999999,14311,64,12,3
23114,2014/03/31,2011/08/24,123,9,0.519527348,20184,123,6,3
23115,2014/03/31,2007/06/11,69,11,0.6833050959999999,15346,69,4,7
23116,2014/03/31,2011/11/25,194,15,0.928515009,11293,194,10,5
23117,2014/03/31,2006/06/02,35,13,0.644978163,16257,35,10,3
23118,2014/03/31,2011/09/16,15,10,0.8483131070000001,12360,15,5,5
23119,2014/03/31,2008/10/13,133,9,0.8367693540000001,12530,133,6,3
23120,2014/03/31,2010/04/18,58,8,0.6905533229999999,15181,58,5,3
23121,2014/03/31,2007/02/18,385,12,0.964183223,10872,385,12,0
23122,2014/03/31,2009/10/30,17,10,0.67546878,15519,17,4,6
23123,2014/03/31,2010/07/27,69,13,0.558866969,18755,69,6,7
23124,2014/03/31,2010/03/30,288,9,0.676422072,15495,288,5,4
23125,2014/03/31,2012/11/17,83,23,0.6316767120000001,16592,83,6,17
23126,2014/03/31,2009/12/10,24,6,0.81,12939,24,0,6
23127,2014/03/31,2012/05/24,70,16,0.852557553,12293,70,9,7
23128,2014/03/31,2009/08/19,82,14,0.6828537920000001,15348,82,0,14
23129,2014/03/31,2006/12/08,11,10,0.7110061059999999,14740,11,6,4
23130,2014/03/31,2011/01/20,328,15,0.772135858,13573,328,13,2
23131,2014/03/31,2006/09/02,18,9,0.656280293,15969,18,4,5
23132,2014/03/31,2012/05/08,24,12,0.864939749,12116,24,8,4
23133,2014/03/31,2007/05/10,148,11,0.833480474,12573,148,8,3
23134,2014/03/31,2006/06/18,122,7,0.883216453,11864,122,4,3
23135,2014/03/31,2007/05/10,60,16,0.7933366140000001,13208,60,8,8
23136,2014/03/31,2012/02/13,8,11,0.774557954,13528,8,0,11
23137,2014/03/31,2007/12/12,189,12,0.943800216,11102,189,5,7
23138,2014/03/31,2011/08/26,134,6,0.761831006,13752,134,3,3
23139,2014/03/31,2005/12/20,170,24,0.563708367,18585,170,12,12
23140,2014/03/31,2013/01/24,43,5,0.58943169,17772,43,0,5
23141,2014/03/31,2012/03/25,68,12,0.774138645,13531,68,6,6
23142,2014/03/31,2007/02/18,113,16,0.572902696,18283,113,9,7
23143,2014/03/31,2008/03/29,31,3,0.74440796,14070,31,0,3
23144,2014/03/31,2011/06/22,201,16,0.542190008,19315,201,6,10
23145,2014/03/31,2009/11/19,72,12,0.713183056,14684,72,5,7
23146,2014/03/31,2005/07/16,200,16,0.715072721,14645,200,13,3
23147,2014/03/31,2010/07/19,22,15,0.5561974820000001,18827,22,2,13
23148,2014/03/31,2007/04/29,119,15,0.759320522,13790,119,7,8
23149,2014/03/31,2009/12/05,287,10,0.77534064,13504,287,6,4
23150,2014/03/31,2011/11/08,3,9,0.708807799,14771,3,7,2
23151,2014/03/31,2011/02/01,19,19,0.463379808,22593,19,11,8
23152,2014/03/31,2008/07/31,107,18,0.799817404,13089,107,8,10
23153,2014/03/31,2012/12/05,85,14,0.801816023,13056,85,7,7
23154,2014/03/31,2011/03/26,234,12,0.681100195,15370,234,7,5
23155,2014/03/31,2006/04/13,82,6,0.958852249,10917,82,0,6
23156,2014/03/31,2012/10/16,98,9,0.663639764,15773,98,4,5
23157,2014/03/31,2008/08/12,77,9,0.848185722,12341,77,7,2
23158,2014/03/31,2005/09/18,342,7,0.8713702959999999,12012,342,5,2
23159,2014/03/31,2009/11/18,26,2,0.69,15168,26,1,1
23160,2014/03/31,2011/07/26,115,2,0.69,15168,115,1,1
23161,2014/03/31,2007/10/07,24,11,0.53545101,19545,24,4,7
23162,2014/03/31,2005/07/14,16,14,0.589563944,17750,16,5,9
23163,2014/03/31,2011/08/10,289,10,0.753542162,13887,289,6,4
23164,2014/03/31,2013/03/14,112,7,0.693395401,15091,112,0,7
23165,2014/03/31,2012/07/11,108,14,0.792530485,13203,108,10,4
23166,2014/03/31,2012/09/12,158,12,0.967829063,10811,158,9,3
23167,2014/03/31,2012/10/30,6,13,0.436494222,23969,6,2,11
23168,2014/03/31,2011/07/29,122,14,0.721323773,14504,122,2,12
23169,2014/03/31,2008/03/15,68,11,0.941213675,11115,68,6,5
23170,2014/03/31,2010/03/29,14,13,0.661319932,15819,14,4,9
23171,2014/03/31,2012/04/11,355,8,0.779708579,13417,355,6,2
23172,2014/03/31,2005/01/08,115,13,0.47906489,21837,115,10,3
23173,2014/03/31,2007/05/16,203,13,0.961665747,10878,203,7,6
23174,2014/03/31,2010/01/08,4,12,0.7063908959999999,14807,4,8,4
23175,2014/03/31,2010/12/07,23,9,0.720383635,14519,23,7,2
23176,2014/03/31,2011/01/05,17,6,1.420672372,7362,17,1,5
23177,2014/03/31,2008/04/17,55,8,0.976420502,10711,55,7,1
23178,2014/03/31,2012/01/20,40,7,0.77901527,13425,40,4,3
23179,2014/03/31,2013/03/12,72,15,0.933333333,11205,72,1,14
23180,2014/03/31,2010/01/01,132,7,0.640274904,16333,132,5,2
23181,2014/03/31,2012/09/25,106,11,0.6915746309999999,15121,106,2,9
23182,2014/03/31,2006/06/23,139,11,0.877634075,11915,139,7,4
23183,2014/03/31,2007/05/21,109,8,0.8168192470000001,12802,109,5,3
23184,2014/03/31,2010/03/19,46,14,0.784948577,13321,46,1,13
23185,2014/03/31,2012/11/22,170,11,0.713250341,14660,170,6,5
23186,2014/03/31,2010/12/03,21,10,0.581109938,17992,21,3,7
23187,2014/03/31,2008/06/22,140,15,0.762540296,13711,140,6,9
23188,2014/03/31,2007/09/12,68,8,0.867958489,12045,68,5,3
23189,2014/03/31,2009/08/24,13,7,0.888290424,11769,13,4,3
23190,2014/03/31,2007/08/31,165,10,0.797357944,13111,165,4,6
23191,2014/03/31,2008/01/29,156,3,0.739195305,14142,156,1,2
23192,2014/03/31,2009/07/28,565,5,0.939280259,11129,565,5,0
23193,2014/03/31,2011/07/06,354,11,0.618683042,16895,354,10,1
23194,2014/03/31,2008/11/21,51,9,0.94525459,11057,51,6,3
23195,2014/03/31,2011/02/25,200,9,0.8098031920000001,12906,200,4,5
23196,2014/03/31,2009/03/05,241,3,0.6499135629999999,16081,241,0,3
23197,2014/03/31,2011/03/31,69,8,0.8927342620000001,11707,69,2,6
23198,2014/03/31,2009/12/12,41,13,0.731170503,14293,41,9,4
23199,2014/03/31,2012/08/23,106,9,0.855522718,12215,106,7,2
23200,2014/03/31,2006/01/13,30,13,0.692453118,15091,30,6,7
23201,2014/03/31,2010/07/08,104,19,0.658978935,15856,104,10,9
23202,2014/03/31,2013/01/25,2,17,0.92929823,11243,2,4,13
23203,2014/03/31,2012/07/14,171,21,0.7090180509999999,14736,171,11,10
23204,2014/03/31,2011/07/26,153,13,0.614031149,17015,153,9,4
23205,2014/03/31,2012/09/02,301,6,0.8666666670000001,12054,301,2,4
23206,2014/03/31,2008/10/01,72,8,0.7455202679999999,14012,72,4,4
23207,2014/03/31,2013/01/12,142,10,0.6801986059999999,15357,142,3,7
23208,2014/03/31,2011/09/26,10,16,0.586312097,17815,10,4,12
23209,2014/03/31,2011/08/04,78,8,0.625239464,16704,78,3,5
23210,2014/03/31,2009/03/06,43,17,0.841184052,12415,43,13,4
23211,2014/03/31,2011/12/26,28,12,0.637158633,16390,28,4,8
23212,2014/03/31,2006/05/10,112,9,0.7736037640000001,13497,112,7,2
23213,2014/03/31,2011/01/21,94,11,0.8763454759999999,11914,94,6,5
23214,2014/03/31,2012/02/12,105,10,0.523737207,19932,105,0,10
23215,2014/03/31,2006/03/05,14,11,0.696417801,14988,14,3,8
23216,2014/03/31,2010/11/25,30,13,0.7174659609999999,14542,30,5,8
23217,2014/03/31,2009/10/21,32,10,0.6411559729999999,16272,32,5,5
23218,2014/03/31,2013/03/30,20,8,0.471607595,22120,20,1,7
23219,2014/03/31,2012/09/08,75,10,0.5783152229999999,18038,75,6,4
23220,2014/03/31,2012/10/21,156,8,0.756104668,13796,156,3,5
23221,2014/03/31,2008/06/14,114,8,0.925457368,11271,114,3,5
23222,2014/03/31,2010/04/19,110,9,0.637126016,16371,110,2,7
23223,2014/03/31,2007/04/06,22,13,0.7123338570000001,14641,22,7,6
23224,2014/03/31,2013/01/28,68,14,0.8260121970000001,12626,68,1,13
23225,2014/03/31,2010/11/25,224,10,0.721174193,14461,224,3,7
23226,2014/03/31,2012/06/09,73,15,0.401804731,25954,73,6,9
23227,2014/03/31,2011/11/20,88,10,0.780267864,13365,88,7,3
23228,2014/03/31,2008/04/20,311,12,0.818953735,12731,311,10,2
23229,2014/03/31,2010/07/15,111,17,0.506032424,20602,111,8,9
23230,2014/03/31,2006/04/29,36,11,0.808716159,12891,36,8,3
23231,2014/03/31,2012/02/03,172,8,0.509203341,20473,172,3,5
23232,2014/03/31,2009/12/01,275,9,0.8855555559999999,11772,275,7,2
23233,2014/03/31,2011/04/27,70,21,0.6960345859999999,14977,70,10,11
23234,2014/03/31,2011/08/16,37,11,0.7697873129999999,13541,37,1,10
23235,2014/03/31,2010/02/01,354,13,0.897812231,11610,354,11,2
23236,2014/03/31,2012/08/07,113,10,0.7245061509999999,14387,113,1,9
23237,2014/03/31,2012/03/13,243,14,0.7571596690000001,13766,243,9,5
23238,2014/03/31,2010/06/14,23,11,0.540629215,19278,23,5,6
23239,2014/03/31,2010/08/24,70,13,0.671270128,15526,70,1,12
23240,2014/03/31,2011/04/14,32,6,0.737666336,14128,32,2,4
23241,2014/03/31,2011/08/26,9,12,0.801992765,12992,9,5,7
23242,2014/03/31,2009/01/26,94,13,0.836123104,12461,94,0,13
23243,2014/03/31,2011/01/16,63,10,0.893854998,11655,63,5,5
23244,2014/03/31,2012/09/19,184,6,0.872731842,11937,184,5,1
23245,2014/03/31,2011/01/24,21,13,0.541320412,19244,21,4,9
23246,2014/03/31,2012/07/19,43,22,0.718485204,14497,43,9,13
23247,2014/03/31,2012/02/19,275,16,0.907839958,11472,275,13,3
23248,2014/03/31,2007/11/08,519,6,0.75247489,13839,519,6,0
23249,2014/03/31,2008/09/28,253,17,0.5699791999999999,18269,253,10,7
23250,2014/03/31,2007/11/22,34,14,0.551323132,18887,34,2,12
23251,2014/03/31,2011/10/24,22,15,0.61165717,17023,22,7,8
23252,2014/03/31,2012/09/07,153,13,0.469507125,22176,153,5,8
23253,2014/03/31,2005/04/14,361,7,0.740880951,14053,361,5,2
23254,2014/03/31,2006/03/11,69,10,0.70984114,14667,69,4,6
23255,2014/03/31,2012/11/29,13,7,0.75,13881,13,3,4
23256,2014/03/31,2009/07/31,199,10,0.528303055,19706,199,4,6
23257,2014/03/31,2012/01/08,22,15,0.75466541,13793,22,9,6
23258,2014/03/31,2005/10/28,291,7,0.723092741,14395,291,6,1
23259,2014/03/31,2007/05/17,32,11,0.647955677,16064,32,3,8
23260,2014/03/31,2008/08/03,23,7,0.780718626,13331,23,1,6
23261,2014/03/31,2012/03/07,82,10,0.552659834,18832,82,3,7
23262,2014/03/31,2009/07/20,7,24,0.747993962,13913,7,9,15
23263,2014/03/31,2008/03/20,342,8,0.753493592,13811,342,7,1
23264,2014/03/31,2010/12/12,195,13,0.7946136220000001,13096,195,5,8
23265,2014/03/31,2007/10/16,226,9,0.8064984890000001,12903,226,8,1
23266,2014/03/31,2008/07/05,55,10,0.568037011,18319,55,8,2
23267,2014/03/31,2013/03/20,222,6,0.8816666670000001,11802,222,0,6
23268,2014/03/31,2012/01/10,178,13,0.907420199,11466,178,7,6
23269,2014/03/31,2011/11/05,402,8,0.543405933,19146,402,8,0
23270,2014/03/31,2006/09/12,14,10,0.777813248,13376,14,2,8
23271,2014/03/31,2009/12/13,48,12,0.683762077,15215,48,7,5
23272,2014/03/31,2009/08/20,267,12,0.661372537,15730,267,5,7
23273,2014/03/31,2011/08/09,78,9,0.6357320129999999,16359,78,7,2
23274,2014/03/31,2009/01/29,43,8,0.481448349,21597,43,1,7
23275,2014/03/31,2012/04/02,220,17,0.499550303,20814,220,10,7
23276,2014/03/31,2006/09/21,60,11,0.751386861,13837,60,8,3
23277,2014/03/31,2010/03/11,436,8,0.4973399670000001,20902,436,8,0
23278,2014/03/31,2007/02/08,47,13,0.7665363909999999,13561,47,3,10
23279,2014/03/31,2009/07/23,37,11,0.56331816,18453,37,1,10
23280,2014/03/31,2010/05/18,20,15,0.85055401,12220,20,6,9
23281,2014/03/31,2010/11/29,137,13,0.6478116429999999,16044,137,4,9
23282,2014/03/31,2011/09/08,4,8,0.539858716,19252,4,0,8
23283,2014/03/31,2005/04/06,37,10,0.7519918959999999,13821,37,1,9
23284,2014/03/31,2009/09/17,19,14,0.561535552,18508,19,4,10
23285,2014/03/31,2010/07/27,257,4,0.735,14140,257,2,2
23286,2014/03/31,2011/10/05,207,12,0.547620929,18978,207,4,8
23287,2014/03/31,2010/07/21,49,14,0.628602625,16531,49,10,4
23288,2014/03/31,2011/03/06,15,15,0.71510426,14531,15,6,9
23289,2014/03/31,2011/08/01,82,2,0.685,15168,82,0,2
23290,2014/03/31,2010/07/08,50,2,0.685,15168,50,1,1
23291,2014/03/31,2012/03/15,303,14,0.408911016,25409,303,9,5
23292,2014/03/31,2012/09/14,5,5,0.736374654,14109,5,0,5
23293,2014/03/31,2011/11/27,8,17,0.562686308,18464,8,12,5
23294,2014/03/31,2007/02/12,40,12,0.753881713,13780,40,4,8
23295,2014/03/31,2011/11/12,207,11,0.6958179259999999,14928,207,9,2
23296,2014/03/31,2011/04/15,84,11,0.6591211370000001,15759,84,8,3
23297,2014/03/31,2011/10/16,1,9,0.927136481,11203,1,4,5
23298,2014/03/31,2008/01/16,19,11,0.700429564,14829,19,5,6
23299,2014/03/31,2005/06/11,433,12,0.7966252490000001,13038,433,12,0
23300,2014/03/31,2011/01/12,25,12,0.72,14424,25,6,6
23301,2014/03/31,2008/04/09,51,9,0.59735174,17385,51,5,4
23302,2014/03/31,2012/06/13,109,10,0.9882756,10508,109,8,2
23303,2014/03/31,2010/08/01,36,9,0.947776764,10957,36,8,1
23304,2014/03/31,2011/06/21,34,4,0.876804864,11843,34,0,4
23305,2014/03/31,2011/02/03,110,12,0.634413418,16366,110,7,5
23306,2014/03/31,2009/06/29,10,11,0.695828698,14921,10,7,4
23307,2014/03/31,2011/08/28,16,12,0.7253325420000001,14314,16,4,8
23308,2014/03/31,2009/11/05,175,9,0.809223694,12830,175,5,4
23309,2014/03/31,2011/04/08,12,14,0.531658132,19528,12,4,10
23310,2014/03/31,2011/06/22,21,20,0.7113342009999999,14593,21,8,12
23311,2014/03/31,2008/04/25,313,8,0.740737173,14013,313,6,2
23312,2014/03/31,2004/12/17,10,47,1.200212766,8648,10,23,24
23313,2014/03/31,2009/08/05,106,10,0.7564941690000001,13720,106,2,8
23314,2014/03/31,2012/06/09,277,11,0.955411526,10862,277,8,3
23315,2014/03/31,2010/12/25,217,8,0.69272964,14980,217,5,3
23316,2014/03/31,2006/10/18,2,9,0.7664524709999999,13539,2,3,6
23317,2014/03/31,2013/02/06,1,10,0.70464145,14726,1,1,9
23318,2014/03/31,2005/04/06,118,11,0.762671077,13605,118,7,4
23319,2014/03/31,2012/04/23,11,6,0.7678789220000001,13512,11,0,6
23320,2014/03/31,2010/10/08,411,17,0.539159694,19243,411,17,0
23321,2014/03/31,2009/12/28,312,8,0.715217841,14506,312,7,1
23322,2014/03/31,2009/02/13,367,15,0.6540348000000001,15862,367,15,0
23323,2014/03/31,2010/06/21,22,16,0.745219828,13920,22,5,11
23324,2014/03/31,2012/03/23,13,10,0.694757886,14931,13,0,10
23325,2014/03/31,2012/04/21,503,4,0.9125,11368,503,4,0
23326,2014/03/31,2006/10/10,10,5,0.73,14210,10,3,2
23327,2014/03/31,2011/01/25,157,11,0.594609344,17445,157,7,4
23328,2014/03/31,2005/04/23,319,9,0.834567107,12428,319,6,3
23329,2014/03/31,2010/12/09,38,16,0.57973115,17891,38,12,4
23330,2014/03/31,2010/11/11,126,14,0.790779201,13116,126,11,3
23331,2014/03/31,2007/09/30,33,4,1.372559555,7556,33,1,3
23332,2014/03/31,2009/10/20,33,16,0.720261824,14399,33,12,4
23333,2014/03/31,2012/10/04,193,11,0.731527121,14177,193,4,7
23334,2014/03/31,2005/05/05,19,8,0.849440577,12209,19,4,4
23335,2014/03/31,2010/10/31,71,12,0.729963398,14207,71,6,6
23336,2014/03/31,2009/02/26,96,12,0.662447937,15654,96,6,6
23337,2014/03/31,2010/05/10,27,5,1.082678012,9578,27,3,2
23338,2014/03/31,2010/11/03,5,13,0.529336907,19590,5,5,8
23339,2014/03/31,2012/10/17,3,10,0.726722966,14269,3,5,5
23340,2014/03/31,2012/02/12,218,13,0.649433832,15967,218,12,1
23341,2014/03/31,2012/06/10,115,8,0.681517681,15214,115,4,4
23342,2014/03/31,2013/03/06,35,9,0.633585528,16363,35,1,8
23343,2014/03/31,2011/12/04,105,16,0.595909065,17397,105,3,13
23344,2014/03/31,2011/12/06,110,6,0.94272008,10996,110,3,3
23345,2014/03/31,2012/11/30,6,11,0.653477493,15862,6,3,8
23346,2014/03/31,2006/06/08,347,11,0.512644048,20219,347,9,2
23347,2014/03/31,2012/11/07,16,16,0.6998176909999999,14810,16,6,10
23348,2014/03/31,2006/05/12,371,11,0.86719103,11951,371,11,0
23349,2014/03/31,2009/11/06,43,6,0.710455917,14586,43,0,6
23350,2014/03/31,2012/01/21,133,9,0.79055848,13107,133,7,2
23351,2014/03/31,2010/11/05,16,10,0.562137587,18432,16,1,9
23352,2014/03/31,2012/06/01,206,8,0.731779787,14159,206,6,2
23353,2014/03/31,2011/08/06,48,8,0.8761919659999999,11825,48,3,5
23354,2014/03/31,2007/12/20,282,5,0.600456679,17255,282,3,2
23355,2014/03/31,2010/07/20,34,7,0.652090652,15885,34,3,4
23356,2014/03/31,2006/10/12,59,13,0.7354142709999999,14085,59,5,8
23357,2014/03/31,2013/03/03,122,15,0.906121074,11431,122,2,13
23358,2014/03/31,2006/08/07,15,12,0.69174247,14973,15,3,9
23359,2014/03/31,2012/08/01,205,10,0.70602045,14670,205,3,7
23360,2014/03/31,2012/03/01,57,13,0.76639189,13514,57,4,9
23361,2014/03/31,2005/12/28,66,10,0.7756279490000001,13353,66,3,7
23362,2014/03/31,2005/08/23,375,11,0.530862679,19509,375,11,0
23363,2014/03/31,2012/02/05,230,11,0.640869431,16160,230,6,5
23364,2014/03/31,2009/01/29,168,13,0.7283963990000001,14218,168,12,1
23365,2014/03/31,2008/12/17,63,11,0.595702617,17385,63,0,11
23366,2014/03/31,2009/10/31,153,10,0.7168641840000001,14446,153,2,8
23367,2014/03/31,2012/02/07,71,13,0.668078586,15499,71,8,5
23368,2014/03/31,2011/07/12,1,13,0.8422327959999999,12294,1,3,10
23369,2014/03/31,2006/12/07,41,7,0.961309999,10771,41,3,4
23370,2014/03/31,2012/08/28,25,9,0.8360998059999999,12384,25,0,9
23371,2014/03/31,2012/05/04,29,11,0.651125715,15901,29,9,2
23372,2014/03/31,2012/07/19,37,10,0.7713813140000001,13422,37,8,2
23373,2014/03/31,2011/04/14,390,8,0.7180746290000001,14418,390,8,0
23374,2014/03/31,2010/11/12,23,16,0.7220968190000001,14336,23,7,9
23375,2014/03/31,2013/03/19,42,11,0.590869913,17519,42,1,10
23376,2014/03/31,2012/04/23,282,9,0.773188135,13384,282,7,2
23377,2014/03/31,2009/09/21,95,16,0.640663736,16151,95,0,16
23378,2014/03/31,2012/01/18,165,14,0.701832734,14743,165,12,2
23379,2014/03/31,2009/06/27,35,10,0.702457903,14728,35,3,7
23380,2014/03/31,2011/07/24,473,5,1.220155679,8479,473,5,0
23381,2014/03/31,2012/04/12,623,5,0.65377591,15824,623,5,0
23382,2014/03/31,2011/11/15,491,13,0.609329721,16978,491,13,0
23383,2014/03/31,2012/06/29,64,9,0.808501758,12795,64,6,3
23384,2014/03/31,2013/01/22,200,8,0.857809105,12059,200,5,3
23385,2014/03/31,2005/06/02,31,6,0.7089923920000001,14589,31,3,3
23386,2014/03/31,2010/08/17,32,19,0.870131236,11887,32,8,11
23387,2014/03/31,2012/11/07,301,7,0.7184994790000001,14395,301,3,4
23388,2014/03/31,2011/02/21,16,9,0.712544953,14515,16,4,5
23389,2014/03/31,2012/07/09,116,12,0.888255604,11643,116,6,6
23390,2014/03/31,2012/10/22,58,10,0.7516418340000001,13759,58,3,7
23391,2014/03/31,2007/06/01,117,7,0.8684028890000001,11909,117,4,3
23392,2014/03/31,2011/01/14,583,8,0.934426674,11067,583,8,0
23393,2014/03/31,2012/06/20,18,13,0.5701449989999999,18138,18,6,7
23394,2014/03/31,2012/09/28,3,15,0.677272251,15269,3,6,9
23395,2014/03/31,2012/01/10,3,11,0.765771623,13504,3,4,7
23396,2014/03/31,2012/09/10,88,10,0.6709999999999999,15410,88,6,4
23397,2014/03/31,2012/11/05,82,14,0.740108797,13971,82,4,10
23398,2014/03/31,2008/05/22,125,9,0.477347306,21661,125,5,4
23399,2014/03/31,2006/11/28,76,15,0.5270176870000001,19619,76,8,7
23400,2014/03/31,2011/05/16,20,12,0.638753938,16187,20,9,3
23401,2014/03/31,2011/01/24,192,11,0.667795647,15483,192,0,11
23402,2014/03/31,2013/02/03,18,11,0.861172747,12006,18,1,10
23403,2014/03/31,2012/12/05,37,10,0.889078167,11629,37,5,5
23404,2014/03/31,2010/04/11,10,12,0.570830435,18111,10,6,6
23405,2014/03/31,2007/07/11,38,8,0.620034187,16673,38,4,4
23406,2014/03/31,2010/02/09,293,11,0.69404431,14895,293,9,2
23407,2014/03/31,2008/06/25,25,8,1.441782427,7170,25,2,6
23408,2014/03/31,2007/11/11,262,12,0.6720549990000001,15382,262,8,4
23409,2014/03/31,2006/07/16,42,14,0.750942903,13766,42,8,6
23410,2014/03/31,2009/08/13,642,4,0.8,12920,642,4,0
23411,2014/03/31,2010/05/14,410,9,0.632715029,16335,410,9,0
23412,2014/03/31,2012/10/15,102,7,0.739343254,13978,102,1,6
23413,2014/03/31,2009/01/13,96,9,0.76578257,13494,96,3,6
23414,2014/03/31,2010/01/05,130,5,0.953488372,10836,130,4,1
23415,2014/03/31,2013/01/21,42,9,0.726031623,14230,42,2,7
23416,2014/03/31,2010/12/13,13,13,0.48648081,21235,13,0,13
23417,2014/03/31,2012/09/29,13,5,0.711235367,14522,13,1,4
23418,2014/03/31,2011/10/07,240,8,0.927793748,11132,240,7,1
23419,2014/03/31,2012/07/13,90,13,0.705122551,14647,90,9,4
23420,2014/03/31,2010/12/01,186,6,0.642681394,16070,186,4,2
23421,2014/03/31,2011/04/17,76,14,0.563010958,18343,76,8,6
23422,2014/03/31,2005/06/02,344,6,0.7076994240000001,14592,344,4,2
23423,2014/03/31,2009/12/31,60,17,0.677651421,15239,60,9,8
23424,2014/03/31,2006/09/10,37,11,0.633678203,16296,37,2,9
23425,2014/03/31,2012/05/27,36,8,0.8021517909999999,12873,36,2,6
23426,2014/03/31,2007/07/07,397,12,0.6960765809999999,14834,397,12,0
23427,2014/03/31,2012/11/01,13,10,0.7801012390000001,13236,13,3,7
23428,2014/03/31,2011/11/20,394,9,0.655555556,15750,394,9,0
23429,2014/03/31,2011/09/10,132,12,0.6258220170000001,16496,132,8,4
23430,2014/03/31,2013/02/02,47,11,0.770860962,13392,47,2,9
23431,2014/03/31,2013/01/31,21,21,0.555097059,18597,21,3,18
23432,2014/03/31,2013/01/17,209,7,0.705078888,14641,209,3,4
23433,2014/03/31,2008/11/03,122,8,0.7970496490000001,12951,122,2,6
23434,2014/03/31,2011/11/24,1,19,0.537093501,19219,1,13,6
23435,2014/03/31,2008/09/24,35,13,0.536712079,19231,35,5,8
23436,2014/03/31,2012/03/06,10,10,0.644537847,16012,10,3,7
23437,2014/03/31,2010/07/29,2,16,0.797112072,12947,2,12,4
23438,2014/03/31,2009/07/18,98,12,0.68777874,15005,98,7,5
23439,2014/03/31,2013/01/18,8,8,0.701188422,14717,8,1,7
23440,2014/03/31,2006/01/19,74,14,0.569341205,18124,74,2,12
23441,2014/03/31,2012/11/10,19,15,0.850522628,12131,19,6,9
23442,2014/03/31,2011/12/07,258,6,1.448203257,7124,258,4,2
23443,2014/03/31,2012/11/01,277,4,0.619402582,16655,277,0,4
23444,2014/03/31,2011/02/24,20,10,0.843774742,12226,20,4,6
23445,2014/03/31,2012/02/05,456,10,0.813614135,12678,456,10,0
23446,2014/03/31,2007/11/19,9,12,0.6,17191,9,1,11
23447,2014/03/31,2013/01/13,293,5,0.695701855,14825,293,2,3
23448,2014/03/31,2012/03/22,74,12,0.866200235,11906,74,8,4
23449,2014/03/31,2010/03/21,32,16,0.433459016,23790,32,10,6
23450,2014/03/31,2007/10/10,158,12,0.517626123,19921,158,7,5
23451,2014/03/31,2011/02/22,111,18,0.940821168,10960,111,12,6
23452,2014/03/31,2011/04/01,117,11,0.745676887,13828,117,7,4
23453,2014/03/31,2011/01/02,6,16,0.670596384,15376,6,7,9
23454,2014/03/31,2012/08/18,75,4,0.7484911409999999,13772,75,1,3
23455,2014/03/31,2012/07/18,518,5,0.78,13215,518,5,0
23456,2014/03/31,2012/10/09,466,3,1.3,7929,466,3,0
23457,2014/03/31,2011/11/13,141,15,0.457539063,22528,141,11,4
23458,2014/03/31,2008/04/14,73,8,0.655,15736,73,5,3
23459,2014/03/31,2009/03/18,5,15,0.502831496,20498,5,5,10
23460,2014/03/31,2007/04/10,130,13,0.773943831,13317,130,3,10
23461,2014/03/31,2006/09/01,219,7,1.091646012,9441,219,0,7
23462,2014/03/31,2010/09/01,102,13,0.743867032,13853,102,9,4
23463,2014/03/31,2006/02/19,414,5,1.082937467,9515,414,5,0
23464,2014/03/31,2011/09/23,459,11,0.777961495,13245,459,11,0
23465,2014/03/31,2007/12/07,210,6,1.237868813,8324,210,3,3
23466,2014/03/31,2008/07/30,450,8,0.564746506,18245,450,8,0
23467,2014/03/31,2005/10/14,43,19,0.455268879,22631,43,7,12
23468,2014/03/31,2010/05/02,125,15,0.548028191,18800,125,8,7
23469,2014/03/31,2012/09/15,95,14,0.800967115,12863,95,4,10
23470,2014/03/31,2011/12/29,293,14,0.572514587,17995,293,11,3
23471,2014/03/31,2006/08/03,160,10,0.975360795,10560,160,4,6
23472,2014/03/31,2011/07/09,42,10,0.818720782,12578,42,6,4
23473,2014/03/31,2011/09/23,71,7,0.589962188,17455,71,3,4
23474,2014/03/31,2009/08/27,8,19,0.413317813,24914,8,10,9
23475,2014/03/31,2013/01/01,1,10,0.720824641,14285,1,1,9
23476,2014/03/31,2011/09/30,61,17,0.751691488,13698,61,6,11
23477,2014/03/31,2010/08/01,247,6,0.6334631479999999,16254,247,0,6
23478,2014/03/31,2006/06/23,68,16,0.651103522,15813,68,10,6
23479,2014/03/31,2009/05/29,62,13,0.6275181329999999,16407,62,5,8
23480,2014/03/31,2008/10/25,498,2,0.755134977,13632,498,2,0
23481,2014/03/31,2012/03/29,213,5,0.722749614,14242,213,2,3
23482,2014/03/31,2010/11/04,29,12,0.574750949,17908,29,7,5
23483,2014/03/31,2007/07/15,78,10,0.7644290909999999,13461,78,6,4
23484,2014/03/31,2009/09/05,101,11,0.6174897979999999,16664,101,3,8
23485,2014/03/31,2005/07/16,194,18,0.618802021,16628,194,10,8
23486,2014/03/31,2010/08/09,20,18,0.620748718,16575,20,11,7
23487,2014/03/31,2009/01/17,432,6,0.780163785,13188,432,6,0
23488,2014/03/31,2013/01/25,121,9,0.53398339,19265,121,1,8
23489,2014/03/31,2008/08/14,38,13,0.912509759,11272,38,7,6
23490,2014/03/31,2008/03/17,84,18,0.622911216,16512,84,9,9
23491,2014/03/31,2009/08/04,2,8,0.633448297,16237,2,4,4
23492,2014/03/31,2008/04/18,6,12,0.7283852690000001,14120,6,0,12
23493,2014/03/31,2007/11/06,147,14,0.720970207,14265,147,11,3
23494,2014/03/31,2012/03/11,190,12,0.713463753,14415,190,7,5
23495,2014/03/31,2009/06/19,118,10,0.6244799320000001,16469,118,3,7
23496,2014/03/31,2008/12/17,135,8,0.7880781609999999,13050,135,2,6
23497,2014/03/31,2013/02/09,7,9,0.6145530060000001,16734,7,3,6
23498,2014/03/31,2009/01/23,25,7,0.8916100229999999,11534,25,1,6
23499,2014/03/31,2012/09/01,15,12,0.540057242,19042,15,3,9
23500,2014/03/31,2008/02/22,144,15,0.480777539,21388,144,3,12
23501,2014/03/31,2007/07/26,2,24,0.6834330340000001,15045,2,0,24
23502,2014/03/31,2006/03/02,62,13,0.847692308,12129,62,9,4
23503,2014/03/31,2012/07/06,93,10,0.74762071,13752,93,6,4
23504,2014/03/31,2011/06/05,232,8,0.767710573,13392,232,5,3
23505,2014/03/31,2012/02/23,222,9,0.8831890029999999,11640,222,3,6
23506,2014/03/31,2012/02/07,45,7,0.709644484,14486,45,2,5
23507,2014/03/31,2012/04/30,168,14,0.602097832,17070,168,8,6
23508,2014/03/31,2011/11/02,13,8,1.027619238,10001,13,7,1
23509,2014/03/31,2012/07/25,42,14,0.734433962,13992,42,8,6
23510,2014/03/31,2007/02/23,67,19,0.883121348,11636,67,10,9
23511,2014/03/31,2008/04/22,106,14,0.647289449,15875,106,4,10
23512,2014/03/31,2009/03/29,171,8,0.6493162720000001,15825,171,4,4
23513,2014/03/31,2007/08/29,24,14,0.739387638,13897,24,5,9
23514,2014/03/31,2012/09/03,81,9,0.546713845,18794,81,8,1
23515,2014/03/31,2009/11/05,18,6,0.671253021,15307,18,1,5
23516,2014/03/31,2012/11/02,20,13,0.496153846,20709,20,8,5
23517,2014/03/31,2007/07/10,75,10,0.8799049409999999,11677,75,7,3
23518,2014/03/31,2012/08/30,479,7,1.2828443,8009,479,7,0
23519,2014/03/31,2013/03/03,39,13,0.639881664,16056,39,1,12
23520,2014/03/31,2010/11/25,184,8,0.700698404,14662,184,3,5
23521,2014/03/31,2008/01/20,460,2,0.887568035,11575,460,2,0
23522,2014/03/31,2011/08/19,4,6,1.228450317,8363,4,5,1
23523,2014/03/31,2012/03/02,30,11,0.7030837670000001,14612,30,5,6
23524,2014/03/31,2012/01/10,15,12,0.819352317,12537,15,8,4
23525,2014/03/31,2013/03/10,35,17,0.746595435,13758,35,2,15
23526,2014/03/31,2008/05/19,378,9,0.817774682,12560,378,9,0
23527,2014/03/31,2012/01/27,93,6,0.79922185,12851,93,5,1
23528,2014/03/31,2007/09/19,166,11,0.51289132,20022,166,1,10
23529,2014/03/31,2012/03/24,437,9,0.7348457740000001,13973,437,9,0
23530,2014/03/31,2007/02/06,5,4,1.305,7868,5,0,4
23531,2014/03/31,2008/02/01,272,6,0.87,11802,272,5,1
23532,2014/03/31,2012/08/02,20,15,0.540824862,18985,20,8,7
23533,2014/03/31,2012/05/31,25,19,0.685136127,14986,25,5,14
23534,2014/03/31,2008/01/17,79,13,0.726091231,14140,79,4,9
23535,2014/03/31,2008/03/29,74,13,0.553364426,18547,74,9,4
23536,2014/03/31,2010/05/13,209,13,0.629590772,16299,209,10,3
23537,2014/03/31,2011/07/14,5,10,0.937357698,10945,5,3,7
23538,2014/03/31,2011/05/24,483,11,0.817760064,12545,483,11,0
23539,2014/03/31,2006/05/15,2,12,0.6027475170000001,17019,2,9,3
23540,2014/03/31,2007/05/04,3,12,0.6829862170000001,15019,3,6,6
23541,2014/03/31,2007/02/14,115,9,0.909499911,11278,115,5,4
23542,2014/03/31,2011/10/21,36,11,0.6920693609999999,14821,36,3,8
23543,2014/03/31,2006/06/03,424,11,0.83577249,12272,424,11,0
23544,2014/03/31,2008/11/30,111,13,0.6501020670000001,15774,111,8,5
23545,2014/03/31,2005/09/23,225,10,0.59100974,17351,225,6,4
23546,2014/03/31,2007/11/20,103,16,0.559713444,18321,103,10,6
23547,2014/03/31,2010/07/13,200,9,0.657937119,15585,200,6,3
23548,2014/03/31,2012/09/28,336,6,0.672008127,15258,336,3,3
23549,2014/03/31,2009/07/26,105,9,0.52785832,19424,105,6,3
23550,2014/03/31,2008/07/01,68,15,0.61185236,16757,68,9,6
23551,2014/03/31,2012/07/27,54,5,0.69604888,14730,54,2,3
23552,2014/03/31,2009/04/25,41,13,0.603481076,16989,41,6,7
23553,2014/03/31,2008/03/17,67,11,0.659104295,15552,67,0,11
23554,2014/03/31,2010/12/13,354,10,0.936928702,10940,354,8,2
23555,2014/03/31,2012/07/19,130,11,0.597093091,17166,130,6,5
23556,2014/03/31,2012/09/19,23,17,0.71153499,14404,23,9,8
23557,2014/03/31,2009/01/26,76,7,0.881233878,11630,76,3,4
23558,2014/03/31,2012/01/25,36,12,0.775165267,13221,36,2,10
23559,2014/03/31,2012/04/17,6,15,0.7074275059999999,14484,6,6,9
23560,2014/03/31,2007/03/19,204,9,0.846236888,12107,204,8,1
23561,2014/03/31,2011/12/30,153,12,0.671046702,15267,153,7,5
23562,2014/03/31,2005/05/29,8,11,0.634473277,16147,8,0,11
23563,2014/03/31,2012/09/21,24,12,0.621323387,16488,24,4,8
23564,2014/03/31,2012/09/16,263,12,0.802359991,12767,263,9,3
23565,2014/03/31,2011/04/22,269,10,0.899155548,11392,269,6,4
23566,2014/03/31,2010/07/01,112,9,0.484480605,21140,112,2,7
23567,2014/03/31,2011/05/21,130,11,0.629193955,16277,130,0,11
23568,2014/03/31,2006/10/04,6,7,0.515574464,19862,6,3,4
23569,2014/03/31,2008/04/22,49,10,0.735068198,13930,49,5,5
23570,2014/03/31,2012/08/14,86,10,0.530560651,19299,86,8,2
23571,2014/03/31,2008/05/21,1,11,0.622523711,16448,1,3,8
23572,2014/03/31,2007/10/23,197,15,0.7873133409999999,13005,197,12,3
23573,2014/03/31,2010/10/01,179,2,0.675,15168,179,0,2
23574,2014/03/31,2009/08/27,76,11,0.750066681,13647,76,6,5
23575,2014/03/31,2011/09/03,79,12,0.391284404,26160,79,3,9
23576,2014/03/31,2008/04/23,339,12,0.639017233,16016,339,11,1
23577,2014/03/31,2011/11/23,120,18,0.70180646,14581,120,13,5
23578,2014/03/31,2010/08/04,134,11,0.547336971,18693,134,5,6
23579,2014/03/31,2012/01/20,7,8,0.8105824090000001,12620,7,1,7
23580,2014/03/31,2012/09/11,105,8,0.578042495,17696,105,3,5
23581,2014/03/31,2005/12/30,101,11,0.576942862,17729,101,3,8
23582,2014/03/31,2010/06/09,124,16,0.688125,14864,124,10,6
23583,2014/03/31,2007/03/15,46,12,0.78104391,13095,46,5,7
23584,2014/03/31,2010/06/10,24,12,0.618349356,16539,24,6,6
23585,2014/03/31,2010/01/14,124,14,0.521332654,19615,124,10,4
23586,2014/03/31,2010/06/13,7,12,0.659135619,15514,7,3,9
23587,2014/03/31,2012/09/07,13,10,0.788981481,12960,13,7,3
23588,2014/03/31,2009/06/11,3,14,0.658486605,15528,3,8,6
23589,2014/03/31,2012/03/16,113,10,0.932935219,10960,113,8,2
23590,2014/03/31,2006/11/30,70,11,0.8343198690000001,12255,70,0,11
23591,2014/03/31,2009/10/14,531,9,0.93740717,10907,531,9,0
23592,2014/03/31,2007/11/11,151,8,0.70289584,14545,151,6,2
23593,2014/03/31,2012/01/14,29,11,0.605122817,16895,29,6,5
23594,2014/03/31,2007/09/20,118,8,0.633796032,16130,118,5,3
23595,2014/03/31,2010/09/07,350,2,0.788765432,12960,350,0,2
23596,2014/03/31,2011/04/01,26,11,0.621146017,16457,26,6,5
23597,2014/03/31,2012/03/23,477,8,0.826491753,12368,477,8,0
23598,2014/03/31,2012/06/09,188,11,0.8233596459999999,12415,188,5,6
23599,2014/03/31,2011/07/29,128,13,0.6518982010000001,15678,128,5,8
23600,2014/03/31,2012/06/09,161,12,0.647920629,15774,161,6,6
23601,2014/03/31,2011/04/27,90,5,0.841608334,12143,90,1,4
23602,2014/03/31,2012/07/07,25,7,0.7949268820000001,12856,25,4,3
23603,2014/03/31,2012/06/07,68,8,0.761972115,13412,68,5,3
23604,2014/03/31,2007/05/15,7,13,0.7157477059999999,14277,7,4,9
23605,2014/03/31,2011/01/24,105,9,0.661315125,15451,105,0,9
23606,2014/03/31,2011/05/19,135,12,0.680304947,15019,135,3,9
23607,2014/03/31,2006/11/17,122,8,0.7175,14240,122,4,4
23608,2014/03/31,2012/05/28,585,6,0.7333333329999999,13932,585,6,0
23609,2014/03/31,2012/08/07,259,6,0.7333333329999999,13932,259,2,4
23610,2014/03/31,2010/11/15,300,11,0.760309593,13437,300,7,4
23611,2014/03/31,2011/08/13,132,11,0.696366053,14670,132,8,3
23612,2014/03/31,2013/03/08,13,8,0.8689689490000001,11755,13,2,6
23613,2014/03/31,2010/02/05,118,5,0.898671476,11366,118,2,3
23614,2014/03/31,2006/06/16,250,9,0.7655884559999999,13340,250,5,4
23615,2014/03/31,2006/12/26,136,8,0.6360347510000001,16057,136,5,3
23616,2014/03/31,2009/07/31,284,11,0.972462623,10501,284,8,3
23617,2014/03/31,2009/06/22,9,16,0.624736295,16344,9,4,12
23618,2014/03/31,2008/08/15,163,12,0.709653183,14388,163,1,11
23619,2014/03/31,2009/09/02,143,8,0.7081647940000001,14418,143,6,2
23620,2014/03/31,2009/08/20,16,10,0.7186738,14206,16,6,4
23621,2014/03/31,2013/02/14,71,14,0.656639439,15548,71,3,11
23622,2014/03/31,2011/10/06,115,12,0.4325,23604,115,10,2
23623,2014/03/31,2009/08/07,25,13,0.640588604,15936,25,4,9
23624,2014/03/31,2006/09/20,13,14,0.7379599509999999,13833,13,7,7
23625,2014/03/31,2012/09/26,1,16,0.686449465,14871,1,2,14
23626,2014/03/31,2011/06/12,18,9,0.6969384129999999,14646,18,6,3
23627,2014/03/31,2012/03/27,275,7,0.5496526660000001,18570,275,3,4
23628,2014/03/31,2012/01/25,4,8,0.688867441,14816,4,4,4
23629,2014/03/31,2012/10/24,15,12,0.5579526570000001,18292,15,5,7
23630,2014/03/31,2011/03/29,494,9,0.920404942,11088,494,9,0
23631,2014/03/31,2013/03/23,35,16,0.924375,11040,35,3,13
23632,2014/03/31,2006/02/26,105,15,0.5105332929999999,19989,105,10,5
23633,2014/03/31,2012/04/27,167,12,0.580047746,17593,167,7,5
23634,2014/03/31,2012/10/01,273,7,0.503623532,20262,273,5,2
23635,2014/03/31,2013/01/10,38,11,0.699833345,14581,38,1,10
23636,2014/03/31,2011/07/27,314,10,0.6275491999999999,16260,314,9,1
23637,2014/03/31,2012/11/12,73,7,0.899413839,11345,73,3,4
23638,2014/03/31,2010/09/26,22,10,0.690008115,14788,22,6,4
23639,2014/03/31,2012/06/23,73,13,0.606644471,16820,73,8,5
23640,2014/03/31,2009/12/09,117,5,1.122095018,9093,117,4,1
23641,2014/03/31,2012/11/26,4,12,0.689768794,14792,4,4,8
23642,2014/03/31,2011/01/27,151,9,0.6891145479999999,14806,151,0,9
23643,2014/03/31,2012/04/14,20,14,0.689305452,14801,20,6,8
23644,2014/03/31,2012/09/21,119,8,0.609384744,16741,119,3,5
23645,2014/03/31,2012/07/10,223,10,0.74702768,13656,223,6,4
23646,2014/03/31,2011/01/20,107,12,0.620876446,16430,107,7,5
23647,2014/03/31,2012/09/13,1,9,0.738374955,13815,1,5,4
23648,2014/03/31,2012/05/25,48,19,0.530591417,19225,48,11,8
23649,2014/03/31,2011/03/06,107,15,0.8162491999999999,12496,107,1,14
23650,2014/03/31,2008/11/25,61,11,0.6637901860000001,15366,61,5,6
23651,2014/03/31,2013/03/15,116,9,0.797710777,12786,116,1,8
23652,2014/03/31,2007/11/13,163,12,0.7816969420000001,13047,163,8,4
23653,2014/03/31,2008/01/24,321,6,0.7394004209999999,13793,321,4,2
23654,2014/03/31,2011/08/09,19,4,0.555658167,18354,19,2,2
23655,2014/03/31,2011/06/03,3,11,0.735108852,13872,3,2,9
23656,2014/03/31,2005/09/14,49,14,0.6213979279999999,16410,49,7,7
23657,2014/03/31,2010/05/30,266,7,0.851142738,11980,266,6,1
23658,2014/03/31,2006/08/15,123,7,0.8114914440000001,12565,123,2,5
23659,2014/03/31,2012/02/25,224,14,0.891507388,11437,224,11,3
23660,2014/03/31,2008/12/16,12,15,0.578305825,17631,12,7,8
23661,2014/03/31,2007/05/21,315,7,0.736193949,13849,315,5,2
23662,2014/03/31,2013/01/08,57,10,0.756868597,13470,57,5,5
23663,2014/03/31,2007/11/15,21,16,0.781008963,13053,21,6,10
23664,2014/03/31,2006/01/19,33,12,0.441739752,23078,33,8,4
23665,2014/03/31,2011/04/05,61,6,0.7702274440000001,13234,61,0,6
23666,2014/03/31,2005/05/26,19,16,0.50042665,20368,19,7,9
23667,2014/03/31,2011/09/09,20,14,0.566488439,17992,20,11,3
23668,2014/03/31,2010/01/28,257,6,0.67848156,15022,257,2,4
23669,2014/03/31,2012/07/21,419,6,0.644554424,15811,419,6,0
23670,2014/03/31,2006/06/23,11,6,0.741610509,13741,11,4,2
23671,2014/03/31,2007/11/06,257,8,0.795564057,12809,257,4,4
23672,2014/03/31,2005/06/15,10,12,0.5935094360000001,17168,10,6,6
23673,2014/03/31,2008/11/28,180,2,0.67,15208,180,0,2
23674,2014/03/31,2006/10/01,18,11,0.577722143,17635,18,3,8
23675,2014/03/31,2011/04/03,21,20,0.674965545,15092,21,6,14
23676,2014/03/31,2012/05/06,399,9,0.922003983,11048,399,9,0
23677,2014/03/31,2009/09/04,7,10,0.7266329009999999,14018,7,5,5
23678,2014/03/31,2008/10/22,128,11,0.774844428,13145,128,2,9
23679,2014/03/31,2012/06/24,3,11,0.818076954,12449,3,3,8
23680,2014/03/31,2008/10/20,78,2,0.67,15199,78,0,2
23681,2014/03/31,2006/01/07,233,9,0.8565780620000001,11888,233,7,2
23682,2014/03/31,2012/10/11,141,8,0.771923281,13191,141,2,6
23683,2014/03/31,2012/12/25,43,5,0.6668339010000001,15268,43,2,3
23684,2014/03/31,2010/03/01,113,5,0.5534973360000001,18394,113,1,4
23685,2014/03/31,2012/05/23,144,11,0.577797389,17620,144,6,5
23686,2014/03/31,2011/05/11,245,15,0.739283276,13771,245,9,6
23687,2014/03/31,2013/03/02,36,9,0.620578517,16404,36,0,9
23688,2014/03/31,2007/07/18,87,4,0.6915625,14720,87,0,4
23689,2014/03/31,2012/03/18,119,10,0.6657157810000001,15291,119,4,6
23690,2014/03/31,2012/06/28,60,10,0.7732583759999999,13163,60,5,5
23691,2014/03/31,2011/11/05,23,13,0.518137759,19643,23,7,6
23692,2014/03/31,2006/11/18,31,10,0.6061928870000001,16787,31,6,4
23693,2014/03/31,2012/01/12,32,12,0.549736359,18510,32,7,5
23694,2014/03/31,2011/12/11,667,5,0.77,13215,667,5,0
23695,2014/03/31,2008/01/12,139,9,0.982655722,10355,139,5,4
23696,2014/03/31,2011/06/14,279,7,0.628806081,16182,279,0,7
23697,2014/03/31,2010/12/05,26,15,0.7392052309999999,13765,26,9,6
23698,2014/03/31,2006/07/31,8,13,0.6932992640000001,14676,8,6,7
23699,2014/03/31,2007/10/01,62,3,0.524944278,19382,62,0,3
23700,2014/03/31,2006/09/28,191,7,0.992662699,10249,191,2,5
23701,2014/03/31,2011/09/09,214,9,0.857674928,11862,214,8,1
23702,2014/03/31,2011/07/02,29,10,0.724241777,14046,29,4,6
23703,2014/03/31,2006/10/09,6,15,0.701699779,14496,6,5,10
23704,2014/03/31,2008/02/27,7,19,0.469801848,21650,7,9,10
23705,2014/03/31,2012/03/04,36,7,0.7587243570000001,13405,36,0,7
23706,2014/03/31,2006/08/29,15,10,0.6822788890000001,14902,15,1,9
23707,2014/03/31,2012/11/26,73,7,0.879564841,11559,73,2,5
23708,2014/03/31,2009/04/04,13,9,0.893817478,11374,13,4,5
23709,2014/03/31,2010/07/17,284,13,0.56693453,17932,284,8,5
23710,2014/03/31,2009/06/30,2,11,0.8285321920000001,12270,2,1,10
23711,2014/03/31,2008/07/09,37,12,0.62576916,16245,37,4,8
23712,2014/03/31,2007/05/01,115,9,0.784548892,12957,115,4,5
23713,2014/03/31,2011/04/07,6,10,0.616559296,16485,6,6,4
23714,2014/03/31,2009/08/18,176,15,0.928620249,10944,176,7,8
23715,2014/03/31,2009/09/19,18,10,0.70583206,14398,18,2,8
23716,2014/03/31,2012/10/27,35,13,0.696556995,14589,35,2,11
23717,2014/03/31,2010/08/10,325,14,0.62615688,16229,325,11,3
23718,2014/03/31,2012/02/15,91,9,0.8031631359999999,12652,91,1,8
23719,2014/03/31,2013/01/25,35,10,0.732177704,13877,35,0,10
23720,2014/03/31,2011/03/11,391,14,0.410087595,24773,391,14,0
23721,2014/03/31,2012/07/13,607,2,0.625,16254,607,2,0
23722,2014/03/31,2012/12/05,2,10,0.583620016,17406,2,5,5
23723,2014/03/31,2006/05/26,178,6,0.695082113,14614,178,4,2
23724,2014/03/31,2011/06/23,32,19,0.8302215140000001,12234,32,7,12
23725,2014/03/31,2007/05/16,143,5,0.920547449,11033,143,4,1
23726,2014/03/31,2008/01/17,4,13,0.5645816889999999,17989,4,5,8
23727,2014/03/31,2013/02/03,44,9,0.663570729,15305,44,2,7
23728,2014/03/31,2010/05/16,9,11,0.755509597,13442,9,4,7
23729,2014/03/31,2010/09/21,40,12,0.666643471,15233,40,4,8
23730,2014/03/31,2013/01/01,34,14,0.816471534,12436,34,0,14
23731,2014/03/31,2010/01/03,125,14,0.571448672,17768,125,7,7
23732,2014/03/31,2012/04/05,337,16,0.697968653,14547,337,13,3
23733,2014/03/31,2012/11/06,11,7,1.265353938,8024,11,4,3
23734,2014/03/31,2007/07/25,45,5,0.795118647,12769,45,0,5
23735,2014/03/31,2007/10/01,67,9,0.771936588,13152,67,5,4
23736,2014/03/31,2007/04/02,208,4,1.461959965,6944,208,3,1
23737,2014/03/31,2011/08/05,2,13,0.7384025609999999,13747,2,1,12
23738,2014/03/31,2012/09/19,174,7,1.027708818,9877,174,3,4
23739,2014/03/31,2011/01/13,32,14,0.778005519,13046,32,6,8
23740,2014/03/31,2012/11/30,162,11,0.762607258,13309,162,2,9
23741,2014/03/31,2009/07/05,142,8,0.8470472379999999,11982,142,6,2
23742,2014/03/31,2005/11/08,236,13,0.513632269,19759,236,8,5
23743,2014/03/31,2011/08/11,103,8,0.525246623,19321,103,4,4
23744,2014/03/31,2013/03/15,5,11,0.6620934479999999,15324,5,0,11
23745,2014/03/31,2009/06/22,196,12,0.897731174,11301,196,10,2
23746,2014/03/31,2008/09/18,7,7,0.677841919,14967,7,5,2
23747,2014/03/31,2012/04/05,166,7,0.7755978590000001,13080,166,4,3
23748,2014/03/31,2007/12/18,337,9,0.943406491,10753,337,3,6
23749,2014/03/31,2012/05/20,208,11,0.7854502520000001,12915,208,7,4
23750,2014/03/31,2011/06/02,226,12,0.727474182,13944,226,6,6
23751,2014/03/31,2005/01/10,44,9,0.539367257,18807,44,2,7
23752,2014/03/31,2012/09/28,14,5,0.7016324270000001,14457,14,1,4
23753,2014/03/31,2007/08/21,104,7,0.974070873,10413,104,6,1
23754,2014/03/31,2007/05/26,114,11,0.610178679,16622,114,4,7
23755,2014/03/31,2010/11/25,225,8,0.791664195,12811,225,6,2
23756,2014/03/31,2012/08/11,92,13,0.540538351,18761,92,7,6
23757,2014/03/31,2012/03/10,172,15,0.7821766290000001,12965,172,12,3
23758,2014/03/31,2006/02/23,136,5,0.766309227,13233,136,0,5
23759,2014/03/31,2010/04/30,69,25,0.768208333,13200,69,15,10
23760,2014/03/31,2006/10/12,85,10,0.823746548,12310,85,7,3
23761,2014/03/31,2011/12/14,26,12,0.55021272,18428,26,11,1
23762,2014/03/31,2012/04/18,42,12,0.936666667,10824,42,6,6
23763,2014/03/31,2011/01/16,22,10,0.529526745,19144,22,8,2
23764,2014/03/31,2008/05/25,124,17,0.564330809,17962,124,8,9
23765,2014/03/31,2011/07/09,126,6,0.807926032,12546,126,2,4
23766,2014/03/31,2011/11/20,6,8,0.8211446859999999,12344,6,2,6
23767,2014/03/31,2012/10/01,10,11,0.563344264,17992,10,2,9
23768,2014/03/31,2013/01/03,22,11,0.703844444,14400,22,0,11
23769,2014/03/31,2009/12/15,438,6,0.61790658,16399,438,6,0
23770,2014/03/31,2009/10/10,18,27,0.647037037,15660,18,14,13
23771,2014/03/31,2012/04/08,67,12,0.732529641,13832,67,3,9
23772,2014/03/31,2005/08/20,216,6,0.856482671,11830,216,2,4
23773,2014/03/31,2011/10/23,67,7,0.575120054,17617,67,0,7
23774,2014/03/31,2012/01/02,72,13,0.566056543,17898,72,5,8
23775,2014/03/31,2007/07/11,75,9,0.7826087290000001,12945,75,3,6
23776,2014/03/31,2012/03/19,95,16,0.609317895,16625,95,15,1
23777,2014/03/31,2009/06/25,373,9,0.67423123,15024,373,9,0
23778,2014/03/31,2009/11/25,74,19,0.378240412,26779,74,9,10
23779,2014/03/31,2008/03/15,30,10,0.624085531,16228,30,4,6
23780,2014/03/31,2011/09/25,32,8,0.7191365479999999,14083,32,7,1
23781,2014/03/31,2011/02/10,4,5,1.161805667,8717,4,0,5
23782,2014/03/31,2012/12/15,57,8,0.83945126,12064,57,1,7
23783,2014/03/31,2007/07/25,75,31,0.399779717,25331,75,15,16
23784,2014/03/31,2013/03/02,71,13,0.566628616,17871,71,2,11
23785,2014/03/31,2011/11/16,52,9,0.447596252,22623,52,1,8
23786,2014/03/31,2012/03/20,17,13,0.548594106,18458,17,6,7
23787,2014/03/31,2012/02/28,19,16,0.49820933,20322,19,12,4
23788,2014/03/31,2011/12/20,102,15,0.7435952990000001,13615,102,5,10
23789,2014/03/31,2008/02/04,205,6,0.726666667,13932,205,4,2
23790,2014/03/31,2012/04/25,36,25,0.750291305,13491,36,9,16
23791,2014/03/31,2009/09/19,109,13,0.981959643,10308,109,6,7
23792,2014/03/31,2005/11/14,138,18,0.643857506,15720,138,13,5
23793,2014/03/31,2007/09/13,153,10,0.68237055,14832,153,9,1
23794,2014/03/31,2012/09/13,125,24,0.8516899509999999,11882,125,10,14
23795,2014/03/31,2008/12/11,270,10,0.663613352,15249,270,9,1
23796,2014/03/31,2006/10/15,73,11,0.711620253,14220,73,4,7
23797,2014/03/31,2012/01/03,27,10,0.8022770159999999,12613,27,9,1
23798,2014/03/31,2011/05/13,68,17,0.509584529,19857,68,6,11
23799,2014/03/31,2012/03/17,18,7,0.755264611,13397,18,0,7
23800,2014/03/31,2008/06/03,277,13,0.645741911,15669,277,9,4
23801,2014/03/31,2012/06/29,217,8,0.504211392,20067,217,4,4
23802,2014/03/31,2011/04/21,271,5,0.7120000000000001,14210,271,3,2
23803,2014/03/31,2011/01/20,4,15,0.645023911,15683,4,4,11
23804,2014/03/31,2012/02/16,77,9,0.641360005,15772,77,0,9
23805,2014/03/31,2012/11/22,161,6,0.87543149,11553,161,2,4
23806,2014/03/31,2010/04/01,108,10,0.71854849,14075,108,4,6
23807,2014/03/31,2005/04/08,58,11,0.63923393,15821,58,6,5
23808,2014/03/31,2012/11/01,103,9,0.703453673,14376,103,3,6
23809,2014/03/31,2007/10/02,1,8,0.617464892,16378,1,3,5
23810,2014/03/31,2011/01/04,102,13,0.721512557,14016,102,5,8
23811,2014/03/31,2011/05/16,15,12,0.592377995,17069,15,0,12
23812,2014/03/31,2009/08/08,153,5,0.773833907,13065,153,2,3
23813,2014/03/31,2012/05/11,6,7,0.761354018,13279,6,6,1
23814,2014/03/31,2012/03/28,19,9,0.7039249409999999,14362,19,3,6
23815,2014/03/31,2005/09/09,108,10,0.700152365,14439,108,6,4
23816,2014/03/31,2005/07/19,7,16,0.544327948,18570,7,6,10
23817,2014/03/31,2009/09/05,191,13,0.5131444820000001,19698,191,4,9
23818,2014/03/31,2011/11/08,347,15,0.6930167979999999,14585,347,13,2
23819,2014/03/31,2010/10/15,445,5,1.141658195,8853,445,5,0
23820,2014/03/31,2006/12/20,103,13,0.687686603,14697,103,9,4
23821,2014/03/31,2012/03/02,42,12,0.678304027,14900,42,6,6
23822,2014/03/31,2008/06/05,233,11,0.47068601,21472,233,6,5
23823,2014/03/31,2008/10/16,5,13,0.8014591590000001,12610,5,0,13
23824,2014/03/31,2011/03/15,6,8,0.650695428,15530,6,0,8
23825,2014/03/31,2012/01/27,81,9,0.8237404209999999,12266,81,0,9
23826,2014/03/31,2010/11/25,368,12,0.8404258859999999,12022,368,12,0
23827,2014/03/31,2013/01/17,98,9,0.490983137,20577,98,0,9
23828,2014/03/31,2006/10/11,14,10,0.629512681,16047,14,7,3
23829,2014/03/31,2011/11/05,261,10,0.897019803,11261,261,5,5
23830,2014/03/31,2012/06/18,168,8,0.7057416329999999,14313,168,3,5
23831,2014/03/31,2012/03/22,288,6,0.725,13932,288,4,2
23832,2014/03/31,2011/04/07,288,14,0.540698073,18680,288,10,4
23833,2014/03/31,2012/09/02,60,10,0.483,20910,60,4,6
23834,2014/03/31,2012/07/22,153,8,0.791984314,12750,153,3,5
23835,2014/03/31,2010/05/08,361,3,1.366860701,7387,361,1,2
23836,2014/03/31,2011/08/24,176,18,0.657240885,15360,176,10,8
23837,2014/03/31,2010/03/22,3,8,0.728044137,13866,3,0,8
23838,2014/03/31,2008/02/24,11,14,0.8613523890000001,11720,11,6,8
23839,2014/03/31,2005/11/27,480,6,0.991084929,10185,480,6,0
23840,2014/03/31,2005/09/06,411,7,0.6653988129999999,15170,411,7,0
23841,2014/03/31,2008/10/16,20,6,0.611001816,16520,20,0,6
23842,2014/03/31,2010/03/27,126,9,0.764104777,13209,126,7,2
23843,2014/03/31,2010/05/31,2,17,0.619809003,16283,2,11,6
23844,2014/03/31,2009/12/06,281,11,0.7197125940000001,14022,281,8,3
23845,2014/03/31,2010/06/05,39,16,0.7514796340000001,13429,39,9,7
23846,2014/03/31,2011/07/23,44,12,0.848956844,11887,44,6,6
23847,2014/03/31,2010/07/17,137,9,0.630316677,16010,137,4,5
23848,2014/03/31,2011/06/09,47,7,0.687249881,14683,47,1,6
23849,2014/03/31,2011/05/13,225,3,0.8753465779999999,11527,225,1,2
23850,2014/03/31,2009/12/30,156,12,0.704033215,14331,156,8,4
23851,2014/03/31,2010/05/25,155,13,0.725870206,13899,155,7,6
23852,2014/03/31,2012/10/11,29,19,0.654736842,15409,29,4,15
23853,2014/03/31,2012/08/10,3,14,0.590810494,17076,3,9,5
23854,2014/03/31,2011/04/16,39,9,0.595934196,16929,39,4,5
23855,2014/03/31,2008/05/24,289,10,0.861298557,11713,289,8,2
23856,2014/03/31,2008/10/08,17,22,0.7583636640000001,13298,17,16,6
23857,2014/03/31,2008/12/02,25,9,0.7858411909999999,12833,25,5,4
23858,2014/03/31,2006/07/30,152,9,0.8888259140000001,11345,152,5,4
23859,2014/03/31,2005/06/03,224,5,0.938593503,10743,224,2,3
23860,2014/03/31,2012/10/30,35,13,0.624011513,16156,35,6,7
23861,2014/03/31,2008/10/23,84,7,0.712022035,14159,84,2,5
23862,2014/03/31,2011/12/09,44,11,0.6455234679999999,15617,44,8,3
23863,2014/03/31,2010/03/06,89,7,0.67563032,14921,89,4,3
23864,2014/03/31,2011/07/20,253,12,0.843869915,11946,253,4,8
23865,2014/03/31,2012/01/27,1,8,0.84,12000,1,7,1
23866,2014/03/31,2006/12/13,21,15,0.67275846,14983,21,8,7
23867,2014/03/31,2009/02/12,31,10,0.5964337279999999,16900,31,8,2
23868,2014/03/31,2008/05/10,12,15,0.6739959879999999,14955,12,9,6
23869,2014/03/31,2010/12/05,199,16,0.609029003,16550,199,11,5
23870,2014/03/31,2013/01/05,88,18,0.930204892,10835,88,3,15
23871,2014/03/31,2011/07/18,399,11,0.69820575,14435,399,11,0
23872,2014/03/31,2009/12/26,102,13,0.609293271,16541,102,7,6
23873,2014/03/31,2011/11/16,17,14,0.679315133,14835,17,5,9
23874,2014/03/31,2009/12/14,220,8,0.804187216,12531,220,6,2
23875,2014/03/31,2008/11/18,51,9,0.644009588,15645,51,1,8
23876,2014/03/31,2012/04/07,31,19,0.720291679,13988,31,6,13
23877,2014/03/31,2012/11/01,22,12,0.695407234,14488,22,2,10
23878,2014/03/31,2010/05/08,353,7,0.639900915,15744,353,5,2
23879,2014/03/31,2012/08/06,69,8,0.8264388840000001,12190,69,6,2
23880,2014/03/31,2009/07/17,207,12,0.705170097,14286,207,9,3
23881,2014/03/31,2010/11/07,26,10,0.729863788,13802,26,6,4
23882,2014/03/31,2007/11/08,586,7,1.0,10073,586,7,0
23883,2014/03/31,2007/03/09,97,8,0.723937042,13914,97,4,4
23884,2014/03/31,2012/11/10,298,14,0.694179876,14510,298,6,8
23885,2014/03/31,2010/07/07,28,15,0.860279296,11708,28,9,6
23886,2014/03/31,2007/10/21,202,11,0.78368503,12852,202,3,8
23887,2014/03/31,2011/03/23,45,12,0.77013993,13078,45,7,5
23888,2014/03/31,2010/01/14,38,12,0.6211390689999999,16215,38,9,3
23889,2014/03/31,2011/08/03,18,13,0.682821695,14750,18,7,6
23890,2014/03/31,2011/01/04,42,8,0.426415598,23619,42,4,4
23891,2014/03/31,2006/07/01,258,8,0.698837693,14411,258,5,3
23892,2014/03/31,2013/02/11,40,10,0.622812616,16170,40,0,10
23893,2014/03/31,2013/01/10,193,6,0.8542326290000001,11787,193,2,4
23894,2014/03/31,2011/12/23,178,12,0.8762894940000001,11489,178,6,6
23895,2014/03/31,2007/05/30,14,6,0.885064181,11374,14,2,4
23896,2014/03/31,2011/06/09,30,8,0.55598089,18106,30,1,7
23897,2014/03/31,2010/12/13,81,11,0.799757687,12587,81,4,7
23898,2014/03/31,2009/09/18,135,11,0.742039071,13565,135,5,6
23899,2014/03/31,2012/12/01,17,6,0.68825971,14624,17,1,5
23900,2014/03/31,2012/10/01,46,9,0.627632826,16036,46,4,5
23901,2014/03/31,2008/12/25,27,11,0.679984461,14801,27,1,10
23902,2014/03/31,2012/04/24,32,4,0.455346123,22102,32,1,3
23903,2014/03/31,2012/12/15,56,5,1.463968577,6874,56,3,2
23904,2014/03/31,2013/01/20,387,4,0.8762518509999999,11483,387,4,0
23905,2014/03/31,2012/12/13,107,9,0.7556830640000001,13315,107,2,7
23906,2014/03/31,2007/12/31,211,10,0.848676619,11856,211,5,5
23907,2014/03/31,2008/07/26,103,8,0.695000345,14477,103,6,2
23908,2014/03/31,2011/03/14,27,8,0.71636642,14044,27,0,8
23909,2014/03/31,2013/01/12,65,6,0.635635939,15827,65,1,5
23910,2014/03/31,2011/01/15,20,6,0.675129857,14901,20,2,4
23911,2014/03/31,2006/06/23,79,11,0.698531352,14401,79,9,2
23912,2014/03/31,2012/05/29,90,18,0.882689776,11395,90,12,6
23913,2014/03/31,2008/11/16,77,11,0.6949018929999999,14474,77,6,5
23914,2014/03/31,2010/11/01,93,10,0.630515955,15951,93,3,7
23915,2014/03/31,2007/08/19,39,6,0.593306195,16950,39,0,6
23916,2014/03/31,2012/11/21,167,14,0.558571429,18004,167,4,10
23917,2014/03/31,2010/03/01,15,12,0.611709246,16440,15,4,8
23918,2014/03/31,2011/09/23,74,14,0.8401512240000001,11969,74,2,12
23919,2014/03/31,2006/05/31,85,7,0.532067834,18899,85,5,2
23920,2014/03/31,2012/12/08,96,11,0.634299773,15852,96,6,5
23921,2014/03/31,2008/08/24,330,10,0.595954357,16870,330,8,2
23922,2014/03/31,2009/02/13,78,9,0.562840107,17862,78,7,2
23923,2014/03/31,2012/07/30,226,10,0.6671329970000001,15068,226,8,2
23924,2014/03/31,2007/03/24,34,4,0.634712382,15837,34,3,1
23925,2014/03/31,2012/03/16,50,12,0.552705928,18186,50,7,5
23926,2014/03/31,2007/08/04,151,15,0.7416321109999999,13553,151,10,5
23927,2014/03/31,2013/03/06,98,16,0.8457097179999999,11885,98,2,14
23928,2014/03/31,2012/08/22,117,7,0.731355599,13743,117,1,6
23929,2014/03/31,2009/11/20,139,9,0.636533882,15790,139,5,4
23930,2014/03/31,2012/10/18,67,7,0.701911446,14319,67,2,5
23931,2014/03/31,2012/11/26,189,10,0.6832979809999999,14709,189,4,6
23932,2014/03/31,2007/12/26,424,9,0.772222222,13014,424,9,0
23933,2014/03/31,2009/07/07,97,9,0.700078729,14353,97,5,4
23934,2014/03/31,2011/07/11,11,7,0.8350029090000001,12033,11,2,5
23935,2014/03/31,2011/04/01,19,11,0.586373505,17135,19,10,1
23936,2014/03/31,2012/12/15,155,15,0.601711291,16695,155,6,9
23937,2014/03/31,2008/03/21,51,11,0.8139283690000001,12341,51,4,7
23938,2014/03/31,2008/04/29,118,11,0.8234680659999999,12197,118,7,4
23939,2014/03/31,2009/04/02,32,10,0.6606051039999999,15204,32,5,5
23940,2014/03/31,2012/03/06,599,5,0.76,13215,599,5,0
23941,2014/03/31,2012/03/18,491,5,0.76,13215,491,5,0
23942,2014/03/31,2013/03/01,11,7,0.788633687,12735,11,0,7
23943,2014/03/31,2005/09/09,69,5,0.6759999999999999,14855,69,2,3
23944,2014/03/31,2011/10/01,128,7,0.825447596,12165,128,3,4
23945,2014/03/31,2011/07/22,7,10,0.706107165,14221,7,4,6
23946,2014/03/31,2013/03/24,127,17,0.598691867,16772,127,0,17
23947,2014/03/31,2012/12/29,16,12,0.677221285,14827,16,3,9
23948,2014/03/31,2010/10/10,18,10,0.693034925,14488,18,1,9
23949,2014/03/31,2010/11/29,113,13,0.541139977,18553,113,8,5
23950,2014/03/31,2010/02/08,222,18,0.709765995,14145,222,15,3
23951,2014/03/31,2010/11/01,396,11,0.84431455,11890,396,11,0
23952,2014/03/31,2009/08/09,5,12,0.8838536709999999,11358,5,4,8
23953,2014/03/31,2011/05/28,464,7,0.811601585,12369,464,7,0
23954,2014/03/31,2009/02/21,5,16,0.875632415,11464,5,9,7
23955,2014/03/31,2012/05/17,6,9,0.551418919,18204,6,8,1
23956,2014/03/31,2007/12/05,367,11,0.765955742,13105,367,11,0
23957,2014/03/31,2006/03/30,35,11,0.716570286,14007,35,7,4
23958,2014/03/31,2012/03/21,382,10,0.639659678,15691,382,10,0
23959,2014/03/31,2010/08/15,40,18,0.61428178,16339,40,13,5
23960,2014/03/31,2010/09/30,101,9,0.6396226420000001,15688,101,4,5
23961,2014/03/31,2009/03/27,75,11,0.627963577,15979,75,6,5
23962,2014/03/31,2011/09/13,79,6,1.067447872,9400,79,1,5
23963,2014/03/31,2012/08/09,26,9,0.63990051,15680,26,4,5
23964,2014/03/31,2010/11/25,99,10,0.510709559,19646,99,6,4
23965,2014/03/31,2005/04/17,38,8,0.578756345,17336,38,4,4
23966,2014/03/31,2011/08/29,20,16,0.546029388,18375,20,12,4
23967,2014/03/31,2008/03/07,153,6,0.845898322,11861,153,2,4
23968,2014/03/31,2008/01/11,210,8,0.716120628,14010,210,3,5
23969,2014/03/31,2010/11/11,80,11,0.665499834,15075,80,7,4
23970,2014/03/31,2011/08/22,264,13,0.84446633,11880,264,11,2
23971,2014/03/31,2010/01/06,144,12,0.6730229440000001,14906,144,7,5
23972,2014/03/31,2006/11/28,74,11,0.590562783,16987,74,3,8
23973,2014/03/31,2009/07/15,9,7,0.7006935809999999,14317,9,0,7
23974,2014/03/31,2009/02/03,348,9,0.8607859959999999,11654,348,8,1
23975,2014/03/31,2010/01/11,56,12,0.703014927,14269,56,5,7
23976,2014/03/31,2010/04/29,27,10,0.75062182,13364,27,0,10
23977,2014/03/31,2010/05/07,150,8,0.727273255,13793,150,7,1
23978,2014/03/31,2012/08/02,15,13,0.632643794,15856,15,1,12
23979,2014/03/31,2007/04/27,153,15,0.661702844,15157,153,4,11
23980,2014/03/31,2008/01/03,37,10,0.572024753,17533,37,3,7
23981,2014/03/31,2012/03/14,702,2,1.05,9551,702,2,0
23982,2014/03/31,2011/12/07,78,12,0.760045475,13194,78,7,5
23983,2014/03/31,2010/03/24,90,9,0.60752969,16504,90,7,2
23984,2014/03/31,2010/05/07,22,18,0.62717583,15987,22,6,12
23985,2014/03/31,2012/08/30,112,10,0.685410172,14628,112,6,4
23986,2014/03/31,2005/07/28,212,8,0.932575574,10751,212,5,3
23987,2014/03/31,2007/06/17,25,11,0.93618136,10708,25,6,5
23988,2014/03/31,2011/08/15,102,8,0.677884095,14788,102,3,5
23989,2014/03/31,2009/09/29,343,8,1.120648407,8945,343,7,1
23990,2014/03/31,2008/07/12,96,14,0.7723688059999999,12977,96,7,7
23991,2014/03/31,2007/03/19,323,6,0.972257251,10309,323,4,2
23992,2014/03/31,2008/10/19,106,8,0.685687898,14617,106,2,6
23993,2014/03/31,2012/03/31,73,12,0.791220494,12667,73,5,7
23994,2014/03/31,2009/11/14,311,8,0.725048832,13823,311,7,1
23995,2014/03/31,2009/10/26,73,11,0.7034688,14247,73,4,7
23996,2014/03/31,2013/03/30,150,5,0.7160321540000001,13995,150,1,4
23997,2014/03/31,2011/10/08,246,12,0.782191086,12811,246,10,2
23998,2014/03/31,2009/12/07,36,7,0.722854566,13862,36,1,6
23999,2014/03/31,2008/02/03,121,13,0.53537134,18716,121,6,7
24000,2014/03/31,2011/12/18,75,16,0.506698357,19775,75,5,11
24001,2014/03/31,2012/12/30,84,10,0.467571289,21427,84,1,9
24002,2014/03/31,2008/07/07,70,13,0.830754623,12059,70,5,8
24003,2014/03/31,2007/04/23,40,11,0.583457775,17170,40,4,7
24004,2014/03/31,2006/06/29,103,7,0.537004556,18655,103,4,3
24005,2014/03/31,2006/10/26,12,11,0.896371365,11175,12,4,7
24006,2014/03/31,2008/01/29,254,8,0.935199328,10711,254,5,3
24007,2014/03/31,2010/09/09,295,7,0.667365405,15008,295,3,4
24008,2014/03/31,2012/01/18,80,12,0.627073003,15972,80,8,4
24009,2014/03/31,2011/09/13,4,16,0.5759307610000001,17389,4,3,13
24010,2014/03/31,2009/10/08,29,9,0.873591555,11463,29,3,6
24011,2014/03/31,2007/10/20,118,11,0.7205842990000001,13897,118,8,3
24012,2014/03/31,2012/11/20,473,2,1.05,9536,473,2,0
24013,2014/03/31,2013/01/04,73,10,0.770668873,12992,73,0,10
24014,2014/03/31,2007/07/28,184,5,0.674,14855,184,1,4
24015,2014/03/31,2009/08/08,599,4,0.827719907,12096,599,4,0
24016,2014/03/31,2007/07/03,18,7,0.7940360059999999,12609,18,2,5
24017,2014/03/31,2012/05/01,153,6,0.535,18714,153,2,4
24018,2014/03/31,2010/07/10,275,6,0.803333333,12462,275,5,1
24019,2014/03/31,2008/11/10,125,6,0.803333333,12462,125,3,3
24020,2014/03/31,2012/09/12,399,9,0.608797056,16443,399,9,0
24021,2014/03/31,2012/01/16,39,4,0.514001232,19474,39,0,4
24022,2014/03/31,2006/12/26,12,8,0.7564253329999999,13232,12,0,8
24023,2014/03/31,2012/05/30,29,6,0.71959304,13908,29,0,6
24024,2014/03/31,2008/12/14,132,14,0.605409231,16531,132,11,3
24025,2014/03/31,2012/11/01,317,3,0.926277305,10804,317,0,3
24026,2014/03/31,2012/07/25,70,10,0.532,18810,70,5,5
24027,2014/03/31,2009/01/31,21,11,0.7098460670000001,14097,21,3,8
24028,2014/03/31,2008/05/06,206,8,0.631204188,15853,206,2,6
24029,2014/03/31,2008/12/21,83,11,0.8367893279999999,11957,83,7,4
24030,2014/03/31,2004/12/31,72,13,0.55955092,17881,72,8,5
24031,2014/03/31,2010/03/19,48,12,0.693434294,14428,48,6,6
24032,2014/03/31,2006/05/01,80,9,0.571385081,17508,80,4,5
24033,2014/03/31,2010/05/11,147,7,0.840787527,11898,147,1,6
24034,2014/03/31,2012/04/02,412,9,0.915708532,10924,412,9,0
24035,2014/03/31,2013/03/05,11,12,0.742669092,13469,11,3,9
24036,2014/03/31,2005/09/26,23,5,1.024011057,9768,23,4,1
24037,2014/03/31,2005/09/09,138,18,0.471541254,21210,138,9,9
24038,2014/03/31,2011/09/18,463,8,0.504224855,19835,463,8,0
24039,2014/03/31,2012/01/28,51,6,1.165772235,8579,51,4,2
24040,2014/03/31,2005/08/13,81,8,0.80433328,12434,81,4,4
24041,2014/03/31,2007/11/02,21,9,0.6476789070000001,15441,21,1,8
24042,2014/03/31,2012/11/20,168,10,0.639975042,15626,168,8,2
24043,2014/03/31,2009/09/11,38,14,0.776034456,12886,38,5,9
24044,2014/03/31,2008/05/23,56,9,0.817108768,12237,56,3,6
24045,2014/03/31,2009/09/08,29,10,0.491919217,20326,29,3,7
24046,2014/03/31,2011/04/06,425,7,0.745655903,13409,425,7,0
24047,2014/03/31,2004/12/20,101,15,0.608600475,16427,101,9,6
24048,2014/03/31,2009/09/11,214,8,0.705623235,14168,214,4,4
24049,2014/03/31,2007/07/12,24,8,0.879248901,11370,24,5,3
24050,2014/03/31,2008/09/04,9,7,0.904997284,11046,9,5,2
24051,2014/03/31,2007/05/17,194,9,0.717764055,13927,194,6,3
24052,2014/03/31,2011/06/03,191,11,0.698997203,14300,191,9,2
24053,2014/03/31,2010/07/24,89,8,0.6196918779999999,16130,89,3,5
24054,2014/03/31,2010/06/30,209,10,0.676857182,14767,209,9,1
24055,2014/03/31,2010/04/20,3,13,0.512072958,19518,3,10,3
24056,2014/03/31,2012/09/22,47,11,0.752100708,13286,47,7,4
24057,2014/03/31,2012/04/21,456,8,0.635,15736,456,8,0
24058,2014/03/31,2006/10/17,58,12,0.658239789,15180,58,8,4
24059,2014/03/31,2011/10/27,263,10,0.716756098,13940,263,6,4
24060,2014/03/31,2013/01/24,124,13,0.55363591,18045,124,6,7
24061,2014/03/31,2012/01/15,192,7,0.622218623,16055,192,2,5
24062,2014/03/31,2007/10/18,2,15,0.707679938,14116,2,0,15
24063,2014/03/31,2009/04/04,152,12,0.783292559,12753,152,3,9
24064,2014/03/31,2008/08/27,9,8,0.770004625,12973,9,3,5
24065,2014/03/31,2013/03/04,74,9,0.717639198,13919,74,1,8
24066,2014/03/31,2009/11/04,613,7,0.644217248,15503,613,7,0
24067,2014/03/31,2008/07/22,156,8,0.708506669,14096,156,5,3
24068,2014/03/31,2013/01/22,11,12,0.5726163989999999,17440,11,3,9
24069,2014/03/31,2005/09/19,144,13,0.651002086,15338,144,12,1
24070,2014/03/31,2013/01/20,35,5,0.764465202,13061,35,1,4
24071,2014/03/31,2007/11/30,358,6,0.716666667,13932,358,4,2
24072,2014/03/31,2012/12/14,224,6,0.716666667,13932,224,4,2
24073,2014/03/31,2009/03/03,236,8,0.8291405079999999,12042,236,5,3
24074,2014/03/31,2009/12/14,200,11,0.8773637959999999,11380,200,2,9
24075,2014/03/31,2012/03/24,309,13,0.8692669340000001,11486,309,7,6
24076,2014/03/31,2007/12/01,12,13,0.77559854,12873,12,6,7
24077,2014/03/31,2012/10/20,523,3,1.318229235,7573,523,3,0
24078,2014/03/31,2007/08/28,111,9,0.60060586,16621,111,6,3
24079,2014/03/31,2007/07/15,5,12,0.7860918179999999,12699,5,1,11
24080,2014/03/31,2010/07/02,21,12,0.752993136,13257,21,6,6
24081,2014/03/31,2011/08/24,165,5,0.895691852,11144,165,2,3
24082,2014/03/31,2012/07/28,47,11,0.5909039779999999,16892,47,0,11
24083,2014/03/31,2012/07/04,25,13,0.722135726,13822,25,4,9
24084,2014/03/31,2011/07/24,97,6,0.634018549,15742,97,1,5
24085,2014/03/31,2012/02/22,413,10,0.805374435,12392,413,10,0
24086,2014/03/31,2011/03/20,203,10,0.630573739,15826,203,8,2
24087,2014/03/31,2012/03/24,529,10,0.728280543,13702,529,10,0
24088,2014/03/31,2007/04/11,14,4,1.23368818,8088,14,2,2
24089,2014/03/31,2005/04/21,164,13,0.736985745,13539,164,5,8
24090,2014/03/31,2007/07/31,122,8,0.6654231970000001,14993,122,3,5
24091,2014/03/31,2009/09/02,17,15,0.701230056,14227,17,1,14
24092,2014/03/31,2008/12/25,4,12,0.657063163,15183,4,4,8
24093,2014/03/31,2009/02/06,121,18,0.603164641,16539,121,14,4
24094,2014/03/31,2012/03/06,106,6,0.7223955390000001,13809,106,0,6
24095,2014/03/31,2008/04/07,520,7,0.677860832,14716,520,7,0
24096,2014/03/31,2010/02/15,165,8,0.7555169279999999,13203,165,3,5
24097,2014/03/31,2010/10/31,188,4,0.570942705,17471,188,0,4
24098,2014/03/31,2012/05/31,239,13,0.867490868,11498,239,7,6
24099,2014/03/31,2005/11/25,140,9,0.601267784,16588,140,3,6
24100,2014/03/31,2008/12/15,5,14,0.5944451070000001,16778,5,4,10
24101,2014/03/31,2009/01/02,114,13,0.6412718620000001,15552,114,3,10
24102,2014/03/31,2005/03/12,268,7,0.7242857140000001,13769,268,6,1
24103,2014/03/31,2007/02/25,269,10,0.773718476,12887,269,6,4
24104,2014/03/31,2006/08/30,186,9,0.7119972859999999,14004,186,7,2
24105,2014/03/31,2006/11/09,416,7,0.794608703,12548,416,7,0
24106,2014/03/31,2008/09/21,283,9,0.6894654590000001,14461,283,7,2
24107,2014/03/31,2010/07/23,374,11,0.703623853,14170,374,11,0
24108,2014/03/31,2012/05/12,125,13,0.571324852,17451,125,6,7
24109,2014/03/31,2008/07/12,47,8,0.654479091,15233,47,2,6
24110,2014/03/31,2010/08/28,78,9,0.619227329,16100,78,5,4
24111,2014/03/31,2013/03/25,50,12,0.660225843,15099,50,1,11
24112,2014/03/31,2012/08/23,134,9,0.728665936,13680,134,8,1
24113,2014/03/31,2012/03/21,30,9,0.7977495,12495,30,6,3
24114,2014/03/31,2006/06/01,233,7,0.6764965390000001,14734,233,4,3
24115,2014/03/31,2010/11/29,101,11,0.745610413,13368,101,8,3
24116,2014/03/31,2006/03/07,237,10,0.5815737879999999,17137,237,7,3
24117,2014/03/31,2005/05/30,21,7,0.8078390209999999,12337,21,3,4
24118,2014/03/31,2008/12/11,352,5,0.95,10490,352,2,3
24119,2014/03/31,2008/03/01,108,7,0.700848864,14219,108,6,1
24120,2014/03/31,2006/11/30,89,7,1.001432017,9951,89,6,1
24121,2014/03/31,2009/11/24,106,11,0.875205094,11385,106,7,4
24122,2014/03/31,2013/01/31,19,7,0.941682261,10581,19,3,4
24123,2014/03/31,2012/01/09,19,15,0.962666667,10350,19,8,7
24124,2014/03/31,2010/09/28,11,15,0.956995486,10411,11,4,11
24125,2014/03/31,2009/04/24,86,8,0.874982435,11386,86,3,5
24126,2014/03/31,2012/07/19,221,16,0.611979237,16279,221,8,8
24127,2014/03/31,2012/08/16,46,12,0.6399216289999999,15567,46,6,6
24128,2014/03/31,2012/01/13,7,6,0.776192146,12834,7,4,2
24129,2014/03/31,2012/06/02,64,14,0.559438953,17806,64,10,4
24130,2014/03/31,2010/06/12,247,7,0.8013435240000001,12430,247,3,4
24131,2014/03/31,2012/05/20,42,7,1.017290369,9791,42,4,3
24132,2014/03/31,2010/04/30,199,8,0.660445653,15079,199,4,4
24133,2014/03/31,2013/01/31,94,15,0.676354252,14724,94,8,7
24134,2014/03/31,2012/05/02,309,7,0.753925354,13209,309,5,2
24135,2014/03/31,2011/10/31,49,12,0.497508244,20014,49,5,7
24136,2014/03/31,2011/02/27,38,13,0.637692308,15613,38,6,7
24137,2014/03/31,2008/09/14,74,13,0.8570233279999999,11617,74,7,6
24138,2014/03/31,2012/07/21,1,10,0.67156425,14825,1,0,10
24139,2014/03/31,2010/12/24,518,2,0.777849832,12799,518,2,0
24140,2014/03/31,2005/11/09,85,12,0.554051647,17968,85,5,7
24141,2014/03/31,2011/06/06,15,9,0.7649704140000001,13013,15,2,7
24142,2014/03/31,2012/03/15,186,13,0.80531834,12361,186,7,6
24143,2014/03/31,2010/04/10,133,10,0.958,10390,133,6,4
24144,2014/03/31,2013/01/19,316,5,0.73,13635,316,4,1
24145,2014/03/31,2012/10/27,80,9,0.610077842,16315,80,3,6
24146,2014/03/31,2012/07/28,51,10,0.631504346,15761,51,4,6
24147,2014/03/31,2009/07/09,218,7,0.5097853920000001,19524,218,4,3
24148,2014/03/31,2006/09/01,165,9,0.887086193,11219,165,5,4
24149,2014/03/31,2013/03/31,12,8,0.8944130859999999,11126,12,0,8
24150,2014/03/31,2009/03/07,198,12,0.6283972210000001,15835,198,10,2
24151,2014/03/31,2012/10/19,516,2,0.8,12438,516,2,0
24152,2014/03/31,2010/12/13,67,8,0.7804494470000001,12749,67,3,5
24153,2014/03/31,2007/10/02,1,6,1.186576029,8385,1,3,3
24154,2014/03/31,2011/03/22,10,13,0.588271152,16913,10,5,8
24155,2014/03/31,2010/04/18,119,4,0.77,12920,119,3,1
24156,2014/03/31,2011/08/05,152,11,0.481350946,20667,152,6,5
24157,2014/03/31,2012/08/11,205,11,0.608738221,16342,205,6,5
24158,2014/03/31,2011/08/01,24,11,0.8317651979999999,11959,24,4,7
24159,2014/03/31,2007/09/08,31,10,0.47102671,21116,31,6,4
24160,2014/03/31,2011/07/11,137,12,0.735719358,13519,137,8,4
24161,2014/03/31,2006/02/08,109,13,0.919641239,10815,109,8,5
24162,2014/03/31,2011/03/05,83,15,0.793884898,12528,83,11,4
24163,2014/03/31,2009/07/27,144,11,0.969090909,10263,144,9,2
24164,2014/03/31,2012/02/24,164,12,1.241770508,8009,164,7,5
24165,2014/03/31,2006/04/28,415,3,0.85,11700,415,3,0
24166,2014/03/31,2010/06/21,182,13,0.801568596,12406,182,8,5
24167,2014/03/31,2008/11/27,27,12,0.8954552,11105,27,1,11
24168,2014/03/31,2012/03/06,248,7,0.745351173,13341,248,4,3
24169,2014/03/31,2010/05/25,22,15,0.655870712,15160,22,7,8
24170,2014/03/31,2012/05/01,50,14,0.650851008,15276,50,12,2
24171,2014/03/31,2012/08/10,162,3,0.868483578,11448,162,0,3
24172,2014/03/31,2007/10/13,324,8,0.6063338620000001,16396,324,6,2
24173,2014/03/31,2012/08/05,385,5,0.8163409429999999,12178,385,5,0
24174,2014/03/31,2007/11/21,286,15,0.653722215,15206,286,12,3
24175,2014/03/31,2007/09/14,41,8,0.601286674,16531,41,5,3
24176,2014/03/31,2007/11/07,151,12,0.797429397,12464,151,3,9
24177,2014/03/31,2012/09/13,431,6,0.634481328,15665,431,6,0
24178,2014/03/31,2012/01/06,32,14,0.615775093,16140,32,3,11
24179,2014/03/31,2008/02/22,8,13,0.687739257,14451,8,7,6
24180,2014/03/31,2011/07/01,71,8,0.791534724,12556,71,2,6
24181,2014/03/31,2009/01/06,141,17,0.7032366259999999,14132,141,14,3
24182,2014/03/31,2011/08/26,104,10,0.6785477259999999,14646,104,6,4
24183,2014/03/31,2008/10/02,4,7,0.721863151,13767,4,5,2
24184,2014/03/31,2005/03/11,237,9,0.8052572729999999,12341,237,8,1
24185,2014/03/31,2006/01/03,64,13,0.647523294,15347,64,7,6
24186,2014/03/31,2010/07/13,5,14,0.66312158,14986,5,6,8
24187,2014/03/31,2011/11/09,7,9,0.776604408,12796,7,0,9
24188,2014/03/31,2013/03/01,38,5,0.8369738059999999,11873,38,0,5
24189,2014/03/31,2013/01/23,80,9,0.6079570479999999,16344,80,0,9
24190,2014/03/31,2012/04/10,313,6,0.8148597670000001,12194,313,2,4
24191,2014/03/31,2010/11/17,55,13,0.687283669,14457,55,9,4
24192,2014/03/31,2006/12/21,132,10,0.725839421,13688,132,7,3
24193,2014/03/31,2008/02/10,23,15,0.7927240090000001,12533,23,9,6
24194,2014/03/31,2013/03/06,13,12,0.573058376,17336,13,2,10
24195,2014/03/31,2008/11/02,340,8,0.63125,15736,340,7,1
24196,2014/03/31,2012/11/24,382,6,0.841666667,11802,382,6,0
24197,2014/03/31,2007/01/12,34,10,0.512169743,19394,34,2,8
24198,2014/03/31,2012/02/27,110,6,0.590203815,16829,110,3,3
24199,2014/03/31,2010/12/20,109,6,0.892667625,11126,109,2,4
24200,2014/03/31,2012/05/30,257,6,0.7427273409999999,13372,257,4,2
24201,2014/03/31,2011/11/15,7,12,0.588034223,16889,7,7,5
24202,2014/03/31,2008/01/26,66,12,0.645102969,15393,66,5,7
24203,2014/03/31,2008/05/28,155,17,0.755827053,13137,155,12,5
24204,2014/03/31,2008/12/18,3,8,0.776521195,12786,3,2,6
24205,2014/03/31,2013/03/05,14,22,1.092727273,9086,14,0,22
24206,2014/03/31,2012/08/13,27,16,0.7643832770000001,12988,27,7,9
24207,2014/03/31,2009/12/05,118,9,0.843333333,11772,118,5,4
24208,2014/03/31,2013/02/14,278,4,0.714949946,13885,278,2,2
24209,2014/03/31,2009/07/08,377,10,0.692576572,14333,377,10,0
24210,2014/03/31,2010/03/04,366,16,0.7884432090000001,12590,366,15,1
24211,2014/03/31,2012/09/03,9,13,0.5803215429999999,17105,9,4,9
24212,2014/03/31,2011/07/27,415,8,0.8813732459999999,11258,415,8,0
24213,2014/03/31,2006/12/07,220,9,0.638055949,15550,220,2,7
24214,2014/03/31,2012/03/24,277,11,0.754714742,13146,277,10,1
24215,2014/03/31,2012/04/27,17,12,0.6110945489999999,16235,17,3,9
24216,2014/03/31,2005/05/09,97,8,0.7273115840000001,13640,97,4,4
24217,2014/03/31,2010/08/27,22,11,0.742636622,13358,22,8,3
24218,2014/03/31,2008/10/10,76,7,0.915847262,10829,76,4,3
24219,2014/03/31,2012/07/04,152,7,0.728913715,13606,152,2,5
24220,2014/03/31,2006/12/24,1,25,0.91195954,10875,1,9,16
24221,2014/03/31,2010/04/11,3,13,0.7118476779999999,13931,3,4,9
24222,2014/03/31,2012/09/26,84,9,0.6330097029999999,15666,84,3,6
24223,2014/03/31,2013/03/23,236,5,0.6995915340000001,14175,236,0,5
24224,2014/03/31,2006/07/20,15,8,0.6819323340000001,14542,15,3,5
24225,2014/03/31,2009/10/24,402,11,0.755719838,13121,402,11,0
24226,2014/03/31,2008/06/08,158,4,1.41,7031,158,0,4
24227,2014/03/31,2009/11/30,420,7,0.7897785209999999,12552,420,7,0
24228,2014/03/31,2005/12/01,23,13,0.844009366,11745,23,8,5
24229,2014/03/31,2008/12/15,674,5,0.75,13215,674,5,0
24230,2014/03/31,2012/12/11,249,5,0.75,13215,249,1,4
24231,2014/03/31,2011/07/22,23,15,0.547411622,18104,23,9,6
24232,2014/03/31,2011/01/29,125,10,0.7587366,13060,125,6,4
24233,2014/03/31,2012/02/23,139,7,0.7161665220000001,13836,139,2,5
24234,2014/03/31,2005/08/24,358,9,0.717698827,13806,358,8,1
24235,2014/03/31,2012/07/05,240,7,1.315525757,7532,240,4,3
24236,2014/03/31,2012/10/04,111,12,0.47909236,20680,111,5,7
24237,2014/03/31,2012/05/22,164,15,0.725355443,13659,164,8,7
24238,2014/03/31,2012/06/09,10,7,0.8012698159999999,12364,10,0,7
24239,2014/03/31,2011/08/31,445,14,0.897084126,11043,445,14,0
24240,2014/03/31,2012/07/16,81,9,0.668521393,14818,81,3,6
24241,2014/03/31,2011/01/15,75,10,0.564836926,17538,75,6,4
24242,2014/03/31,2012/05/31,633,8,0.8309663620000001,11921,633,8,0
24243,2014/03/31,2010/04/29,265,11,0.599575061,16520,265,9,2
24244,2014/03/31,2011/01/15,131,12,0.542746452,18249,131,4,8
24245,2014/03/31,2007/01/28,141,14,0.71961273,13763,141,6,8
24246,2014/03/31,2011/07/11,1,13,0.493543629,20067,1,5,8
24247,2014/03/31,2011/06/23,5,11,0.659225854,15023,5,0,11
24248,2014/03/31,2012/10/08,40,9,0.572645579,17293,40,3,6
24249,2014/03/31,2006/05/25,35,16,0.589679014,16792,35,8,8
24250,2014/03/31,2007/07/01,3,12,0.90468159,10945,3,5,7
24251,2014/03/31,2010/08/27,529,7,0.812309207,12186,529,7,0
24252,2014/03/31,2005/04/25,214,8,0.551465181,17950,214,5,3
24253,2014/03/31,2011/04/01,125,7,0.653385479,15150,125,2,5
24254,2014/03/31,2011/09/02,44,8,0.8472669690000001,11683,44,4,4
24255,2014/03/31,2008/12/17,11,8,0.835368839,11848,11,0,8
24256,2014/03/31,2005/02/24,51,11,0.664526591,14892,51,3,8
24257,2014/03/31,2012/08/06,20,11,0.478181818,20691,20,3,8
24258,2014/03/31,2008/06/30,202,7,0.6729499390000001,14702,202,3,4
24259,2014/03/31,2005/11/22,8,12,0.77124961,12828,8,4,8
24260,2014/03/31,2007/07/23,68,14,0.7522927759999999,13150,68,11,3
24261,2014/03/31,2009/04/02,473,9,0.982656203,10067,473,9,0
24262,2014/03/31,2006/01/11,141,13,0.5299694620000001,18665,141,8,5
24263,2014/03/31,2005/11/27,110,5,1.242853374,7959,110,2,3
24264,2014/03/31,2005/10/20,19,12,0.746756002,13246,19,5,7
24265,2014/03/31,2007/05/11,175,14,0.7703909959999999,12839,175,12,2
24266,2014/03/31,2012/03/16,429,7,0.709733783,13936,429,7,0
24267,2014/03/31,2012/06/12,107,5,0.592703464,16686,107,0,5
24268,2014/03/31,2007/09/25,260,9,0.635003853,15574,260,6,3
24269,2014/03/31,2011/02/24,164,16,0.710300223,13923,164,9,7
24270,2014/03/31,2011/07/23,467,11,0.699250513,14143,467,11,0
24271,2014/03/31,2010/02/28,32,8,0.740101033,13362,32,0,8
24272,2014/03/31,2013/01/10,172,6,0.938286365,10539,172,1,5
24273,2014/03/31,2011/12/01,88,8,0.6858100979999999,14418,88,5,3
24274,2014/03/31,2011/03/17,221,10,0.898893536,10999,221,6,4
24275,2014/03/31,2013/02/02,1,14,0.904658186,10927,1,0,14
24276,2014/03/31,2011/12/26,279,2,0.65,15208,279,0,2
24277,2014/03/31,2007/09/18,140,7,0.889991896,11105,140,6,1
24278,2014/03/31,2007/04/14,30,11,0.745987319,13248,30,4,7
24279,2014/03/31,2012/04/17,313,10,0.655930966,15065,313,9,1
24280,2014/03/31,2012/06/01,14,7,0.780373559,12662,14,6,1
24281,2014/03/31,2011/09/07,65,7,0.821622318,12026,65,0,7
24282,2014/03/31,2010/01/19,578,4,0.8764747629999999,11273,578,4,0
24283,2014/03/31,2008/07/02,32,11,0.747272727,13222,32,5,6
24284,2014/03/31,2007/08/07,164,15,0.572425261,17260,164,14,1
24285,2014/03/31,2011/11/25,298,11,0.7707442659999999,12818,298,9,2
24286,2014/03/31,2007/11/01,221,2,0.65,15199,221,0,2
24287,2014/03/31,2012/06/22,509,8,0.623638028,15841,509,8,0
24288,2014/03/31,2008/03/30,621,7,0.792857143,12460,621,7,0
24289,2014/03/31,2012/01/27,362,6,0.919832402,10740,362,4,2
24290,2014/03/31,2008/02/26,61,14,0.39624644,24931,61,5,9
24291,2014/03/31,2007/05/16,25,7,0.890542685,11093,25,2,5
24292,2014/03/31,2007/07/06,30,11,0.711381247,13886,30,6,5
24293,2014/03/31,2008/06/29,88,4,0.6995411090000001,14121,88,1,3
24294,2014/03/31,2010/10/25,200,9,0.747024881,13223,200,4,5
24295,2014/03/31,2011/11/19,45,8,0.691187461,14291,45,5,3
24296,2014/03/31,2012/04/17,666,4,0.875,11288,666,4,0
24297,2014/03/31,2012/12/03,49,13,0.761798689,12965,49,4,9
24298,2014/03/31,2011/04/13,49,7,0.7690002340000001,12843,49,3,4
24299,2014/03/31,2013/03/31,2,9,0.77075158,12813,2,1,8
24300,2014/03/31,2012/06/05,30,8,0.523567149,18861,30,1,7
24301,2014/03/31,2012/09/18,3,9,0.7043195440000001,14020,3,3,6
24302,2014/03/31,2009/11/25,210,9,0.7239149559999999,13640,210,3,6
24303,2014/03/31,2012/11/29,229,6,0.940342857,10500,229,4,2
24304,2014/03/31,2010/01/01,99,10,0.7387458840000001,13364,99,6,4
24305,2014/03/31,2006/04/16,648,3,1.285460346,7679,648,3,0
24306,2014/03/31,2012/03/10,338,12,0.7910642729999999,12478,338,11,1
24307,2014/03/31,2012/08/06,215,7,0.655036167,15069,215,6,1
24308,2014/03/31,2012/03/30,250,9,0.952125012,10367,250,8,1
24309,2014/03/31,2012/11/05,3,15,0.512714805,19250,3,3,12
24310,2014/03/31,2008/03/08,29,9,0.7152032759999999,13799,29,7,2
24311,2014/03/31,2011/11/12,119,9,0.652285525,15130,119,4,5
24312,2014/03/31,2011/03/10,133,8,0.459032048,21499,133,4,4
24313,2014/03/31,2008/07/05,6,26,0.547885619,18010,6,4,22
24314,2014/03/31,2013/02/11,110,7,0.800456721,12327,110,3,4
24315,2014/03/31,2013/01/23,49,7,0.766375922,12875,49,2,5
24316,2014/03/31,2012/01/05,138,12,0.900769582,10954,138,4,8
24317,2014/03/31,2012/04/25,320,8,0.659823459,14954,320,7,1
24318,2014/03/31,2010/11/15,229,8,0.55477058,17784,229,4,4
24319,2014/03/31,2011/11/19,201,4,0.98492962,10017,201,3,1
24320,2014/03/31,2012/03/06,256,12,0.8299108340000001,11888,256,10,2
24321,2014/03/31,2012/05/20,479,5,0.590881595,16697,479,5,0
24322,2014/03/31,2011/02/22,224,8,0.767646281,12852,224,6,2
24323,2014/03/31,2011/06/18,322,11,0.640111601,15412,322,7,4
24324,2014/03/31,2011/04/11,12,14,0.6658636520000001,14815,12,1,13
24325,2014/03/31,2007/03/07,36,11,0.5794543000000001,17024,36,5,6
24326,2014/03/31,2012/09/01,73,10,0.728,13550,73,2,8
24327,2014/03/31,2007/03/05,22,16,0.689149025,14313,22,11,5
24328,2014/03/31,2012/08/23,367,11,0.6843023659999999,14413,367,11,0
24329,2014/03/31,2005/12/03,96,14,0.7265853840000001,13574,96,4,10
24330,2014/03/31,2011/07/17,60,9,0.967375184,10195,60,6,3
24331,2014/03/31,2005/05/11,1,6,0.739350776,13339,1,2,4
24332,2014/03/31,2010/08/11,74,13,0.6837886559999999,14422,74,7,6
24333,2014/03/31,2011/10/31,6,7,0.8571888040000001,11504,6,5,2
24334,2014/03/31,2012/07/23,30,4,0.855619089,11525,30,1,3
24335,2014/03/31,2008/07/21,32,10,0.619287823,15923,32,0,10
24336,2014/03/31,2005/12/20,309,3,0.56195646,17547,309,2,1
24337,2014/03/31,2013/01/29,121,12,0.80373492,12268,121,1,11
24338,2014/03/31,2012/03/01,137,16,0.513980922,19184,137,11,5
24339,2014/03/31,2011/10/03,244,10,0.6295536110000001,15659,244,6,4
24340,2014/03/31,2011/02/23,100,11,0.606046354,16266,100,9,2
24341,2014/03/31,2013/01/08,219,10,0.686362624,14362,219,2,8
24342,2014/03/31,2005/10/03,269,8,0.564232398,17470,269,7,1
24343,2014/03/31,2012/11/29,34,9,0.658219581,14974,34,5,4
24344,2014/03/31,2010/10/16,31,12,0.658955673,14957,31,8,4
24345,2014/03/31,2012/09/05,38,8,0.677471817,14548,38,2,6
24346,2014/03/31,2009/08/23,112,9,0.789095276,12490,112,5,4
24347,2014/03/31,2010/09/06,226,3,0.720005845,13688,226,0,3
24348,2014/03/31,2007/05/07,57,11,0.7139781209999999,13803,57,6,5
24349,2014/03/31,2005/09/21,502,7,1.5,6570,502,7,0
24350,2014/03/31,2012/06/26,20,16,0.815867208,12079,20,2,14
24351,2014/03/31,2005/10/28,115,7,0.8042577329999999,12253,115,2,5
24352,2014/03/31,2007/07/03,348,7,0.8463071109999999,11644,348,4,3
24353,2014/03/31,2008/11/13,44,14,0.818460133,12040,44,5,9
24354,2014/03/31,2011/11/06,83,10,0.639040856,15420,83,5,5
24355,2014/03/31,2012/12/28,47,12,0.7082512759999999,13913,47,1,11
24356,2014/03/31,2009/08/10,16,12,0.542064697,18177,16,0,12
24357,2014/03/31,2012/01/01,37,7,0.548601336,17960,37,4,3
24358,2014/03/31,2006/08/18,59,12,0.605864953,16261,59,6,6
24359,2014/03/31,2010/10/29,112,13,0.765304902,12873,112,7,6
24360,2014/03/31,2009/10/13,313,4,0.7625,12920,313,2,2
24361,2014/03/31,2012/03/27,18,15,0.528057997,18656,18,2,13
24362,2014/03/31,2009/09/06,118,10,0.8185467390000001,12035,118,4,6
24363,2014/03/31,2006/06/10,7,11,0.7048590440000001,13976,7,4,7
24364,2014/03/31,2012/10/18,101,13,0.6160221370000001,15991,101,5,8
24365,2014/03/31,2011/12/18,120,7,0.7731214190000001,12741,120,4,3
24366,2014/03/31,2010/01/24,70,11,0.766680417,12848,70,7,4
24367,2014/03/31,2011/12/02,479,4,0.7325747429999999,13446,479,4,0
24368,2014/03/31,2012/10/06,102,11,0.695771703,14157,102,7,4
24369,2014/03/31,2009/02/20,33,11,0.622256618,15829,33,6,5
24370,2014/03/31,2012/10/23,1,31,0.836129032,11780,1,0,31
24371,2014/03/31,2006/06/20,65,10,0.7868754490000001,12517,65,0,10
24372,2014/03/31,2007/04/29,379,15,0.703945675,13990,379,15,0
24373,2014/03/31,2013/01/01,22,7,1.392857143,7070,22,1,6
24374,2014/03/31,2009/04/23,112,8,0.85125,11568,112,3,5
24375,2014/03/31,2012/02/16,112,13,0.72049978,13666,112,5,8
24376,2014/03/31,2011/03/27,253,10,0.652528835,15086,253,4,6
24377,2014/03/31,2006/10/11,63,11,0.959090909,10263,63,9,2
24378,2014/03/31,2012/07/25,271,4,0.555350937,17724,271,1,3
24379,2014/03/31,2005/02/01,32,14,0.678014052,14517,32,7,7
24380,2014/03/31,2010/02/12,101,10,0.8609692090000001,11432,101,7,3
24381,2014/03/31,2008/05/15,21,15,0.7002596940000001,14055,21,4,11
24382,2014/03/31,2008/01/23,41,15,0.7540075079999999,13053,41,7,8
24383,2014/03/31,2009/03/09,23,13,0.555046529,17731,23,8,5
24384,2014/03/31,2006/08/04,59,10,0.713349522,13796,59,5,5
24385,2014/03/31,2009/09/17,83,9,0.910216426,10812,83,0,9
24386,2014/03/31,2011/08/26,1,12,0.718605229,13694,1,6,6
24387,2014/03/31,2008/08/08,105,10,0.699187749,14072,105,2,8
24388,2014/03/31,2010/06/09,79,9,0.628189886,15662,79,4,5
24389,2014/03/31,2005/09/01,77,11,0.754723075,13036,77,6,5
24390,2014/03/31,2012/11/06,430,4,0.754332158,13042,430,4,0
24391,2014/03/31,2010/09/19,446,5,0.946023656,10399,446,5,0
24392,2014/03/31,2013/03/14,135,7,0.675532207,14562,135,2,5
24393,2014/03/31,2007/08/17,109,12,0.820626512,11987,109,7,5
24394,2014/03/31,2011/09/30,6,17,0.7673375459999999,12819,6,3,14
24395,2014/03/31,2009/04/12,17,12,0.674234302,14588,17,6,6
24396,2014/03/31,2005/03/24,70,9,0.541757188,18154,70,4,5
24397,2014/03/31,2007/10/16,627,4,0.5706022279999999,17236,627,4,0
24398,2014/03/31,2007/03/10,265,6,1.087640748,9041,265,5,1
24399,2014/03/31,2010/04/15,130,12,0.666251779,14759,130,6,6
24400,2014/03/31,2006/06/26,181,10,0.5336072070000001,18427,181,6,4
24401,2014/03/31,2007/08/20,31,14,0.611822651,16070,31,7,7
24402,2014/03/31,2012/07/25,558,3,1.5,6554,558,3,0
24403,2014/03/31,2010/03/15,209,9,0.808533597,12159,209,7,2
24404,2014/03/31,2008/11/06,114,7,1.276565381,7701,114,0,7
24405,2014/03/31,2007/08/09,12,9,0.788193554,12472,12,1,8
24406,2014/03/31,2012/08/05,159,12,0.616038102,15957,159,7,5
24407,2014/03/31,2008/07/14,130,6,0.655321688,14999,130,3,3
24408,2014/03/31,2009/07/29,26,11,0.887870822,11070,26,3,8
24409,2014/03/31,2008/05/25,38,8,0.7551882590000001,13014,38,2,6
24410,2014/03/31,2007/11/28,30,12,0.694034605,14160,30,2,10
24411,2014/03/31,2012/09/21,265,6,0.623904762,15750,265,4,2
24412,2014/03/31,2012/05/31,1,11,0.6967858159999999,14100,1,4,7
24413,2014/03/31,2012/02/24,597,3,1.033333333,9507,597,3,0
24414,2014/03/31,2011/01/30,14,10,0.659498523,14896,14,5,5
24415,2014/03/31,2007/06/28,197,8,0.6509283060000001,15092,197,4,4
24416,2014/03/31,2007/07/16,32,11,0.8239292009999999,11921,32,4,7
24417,2014/03/31,2012/09/20,219,5,0.839997434,11692,219,3,2
24418,2014/03/31,2008/04/09,153,11,0.558613276,17581,153,5,6
24419,2014/03/31,2006/10/18,76,2,0.725223043,13540,76,0,2
24420,2014/03/31,2010/12/21,124,11,0.689667767,14237,124,7,4
24421,2014/03/31,2010/02/22,12,11,0.62603545,15684,12,2,9
24422,2014/03/31,2007/11/23,178,10,0.566255263,17339,178,5,5
24423,2014/03/31,2004/12/29,103,8,0.773204442,12698,103,6,2
24424,2014/03/31,2009/07/26,107,4,1.067794214,9194,107,2,2
24425,2014/03/31,2012/03/28,55,10,0.564255662,17398,55,4,6
24426,2014/03/31,2012/03/16,468,11,0.583701017,16817,468,11,0
24427,2014/03/31,2007/02/23,222,6,1.27862837,7677,222,5,1
24428,2014/03/31,2010/10/16,87,8,0.412010746,23822,87,1,7
24429,2014/03/31,2010/08/07,143,8,0.924273472,10619,143,6,2
24430,2014/03/31,2008/03/13,11,13,0.7123907359999999,13774,11,7,6
24431,2014/03/31,2012/10/20,60,14,0.676312815,14507,60,8,6
24432,2014/03/31,2012/12/09,94,8,0.769035823,12757,94,1,7
24433,2014/03/31,2005/06/22,127,6,0.818333333,11988,127,1,5
24434,2014/03/31,2009/08/07,437,5,0.7971802370000001,12306,437,5,0
24435,2014/03/31,2011/10/12,106,4,0.598242469,16398,106,3,1
24436,2014/03/31,2011/01/13,115,15,0.6746784509999999,14539,115,11,4
24437,2014/03/31,2006/08/16,143,6,0.566968436,17298,143,1,5
24438,2014/03/31,2009/12/21,13,13,0.642847404,15256,13,8,5
24439,2014/03/31,2012/12/09,218,10,0.8250416420000001,11887,218,3,7
24440,2014/03/31,2013/03/10,32,14,0.5847191079999999,16768,32,0,14
24441,2014/03/31,2010/09/23,93,8,0.8204820890000001,11948,93,2,6
24442,2014/03/31,2013/01/26,14,11,0.66286091,14789,14,2,9
24443,2014/03/31,2012/01/17,35,12,0.7721093259999999,12696,35,2,10
24444,2014/03/31,2007/02/01,57,15,0.594615711,16485,57,4,11
24445,2014/03/31,2012/06/02,253,7,0.471849427,20774,253,4,3
24446,2014/03/31,2006/08/17,154,7,0.711241564,13781,154,2,5
24447,2014/03/31,2009/04/06,349,14,0.594636573,16482,349,13,1
24448,2014/03/31,2008/06/25,106,8,0.653296894,15002,106,4,4
24449,2014/03/31,2009/09/28,167,9,0.687871131,14247,167,2,7
24450,2014/03/31,2013/01/04,135,5,0.614899278,15935,135,2,3
24451,2014/03/31,2011/02/17,7,7,0.812728102,12056,7,0,7
24452,2014/03/31,2008/04/01,61,8,0.8030563070000001,12201,61,3,5
24453,2014/03/31,2012/12/15,2,9,0.7013034140000001,13971,2,3,6
24454,2014/03/31,2009/10/12,627,8,0.7675597340000001,12765,627,8,0
24455,2014/03/31,2010/10/16,5,8,0.743536733,13176,5,0,8
24456,2014/03/31,2006/01/15,13,3,0.570229932,17179,13,0,3
24457,2014/03/31,2007/03/23,42,9,0.729614095,13423,42,5,4
24458,2014/03/31,2006/12/25,189,6,1.410642466,6942,189,1,5
24459,2014/03/31,2008/11/20,459,5,0.74667175,13115,459,5,0
24460,2014/03/31,2011/12/25,465,7,0.808821343,12107,465,7,0
24461,2014/03/31,2013/02/01,163,5,0.7189588840000001,13620,163,2,3
24462,2014/03/31,2009/09/16,61,17,0.551785191,17746,61,1,16
24463,2014/03/31,2012/09/23,43,8,0.764612682,12806,43,2,6
24464,2014/03/31,2010/03/07,57,10,0.625566062,15652,57,2,8
24465,2014/03/31,2012/07/05,192,13,0.6946183309999999,14096,192,5,8
24466,2014/03/31,2006/11/21,453,4,0.802089136,12206,453,4,0
24467,2014/03/31,2012/01/10,29,11,0.569295807,17197,29,9,2
24468,2014/03/31,2008/05/31,105,9,0.748544885,13078,105,1,8
24469,2014/03/31,2013/01/18,64,10,0.616371364,15882,64,1,9
24470,2014/03/31,2011/03/23,258,3,1.445510927,6772,258,1,2
24471,2014/03/31,2008/02/13,52,19,0.635263158,15409,52,7,12
24472,2014/03/31,2008/06/13,316,7,0.559563826,17493,316,6,1
24473,2014/03/31,2008/02/03,120,8,0.785194128,12466,120,6,2
24474,2014/03/31,2011/01/14,70,12,0.65776314,14878,70,6,6
24475,2014/03/31,2011/08/07,257,16,0.649291401,15072,257,7,9
24476,2014/03/31,2007/02/01,67,17,0.484195735,20211,67,11,6
24477,2014/03/31,2012/07/05,194,7,0.764714386,12797,194,4,3
24478,2014/03/31,2006/06/18,2,19,0.8690169609999999,11261,2,9,10
24479,2014/03/31,2013/03/22,14,19,0.7438999540000001,13154,14,1,18
24480,2014/03/31,2010/08/08,95,8,0.6730235920000001,14539,95,2,6
24481,2014/03/31,2010/12/19,198,11,0.741794541,13190,198,9,2
24482,2014/03/31,2009/03/24,154,5,0.860812951,11366,154,3,2
24483,2014/03/31,2012/09/30,109,13,0.800239692,12224,109,5,8
24484,2014/03/31,2013/01/09,76,4,0.709338603,13789,76,2,2
24485,2014/03/31,2012/10/04,185,10,0.537859775,18185,185,5,5
24486,2014/03/31,2011/12/23,34,14,0.688265428,14211,34,9,5
24487,2014/03/31,2012/08/26,297,8,0.733968183,13326,297,6,2
24488,2014/03/31,2006/04/03,148,8,0.6873792959999999,14229,148,5,3
24489,2014/03/31,2012/09/04,160,7,0.958420382,10205,160,2,5
24490,2014/03/31,2011/05/11,12,8,0.721018798,13565,12,0,8
24491,2014/03/31,2012/06/25,113,10,0.6947421509999999,14078,113,4,6
24492,2014/03/31,2008/04/03,69,10,0.615354222,15894,69,7,3
24493,2014/03/31,2008/03/01,1,10,0.680267093,14377,1,3,7
24494,2014/03/31,2009/04/08,1,8,0.57714488,16945,1,2,6
24495,2014/03/31,2012/02/07,21,13,0.664171421,14724,21,7,6
24496,2014/03/31,2007/03/23,66,8,0.989371712,9884,66,7,1
24497,2014/03/31,2006/05/08,198,14,0.739567355,13221,198,11,3
24498,2014/03/31,2005/08/22,29,18,0.568469186,17200,29,2,16
24499,2014/03/31,2007/01/07,19,7,0.71,13769,19,3,4
24500,2014/03/31,2011/05/01,144,5,0.904540491,10805,144,0,5
24501,2014/03/31,2006/03/01,57,8,0.6930345370000001,14101,57,4,4
24502,2014/03/31,2011/12/26,104,9,0.8546510409999999,11434,104,7,2
24503,2014/03/31,2010/10/29,118,13,0.7540916809999999,12958,118,7,6
24504,2014/03/31,2008/10/08,176,10,0.5797276610000001,16854,176,3,7
24505,2014/03/31,2010/11/29,30,10,0.675622018,14461,30,2,8
24506,2014/03/31,2009/11/26,187,15,0.670380129,14574,187,7,8
24507,2014/03/31,2007/03/18,239,11,0.767111338,12736,239,7,4
24508,2014/03/31,2010/01/21,29,10,0.684310937,14273,29,8,2
24509,2014/03/31,2011/08/30,4,12,0.7685725529999999,12708,4,2,10
24510,2014/03/31,2010/08/20,139,12,0.538357312,18141,139,7,5
24511,2014/03/31,2008/02/27,43,16,0.56143432,17395,43,7,9
24512,2014/03/31,2008/02/21,59,13,0.861599894,11332,59,7,6
24513,2014/03/31,2006/07/05,133,11,0.718907953,13580,133,4,7
24514,2014/03/31,2008/05/10,16,16,0.74292063,13141,16,7,9
24515,2014/03/31,2012/12/17,186,11,0.82031762,11901,186,2,9
24516,2014/03/31,2012/10/25,46,10,0.60114532,16240,46,0,10
24517,2014/03/31,2008/07/02,110,8,0.5875,16616,110,3,5
24518,2014/03/31,2012/05/03,273,5,0.512314475,19054,273,4,1
24519,2014/03/31,2011/12/30,101,7,0.789322335,12366,101,3,4
24520,2014/03/31,2006/08/26,81,12,0.7875760509999999,12393,81,8,4
24521,2014/03/31,2011/05/22,469,9,0.7453035509999999,13095,469,9,0
24522,2014/03/31,2013/01/09,9,14,0.910028907,10724,9,2,12
24523,2014/03/31,2005/09/25,188,15,0.596479433,16361,188,13,2
24524,2014/03/31,2010/10/22,517,11,0.77188736,12642,517,11,0
24525,2014/03/31,2010/09/13,219,10,0.703898867,13863,219,8,2
24526,2014/03/31,2012/09/15,32,7,0.492854978,19797,32,2,5
24527,2014/03/31,2008/08/02,15,10,0.786237408,12409,15,7,3
24528,2014/03/31,2011/12/17,90,20,0.7569392509999999,12889,90,12,8
24529,2014/03/31,2013/01/28,161,15,0.616411196,15827,161,3,12
24530,2014/03/31,2008/03/21,477,9,0.657729908,14832,477,9,0
24531,2014/03/31,2010/03/31,21,11,0.928516086,10506,21,2,9
24532,2014/03/31,2008/04/04,529,9,0.716309297,13618,529,9,0
24533,2014/03/31,2011/09/30,484,12,0.875,11148,484,12,0
24534,2014/03/31,2008/01/07,26,9,0.730515279,13352,26,2,7
24535,2014/03/31,2006/03/22,375,7,0.7050166259999999,13834,375,7,0
24536,2014/03/31,2012/10/20,198,10,0.863586292,11293,198,7,3
24537,2014/03/31,2012/08/03,190,12,0.633356067,15396,190,11,1
24538,2014/03/31,2009/04/01,325,12,0.532343306,18316,325,11,1
24539,2014/03/31,2006/01/27,4,11,0.68207625,14295,4,5,6
24540,2014/03/31,2011/04/30,194,6,0.60487994,16117,194,2,4
24541,2014/03/31,2013/03/20,8,18,0.7024717159999999,13877,8,0,18
24542,2014/03/31,2009/10/26,131,16,0.5941782489999999,16404,131,12,4
24543,2014/03/31,2012/10/27,28,12,0.8555982790000001,11391,28,1,11
24544,2014/03/31,2008/09/02,15,12,0.527439117,18478,15,5,7
24545,2014/03/31,2012/07/14,7,14,0.627032104,15543,7,3,11
24546,2014/03/31,2008/04/17,39,10,0.700860184,13904,39,7,3
24547,2014/03/31,2010/06/08,57,11,0.581954133,16744,57,7,4
24548,2014/03/31,2007/06/16,519,11,0.752517763,12948,519,11,0
24549,2014/03/31,2010/01/15,75,8,0.575620606,16927,75,4,4
24550,2014/03/31,2010/05/07,49,18,0.6084836370000001,16012,49,8,10
24551,2014/03/31,2011/04/01,33,7,0.6872169309999999,14175,33,3,4
24552,2014/03/31,2008/08/06,82,14,0.902631579,10792,82,3,11
24553,2014/03/31,2012/12/27,19,9,0.704061438,13835,19,1,8
24554,2014/03/31,2012/12/26,58,13,0.656306179,14841,58,4,9
24555,2014/03/31,2012/08/14,176,6,0.597187615,16310,176,4,2
24556,2014/03/31,2007/02/25,27,10,0.515726767,18885,27,5,5
24557,2014/03/31,2012/10/25,24,13,0.5882180610000001,16555,24,5,8
24558,2014/03/31,2005/01/22,247,7,0.6909152829999999,14094,247,3,4
24559,2014/03/31,2005/12/02,79,11,0.593447099,16408,79,5,6
24560,2014/03/31,2012/05/17,255,8,0.69729662,13964,255,7,1
24561,2014/03/31,2011/07/27,118,8,0.77851763,12507,118,5,3
24562,2014/03/31,2010/10/21,649,2,1.5,6491,649,2,0
24563,2014/03/31,2012/04/19,4,10,0.456108222,21345,4,3,7
24564,2014/03/31,2012/06/26,172,7,0.783299002,12428,172,2,5
24565,2014/03/31,2010/01/04,134,11,0.626326728,15542,134,6,5
24566,2014/03/31,2013/02/24,185,10,0.710786418,13695,185,2,8
24567,2014/03/31,2012/05/16,163,5,1.161825018,8378,163,2,3
24568,2014/03/31,2012/11/27,15,2,0.640028932,15208,15,1,1
24569,2014/03/31,2006/06/01,15,15,0.743974624,13083,15,3,12
24570,2014/03/31,2011/12/03,191,9,0.712971943,13651,191,7,2
24571,2014/03/31,2009/04/27,75,15,0.5340518,18224,75,8,7
24572,2014/03/31,2012/12/05,74,7,0.736513775,13212,74,1,6
24573,2014/03/31,2010/10/13,3,8,0.625487272,15556,3,0,8
24574,2014/03/31,2011/11/03,182,8,0.623870864,15596,182,6,2
24575,2014/03/31,2013/01/01,75,8,1.43440513,6783,75,3,5
24576,2014/03/31,2008/12/22,109,13,0.7088641170000001,13725,109,2,11
24577,2014/03/31,2007/10/30,219,15,0.687658868,14147,219,9,6
24578,2014/03/31,2009/12/26,25,7,0.8577453490000001,11341,25,2,5
24579,2014/03/31,2010/04/27,360,11,0.7671780109999999,12679,360,10,1
24580,2014/03/31,2009/03/05,30,17,0.708403263,13728,30,2,15
24581,2014/03/31,2006/02/20,522,7,0.980223768,9921,522,7,0
24582,2014/03/31,2011/09/17,155,7,0.7046739129999999,13800,155,5,2
24583,2014/03/31,2009/12/07,16,10,0.566470931,17166,16,6,4
24584,2014/03/31,2012/11/12,88,20,0.593998778,16370,88,4,16
24585,2014/03/31,2012/01/05,104,10,0.628970179,15459,104,4,6
24586,2014/03/31,2008/06/18,4,8,0.87391066,11126,4,0,8
24587,2014/03/31,2011/06/08,251,4,0.8735627640000001,11129,251,1,3
24588,2014/03/31,2006/11/11,13,13,0.7282761459999999,13348,13,7,6
24589,2014/03/31,2012/04/11,12,11,0.784085666,12397,12,9,2
24590,2014/03/31,2007/04/20,135,7,0.617142857,15750,135,5,2
24591,2014/03/31,2012/08/15,3,15,0.658509485,14760,3,2,13
24592,2014/03/31,2012/06/24,35,11,0.575801884,16879,35,6,5
24593,2014/03/31,2010/12/03,21,9,0.81624643,11906,21,4,5
24594,2014/03/31,2009/09/02,318,9,0.7237059659999999,13427,318,8,1
24595,2014/03/31,2010/03/19,59,11,0.610909091,15906,59,8,3
24596,2014/03/31,2010/04/25,208,7,0.867609608,11199,208,4,3
24597,2014/03/31,2011/01/06,1,12,0.801666667,12120,1,0,12
24598,2014/03/31,2007/11/16,44,15,0.611530715,15888,44,4,11
24599,2014/03/31,2010/07/05,130,10,0.6698545229999999,14504,130,2,8
24600,2014/03/31,2008/10/11,215,8,0.646779627,15020,215,5,3
24601,2014/03/31,2012/03/01,127,9,0.751128895,12933,127,7,2
24602,2014/03/31,2008/11/21,84,8,0.685642292,14168,84,4,4
24603,2014/03/31,2012/06/26,11,21,0.8430532890000001,11522,11,13,8
24604,2014/03/31,2011/04/10,271,8,0.674786384,14395,271,4,4
24605,2014/03/31,2008/11/01,111,5,0.649826052,14947,111,4,1
24606,2014/03/31,2010/09/08,152,8,0.6065783889999999,16010,152,6,2
24607,2014/03/31,2007/08/16,17,7,1.305278226,7440,17,0,7
24608,2014/03/31,2006/01/16,199,7,0.928516925,10458,199,2,5
24609,2014/03/31,2009/02/13,153,8,0.768147152,12640,153,4,4
24610,2014/03/31,2012/05/17,11,22,0.6523483170000001,14883,11,14,8
24611,2014/03/31,2008/11/10,32,8,0.789812886,12292,32,4,4
24612,2014/03/31,2013/03/16,67,13,0.7121691609999999,13632,67,4,9
24613,2014/03/31,2008/02/11,132,9,0.953273763,10184,132,6,3
24614,2014/03/31,2013/01/19,188,5,0.695120292,13966,188,4,1
24615,2014/03/31,2012/03/17,82,13,0.803846154,12077,82,11,2
24616,2014/03/31,2012/09/21,104,8,0.705575987,13759,104,3,5
24617,2014/03/31,2008/12/18,47,7,0.918100057,10574,47,4,3
24618,2014/03/31,2007/02/10,99,2,0.64,15168,99,1,1
24619,2014/03/31,2012/07/12,188,5,0.938067259,10348,188,2,3
24620,2014/03/31,2013/03/10,134,7,0.795349885,12204,134,1,6
24621,2014/03/31,2011/08/20,130,12,0.827456948,11730,130,8,4
24622,2014/03/31,2009/08/05,285,4,0.635601834,15270,285,2,2
24623,2014/03/31,2011/09/28,16,10,0.649639869,14939,16,3,7
24624,2014/03/31,2012/02/15,279,8,0.893639042,10860,279,7,1
24625,2014/03/31,2010/12/24,52,15,0.506728279,19152,52,8,7
24626,2014/03/31,2012/11/28,33,9,0.7016209959999999,13831,33,4,5
24627,2014/03/31,2006/05/30,122,12,0.759441183,12777,122,4,8
24628,2014/03/31,2008/06/11,196,10,0.773592728,12542,196,2,8
24629,2014/03/31,2008/07/12,229,7,0.721447163,13447,229,6,1
24630,2014/03/31,2010/01/03,13,18,0.5177005179999999,18739,13,2,16
24631,2014/03/31,2008/03/11,21,8,0.75831848,12792,21,0,8
24632,2014/03/31,2010/11/17,8,8,0.7925,12240,8,6,2
24633,2014/03/31,2009/01/13,75,4,1.139800235,8510,75,1,3
24634,2014/03/31,2011/01/13,314,9,0.7505920140000001,12922,314,7,2
24635,2014/03/31,2006/11/24,143,8,0.7304760109999999,13277,143,6,2
24636,2014/03/31,2009/09/29,139,13,0.8140988840000001,11913,139,10,3
24637,2014/03/31,2008/01/10,1,12,0.557489508,17395,1,1,11
24638,2014/03/31,2012/05/15,35,15,0.619187791,15661,35,11,4
24639,2014/03/31,2012/02/14,44,10,0.726475877,13348,44,8,2
24640,2014/03/31,2009/07/12,312,14,0.739772641,13107,312,10,4
24641,2014/03/31,2011/03/31,385,8,0.597304873,16233,385,8,0
24642,2014/03/31,2012/09/17,215,8,0.705866337,13736,215,4,4
24643,2014/03/31,2011/08/08,3,12,0.690391682,14042,3,0,12
24644,2014/03/31,2010/08/17,83,4,0.960652066,10091,83,2,2
24645,2014/03/31,2004/12/12,126,15,0.68557253,14139,126,7,8
24646,2014/03/31,2007/09/23,39,8,0.662805662,14624,39,5,3
24647,2014/03/31,2010/09/30,32,11,0.525415221,18448,32,5,6
24648,2014/03/31,2008/02/07,18,8,0.711932569,13614,18,0,8
24649,2014/03/31,2010/04/23,21,15,0.735382047,13179,21,10,5
24650,2014/03/31,2012/03/30,92,8,0.618867816,15660,92,4,4
24651,2014/03/31,2013/01/09,94,11,0.7199591409999999,13461,94,1,10
24652,2014/03/31,2011/10/21,136,9,0.8316786820000001,11652,136,8,1
24653,2014/03/31,2008/01/04,127,2,0.48,20188,127,0,2
24654,2014/03/31,2009/12/31,19,3,1.0,9690,19,1,2
24655,2014/03/31,2007/11/26,362,12,0.803374513,12061,362,11,1
24656,2014/03/31,2010/03/28,266,13,0.569110132,17025,266,12,1
24657,2014/03/31,2012/08/22,383,9,0.827403928,11710,383,9,0
24658,2014/03/31,2009/08/27,41,9,0.727438228,13315,41,4,5
24659,2014/03/31,2011/08/26,158,9,0.625157168,15493,158,4,5
24660,2014/03/31,2012/11/03,10,15,0.621286246,15588,10,6,9
24661,2014/03/31,2005/06/25,303,14,0.519560062,18639,303,10,4
24662,2014/03/31,2011/09/14,61,11,0.7283962690000001,13294,61,9,2
24663,2014/03/31,2011/11/13,345,11,0.638684783,15161,345,9,2
24664,2014/03/31,2008/11/04,98,15,0.778783882,12433,98,7,8
24665,2014/03/31,2010/08/30,34,6,0.790887927,12242,34,3,3
24666,2014/03/31,2011/06/28,21,13,0.728226267,13294,21,5,8
24667,2014/03/31,2010/03/23,71,15,0.6503130460000001,14886,71,9,6
24668,2014/03/31,2012/08/07,171,13,0.805456891,12016,171,8,5
24669,2014/03/31,2011/07/07,245,5,1.322309059,7319,245,3,2
24670,2014/03/31,2008/06/12,29,13,0.6308506620000001,15341,29,5,8
24671,2014/03/31,2008/12/30,161,12,0.66903906,14465,161,8,4
24672,2014/03/31,2013/01/25,85,14,0.777370873,12449,85,4,10
24673,2014/03/31,2013/01/05,119,12,0.6949037770000001,13926,119,3,9
24674,2014/03/31,2006/10/11,23,8,0.6360717810000001,15213,23,6,2
24675,2014/03/31,2007/11/20,65,8,0.93300646,10371,65,6,2
24676,2014/03/31,2013/01/26,26,9,0.843072231,11477,26,1,8
24677,2014/03/31,2013/03/01,34,14,0.707919227,13668,34,3,11
24678,2014/03/31,2010/10/17,228,3,1.057261501,9151,228,1,2
24679,2014/03/31,2013/02/28,30,5,0.8756403290000001,11049,30,2,3
24680,2014/03/31,2006/06/23,20,12,0.656111902,14745,20,4,8
24681,2014/03/31,2007/04/20,219,11,0.521193901,18561,219,10,1
24682,2014/03/31,2013/02/02,132,9,0.822645008,11758,132,4,5
24683,2014/03/31,2012/11/29,21,12,0.5043318210000001,19179,21,2,10
24684,2014/03/31,2010/08/13,52,14,0.7858750409999999,12308,52,9,5
24685,2014/03/31,2012/12/27,289,7,0.71383321,13550,289,2,5
24686,2014/03/31,2011/04/28,26,6,0.655927031,14746,26,2,4
24687,2014/03/31,2006/06/19,32,11,0.620518381,15587,32,5,6
24688,2014/03/31,2011/11/26,40,12,0.579263341,16697,40,7,5
24689,2014/03/31,2013/01/09,142,2,1.448301887,6678,142,1,1
24690,2014/03/31,2012/12/14,210,5,0.72883111,13269,210,3,2
24691,2014/03/31,2006/08/22,156,17,1.017657582,9503,156,11,6
24692,2014/03/31,2012/05/24,38,11,0.685094219,14116,38,5,6
24693,2014/03/31,2008/09/23,74,16,0.567093766,17053,74,9,7
24694,2014/03/31,2008/08/14,17,12,0.592496324,16320,17,9,3
24695,2014/03/31,2012/10/17,155,8,0.73464823,13162,155,3,5
24696,2014/03/31,2006/12/01,6,13,0.5939189189999999,16280,6,1,12
24697,2014/03/31,2011/08/10,321,13,0.7410669120000001,13047,321,12,1
24698,2014/03/31,2009/07/28,39,8,0.689013683,14032,39,0,8
24699,2014/03/31,2012/08/02,328,10,0.830508547,11641,328,9,1
24700,2014/03/31,2012/09/30,297,7,0.696540817,13879,297,3,4
24701,2014/03/31,2006/09/05,121,9,0.7384896870000001,13090,121,7,2
24702,2014/03/31,2012/01/04,92,19,0.5257333989999999,18387,92,10,9
24703,2014/03/31,2010/09/27,111,8,0.552754203,17486,111,5,3
24704,2014/03/31,2008/03/29,17,13,0.773900232,12489,17,4,9
24705,2014/03/31,2007/05/26,111,10,0.784748295,12316,111,7,3
24706,2014/03/31,2012/02/18,502,10,0.75530676,12795,502,10,0
24707,2014/03/31,2012/08/15,50,8,0.767077314,12598,50,4,4
24708,2014/03/31,2011/10/16,86,7,0.8019419090000001,12050,86,6,1
24709,2014/03/31,2005/04/24,8,16,0.6208352070000001,15565,8,10,6
24710,2014/03/31,2010/03/23,20,4,0.85,11368,20,2,2
24711,2014/03/31,2011/05/12,477,13,0.8,12077,477,13,0
24712,2014/03/31,2007/08/24,238,5,1.378412042,7009,238,3,2
24713,2014/03/31,2005/04/08,57,9,0.792222222,12195,57,4,5
24714,2014/03/31,2008/11/23,120,9,0.925789171,10435,120,8,1
24715,2014/03/31,2007/09/26,209,5,0.7790991209999999,12399,209,0,5
24716,2014/03/31,2006/04/13,144,13,1.133666236,8521,144,7,6
24717,2014/03/31,2005/09/09,201,15,0.459988095,21000,201,10,5
24718,2014/03/31,2006/12/07,186,16,0.690870405,13982,186,9,7
24719,2014/03/31,2011/05/19,14,11,0.613413984,15747,14,4,7
24720,2014/03/31,2011/06/18,74,4,0.944358623,10228,74,2,2
24721,2014/03/31,2011/05/15,3,11,0.7976734390000001,12108,3,4,7
24722,2014/03/31,2005/09/20,599,7,0.664285714,14539,599,7,0
24723,2014/03/31,2008/03/17,13,10,0.626710578,15410,13,5,5
24724,2014/03/31,2012/09/09,43,9,0.8799343959999999,10975,43,2,7
24725,2014/03/31,2012/10/01,190,10,0.644033344,14995,190,8,2
24726,2014/03/31,2012/03/12,135,7,0.67901561,14222,135,5,2
24727,2014/03/31,2009/06/02,19,12,0.6899064020000001,13996,19,6,6
24728,2014/03/31,2013/01/22,4,11,0.569302435,16959,4,1,10
24729,2014/03/31,2010/05/08,339,10,0.8393114840000001,11503,339,9,1
24730,2014/03/31,2009/07/21,127,9,0.914855951,10552,127,6,3
24731,2014/03/31,2012/03/01,162,10,0.727334991,13272,162,9,1
24732,2014/03/31,2008/04/23,124,10,0.560230992,17230,124,3,7
24733,2014/03/31,2007/03/20,274,23,0.903933321,10678,274,16,7
24734,2014/03/31,2013/02/06,198,10,0.694547025,13897,198,1,9
24735,2014/03/31,2009/10/19,86,8,0.764291258,12628,86,6,2
24736,2014/03/31,2007/01/17,4,9,0.661091856,14599,4,2,7
24737,2014/03/31,2010/09/02,105,13,0.493199612,19568,105,10,3
24738,2014/03/31,2008/03/08,116,7,0.7550266,12782,116,1,6
24739,2014/03/31,2010/08/10,95,10,0.762899605,12650,95,4,6
24740,2014/03/31,2010/02/11,366,11,0.983469221,9812,366,10,1
24741,2014/03/31,2012/02/27,45,9,0.684510889,14097,45,3,6
24742,2014/03/31,2007/03/06,56,17,0.830626668,11617,56,9,8
24743,2014/03/31,2013/01/31,353,6,0.748,12900,353,4,2
24744,2014/03/31,2012/11/04,6,10,0.634231629,15214,6,1,9
24745,2014/03/31,2010/06/18,107,5,0.882879495,10929,107,3,2
24746,2014/03/31,2008/10/24,274,6,0.8385997390000001,11505,274,5,1
24747,2014/03/31,2011/09/14,28,12,0.687373896,14036,28,8,4
24748,2014/03/31,2011/05/01,21,13,0.634217723,15212,21,4,9
24749,2014/03/31,2011/04/14,11,11,0.8087266329999999,11929,11,7,4
24750,2014/03/31,2012/05/23,466,5,0.922275335,10460,466,5,0
24751,2014/03/31,2011/08/11,330,10,0.959679666,10052,330,9,1
24752,2014/03/31,2008/02/11,341,7,0.985231335,9791,341,5,2
24753,2014/03/31,2012/09/05,20,12,0.599057143,16100,20,4,8
24754,2014/03/31,2006/10/27,124,7,0.732601033,13164,124,2,5
24755,2014/03/31,2011/03/15,66,12,0.551742663,17479,66,3,9
24756,2014/03/31,2012/01/10,62,11,0.611422775,15772,62,3,8
24757,2014/03/31,2010/10/10,198,6,0.5996958960000001,16080,198,1,5
24758,2014/03/31,2006/07/03,366,4,0.815622093,11823,366,3,1
24759,2014/03/31,2012/06/06,380,9,0.739323775,13043,380,9,0
24760,2014/03/31,2013/01/25,213,5,0.7895267340000001,12213,213,2,3
24761,2014/03/31,2012/05/15,5,8,0.72461972,13306,5,2,6
24762,2014/03/31,2011/10/27,49,11,0.473748894,20350,49,7,4
24763,2014/03/31,2012/01/17,350,13,0.561408106,17172,350,11,2
24764,2014/03/31,2011/10/02,35,16,0.697619944,13819,35,7,9
24765,2014/03/31,2011/11/02,165,15,0.905968045,10640,165,8,7
24766,2014/03/31,2006/06/22,74,14,0.718288376,13420,74,8,6
24767,2014/03/31,2007/05/11,109,5,0.925865514,10410,109,2,3
24768,2014/03/31,2011/03/09,38,10,0.53219989,18110,38,2,8
24769,2014/03/31,2005/08/18,18,12,0.672425342,14332,18,5,7
24770,2014/03/31,2005/08/04,93,7,0.690653,13951,93,4,3
24771,2014/03/31,2012/08/18,243,10,0.552368285,17443,243,9,1
24772,2014/03/31,2005/10/26,4,8,0.64798776,14869,4,2,6
24773,2014/03/31,2008/02/24,195,12,0.572888572,16818,195,7,5
24774,2014/03/31,2007/07/03,129,11,0.531161034,18139,129,8,3
24775,2014/03/31,2009/08/25,26,12,0.6996572259999999,13770,26,3,9
24776,2014/03/31,2013/01/18,45,15,0.610299018,15785,45,0,15
24777,2014/03/31,2005/09/09,60,8,0.927177093,10390,60,4,4
24778,2014/03/31,2008/05/24,56,4,1.41,6832,56,0,4
24779,2014/03/31,2010/07/01,3,19,0.602649525,15984,3,11,8
24780,2014/03/31,2011/06/09,94,9,0.780552719,12339,94,2,7
24781,2014/03/31,2007/06/05,58,5,0.6622077829999999,14544,58,3,2
24782,2014/03/31,2008/03/06,119,10,0.8285168620000001,11624,119,7,3
24783,2014/03/31,2012/06/18,245,12,0.686935587,14019,245,9,3
24784,2014/03/31,2012/11/29,32,5,0.726239819,13260,32,2,3
24785,2014/03/31,2012/08/24,40,9,0.943665229,10204,40,4,5
24786,2014/03/31,2005/09/09,278,8,0.48160106,19993,278,6,2
24787,2014/03/31,2008/11/13,164,10,0.824515245,11676,164,3,7
24788,2014/03/31,2009/07/29,122,8,0.699513843,13761,122,1,7
24789,2014/03/31,2011/10/12,39,5,0.7776474390000001,12378,39,2,3
24790,2014/03/31,2007/03/28,255,8,0.676222425,14234,255,5,3
24791,2014/03/31,2006/09/09,50,12,0.737979449,13041,50,3,9
24792,2014/03/31,2009/10/31,27,4,0.851120743,11305,27,1,3
24793,2014/03/31,2006/07/11,72,14,0.8414780479999999,11434,72,7,7
24794,2014/03/31,2012/05/20,433,10,0.675366847,14243,433,10,0
24795,2014/03/31,2011/12/23,536,5,0.82,11730,536,5,0
24796,2014/03/31,2012/05/26,63,11,0.89141798,10790,63,7,4
24797,2014/03/31,2012/09/10,326,6,0.808333333,11898,326,5,1
24798,2014/03/31,2008/08/05,118,12,0.770087291,12487,118,2,10
24799,2014/03/31,2008/12/04,4,11,0.755150801,12732,4,3,8
24800,2014/03/31,2008/05/19,19,10,0.814582733,11803,19,4,6
24801,2014/03/31,2011/03/01,58,7,0.7641098390000001,12582,58,3,4
24802,2014/03/31,2012/08/18,46,9,0.7055496840000001,13626,46,7,2
24803,2014/03/31,2006/07/17,125,12,0.5386485879999999,17848,125,8,4
24804,2014/03/31,2006/01/13,19,9,1.051659556,9141,19,5,4
24805,2014/03/31,2008/01/01,56,17,0.804515022,11949,56,9,8
24806,2014/03/31,2007/04/09,179,5,0.669107615,14366,179,0,5
24807,2014/03/31,2012/11/04,13,12,0.579504431,16587,13,3,9
24808,2014/03/31,2005/01/01,33,11,0.469270126,20483,33,8,3
24809,2014/03/31,2011/10/26,216,16,0.674624509,14248,216,10,6
24810,2014/03/31,2013/02/10,22,6,0.472233577,20353,22,2,4
24811,2014/03/31,2008/04/25,390,5,1.108768894,8667,390,5,0
24812,2014/03/31,2011/06/15,6,14,0.6077025229999999,15813,6,5,9
24813,2014/03/31,2009/07/19,26,10,0.557790549,17226,26,3,7
24814,2014/03/31,2010/05/01,39,10,0.538781199,17829,39,6,4
24815,2014/03/31,2013/01/29,36,13,0.73164153,13128,36,1,12
24816,2014/03/31,2011/10/08,171,10,0.428945558,22391,171,6,4
24817,2014/03/31,2010/06/17,24,17,0.837703445,11465,24,4,13
24818,2014/03/31,2011/02/25,9,7,0.690548605,13908,9,3,4
24819,2014/03/31,2010/12/16,65,7,0.901335523,10655,65,4,3
24820,2014/03/31,2012/08/23,6,17,0.545102458,17617,6,6,11
24821,2014/03/31,2005/03/25,205,9,0.908688494,10568,205,7,2
24822,2014/03/31,2007/04/09,15,13,0.6778702529999999,14166,15,5,8
24823,2014/03/31,2012/01/13,278,12,0.5571765120000001,17234,278,9,3
24824,2014/03/31,2008/08/22,4,11,0.8095691759999999,11861,4,3,8
24825,2014/03/31,2011/09/08,68,12,0.900589946,10662,68,0,12
24826,2014/03/31,2010/04/01,78,8,1.159724604,8279,78,2,6
24827,2014/03/31,2005/04/06,34,13,0.549081498,17485,34,2,11
24828,2014/03/31,2009/03/26,47,16,0.646257152,14855,47,6,10
24829,2014/03/31,2007/09/21,310,6,0.670600768,14315,310,5,1
24830,2014/03/31,2011/02/18,327,8,0.657545037,14599,327,7,1
24831,2014/03/31,2007/11/19,25,14,0.574569941,16707,25,5,9
24832,2014/03/31,2012/03/20,183,14,0.60855395,15774,183,11,3
24833,2014/03/31,2011/12/18,7,13,0.7281042329999999,13182,7,4,9
24834,2014/03/31,2007/07/24,391,8,0.822689868,11666,391,8,0
24835,2014/03/31,2007/10/17,64,12,0.725090662,13236,64,0,12
24836,2014/03/31,2012/01/25,49,8,0.739292042,12981,49,5,3
24837,2014/03/31,2010/12/30,195,9,0.644163646,14898,195,5,4
24838,2014/03/31,2012/09/18,70,10,0.520876669,18422,70,5,5
24839,2014/03/31,2008/09/15,95,6,0.733543307,13081,95,2,4
24840,2014/03/31,2011/09/07,144,12,0.696912181,13767,144,5,7
24841,2014/03/31,2012/11/15,251,8,0.629629873,15238,251,3,5
24842,2014/03/31,2012/11/01,461,3,0.94260169,10178,461,3,0
24843,2014/03/31,2008/10/12,27,12,0.8574517340000001,11188,27,7,5
24844,2014/03/31,2009/01/23,66,11,0.6898475479999999,13906,66,6,5
24845,2014/03/31,2013/01/05,126,7,0.790309771,12138,126,2,5
24846,2014/03/31,2009/12/01,163,7,0.88232248,10872,163,5,2
24847,2014/03/31,2012/06/16,3,11,0.804545836,11923,3,9,2
24848,2014/03/31,2007/12/11,63,12,0.5061957779999999,18950,63,6,6
24849,2014/03/31,2008/04/17,26,8,0.775289363,12372,26,2,6
24850,2014/03/31,2010/08/18,34,7,0.7331422459999999,13083,34,6,1
24851,2014/03/31,2011/09/03,4,11,0.813402307,11792,4,6,5
24852,2014/03/31,2006/06/15,321,8,0.7160892940000001,13394,321,5,3
24853,2014/03/31,2009/11/16,11,8,1.391420281,6893,11,3,5
24854,2014/03/31,2009/02/08,34,16,0.610147592,15719,34,6,10
24855,2014/03/31,2008/06/27,114,8,0.620760567,15449,114,4,4
24856,2014/03/31,2008/04/19,190,6,0.873859122,10974,190,0,6
24857,2014/03/31,2012/01/07,73,10,0.378885816,25310,73,4,6
24858,2014/03/31,2009/08/28,18,7,0.731134492,13116,18,4,3
24859,2014/03/31,2007/08/04,90,10,0.601230171,15949,90,4,6
24860,2014/03/31,2010/08/11,115,9,0.6308091570000001,15201,115,4,5
24861,2014/03/31,2011/05/13,382,6,0.768384356,12478,382,6,0
24862,2014/03/31,2010/04/21,6,8,0.740278743,12951,6,5,3
24863,2014/03/31,2009/07/16,94,11,0.468893617,20445,94,6,5
24864,2014/03/31,2012/07/14,66,11,0.705328526,13591,66,2,9
24865,2014/03/31,2006/11/23,65,18,0.451028561,21253,65,11,7
24866,2014/03/31,2013/01/29,47,4,1.3928073230000002,6882,47,1,3
24867,2014/03/31,2007/05/25,202,9,0.8671808559999999,11053,202,6,3
24868,2014/03/31,2013/03/23,34,8,0.568858092,16849,34,1,7
24869,2014/03/31,2006/10/01,99,14,0.6481504020000001,14787,99,3,11
24870,2014/03/31,2008/05/07,201,9,0.5657104070000001,16941,201,8,1
24871,2014/03/31,2008/03/03,70,10,0.688734368,13914,70,4,6
24872,2014/03/31,2012/05/26,77,13,0.7624299809999999,12568,77,3,10
24873,2014/03/31,2011/12/12,19,16,0.586513436,16337,19,3,13
24874,2014/03/31,2011/03/18,372,9,1.033858438,9268,372,9,0
24875,2014/03/31,2007/01/11,102,15,0.486254568,19704,102,10,5
24876,2014/03/31,2012/10/17,85,10,0.7322049829999999,13084,85,1,9
24877,2014/03/31,2010/12/13,193,9,1.024444444,9351,193,7,2
24878,2014/03/31,2011/09/01,300,7,0.791428571,12103,300,5,2
24879,2014/03/31,2010/04/25,420,7,0.7963789809999999,12027,420,7,0
24880,2014/03/31,2011/01/25,33,7,0.7041530659999999,13602,33,2,5
24881,2014/03/31,2012/08/26,29,26,0.70377572,13608,29,14,12
24882,2014/03/31,2011/10/19,44,12,0.611300989,15665,44,5,7
24883,2014/03/31,2011/10/28,339,2,0.733623688,13053,339,1,1
24884,2014/03/31,2013/03/24,94,2,0.63,15199,94,0,2
24885,2014/03/31,2006/01/12,35,15,0.60168468,15914,35,9,6
24886,2014/03/31,2012/12/06,23,15,0.8143718640000001,11757,23,1,14
24887,2014/03/31,2012/08/01,360,5,0.661880401,14465,360,4,1
24888,2014/03/31,2010/05/13,68,8,1.015770822,9425,68,1,7
24889,2014/03/31,2009/12/12,105,13,0.4442271820000001,21551,105,5,8
24890,2014/03/31,2012/05/05,33,7,0.655189241,14611,33,4,3
24891,2014/03/31,2008/02/14,54,12,0.919917355,10406,54,10,2
24892,2014/03/31,2007/10/11,104,10,0.476958146,20070,104,6,4
24893,2014/03/31,2007/10/27,154,18,0.7625844490000001,12552,154,11,7
24894,2014/03/31,2012/03/15,27,8,0.696564297,13741,27,2,6
24895,2014/03/31,2008/11/17,119,14,0.781613852,12244,119,4,10
24896,2014/03/31,2012/07/14,531,10,0.929919347,10291,531,10,0
24897,2014/03/31,2012/07/11,280,10,0.665673344,14376,280,5,5
24898,2014/03/31,2006/10/13,104,9,0.7194489140000001,13301,104,2,7
24899,2014/03/31,2013/01/12,43,7,0.58694044,16303,43,3,4
24900,2014/03/31,2010/04/13,10,9,0.815868156,11726,10,4,5
24901,2014/03/31,2011/04/01,72,8,0.732623679,13058,72,5,3
24902,2014/03/31,2012/06/10,150,12,0.86043533,11118,150,7,5
24903,2014/03/31,2008/11/16,165,5,0.567961765,16843,165,0,5
24904,2014/03/31,2012/04/25,10,10,0.772890038,12377,10,7,3
24905,2014/03/31,2008/08/11,126,15,0.555348621,17225,126,7,8
24906,2014/03/31,2012/07/06,18,7,0.7026836609999999,13612,18,4,3
24907,2014/03/31,2009/09/28,69,13,0.792741815,12065,69,6,7
24908,2014/03/31,2009/01/27,65,14,0.5170236229999999,18499,65,5,9
24909,2014/03/31,2012/09/12,52,8,0.627278809,15247,52,1,7
24910,2014/03/31,2009/09/15,468,11,0.756007905,12650,468,11,0
24911,2014/03/31,2011/07/12,110,7,0.67,14273,110,6,1
24912,2014/03/31,2011/09/10,23,8,0.75341081,12692,23,1,7
24913,2014/03/31,2009/02/24,164,6,0.902689512,10593,164,2,4
24914,2014/03/31,2012/10/24,11,12,0.938902092,10183,11,0,12
24915,2014/03/31,2012/11/27,161,6,0.7068916820000001,13525,161,0,6
24916,2014/03/31,2012/02/13,343,9,0.522592107,18294,343,8,1
24917,2014/03/31,2011/06/15,647,2,0.707190413,13518,647,2,0
24918,2014/03/31,2012/09/25,30,9,0.492868633,19396,30,2,7
24919,2014/03/31,2011/07/09,18,21,0.625381395,15286,18,3,18
24920,2014/03/31,2006/03/27,273,9,0.549525151,17395,273,7,2
24921,2014/03/31,2006/03/01,42,10,0.7044178329999999,13570,42,2,8
24922,2014/03/31,2007/08/23,76,20,0.852623316,11211,76,11,9
24923,2014/03/31,2012/03/05,381,9,0.681789001,14019,381,9,0
24924,2014/03/31,2010/02/05,73,3,1.167449615,8187,73,0,3
24925,2014/03/31,2008/04/21,180,7,0.5715609110000001,16721,180,4,3
24926,2014/03/31,2011/06/28,74,26,0.496289795,19255,74,17,9
24927,2014/03/31,2009/11/05,171,15,0.547021581,17469,171,9,6
24928,2014/03/31,2007/10/18,257,10,0.703507325,13583,257,3,7
24929,2014/03/31,2009/07/23,489,8,0.8068479270000001,11843,489,8,0
24930,2014/03/31,2011/11/10,535,6,1.0,9555,535,6,0
24931,2014/03/31,2011/08/15,149,13,0.520936699,18341,149,6,7
24932,2014/03/31,2009/10/11,122,10,0.7529109540000001,12690,122,2,8
24933,2014/03/31,2009/11/13,13,11,0.868111939,11006,13,6,5
24934,2014/03/31,2008/12/17,135,10,0.544770213,17538,135,4,6
24935,2014/03/31,2006/12/25,418,6,0.814059305,11736,418,6,0
24936,2014/03/31,2008/11/23,29,10,0.636063915,15020,29,3,7
24937,2014/03/31,2012/08/24,208,13,0.92342291,10345,208,8,5
24938,2014/03/31,2006/12/21,80,3,1.41,6775,80,0,3
24939,2014/03/31,2011/11/22,77,7,0.565674187,16887,77,3,4
24940,2014/03/31,2006/10/31,49,6,0.835338872,11435,49,2,4
24941,2014/03/31,2007/08/28,76,11,0.771429494,12382,76,5,6
24942,2014/03/31,2008/09/13,385,9,0.854819655,11173,385,9,0
24943,2014/03/31,2010/02/09,478,15,0.59,16185,478,15,0
24944,2014/03/31,2012/07/31,517,2,1.5,6365,517,2,0
24945,2014/03/31,2011/04/06,178,8,0.755475983,12637,178,5,3
24946,2014/03/31,2012/04/14,101,10,0.7009140970000001,13620,101,6,4
24947,2014/03/31,2009/09/10,120,17,0.730798438,13063,120,9,8
24948,2014/03/31,2006/03/29,115,6,0.5861660320000001,16286,115,0,6
24949,2014/03/31,2011/01/14,112,12,0.681494967,14007,112,7,5
24950,2014/03/31,2005/10/20,78,10,0.6571226929999999,14524,78,5,5
24951,2014/03/31,2010/02/20,27,11,0.7207045759999999,13242,27,7,4
24952,2014/03/31,2011/12/06,202,11,0.710332713,13435,202,2,9
24953,2014/03/31,2011/10/15,111,8,0.634950765,15030,111,7,1
24954,2014/03/31,2008/09/20,243,8,0.858154676,11120,243,6,2
24955,2014/03/31,2006/04/03,96,8,0.733573186,13008,96,7,1
24956,2014/03/31,2008/01/25,114,10,0.766225006,12453,114,7,3
24957,2014/03/31,2009/01/21,115,15,0.743686672,12830,115,13,2
24958,2014/03/31,2011/06/27,249,8,0.843257623,11315,249,4,4
24959,2014/03/31,2010/03/10,2,15,0.60860296,15676,2,3,12
24960,2014/03/31,2012/10/28,101,9,0.753398089,12663,101,4,5
24961,2014/03/31,2008/10/01,181,5,0.708338283,13468,181,2,3
24962,2014/03/31,2007/11/16,72,4,0.590767897,16148,72,0,4
24963,2014/03/31,2010/09/09,107,12,0.69186539,13788,107,4,8
24964,2014/03/31,2009/03/07,214,6,0.795406487,11993,214,3,3
24965,2014/03/31,2005/09/01,471,14,0.6450835189999999,14787,471,14,0
24966,2014/03/31,2009/01/23,70,24,0.600083679,15894,70,18,6
24967,2014/03/31,2009/08/31,38,14,0.568329063,16781,38,4,10
24968,2014/03/31,2008/01/27,7,9,0.654995879,14560,7,5,4
24969,2014/03/31,2012/10/17,8,11,0.678616665,14053,8,5,6
24970,2014/03/31,2008/07/25,114,8,0.6952343809999999,13717,114,2,6
24971,2014/03/31,2006/09/27,200,7,0.799744213,11924,200,4,3
24972,2014/03/31,2011/05/14,486,7,0.62355326,15293,486,7,0
24973,2014/03/31,2012/05/15,32,12,0.646201125,14757,32,5,7
24974,2014/03/31,2005/06/08,90,6,0.970613865,9823,90,1,5
24975,2014/03/31,2011/12/08,39,14,0.653187175,14596,39,4,10
24976,2014/03/31,2010/09/19,116,10,0.6475933979999999,14722,116,4,6
24977,2014/03/31,2006/08/31,15,8,0.57375,16616,15,5,3
24978,2014/03/31,2010/02/02,9,10,0.684078645,13936,9,1,9
24979,2014/03/31,2012/08/28,12,10,0.8810693159999999,10820,12,1,9
24980,2014/03/31,2010/07/28,85,14,0.504872623,18881,85,6,8
24981,2014/03/31,2012/06/30,366,2,0.571895248,16668,366,1,1
24982,2014/03/31,2009/10/03,95,12,0.550075596,17329,95,6,6
24983,2014/03/31,2006/01/22,61,7,0.638841745,14919,61,2,5
24984,2014/03/31,2011/12/28,35,11,0.577081264,16514,35,5,6
24985,2014/03/31,2005/06/20,2,5,1.115118184,8546,2,2,3
24986,2014/03/31,2011/06/19,9,13,0.7010152279999999,13593,9,8,5
24987,2014/03/31,2010/05/18,201,7,0.765744595,12443,201,3,4
24988,2014/03/31,2010/04/30,72,19,0.92057971,10350,72,11,8
24989,2014/03/31,2011/12/30,376,7,0.6972411270000001,13665,376,7,0
24990,2014/03/31,2009/09/09,72,14,0.539372169,17664,72,11,3
24991,2014/03/31,2011/05/14,527,7,0.669450495,14231,527,7,0
24992,2014/03/31,2009/06/08,33,17,0.618734169,15397,33,3,14
24993,2014/03/31,2010/05/27,192,12,0.6594019520000001,14447,192,6,6
24994,2014/03/31,2007/12/14,142,11,0.631847184,15077,142,8,3
24995,2014/03/31,2006/05/25,121,21,0.563359749,16909,121,11,10
24996,2014/03/31,2012/03/28,156,10,0.660547119,14421,156,6,4
24997,2014/03/31,2012/11/23,144,8,0.771591866,12344,144,2,6
24998,2014/03/31,2006/11/13,174,6,0.854731221,11143,174,3,3
24999,2014/03/31,2012/11/15,8,7,0.626668421,15197,8,3,4
25000,2014/03/31,2012/12/20,70,11,0.542249174,17562,70,4,7
25001,2014/03/31,2011/09/30,165,9,0.6747566070000001,14113,165,4,5
25002,2014/03/31,2008/07/02,4,10,0.840642769,11326,4,1,9
25003,2014/03/31,2010/04/04,127,18,0.652037392,14602,127,16,2
25004,2014/03/31,2010/12/17,588,5,0.67,14210,588,5,0
25005,2014/03/31,2012/08/29,327,6,0.683333333,13932,327,4,2
25006,2014/03/31,2011/05/12,2,25,0.615835436,15459,2,9,16
25007,2014/03/31,2007/10/14,169,13,0.536279646,17751,169,5,8
25008,2014/03/31,2012/06/23,161,10,0.645462436,14748,161,6,4
25009,2014/03/31,2010/11/20,517,9,0.667882956,14251,517,9,0
25010,2014/03/31,2013/03/05,83,8,0.624657741,15237,83,1,7
25011,2014/03/31,2008/11/03,79,9,0.757211967,12568,79,1,8
25012,2014/03/31,2012/02/21,75,11,0.6918979059999999,13752,75,9,2
25013,2014/03/31,2006/12/02,258,15,0.8713333329999999,10920,258,12,3
25014,2014/03/31,2007/08/28,311,8,0.732760878,12985,311,6,2
25015,2014/03/31,2011/03/27,395,17,0.7067406970000001,13463,395,17,0
25016,2014/03/31,2010/11/01,249,9,0.7562056909999999,12582,249,7,2
25017,2014/03/31,2012/03/05,115,9,0.637894737,14915,115,3,6
25018,2014/03/31,2012/11/10,283,7,0.7165918509999999,13277,283,5,2
25019,2014/03/31,2013/02/24,36,15,0.82912244,11475,36,1,14
25020,2014/03/31,2013/03/16,250,4,0.828277904,11486,250,0,4
25021,2014/03/31,2012/08/24,118,9,0.7654783940000001,12427,118,5,4
25022,2014/03/31,2012/01/09,71,17,0.499967411,19025,71,12,5
25023,2014/03/31,2010/06/09,14,13,0.8391354209999999,11335,14,7,6
25024,2014/03/31,2006/12/13,30,10,0.7447647009999999,12771,30,4,6
25025,2014/03/31,2009/09/29,218,16,0.547351672,17377,218,8,8
25026,2014/03/31,2008/04/20,517,9,0.693987157,13704,517,9,0
25027,2014/03/31,2013/03/21,137,10,0.786488587,12092,137,1,9
25028,2014/03/31,2012/03/28,290,9,0.78233465,12156,290,6,3
25029,2014/03/31,2011/05/12,153,7,0.988557173,9620,153,6,1
25030,2014/03/31,2008/07/20,69,10,0.904664193,10512,69,5,5
25031,2014/03/31,2011/12/17,5,16,0.5916244629999999,16073,5,11,5
25032,2014/03/31,2006/05/17,16,7,0.761440583,12488,16,1,6
25033,2014/03/31,2008/03/12,34,13,0.833076923,11414,34,7,6
25034,2014/03/31,2007/03/16,60,11,0.5225817620000001,18193,60,2,9
25035,2014/03/31,2007/12/04,165,8,0.648122571,14669,165,4,4
25036,2014/03/31,2007/06/03,32,10,0.802294515,11850,32,3,7
25037,2014/03/31,2012/05/13,427,7,0.426779943,22276,427,7,0
25038,2014/03/31,2008/10/16,155,9,0.919951616,10334,155,4,5
25039,2014/03/31,2008/11/13,136,11,0.692301362,13731,136,5,6
25040,2014/03/31,2012/04/10,228,12,0.794994564,11957,228,11,1
25041,2014/03/31,2012/03/08,35,16,0.7251293000000001,13109,35,8,8
25042,2014/03/31,2012/08/07,518,5,1.5,6337,518,5,0
25043,2014/03/31,2007/03/21,6,17,0.7885664509999999,12054,6,2,15
25044,2014/03/31,2011/08/29,26,12,0.8962891359999999,10604,26,6,6
25045,2014/03/31,2009/11/30,191,13,0.969421665,9804,191,6,7
25046,2014/03/31,2012/06/16,3,14,0.673673093,14108,3,4,10
25047,2014/03/31,2010/04/08,677,3,0.499584691,19022,677,3,0
25048,2014/03/31,2012/04/28,44,7,0.666070653,14267,44,2,5
25049,2014/03/31,2011/01/28,36,17,0.562377345,16897,36,14,3
25050,2014/03/31,2008/03/30,50,10,0.8438326970000001,11261,50,8,2
25051,2014/03/31,2012/07/21,32,7,0.7464718359999999,12729,32,1,6
25052,2014/03/31,2008/02/23,164,11,0.6378029129999999,14897,164,7,4
25053,2014/03/31,2009/07/01,219,6,0.805,11802,219,2,4
25054,2014/03/31,2012/08/25,49,9,0.552939704,17182,49,7,2
25055,2014/03/31,2012/10/24,225,7,0.61562986,15432,225,4,3
25056,2014/03/31,2011/03/16,132,9,0.828078801,11472,132,6,3
25057,2014/03/31,2013/01/16,47,12,0.7393881840000001,12847,47,2,10
25058,2014/03/31,2012/05/09,369,9,0.561851523,16905,369,9,0
25059,2014/03/31,2010/04/29,86,13,0.6731389090000001,14110,86,9,4
25060,2014/03/31,2008/10/10,30,12,0.791484167,12000,30,4,8
25061,2014/03/31,2010/12/06,103,12,0.82060394,11574,103,6,6
25062,2014/03/31,2009/10/22,166,5,0.863285455,11000,166,4,1
25063,2014/03/31,2011/03/06,279,5,0.652420474,14555,279,3,2
25064,2014/03/31,2006/09/09,12,11,0.575698436,16494,12,1,10
25065,2014/03/31,2006/04/27,163,6,0.455422542,20850,163,3,3
25066,2014/03/31,2008/03/12,134,7,0.76714632,12377,134,5,2
25067,2014/03/31,2011/05/19,280,11,0.608707444,15597,280,9,2
25068,2014/03/31,2009/11/24,209,11,0.652517011,14549,209,7,4
25069,2014/03/31,2008/01/17,1,7,0.698571429,13587,1,0,7
25070,2014/03/31,2011/01/29,146,12,0.735745407,12899,146,7,5
25071,2014/03/31,2012/09/11,20,11,0.621418282,15272,20,6,5
25072,2014/03/31,2006/02/25,119,7,0.685912113,13836,119,3,4
25073,2014/03/31,2007/09/30,166,12,0.608910491,15585,166,9,3
25074,2014/03/31,2012/09/20,234,11,0.666728026,14233,234,4,7
25075,2014/03/31,2008/05/10,96,18,0.743201222,12767,96,11,7
25076,2014/03/31,2007/08/16,12,7,0.966120558,9821,12,4,3
25077,2014/03/31,2011/04/01,508,4,1.366978821,6941,508,4,0
25078,2014/03/31,2012/03/20,250,10,0.536822451,17674,250,7,3
25079,2014/03/31,2012/03/06,8,10,0.6545284579999999,14495,8,4,6
25080,2014/03/31,2006/08/07,43,5,0.944,10050,43,3,2
25081,2014/03/31,2004/12/09,20,13,0.419427005,22618,20,5,8
25082,2014/03/31,2009/11/26,73,5,0.724673033,13090,73,2,3
25083,2014/03/31,2006/06/25,577,5,0.704149963,13470,577,5,0
25084,2014/03/31,2007/09/19,51,9,0.707058297,13414,51,3,6
25085,2014/03/31,2005/10/11,149,7,0.774458599,12246,149,1,6
25086,2014/03/31,2008/01/10,194,9,0.869743213,10904,194,6,3
25087,2014/03/31,2011/04/18,48,6,0.7487319379999999,12665,48,1,5
25088,2014/03/31,2012/09/29,65,7,0.759826122,12480,65,1,6
25089,2014/03/31,2012/01/27,43,9,0.6860082479999999,13821,43,4,5
25090,2014/03/31,2010/12/20,66,6,0.803333333,11802,66,0,6
25091,2014/03/31,2010/12/13,273,8,0.6025,15736,273,5,3
25092,2014/03/31,2012/09/30,67,9,0.535555556,17703,67,6,3
25093,2014/03/31,2011/04/27,32,10,0.767901815,12344,32,5,5
25094,2014/03/31,2010/10/26,100,14,0.64034725,14802,100,7,7
25095,2014/03/31,2005/05/26,129,5,0.629959455,15045,129,3,2
25096,2014/03/31,2009/06/30,142,11,0.6137054789999999,15442,142,3,8
25097,2014/03/31,2011/06/14,432,8,0.908251869,10434,432,8,0
25098,2014/03/31,2009/11/02,148,14,0.561770704,16869,148,10,4
25099,2014/03/31,2012/10/31,103,15,0.7987263990000001,11864,103,7,8
25100,2014/03/31,2010/05/31,57,11,0.623626193,15195,57,3,8
25101,2014/03/31,2013/03/20,143,11,0.6845477529999999,13842,143,1,10
25102,2014/03/31,2008/03/27,318,9,0.692789762,13675,318,6,3
25103,2014/03/31,2005/09/21,21,15,0.6623079070000001,14303,21,7,8
25104,2014/03/31,2009/07/28,171,5,0.675333999,14027,171,3,2
25105,2014/03/31,2011/09/12,126,6,0.7970307109999999,11885,126,3,3
25106,2014/03/31,2010/07/09,416,13,0.942162323,10054,416,13,0
25107,2014/03/31,2011/08/22,21,7,0.7408399809999999,12786,21,2,5
25108,2014/03/31,2012/10/22,73,17,0.6052377,15650,73,1,16
25109,2014/03/31,2010/02/23,397,10,0.76814127,12331,397,10,0
25110,2014/03/31,2006/03/09,326,8,0.62811008,15080,326,5,3
25111,2014/03/31,2007/02/18,43,11,0.6947597740000001,13633,43,6,5
25112,2014/03/31,2012/02/20,151,9,0.8031557970000001,11791,151,7,2
25113,2014/03/31,2012/07/25,2,17,0.660559431,14336,2,2,15
25114,2014/03/31,2013/01/12,62,6,0.948669605,9982,62,3,3
25115,2014/03/31,2012/04/04,279,7,0.76,12460,279,5,2
25116,2014/03/31,2007/10/30,105,5,0.788299201,12012,105,0,5
25117,2014/03/31,2010/02/03,67,9,0.64734532,14627,67,4,5
25118,2014/03/31,2012/09/27,74,14,0.778397731,12164,74,4,10
25119,2014/03/31,2012/03/01,60,10,1.24775962,7588,60,3,7
25120,2014/03/31,2007/07/05,37,9,0.725841448,13043,37,4,5
25121,2014/03/31,2013/01/13,27,17,0.716782767,13207,27,1,16
25122,2014/03/31,2013/03/29,40,9,0.724564103,13065,40,1,8
25123,2014/03/31,2010/06/10,153,9,0.6765835179999999,13991,153,4,5
25124,2014/03/31,2007/12/14,151,7,0.5211925999999999,18162,151,4,3
25125,2014/03/31,2008/05/23,245,11,0.664930102,14235,245,8,3
25126,2014/03/31,2007/12/14,170,11,0.664835628,14236,170,6,5
25127,2014/03/31,2010/12/26,7,11,0.482435133,19617,7,5,6
25128,2014/03/31,2012/09/03,165,9,0.7116694240000001,13298,165,3,6
25129,2014/03/31,2007/02/10,53,4,0.570818505,16579,53,1,3
25130,2014/03/31,2010/01/16,152,10,0.680113555,13914,152,6,4
25131,2014/03/31,2012/10/15,32,11,0.5359501560000001,17655,32,2,9
25132,2014/03/31,2012/08/29,36,4,1.2025,7868,36,1,3
25133,2014/03/31,2012/04/15,249,8,0.60125,15736,249,5,3
25134,2014/03/31,2008/09/29,81,9,0.538942691,17554,81,0,9
25135,2014/03/31,2006/09/14,62,11,0.586148079,16140,62,3,8
25136,2014/03/31,2007/04/19,542,6,0.777082307,12174,542,6,0
25137,2014/03/31,2005/12/03,326,7,0.5800925929999999,16308,326,5,2
25138,2014/03/31,2012/11/04,132,8,0.8272409270000001,11435,132,4,4
25139,2014/03/31,2012/02/07,16,7,0.4985706,18973,16,1,6
25140,2014/03/31,2012/03/29,73,11,0.753120968,12557,73,8,3
25141,2014/03/31,2007/11/13,106,7,0.7624494070000001,12403,106,4,3
25142,2014/03/31,2012/03/28,535,5,0.880648165,10738,535,5,0
25143,2014/03/31,2012/04/04,45,8,0.741875098,12746,45,3,5
25144,2014/03/31,2007/12/17,44,7,0.761837738,12412,44,2,5
25145,2014/03/31,2011/10/31,463,8,0.7340358640000001,12882,463,8,0
25146,2014/03/31,2011/08/24,384,4,0.8049974459999999,11746,384,4,0
25147,2014/03/31,2009/09/18,125,16,0.765557895,12350,125,6,10
25148,2014/03/31,2007/11/01,21,10,0.547520848,17268,21,1,9
25149,2014/03/31,2012/02/24,16,9,0.643387327,14693,16,5,4
25150,2014/03/31,2012/01/07,200,10,0.614357575,15387,200,1,9
25151,2014/03/31,2013/01/08,341,5,0.92,10275,341,4,1
25152,2014/03/31,2008/07/23,16,9,0.628649242,15036,16,2,7
25153,2014/03/31,2012/04/30,179,9,0.630429534,14993,179,4,5
25154,2014/03/31,2007/11/28,258,9,0.815890021,11584,258,3,6
25155,2014/03/31,2010/07/29,73,11,0.707603324,13356,73,8,3
25156,2014/03/31,2008/04/22,25,9,0.702627509,13450,25,4,5
25157,2014/03/31,2010/02/13,40,14,0.681819625,13860,40,9,5
25158,2014/03/31,2005/03/01,84,15,0.770501468,12264,84,4,11
25159,2014/03/31,2013/02/27,39,3,0.44865296,21061,39,0,3
25160,2014/03/31,2007/04/10,7,10,0.724949363,13034,7,7,3
25161,2014/03/31,2007/10/20,14,10,0.6289834910000001,15022,14,1,9
25162,2014/03/31,2013/02/06,42,12,0.7747219940000001,12194,42,2,10
25163,2014/03/31,2005/11/18,12,10,0.656765156,14384,12,3,7
25164,2014/03/31,2012/08/17,156,7,0.92539087,10208,156,5,2
25165,2014/03/31,2006/09/28,596,5,0.87741501,10766,596,5,0
25166,2014/03/31,2009/10/23,41,7,0.6981080479999999,13531,41,4,3
25167,2014/03/31,2012/08/05,20,9,0.678491596,13922,20,4,5
25168,2014/03/31,2011/03/27,119,7,0.879706595,10736,119,5,2
25169,2014/03/31,2007/08/15,36,27,0.768021469,12297,36,12,15
25170,2014/03/31,2012/08/23,43,15,0.78544827,12024,43,6,9
25171,2014/03/31,2009/04/06,287,9,0.802222222,11772,287,6,3
25172,2014/03/31,2011/08/14,25,11,0.56186719,16806,25,7,4
25173,2014/03/31,2009/10/27,16,8,0.6794480820000001,13897,16,0,8
25174,2014/03/31,2012/09/21,194,12,0.731777881,12903,194,2,10
25175,2014/03/31,2012/04/02,207,13,0.693249633,13620,207,3,10
25176,2014/03/31,2011/07/12,113,13,0.773841488,12201,113,6,7
25177,2014/03/31,2011/04/28,11,12,0.61172282,15434,11,1,11
25178,2014/03/31,2012/09/02,328,9,0.707842255,13338,328,7,2
25179,2014/03/31,2008/11/24,338,8,0.8045594,11734,338,4,4
25180,2014/03/31,2006/12/13,10,8,0.663935579,14219,10,6,2
25181,2014/03/31,2012/06/30,286,4,1.436612388,6571,286,2,2
25182,2014/03/31,2011/05/29,110,8,0.67073403,14073,110,7,1
25183,2014/03/31,2009/01/30,112,10,0.562473035,16781,112,3,7
25184,2014/03/31,2013/01/26,107,6,0.6364281860000001,14830,107,3,3
25185,2014/03/31,2007/11/13,320,8,0.400992055,23537,320,6,2
25186,2014/03/31,2010/02/10,74,8,0.883470935,10683,74,6,2
25187,2014/03/31,2007/06/06,53,22,0.529732809,17815,53,8,14
25188,2014/03/31,2012/08/08,113,11,0.636363636,14828,113,2,9
25189,2014/03/31,2011/08/15,119,16,0.6716399740000001,14049,119,5,11
25190,2014/03/31,2010/12/26,46,11,0.467717359,20174,46,8,3
25191,2014/03/31,2011/10/25,129,11,0.7418848790000001,12717,129,1,10
25192,2014/03/31,2012/12/29,13,9,0.664735025,14190,13,0,9
25193,2014/03/31,2008/09/02,130,10,0.442,21340,130,2,8
25194,2014/03/31,2012/03/31,489,8,0.816490651,11552,489,8,0
25195,2014/03/31,2011/11/24,314,5,0.673751697,13999,314,4,1
25196,2014/03/31,2006/07/14,75,8,0.832817026,11324,75,2,6
25197,2014/03/31,2012/10/31,88,11,0.7676970040000001,12284,88,8,3
25198,2014/03/31,2008/06/20,37,11,0.714990901,13188,37,8,3
25199,2014/03/31,2009/12/29,233,11,0.563386711,16736,233,9,2
25200,2014/03/31,2011/06/27,89,9,0.63984867,14736,89,4,5
25201,2014/03/31,2008/05/19,140,2,0.58,16254,140,0,2
25202,2014/03/31,2010/09/30,12,15,0.797888099,11814,12,7,8
25203,2014/03/31,2008/04/10,75,6,1.080708553,8722,75,4,2
25204,2014/03/31,2007/06/16,5,8,0.73023009,12908,5,2,6
25205,2014/03/31,2009/05/13,91,16,0.691964758,13620,91,12,4
25206,2014/03/31,2005/04/13,235,8,0.631568365,14920,235,4,4
25207,2014/03/31,2011/11/07,489,4,1.5,6282,489,4,0
25208,2014/03/31,2009/03/25,246,6,0.740087967,12732,246,4,2
25209,2014/03/31,2008/10/11,35,6,1.179011512,7992,35,1,5
25210,2014/03/31,2008/11/11,155,13,0.74881488,12581,155,8,5
25211,2014/03/31,2006/08/04,119,9,0.800861175,11763,119,5,4
25212,2014/03/31,2008/12/22,311,11,0.65960717,14281,311,9,2
25213,2014/03/31,2012/06/16,461,8,0.737537197,12770,461,8,0
25214,2014/03/31,2012/01/15,201,9,0.7407196220000001,12715,201,5,4
25215,2014/03/31,2010/04/15,432,11,0.88658571,10623,432,11,0
25216,2014/03/31,2007/09/20,165,5,1.060121567,8884,165,2,3
25217,2014/03/31,2012/07/05,84,10,0.8077289879999999,11660,84,3,7
25218,2014/03/31,2008/07/15,27,9,0.819793662,11486,27,6,3
25219,2014/03/31,2007/05/06,101,11,0.505397456,18631,101,1,10
25220,2014/03/31,2012/05/31,345,6,1.0,9416,345,5,1
25221,2014/03/31,2006/05/31,57,5,0.911274681,10332,57,2,3
25222,2014/03/31,2010/07/24,3,12,0.63242526,14885,3,7,5
25223,2014/03/31,2006/03/08,199,11,0.504935093,18642,199,3,8
25224,2014/03/31,2011/12/17,74,10,0.5265488110000001,17875,74,4,6
25225,2014/03/31,2013/02/05,102,9,0.834379433,11280,102,2,7
25226,2014/03/31,2011/04/27,47,10,0.7741806520000001,12156,47,8,2
25227,2014/03/31,2011/08/27,14,8,0.647593587,14532,14,0,8
25228,2014/03/31,2009/11/18,21,13,0.702085198,13404,21,2,11
25229,2014/03/31,2008/10/05,21,5,0.8431798229999999,11161,21,0,5
25230,2014/03/31,2010/03/08,1,15,0.650824457,14458,1,7,8
25231,2014/03/31,2013/02/03,363,4,0.565443783,16641,363,3,1
25232,2014/03/31,2010/12/11,415,10,0.696178603,13516,415,10,0
25233,2014/03/31,2006/07/01,62,8,0.6814513329999999,13808,62,5,3
25234,2014/03/31,2008/12/13,240,8,0.680853835,13820,240,4,4
25235,2014/03/31,2011/12/18,51,7,0.7726804629999999,12177,51,4,3
25236,2014/03/31,2007/11/01,40,10,0.73672696,12771,40,2,8
25237,2014/03/31,2005/08/24,244,11,0.878273898,10712,244,9,2
25238,2014/03/31,2010/03/30,50,11,0.64411954,14606,50,2,9
25239,2014/03/31,2011/11/01,67,3,1.103333333,8526,67,1,2
25240,2014/03/31,2005/01/18,444,12,0.635050294,14813,444,12,0
25241,2014/03/31,2006/08/04,137,10,0.6821852340000001,13788,137,5,5
25242,2014/03/31,2005/09/09,44,13,0.507079312,18547,44,5,8
25243,2014/03/31,2010/11/29,138,12,0.843779831,11146,138,5,7
25244,2014/03/31,2006/03/28,22,8,0.700614617,13423,22,1,7
25245,2014/03/31,2010/05/25,123,16,0.6759218000000001,13913,123,8,8
25246,2014/03/31,2005/07/19,27,10,0.961765368,9777,27,7,3
25247,2014/03/31,2011/02/08,191,14,0.7649886090000001,12290,191,9,5
25248,2014/03/31,2012/06/27,534,7,0.832506863,11293,534,7,0
25249,2014/03/31,2010/03/19,138,13,0.6957844879999999,13512,138,3,10
25250,2014/03/31,2010/06/16,438,7,0.766518549,12265,438,7,0
25251,2014/03/31,2013/01/02,70,11,0.686075312,13703,70,0,11
25252,2014/03/31,2011/10/18,17,10,0.751296252,12513,17,8,2
25253,2014/03/31,2005/01/07,378,8,0.906752194,10367,378,8,0
25254,2014/03/31,2005/09/08,33,21,0.641508327,14652,33,10,11
25255,2014/03/31,2008/03/05,76,14,0.529536338,17750,76,12,2
25256,2014/03/31,2013/01/22,27,11,0.849830018,11060,27,3,8
25257,2014/03/31,2013/03/22,91,8,0.8250447679999999,11392,91,0,8
25258,2014/03/31,2008/03/17,38,13,0.620337271,15151,38,6,7
25259,2014/03/31,2011/11/29,34,9,0.586666667,16020,34,6,3
25260,2014/03/31,2011/07/18,11,7,0.7819821920000001,12017,11,1,6
25261,2014/03/31,2010/07/27,220,10,0.6685237620000001,14056,220,3,7
25262,2014/03/31,2011/09/28,39,13,0.621437074,15121,39,8,5
25263,2014/03/31,2012/09/16,44,12,0.7975967740000001,11780,44,4,8
25264,2014/03/31,2012/10/16,40,15,0.7643695090000001,12292,40,5,10
25265,2014/03/31,2011/08/11,202,14,1.018587381,9224,202,10,4
25266,2014/03/31,2012/07/20,144,16,0.770304993,12197,144,6,10
25267,2014/03/31,2006/03/05,203,11,0.645926435,14545,203,5,6
25268,2014/03/31,2006/07/13,81,7,0.7208609579999999,13032,81,4,3
25269,2014/03/31,2006/08/15,29,11,0.641375708,14647,29,3,8
25270,2014/03/31,2010/07/05,224,7,0.8017804709999999,11716,224,5,2
25271,2014/03/31,2011/07/10,177,9,0.774565773,12125,177,7,2
25272,2014/03/31,2011/12/22,25,11,0.7290909090000001,12881,25,7,4
25273,2014/03/31,2009/08/08,103,12,0.743974806,12622,103,6,6
25274,2014/03/31,2004/12/12,51,12,0.65993956,14229,51,6,6
25275,2014/03/31,2012/01/02,258,10,0.832607732,11278,258,8,2
25276,2014/03/31,2013/01/17,126,2,0.607292718,15462,126,1,1
25277,2014/03/31,2011/09/07,511,5,0.88,10670,511,5,0
25278,2014/03/31,2008/05/11,166,7,0.670657904,13999,166,5,2
25279,2014/03/31,2011/02/26,208,8,0.646930816,14512,208,4,4
25280,2014/03/31,2012/05/11,145,9,0.891133365,10535,145,8,1
25281,2014/03/31,2012/04/14,104,8,0.769554882,12199,104,6,2
25282,2014/03/31,2012/09/06,132,7,0.729747357,12864,132,2,5
25283,2014/03/31,2005/08/18,2,14,0.39507849,23761,2,5,9
25284,2014/03/31,2013/01/22,19,13,0.8613452009999999,10898,19,5,8
25285,2014/03/31,2012/07/12,204,8,0.7452306470000001,12595,204,6,2
25286,2014/03/31,2012/06/02,158,9,0.7664380209999999,12246,158,4,5
25287,2014/03/31,2005/07/10,708,3,1.120255431,8378,708,3,0
25288,2014/03/31,2007/06/14,600,11,0.559090909,16786,600,11,0
25289,2014/03/31,2009/06/26,16,10,0.6352816139999999,14772,16,3,7
25290,2014/03/31,2008/12/06,127,11,0.642712828,14601,127,5,6
25291,2014/03/31,2011/12/19,239,8,0.706129882,13289,239,5,3
25292,2014/03/31,2011/02/25,395,10,0.631342932,14863,395,10,0
25293,2014/03/31,2010/05/25,1,6,0.668235294,14042,1,0,6
25294,2014/03/31,2009/01/20,93,8,0.7247223290000001,12947,93,2,6
25295,2014/03/31,2011/10/06,324,12,0.775502108,12099,324,11,1
25296,2014/03/31,2012/09/15,365,6,1.258302039,7456,365,5,1
25297,2014/03/31,2007/09/18,89,15,0.823327482,11393,89,13,2
25298,2014/03/31,2012/07/26,131,13,0.577217675,16249,131,9,4
25299,2014/03/31,2005/11/01,281,10,0.66871016,14025,281,7,3
25300,2014/03/31,2012/02/28,1,10,0.6889567259999999,13611,1,0,10
25301,2014/03/31,2013/01/14,8,9,0.56364609,16637,8,1,8
25302,2014/03/31,2006/05/29,114,12,0.8879761340000001,10559,114,8,4
25303,2014/03/31,2012/12/27,32,11,1.009158325,9291,32,6,5
25304,2014/03/31,2009/09/21,433,8,0.671579513,13960,433,8,0
25305,2014/03/31,2007/11/13,182,6,0.805761066,11635,182,2,4
25306,2014/03/31,2007/02/01,180,11,0.7777302140000001,12054,180,6,5
25307,2014/03/31,2007/12/23,146,10,0.72,13020,146,6,4
25308,2014/03/31,2012/12/30,35,17,0.7075836040000001,13247,35,0,17
25309,2014/03/31,2011/01/19,485,4,0.735445273,12745,485,4,0
25310,2014/03/31,2007/11/06,79,8,0.717555505,13062,79,0,8
25311,2014/03/31,2010/07/08,149,7,0.717142857,13069,149,3,4
25312,2014/03/31,2012/08/10,43,13,0.7161289829999999,13087,43,8,5
25313,2014/03/31,2007/07/03,17,6,0.7128004259999999,13148,17,3,3
25314,2014/03/31,2006/11/01,42,12,0.732063901,12801,42,0,12
25315,2014/03/31,2013/03/08,186,5,0.43232526,21675,186,2,3
25316,2014/03/31,2007/03/30,297,12,0.6548179470000001,14309,297,5,7
25317,2014/03/31,2012/04/18,46,6,0.776625497,12064,46,2,4
25318,2014/03/31,2011/11/01,117,9,0.7147001829999999,13108,117,0,9
25319,2014/03/31,2012/04/24,235,7,0.66463072,14095,235,6,1
25320,2014/03/31,2012/10/20,380,7,0.75,12490,380,7,0
25321,2014/03/31,2012/10/19,95,10,0.814670377,11498,95,5,5
25322,2014/03/31,2012/12/20,135,6,0.811338242,11545,135,1,5
25323,2014/03/31,2010/03/09,20,9,0.653868063,14325,20,5,4
25324,2014/03/31,2007/07/02,101,14,0.663379134,14119,101,5,9
25325,2014/03/31,2009/08/12,404,9,0.68459177,13681,404,9,0
25326,2014/03/31,2011/04/10,15,11,0.755860705,12391,15,5,6
25327,2014/03/31,2012/05/28,37,10,0.925464967,10119,37,6,4
25328,2014/03/31,2011/04/23,29,10,0.679864237,13774,29,6,4
25329,2014/03/31,2008/09/09,89,11,0.641968191,14587,89,6,5
25330,2014/03/31,2012/02/11,248,14,0.633479231,14782,248,13,1
25331,2014/03/31,2012/02/03,252,9,0.699840048,13379,252,5,4
25332,2014/03/31,2012/08/11,239,8,0.8938109790000001,10475,239,5,3
25333,2014/03/31,2011/04/23,59,7,0.7097218009999999,13192,59,2,5
25334,2014/03/31,2009/12/17,78,6,0.7985465709999999,11724,78,2,4
25335,2014/03/31,2012/05/11,14,4,0.539911765,17340,14,1,3
25336,2014/03/31,2012/05/06,69,6,0.941810865,9940,69,1,5
25337,2014/03/31,2007/06/07,43,7,0.7732851479999999,12106,43,3,4
25338,2014/03/31,2008/02/01,100,8,0.7383263659999999,12679,100,5,3
25339,2014/03/31,2013/01/21,47,11,0.92,10175,47,2,9
25340,2014/03/31,2010/05/10,82,12,0.627885699,14908,82,6,6
25341,2014/03/31,2011/08/22,340,11,0.6768746840000001,13829,340,8,3
25342,2014/03/31,2007/07/13,11,10,0.7771139159999999,12044,11,5,5
25343,2014/03/31,2011/12/27,94,10,0.666681388,14039,94,4,6
25344,2014/03/31,2007/01/14,122,10,0.7137054829999999,13113,122,8,2
25345,2014/03/31,2008/02/26,41,5,0.730312159,12814,41,2,3
25346,2014/03/31,2013/02/03,36,6,0.456764936,20488,36,1,5
25347,2014/03/31,2013/02/09,402,2,0.753704897,12416,402,2,0
25348,2014/03/31,2009/04/12,163,9,0.837844928,11169,163,7,2
25349,2014/03/31,2007/07/09,19,5,0.6,15595,19,2,3
25350,2014/03/31,2007/09/29,265,5,0.67,13965,265,2,3
25351,2014/03/31,2009/07/13,19,11,0.803571245,11643,19,5,6
25352,2014/03/31,2011/08/04,38,7,0.801557574,11672,38,2,5
25353,2014/03/31,2012/04/09,80,13,0.589816543,15862,80,4,9
25354,2014/03/31,2012/10/31,196,7,0.811106294,11534,196,4,3
25355,2014/03/31,2011/03/04,12,9,0.608075923,15384,12,4,5
25356,2014/03/31,2008/11/05,116,6,0.7272455879999999,12863,116,3,3
25357,2014/03/31,2008/08/25,4,13,0.6689122510000001,13983,4,6,7
25358,2014/03/31,2012/11/20,3,14,0.664944547,14066,3,0,14
25359,2014/03/31,2012/08/12,177,4,0.838157541,11159,177,2,2
25360,2014/03/31,2007/05/10,49,7,0.710220973,13169,49,4,3
25361,2014/03/31,2012/06/06,293,9,0.745699705,12541,293,7,2
25362,2014/03/31,2011/09/07,20,9,0.7581657479999999,12332,20,4,5
25363,2014/03/31,2011/11/22,112,13,0.666789815,14021,112,9,4
25364,2014/03/31,2008/07/01,149,11,0.7837156270000001,11928,149,5,6
25365,2014/03/31,2007/04/16,163,4,0.7089428179999999,13186,163,2,2
25366,2014/03/31,2012/07/19,124,12,0.641783851,14564,124,5,7
25367,2014/03/31,2010/07/19,25,8,0.824037207,11342,25,5,3
25368,2014/03/31,2005/05/25,75,10,0.7918410570000001,11803,75,3,7
25369,2014/03/31,2012/05/04,662,2,0.575,16254,662,2,0
25370,2014/03/31,2005/03/18,323,6,1.107077707,8442,323,5,1
25371,2014/03/31,2013/01/07,98,10,0.6879006259999999,13585,98,2,8
25372,2014/03/31,2012/06/05,220,9,0.7992934740000001,11691,220,5,4
25373,2014/03/31,2009/03/15,153,7,0.40243852,23219,153,3,4
25374,2014/03/31,2007/12/31,171,3,0.700667367,13336,171,1,2
25375,2014/03/31,2005/04/14,555,6,0.816979977,11437,555,6,0
25376,2014/03/31,2011/04/21,20,15,0.728192658,12831,20,0,15
25377,2014/03/31,2009/02/20,36,8,0.60458975,15454,36,3,5
25378,2014/03/31,2012/11/24,31,5,0.95,9835,31,2,3
25379,2014/03/31,2008/05/19,256,8,0.872236228,10710,256,3,5
25380,2014/03/31,2012/04/02,213,10,0.630635253,14813,213,4,6
25381,2014/03/31,2007/11/20,142,8,0.6329565629999999,14757,142,4,4
25382,2014/03/31,2007/02/20,26,7,0.52660821,17734,26,4,3
25383,2014/03/31,2012/02/20,2,9,0.779706938,11977,2,6,3
25384,2014/03/31,2007/11/19,37,11,0.749722222,12456,37,7,4
25385,2014/03/31,2010/09/12,215,9,0.570285802,16375,215,6,3
25386,2014/03/31,2010/09/09,195,2,0.7,13340,195,0,2
25387,2014/03/31,2010/12/12,75,15,0.594367282,15710,75,9,6
25388,2014/03/31,2011/03/31,35,13,0.7650323640000001,12205,35,6,7
25389,2014/03/31,2010/10/08,109,9,0.623547482,14974,109,7,2
25390,2014/03/31,2008/02/19,4,7,0.589424874,15840,4,0,7
25391,2014/03/31,2008/09/16,2,23,0.70504531,13242,2,8,15
25392,2014/03/31,2012/12/19,29,6,0.8441030740000001,11060,29,2,4
25393,2014/03/31,2007/11/05,15,9,0.677554798,13778,15,5,4
25394,2014/03/31,2010/04/19,62,15,0.749325734,12458,62,2,13
25395,2014/03/31,2012/12/07,48,12,0.488333333,19116,48,7,5
25396,2014/03/31,2013/01/25,3,13,0.6891863559999999,13544,3,4,9
25397,2014/03/31,2011/11/04,108,5,0.8125165390000001,11488,108,2,3
25398,2014/03/31,2013/01/26,337,3,0.7850954659999999,11889,337,2,1
25399,2014/03/31,2009/12/18,578,3,0.630505269,14804,578,3,0
25400,2014/03/31,2012/07/05,22,16,0.5057841120000001,18454,22,3,13
25401,2014/03/31,2006/06/12,57,11,0.6323985360000001,14759,57,1,10
25402,2014/03/31,2012/08/06,329,8,0.7625,12240,329,6,2
25403,2014/03/31,2006/11/23,9,13,0.7825498909999999,11926,9,8,5
25404,2014/03/31,2008/10/01,119,8,0.669924623,13930,119,2,6
25405,2014/03/31,2012/05/13,140,15,0.593913818,15711,140,7,8
25406,2014/03/31,2010/02/26,33,7,0.84314296,11066,33,0,7
25407,2014/03/31,2007/10/31,448,10,1.0,9330,448,10,0
25408,2014/03/31,2010/04/27,132,12,0.565395152,16500,132,8,4
25409,2014/03/31,2011/05/31,68,11,0.801165407,11644,68,8,3
25410,2014/03/31,2008/09/24,242,7,0.889021252,10493,242,6,1
25411,2014/03/31,2007/12/09,103,9,0.751749537,12409,103,5,4
25412,2014/03/31,2011/03/10,66,10,0.697936401,13365,66,7,3
25413,2014/03/31,2013/02/25,4,10,0.8947635490000001,10425,4,4,6
25414,2014/03/31,2012/04/22,63,7,0.839287385,11114,63,4,3
25415,2014/03/31,2012/12/01,86,8,0.831438887,11217,86,0,8
25416,2014/03/31,2012/11/04,500,4,0.489153467,19066,500,4,0
25417,2014/03/31,2006/09/20,37,8,0.753633425,12374,37,0,8
25418,2014/03/31,2012/07/21,146,7,0.7623414000000001,12232,146,0,7
25419,2014/03/31,2007/05/15,45,11,0.667718419,13964,45,7,4
25420,2014/03/31,2012/08/24,44,11,0.50409548,18496,44,7,4
25421,2014/03/31,2013/03/11,146,5,0.7754141720000001,12024,146,2,3
25422,2014/03/31,2006/07/29,4,10,1.190431563,7832,4,3,7
25423,2014/03/31,2011/03/20,8,6,0.504137241,18493,8,3,3
25424,2014/03/31,2008/12/10,28,12,0.503093735,18531,28,7,5
25425,2014/03/31,2011/05/19,118,12,0.701822768,13282,118,8,4
25426,2014/03/31,2010/04/16,240,10,0.6430900310000001,14495,240,7,3
25427,2014/03/31,2007/07/31,67,12,0.705775725,13207,67,7,5
25428,2014/03/31,2012/03/16,202,14,0.535389431,17410,202,7,7
25429,2014/03/31,2006/12/01,122,10,0.633039462,14723,122,7,3
25430,2014/03/31,2005/11/08,475,13,0.669492134,13921,475,13,0
25431,2014/03/31,2009/11/08,256,8,0.6858963790000001,13588,256,5,3
25432,2014/03/31,2011/09/10,199,8,0.629964175,14794,199,4,4
25433,2014/03/31,2012/04/11,421,5,0.7791220740000001,11960,421,5,0
25434,2014/03/31,2005/05/19,8,17,0.586807104,15879,8,11,6
25435,2014/03/31,2009/11/18,79,10,0.867972986,10735,79,6,4
25436,2014/03/31,2011/02/21,129,12,1.256668465,7414,129,11,1
25437,2014/03/31,2012/04/18,153,7,0.8172011229999999,11401,153,2,5
25438,2014/03/31,2011/07/21,21,6,0.709156645,13138,21,2,4
25439,2014/03/31,2012/08/31,203,7,0.8990002890000001,10363,203,4,3
25440,2014/03/31,2009/11/02,6,11,0.749318748,12433,6,1,10
25441,2014/03/31,2012/10/25,51,9,0.702879131,13254,51,2,7
25442,2014/03/31,2012/02/17,158,11,0.7492930109999999,12433,158,6,5
25443,2014/03/31,2006/09/12,226,4,1.05,8872,226,2,2
25444,2014/03/31,2012/11/21,16,11,0.639278068,14572,16,5,6
25445,2014/03/31,2012/05/30,24,13,0.851256511,10943,24,3,10
25446,2014/03/31,2010/08/18,573,2,0.6600155879999999,14113,573,2,0
25447,2014/03/31,2007/03/01,68,12,0.502360047,18542,68,5,7
25448,2014/03/31,2012/06/07,469,10,0.734234589,12686,469,10,0
25449,2014/03/31,2012/01/22,19,13,0.8733705340000001,10663,19,2,11
25450,2014/03/31,2010/09/30,557,12,0.683092496,13633,557,12,0
25451,2014/03/31,2012/07/24,39,14,0.6950425440000001,13398,39,4,10
25452,2014/03/31,2012/09/02,577,2,0.75,12416,577,2,0
25453,2014/03/31,2007/11/19,391,6,1.0,9312,391,6,0
25454,2014/03/31,2006/05/19,239,8,0.699780567,13307,239,5,3
25455,2014/03/31,2013/01/01,133,6,1.164203551,7998,133,0,6
25456,2014/03/31,2012/12/24,94,10,0.590216785,15776,94,4,6
25457,2014/03/31,2008/03/15,106,9,0.734035475,12685,106,0,9
25458,2014/03/31,2011/07/26,305,12,0.6843719220000001,13605,305,10,2
25459,2014/03/31,2007/03/01,569,8,0.859817141,10828,569,8,0
25460,2014/03/31,2009/10/26,4,7,0.83498296,11150,4,2,5
25461,2014/03/31,2012/06/22,419,4,1.126982206,8261,419,4,0
25462,2014/03/31,2009/12/19,88,8,0.482367358,19300,88,6,2
25463,2014/03/31,2010/05/23,26,12,0.911974922,10208,26,4,8
25464,2014/03/31,2008/08/25,42,12,0.902884858,10309,42,8,4
25465,2014/03/31,2013/01/01,22,15,0.421493524,22082,22,8,7
25466,2014/03/31,2012/04/12,85,8,0.7093757620000001,13120,85,3,5
25467,2014/03/31,2007/10/07,29,17,0.544540082,17090,29,15,2
25468,2014/03/31,2012/01/27,3,7,0.664396687,14006,3,2,5
25469,2014/03/31,2010/07/13,44,14,0.834576682,11150,44,6,8
25470,2014/03/31,2012/01/26,50,4,0.8975,10368,50,2,2
25471,2014/03/31,2008/07/30,1,8,0.56,16616,1,7,1
25472,2014/03/31,2012/04/02,133,6,1.413646308,6582,133,4,2
25473,2014/03/31,2011/11/08,177,7,0.7613756140000001,12220,177,3,4
25474,2014/03/31,2009/04/29,40,12,0.5707932520000001,16300,40,0,12
25475,2014/03/31,2012/08/16,55,11,0.688855324,13506,55,1,10
25476,2014/03/31,2007/01/24,17,11,0.667932223,13928,17,4,7
25477,2014/03/31,2012/01/17,43,6,0.5770775429999999,16120,43,2,4
25478,2014/03/31,2008/06/18,30,14,0.6964400690000001,13357,30,6,8
25479,2014/03/31,2009/12/05,30,7,0.64169564,14496,30,3,4
25480,2014/03/31,2011/06/30,137,5,0.765300313,12154,137,2,3
25481,2014/03/31,2012/05/16,6,10,0.602222726,15445,6,4,6
25482,2014/03/31,2005/02/10,278,5,1.046598402,8887,278,4,1
25483,2014/03/31,2010/12/22,66,8,0.77328733,12028,66,3,5
25484,2014/03/31,2007/03/10,104,16,0.496087583,18748,104,6,10
25485,2014/03/31,2012/08/01,476,4,0.847275875,10976,476,4,0
25486,2014/03/31,2012/11/20,61,8,0.6891477690000001,13494,61,1,7
25487,2014/03/31,2007/06/16,28,8,0.76725495,12120,28,4,4
25488,2014/03/31,2012/05/16,135,5,0.606,15345,135,2,3
25489,2014/03/31,2011/11/18,104,7,0.747419822,12441,104,6,1
25490,2014/03/31,2006/06/02,89,9,0.813930322,11424,89,5,4
25491,2014/03/31,2008/05/05,313,11,0.71557642,12994,313,9,2
25492,2014/03/31,2012/10/26,25,7,0.902605572,10301,25,1,6
25493,2014/03/31,2006/04/02,90,9,0.719777812,12917,90,4,5
25494,2014/03/31,2012/04/14,566,8,0.7263242190000001,12800,566,8,0
25495,2014/03/31,2008/06/01,236,11,0.7217188109999999,12881,236,8,3
25496,2014/03/31,2011/08/12,98,11,0.81898423,11351,98,5,6
25497,2014/03/31,2006/03/27,40,7,0.606379648,15330,40,3,4
25498,2014/03/31,2005/11/22,26,14,0.639888476,14526,26,4,10
25499,2014/03/31,2009/04/04,15,4,0.944892752,9837,15,0,4
25500,2014/03/31,2010/11/02,495,8,0.630773668,14735,495,8,0
25501,2014/03/31,2008/03/04,151,5,1.224721307,7589,151,2,3
25502,2014/03/31,2013/02/03,42,6,0.520432275,17859,42,2,4
25503,2014/03/31,2009/08/12,128,7,0.65622467,14163,128,3,4
25504,2014/03/31,2011/01/05,8,10,0.7586269390000001,12250,8,2,8
25505,2014/03/31,2011/02/14,146,12,0.7293807390000001,12741,146,6,6
25506,2014/03/31,2010/05/29,114,10,0.673592346,13796,114,3,7
25507,2014/03/31,2011/03/25,171,9,0.683498088,13596,171,5,4
25508,2014/03/31,2007/02/01,99,8,0.6108842870000001,15210,99,4,4
25509,2014/03/31,2011/04/21,441,10,0.70587632,13163,441,10,0
25510,2014/03/31,2010/09/01,518,9,0.623630505,14896,518,9,0
25511,2014/03/31,2012/09/11,251,2,0.816004919,11384,251,1,1
25512,2014/03/31,2006/05/13,52,12,0.907189179,10239,52,6,6
25513,2014/03/31,2011/09/07,588,12,0.5443995079999999,17061,588,12,0
25514,2014/03/31,2011/10/01,254,9,0.652012636,14245,254,5,4
25515,2014/03/31,2012/04/05,83,9,0.8690558620000001,10687,83,8,1
25516,2014/03/31,2010/12/24,76,8,0.529885313,17526,76,5,3
25517,2014/03/31,2011/05/24,74,5,0.985379881,9424,74,2,3
25518,2014/03/31,2013/02/05,25,13,0.64217704,14460,25,1,12
25519,2014/03/31,2009/12/24,1,8,0.912568059,10175,1,7,1
25520,2014/03/31,2011/02/08,128,12,0.601666667,15432,128,7,5
25521,2014/03/31,2009/03/26,19,10,0.517692779,17935,19,6,4
25522,2014/03/31,2009/09/29,12,6,0.58109463,15978,12,4,2
25523,2014/03/31,2011/10/19,2,12,0.714093986,13002,2,8,4
25524,2014/03/31,2008/07/22,316,9,0.6854115909999999,13545,316,6,3
25525,2014/03/31,2009/04/19,273,13,0.918909235,10103,273,11,2
25526,2014/03/31,2009/09/20,262,7,0.821192393,11305,262,6,1
25527,2014/03/31,2012/02/26,37,11,0.802064973,11574,37,8,3
25528,2014/03/31,2011/09/20,108,9,0.753596363,12318,108,3,6
25529,2014/03/31,2012/10/15,75,8,0.569696821,16294,75,2,6
25530,2014/03/31,2012/04/05,96,12,0.907191165,10232,96,4,8
25531,2014/03/31,2011/02/20,101,12,0.594689262,15608,101,8,4
25532,2014/03/31,2013/01/04,81,12,0.59,15732,81,5,7
25533,2014/03/31,2012/11/06,23,9,0.604532308,15352,23,5,4
25534,2014/03/31,2011/05/27,329,8,0.606096526,15312,329,6,2
25535,2014/03/31,2012/09/02,564,5,0.52017657,17840,564,5,0
25536,2014/03/31,2006/06/30,6,13,0.645414522,14378,6,5,8
25537,2014/03/31,2006/11/29,25,7,0.71619665,12957,25,0,7
25538,2014/03/31,2009/12/15,15,9,0.7430952190000001,12487,15,6,3
25539,2014/03/31,2013/03/01,185,12,0.9006358609999999,10301,185,1,11
25540,2014/03/31,2007/12/08,124,11,0.567700404,16342,124,6,5
25541,2014/03/31,2008/09/18,5,8,0.714566741,12983,5,2,6
25542,2014/03/31,2013/01/26,346,13,0.594958953,15592,346,9,4
25543,2014/03/31,2013/01/01,38,7,0.539712557,17186,38,0,7
25544,2014/03/31,2012/12/16,1,20,0.679157879,13656,1,6,14
25545,2014/03/31,2013/01/28,78,10,0.6824008540000001,13591,78,3,7
25546,2014/03/31,2013/01/19,30,7,0.737565418,12573,30,0,7
25547,2014/03/31,2012/11/14,311,5,0.715982088,12952,311,3,2
25548,2014/03/31,2010/05/08,77,5,0.766394215,12100,77,0,5
25549,2014/03/31,2008/04/13,41,7,0.7352790990000001,12612,41,0,7
25550,2014/03/31,2012/08/06,66,11,0.842888182,11000,66,2,9
25551,2014/03/31,2012/08/19,340,6,0.718137103,12910,340,4,2
25552,2014/03/31,2011/01/22,16,8,0.888154819,10438,16,5,3
25553,2014/03/31,2005/09/09,32,8,0.80513159,11513,32,6,2
25554,2014/03/31,2012/07/24,112,8,0.803345467,11538,112,7,1
25555,2014/03/31,2010/10/04,347,12,0.746957608,12408,347,11,1
25556,2014/03/31,2012/02/20,98,9,0.493493078,18780,98,6,3
25557,2014/03/31,2012/06/02,114,7,0.895492318,10349,114,6,1
25558,2014/03/31,2005/08/19,40,14,0.743956326,12456,40,12,2
25559,2014/03/31,2012/06/21,75,9,0.687777778,13473,75,2,7
25560,2014/03/31,2012/11/25,60,9,0.789483684,11737,60,1,8
25561,2014/03/31,2006/07/02,10,22,0.669791817,13834,10,6,16
25562,2014/03/31,2011/11/10,214,10,0.918292369,10090,214,8,2
25563,2014/03/31,2010/08/26,34,15,0.63352,14625,34,6,9
25564,2014/03/31,2012/06/09,197,15,0.64937062,14268,197,7,8
25565,2014/03/31,2006/05/08,41,10,0.71609445,12938,41,6,4
25566,2014/03/31,2007/06/27,2,12,0.6887873609999999,13450,2,5,7
25567,2014/03/31,2012/08/11,12,14,0.860023208,10772,12,3,11
25568,2014/03/31,2008/12/17,414,12,0.812908038,11396,414,12,0
25569,2014/03/31,2007/06/09,18,27,0.956789919,9682,18,22,5
25570,2014/03/31,2008/05/16,98,12,0.560129399,16538,98,5,7
25571,2014/03/31,2013/03/02,9,9,0.786853551,11772,9,2,7
25572,2014/03/31,2011/11/08,110,7,0.723601281,12801,110,2,5
25573,2014/03/31,2012/09/26,137,9,0.841437267,11007,137,4,5
25574,2014/03/31,2008/10/09,163,6,0.843956625,10974,163,4,2
25575,2014/03/31,2010/11/25,23,13,0.70866631,13069,23,6,7
25576,2014/03/31,2012/01/09,54,6,0.736227045,12579,54,4,2
25577,2014/03/31,2012/12/12,130,11,0.6006141770000001,15419,130,2,9
25578,2014/03/31,2012/06/17,5,11,0.765786819,12093,5,2,9
25579,2014/03/31,2010/06/08,60,12,0.801764502,11550,60,8,4
25580,2014/03/31,2007/06/21,116,19,0.763063865,12135,116,14,5
25581,2014/03/31,2012/01/18,285,10,0.669008742,13841,285,6,4
25582,2014/03/31,2010/01/05,402,9,0.703250798,13166,402,9,0
25583,2014/03/31,2006/02/22,114,10,0.786780252,11768,114,6,4
25584,2014/03/31,2011/08/20,157,8,0.973302492,9511,157,0,8
25585,2014/03/31,2011/05/01,4,4,1.135,8156,4,0,4
25586,2014/03/31,2010/08/26,198,7,0.7913901,11697,198,4,3
25587,2014/03/31,2011/03/16,103,5,1.41,6565,103,0,5
25588,2014/03/31,2012/06/07,536,9,0.640359737,14455,536,9,0
25589,2014/03/31,2012/12/31,120,7,0.7428571429999999,12460,120,3,4
25590,2014/03/31,2011/12/16,82,13,0.686034687,13492,82,6,7
25591,2014/03/31,2012/01/14,101,8,0.560414749,16516,101,3,5
25592,2014/03/31,2009/11/25,16,14,0.644739115,14355,16,10,4
25593,2014/03/31,2012/10/06,73,15,0.611101354,15145,73,3,12
25594,2014/03/31,2013/01/24,89,12,0.8475,10920,89,4,8
25595,2014/03/31,2008/10/22,38,4,0.895013057,10339,38,0,4
25596,2014/03/31,2012/10/19,524,2,1.042731575,8874,524,2,0
25597,2014/03/31,2008/03/31,119,6,0.677429345,13658,119,4,2
25598,2014/03/31,2012/02/03,152,12,0.8104213379999999,11416,152,7,5
25599,2014/03/31,2006/05/18,343,7,0.945961145,9780,343,5,2
25600,2014/03/31,2010/11/25,288,7,0.818060837,11309,288,6,1
25601,2014/03/31,2011/12/05,184,8,0.5329792010000001,17357,184,2,6
25602,2014/03/31,2012/07/04,229,9,0.747673403,12370,229,7,2
25603,2014/03/31,2013/02/19,9,10,0.70518414,13115,9,2,8
25604,2014/03/31,2012/03/18,5,11,0.791249144,11688,5,2,9
25605,2014/03/31,2011/03/06,100,11,0.624616684,14805,100,8,3
25606,2014/03/31,2011/11/05,208,8,0.743347267,12440,208,5,3
25607,2014/03/31,2012/03/07,662,6,0.717243252,12892,662,6,0
25608,2014/03/31,2010/10/04,166,13,0.82741387,11175,166,8,5
25609,2014/03/31,2012/02/17,98,10,0.65169028,14187,98,6,4
25610,2014/03/31,2011/08/31,3,11,0.6639744329999999,13924,3,2,9
25611,2014/03/31,2008/05/17,216,12,0.509596516,18142,216,5,7
25612,2014/03/31,2009/10/18,102,10,0.7096898509999999,13026,102,7,3
25613,2014/03/31,2009/01/20,41,12,0.721410957,12814,41,8,4
25614,2014/03/31,2007/10/09,156,10,0.8117105729999999,11388,156,8,2
25615,2014/03/31,2008/05/06,31,13,0.454312048,20343,31,9,4
25616,2014/03/31,2008/02/05,113,6,0.793711783,11644,113,4,2
25617,2014/03/31,2008/08/29,5,7,0.8461765240000001,10922,5,1,6
25618,2014/03/31,2008/11/25,90,16,0.89,10384,90,10,6
25619,2014/03/31,2006/11/24,32,17,0.63620749,14526,32,4,13
25620,2014/03/31,2008/06/10,24,10,0.6346216179999999,14562,24,0,10
25621,2014/03/31,2011/11/09,17,8,0.6726655990000001,13738,17,2,6
25622,2014/03/31,2009/04/01,27,12,0.629191802,14687,27,6,6
25623,2014/03/31,2011/07/04,316,8,0.688422856,13423,316,7,1
25624,2014/03/31,2011/03/15,79,11,0.871808661,10599,79,4,7
25625,2014/03/31,2009/07/03,113,9,0.651447508,14183,113,2,7
25626,2014/03/31,2012/10/11,30,11,0.756089198,12220,30,10,1
25627,2014/03/31,2008/04/18,100,8,0.810024548,11406,100,0,8
25628,2014/03/31,2007/02/07,115,5,0.939291379,9836,115,1,4
25629,2014/03/31,2011/10/24,13,12,0.565263093,16344,13,2,10
25630,2014/03/31,2013/03/08,187,2,0.824132025,11210,187,1,1
25631,2014/03/31,2011/12/12,168,10,0.649612518,14220,168,4,6
25632,2014/03/31,2008/04/01,506,6,0.727919622,12690,506,6,0
25633,2014/03/31,2009/03/14,201,9,0.647893666,14257,201,2,7
25634,2014/03/31,2012/04/16,122,10,0.793066026,11647,122,8,2
25635,2014/03/31,2012/06/10,152,10,0.8749284829999999,10557,152,5,5
25636,2014/03/31,2013/01/25,161,5,0.554213369,16666,161,0,5
25637,2014/03/31,2005/06/26,3,9,0.7278510640000001,12690,3,3,6
25638,2014/03/31,2009/03/11,305,9,0.924066033,9995,305,8,1
25639,2014/03/31,2010/05/28,235,5,0.92,10038,235,0,5
25640,2014/03/31,2011/11/24,7,11,0.7306163459999999,12639,7,5,6
25641,2014/03/31,2004/12/07,12,13,0.845529713,10921,12,4,9
25642,2014/03/31,2012/08/29,144,12,0.6944446120000001,13297,144,11,1
25643,2014/03/31,2005/08/27,243,10,0.7404995990000001,12470,243,4,6
25644,2014/03/31,2010/03/18,163,10,0.6466351539999999,14280,163,5,5
25645,2014/03/31,2012/01/02,62,9,0.905990973,10192,62,5,4
25646,2014/03/31,2012/12/18,13,16,0.677840675,13620,13,4,12
25647,2014/03/31,2012/12/22,10,18,0.625529507,14759,10,2,16
25648,2014/03/31,2012/07/05,3,7,0.846047471,10912,3,1,6
25649,2014/03/31,2005/09/08,23,8,0.590942961,15621,23,4,4
25650,2014/03/31,2007/10/10,22,11,0.592532897,15579,22,2,9
25651,2014/03/31,2011/12/15,382,11,0.548541035,16827,382,11,0
25652,2014/03/31,2007/07/13,424,3,0.7140259940000001,12926,424,3,0
25653,2014/03/31,2011/11/02,52,14,0.73196447,12609,52,8,6
25654,2014/03/31,2009/08/22,25,12,0.700744115,13170,25,8,4
25655,2014/03/31,2006/05/16,35,14,0.58392369,15804,35,9,5
25656,2014/03/31,2011/09/03,126,10,0.603211741,15297,126,7,3
25657,2014/03/31,2008/05/28,133,16,0.569605531,16199,133,11,5
25658,2014/03/31,2005/11/28,370,11,0.612067936,15073,370,11,0
25659,2014/03/31,2010/01/29,221,11,0.63770374,14467,221,8,3
25660,2014/03/31,2005/07/26,19,11,0.675259113,13662,19,6,5
25661,2014/03/31,2010/10/31,188,4,0.527980081,17471,188,0,4
25662,2014/03/31,2012/03/08,8,9,0.587117306,15711,8,4,5
25663,2014/03/31,2006/05/26,222,15,0.524898981,17571,222,12,3
25664,2014/03/31,2007/06/20,172,7,0.790041977,11673,172,2,5
25665,2014/03/31,2007/12/02,64,12,0.667698212,13811,64,5,7
25666,2014/03/31,2011/06/03,49,8,0.722736108,12759,49,7,1
25667,2014/03/31,2011/09/01,62,15,0.726487551,12692,62,5,10
25668,2014/03/31,2011/12/08,143,10,0.666614128,13831,143,1,9
25669,2014/03/31,2013/03/12,38,8,0.6663342010000001,13836,38,2,6
25670,2014/03/31,2007/05/08,49,11,0.5788622379999999,15926,49,5,6
25671,2014/03/31,2007/09/01,69,19,0.664045235,13883,69,11,8
25672,2014/03/31,2011/03/13,6,13,0.736379613,12518,6,10,3
25673,2014/03/31,2006/02/15,196,8,1.340573008,6876,196,5,3
25674,2014/03/31,2007/12/22,127,15,0.6492189039999999,14198,127,7,8
25675,2014/03/31,2009/03/21,349,11,0.7224896140000001,12757,349,10,1
25676,2014/03/31,2012/04/11,343,8,0.840564575,10964,343,6,2
25677,2014/03/31,2012/09/07,153,6,0.638681128,14429,153,1,5
25678,2014/03/31,2007/06/29,66,10,0.653154948,14108,66,5,5
25679,2014/03/31,2006/12/01,145,8,0.8122928420000001,11344,145,6,2
25680,2014/03/31,2007/10/26,116,9,0.5101013120000001,18063,116,6,3
25681,2014/03/31,2012/05/05,124,8,0.68340899,13482,124,5,3
25682,2014/03/31,2008/05/06,126,11,0.829835135,11100,126,6,5
25683,2014/03/31,2012/09/25,154,10,0.67097035,13727,154,3,7
25684,2014/03/31,2007/03/18,67,8,0.712211739,12931,67,5,3
25685,2014/03/31,2009/04/03,92,13,0.575742686,15996,92,7,6
25686,2014/03/31,2012/10/27,20,8,0.626817996,14692,20,2,6
25687,2014/03/31,2010/06/22,213,8,0.413492905,22268,213,4,4
25688,2014/03/31,2005/03/01,47,7,1.201165036,7665,47,0,7
25689,2014/03/31,2005/01/30,102,6,0.89118188,10331,102,5,1
25690,2014/03/31,2011/09/04,1,7,0.5824006829999999,15808,1,2,5
25691,2014/03/31,2007/09/22,73,7,0.733631365,12549,73,4,3
25692,2014/03/31,2011/11/21,11,25,0.826338749,11141,11,17,8
25693,2014/03/31,2011/11/15,62,9,0.942288639,9770,62,5,4
25694,2014/03/31,2009/04/01,1,13,0.735358255,12519,1,4,9
25695,2014/03/31,2012/09/14,171,9,0.608017834,15140,171,2,7
25696,2014/03/31,2012/05/11,158,11,0.561944326,16381,158,5,6
25697,2014/03/31,2008/09/09,580,5,1.413978495,6510,580,5,0
25698,2014/03/31,2013/01/14,8,12,0.488781265,18831,8,0,12
25699,2014/03/31,2009/09/01,33,9,0.63521049,14490,33,3,6
25700,2014/03/31,2008/03/29,81,7,0.7348630740000001,12525,81,2,5
25701,2014/03/31,2012/04/19,386,9,0.7076464709999999,13006,386,9,0
25702,2014/03/31,2009/10/31,255,6,0.732310018,12567,255,5,1
25703,2014/03/31,2009/09/12,390,7,0.742936143,12387,390,7,0
25704,2014/03/31,2011/11/29,3,15,0.8769713140000001,10493,3,2,13
25705,2014/03/31,2009/02/21,56,10,0.889747631,10342,56,2,8
25706,2014/03/31,2008/11/10,4,7,0.7026498659999999,13095,4,2,5
25707,2014/03/31,2006/09/24,173,13,0.824107479,11165,173,8,5
25708,2014/03/31,2007/04/28,34,11,0.7286078559999999,12628,34,0,11
25709,2014/03/31,2012/11/13,11,10,0.78090477,11782,11,4,6
25710,2014/03/31,2007/09/04,69,8,0.65337263,14081,69,5,3
25711,2014/03/31,2012/06/21,80,19,0.6733418720000001,13663,80,11,8
25712,2014/03/31,2007/04/29,197,7,0.987571659,9315,197,3,4
25713,2014/03/31,2009/07/02,17,8,0.551006289,16695,17,3,5
25714,2014/03/31,2012/11/29,10,14,0.743100412,12379,10,6,8
25715,2014/03/31,2008/04/12,80,7,0.484499631,18986,80,3,4
25716,2014/03/31,2009/07/11,71,15,0.833059228,11042,71,6,9
25717,2014/03/31,2008/11/01,27,11,0.597272727,15400,27,5,6
25718,2014/03/31,2007/01/14,52,9,0.695007556,13234,52,4,5
25719,2014/03/31,2009/12/06,12,7,0.7038876559999999,13067,12,1,6
25720,2014/03/31,2008/10/28,5,11,0.562445423,16353,5,7,4
25721,2014/03/31,2010/02/06,123,9,0.745157579,12343,123,7,2
25722,2014/03/31,2009/02/03,127,4,1.450012612,6343,127,2,2
25723,2014/03/31,2011/12/28,26,7,1.015840512,9054,26,0,7
25724,2014/03/31,2012/08/04,377,5,0.7236210559999999,12709,377,5,0
25725,2014/03/31,2011/01/25,17,11,0.6842108790000001,13439,17,8,3
25726,2014/03/31,2009/01/26,234,6,0.68184353,13485,234,3,3
25727,2014/03/31,2010/05/15,23,13,0.721472966,12743,23,0,13
25728,2014/03/31,2012/07/21,163,8,0.88730695,10360,163,4,4
25729,2014/03/31,2005/04/10,34,13,0.640267465,14357,34,7,6
25730,2014/03/31,2010/03/23,8,9,0.745381933,12332,8,7,2
25731,2014/03/31,2009/12/31,16,12,0.699773125,13135,16,6,6
25732,2014/03/31,2013/01/22,18,12,0.874183945,10514,18,3,9
25733,2014/03/31,2006/11/12,8,10,0.591868238,15528,8,4,6
25734,2014/03/31,2006/11/02,225,6,1.148627672,8001,225,2,4
25735,2014/03/31,2012/07/20,399,7,0.7204491999999999,12756,399,7,0
25736,2014/03/31,2004/12/21,127,8,0.845033569,10873,127,5,3
25737,2014/03/31,2007/01/07,236,7,0.69293461,13259,236,2,5
25738,2014/03/31,2011/11/09,136,13,0.600733717,15292,136,10,3
25739,2014/03/31,2012/05/17,474,9,0.8551293990000001,10742,474,9,0
25740,2014/03/31,2009/09/25,73,8,0.78089943,11763,73,3,5
25741,2014/03/31,2013/02/26,21,9,0.56539366,16245,21,2,7
25742,2014/03/31,2009/04/01,87,9,0.54458578,16863,87,6,3
25743,2014/03/31,2007/06/20,250,10,0.610065768,15053,250,8,2
25744,2014/03/31,2011/01/06,494,8,0.648626218,14158,494,8,0
25745,2014/03/31,2012/08/26,20,13,0.5586358379999999,16435,20,5,8
25746,2014/03/31,2010/06/26,5,11,0.865159254,10612,5,2,9
25747,2014/03/31,2007/06/02,24,11,0.584860801,15697,24,7,4
25748,2014/03/31,2010/07/28,269,9,0.655859827,13997,269,6,3
25749,2014/03/31,2012/10/13,125,4,0.8075,11368,125,0,4
25750,2014/03/31,2006/12/17,13,10,0.630779274,14552,13,5,5
25751,2014/03/31,2009/10/01,31,16,0.437365988,20987,31,10,6
25752,2014/03/31,2011/09/27,141,14,0.620341308,14796,141,5,9
25753,2014/03/31,2012/11/19,12,14,0.63232587,14515,12,4,10
25754,2014/03/31,2012/03/07,147,8,0.6726671059999999,13644,147,4,4
25755,2014/03/31,2007/08/16,2,9,0.6078479170000001,15097,2,2,7
25756,2014/03/31,2012/08/08,291,9,0.535407866,17138,291,2,7
25757,2014/03/31,2008/09/18,132,10,0.76057941,12064,132,5,5
25758,2014/03/31,2008/08/11,297,9,0.909911741,10084,297,5,4
25759,2014/03/31,2009/02/26,69,12,0.491928583,18651,69,7,5
25760,2014/03/31,2012/01/04,29,16,0.726526766,12628,29,8,8
25761,2014/03/31,2010/11/26,518,7,0.762690165,12029,518,7,0
25762,2014/03/31,2011/04/25,2,8,1.138235732,8060,2,1,7
25763,2014/03/31,2012/11/17,93,11,0.590560098,15533,93,4,7
25764,2014/03/31,2010/08/01,11,13,0.734945117,12481,11,10,3
25765,2014/03/31,2009/03/06,214,6,0.920960843,9960,214,1,5
25766,2014/03/31,2012/03/01,657,5,0.79,11610,657,5,0
25767,2014/03/31,2011/01/04,159,8,0.6413979999999999,14299,159,5,3
25768,2014/03/31,2009/01/05,360,6,0.590056617,15543,360,4,2
25769,2014/03/31,2012/08/27,93,11,0.691743853,13258,93,5,6
25770,2014/03/31,2006/03/25,4,18,0.556689329,16474,4,8,10
25771,2014/03/31,2012/02/05,291,4,0.7925,11572,291,2,2
25772,2014/03/31,2006/06/19,305,6,0.722650118,12690,305,5,1
25773,2014/03/31,2011/07/26,292,9,0.7939487359999999,11548,292,6,3
25774,2014/03/31,2011/02/28,339,2,0.804113313,11402,339,1,1
25775,2014/03/31,2008/09/18,209,13,0.977542382,9379,209,4,9
25776,2014/03/31,2006/12/18,71,10,0.7293579440000001,12569,71,4,6
25777,2014/03/31,2011/02/24,6,13,0.468248966,19577,6,8,5
25778,2014/03/31,2012/12/17,24,2,0.7573626370000001,12103,24,1,1
25779,2014/03/31,2010/10/17,219,9,0.632835543,14484,219,3,6
25780,2014/03/31,2008/06/09,411,4,0.8139152829999999,11261,411,4,0
25781,2014/03/31,2012/11/28,66,7,0.77613007,11809,66,0,7
25782,2014/03/31,2012/09/19,42,13,0.689109023,13300,42,5,8
25783,2014/03/31,2012/05/27,65,13,0.961805016,9529,65,6,7
25784,2014/03/31,2008/03/19,4,10,0.874731316,10477,4,7,3
25785,2014/03/31,2012/08/15,49,9,0.88987182,10298,49,2,7
25786,2014/03/31,2012/01/09,39,11,0.779889362,11750,39,6,5
25787,2014/03/31,2010/11/30,129,8,0.8548829179999999,10719,129,3,5
25788,2014/03/31,2012/12/25,29,15,0.504615342,18159,29,4,11
25789,2014/03/31,2012/04/10,419,10,0.935,9800,419,10,0
25790,2014/03/31,2012/10/31,8,8,0.540933404,16938,8,2,6
25791,2014/03/31,2007/05/30,49,14,0.5952033520000001,15392,49,6,8
25792,2014/03/31,2010/02/05,38,8,0.594959086,15398,38,2,6
25793,2014/03/31,2012/08/31,184,6,0.971923607,9425,184,2,4
25794,2014/03/31,2012/03/27,327,8,0.8029893920000001,11407,327,7,1
25795,2014/03/31,2012/12/07,32,11,0.755498185,12124,32,5,6
25796,2014/03/31,2011/05/02,7,14,0.673103322,13608,7,0,14
25797,2014/03/31,2012/07/27,337,2,0.628943754,14561,337,1,1
25798,2014/03/31,2009/02/20,154,5,1.165426317,7858,154,4,1
25799,2014/03/31,2006/03/09,72,12,0.54487654,16807,72,7,5
25800,2014/03/31,2008/03/17,101,4,1.14128988,8024,101,1,3
25801,2014/03/31,2009/01/11,104,14,0.724953293,12632,104,12,2
25802,2014/03/31,2006/11/06,11,14,0.690060291,13269,11,4,10
25803,2014/03/31,2006/06/14,3,18,0.821814918,11141,3,3,15
25804,2014/03/31,2008/09/01,1,9,0.646469176,14161,1,0,9
25805,2014/03/31,2007/02/19,2,12,0.553973009,16524,2,0,12
25806,2014/03/31,2012/11/23,122,10,0.750304098,12200,122,3,7
25807,2014/03/31,2012/10/11,24,11,0.546363636,16753,24,2,9
25808,2014/03/31,2009/03/31,19,8,0.88625,10328,19,2,6
25809,2014/03/31,2006/09/09,85,10,0.6276172520000001,14584,85,6,4
25810,2014/03/31,2011/08/15,630,2,0.644587647,14199,630,2,0
25811,2014/03/31,2012/06/30,92,12,0.6950964609999999,13166,92,4,8
25812,2014/03/31,2009/01/06,495,9,0.674121547,13575,495,9,0
25813,2014/03/31,2011/09/21,244,8,0.729888331,12537,244,5,3
25814,2014/03/31,2012/01/19,109,13,0.5961923379999999,15348,109,8,5
25815,2014/03/31,2012/12/21,2,7,0.855821719,10691,2,2,5
25816,2014/03/31,2006/05/26,10,7,1.247696713,7333,10,3,4
25817,2014/03/31,2010/11/24,178,6,0.7297359809999999,12537,178,2,4
25818,2014/03/31,2012/07/18,137,10,0.964095268,9489,137,7,3
25819,2014/03/31,2008/04/07,9,18,0.7956832220000001,11497,9,6,12
25820,2014/03/31,2008/03/15,131,9,0.7696920490000001,11885,131,6,3
25821,2014/03/31,2011/03/25,5,9,0.570095351,16046,5,5,4
25822,2014/03/31,2011/02/23,256,7,0.664285714,13769,256,6,1
25823,2014/03/31,2011/06/09,26,10,0.704540411,12979,26,7,3
25824,2014/03/31,2009/12/15,32,14,0.72548318,12604,32,11,3
25825,2014/03/31,2007/08/30,13,13,0.583045336,15683,13,5,8
25826,2014/03/31,2008/05/30,117,4,1.439253896,6353,117,2,2
25827,2014/03/31,2005/11/24,3,9,0.676093611,13524,3,3,6
25828,2014/03/31,2012/06/24,43,8,0.97760107,9350,43,5,3
25829,2014/03/31,2013/02/15,49,9,0.618558473,14776,49,4,5
25830,2014/03/31,2009/01/23,103,7,0.8046236459999999,11359,103,3,4
25831,2014/03/31,2010/03/15,55,10,0.776231527,11774,55,7,3
25832,2014/03/31,2012/04/26,2,8,0.738864812,12368,2,2,6
25833,2014/03/31,2011/12/16,8,14,0.582206435,15695,8,8,6
25834,2014/03/31,2009/01/30,2,6,1.084817761,8423,2,0,6
25835,2014/03/31,2008/12/30,2,9,0.782905492,11671,2,6,3
25836,2014/03/31,2012/06/07,41,7,0.6280259810000001,14549,41,4,3
25837,2014/03/31,2012/03/03,192,6,0.752020742,12149,192,4,2
25838,2014/03/31,2011/12/01,132,8,0.846029453,10797,132,6,2
25839,2014/03/31,2011/06/14,196,5,0.762142678,11985,196,0,5
25840,2014/03/31,2008/02/24,1,13,0.7618248540000001,11990,1,8,5
25841,2014/03/31,2008/02/16,53,9,0.618948973,14757,53,3,6
25842,2014/03/31,2012/12/20,278,8,0.883164765,10342,278,2,6
25843,2014/03/31,2012/06/30,57,10,0.862052855,10595,57,5,5
25844,2014/03/31,2004/11/22,112,14,0.457236131,19972,112,7,7
25845,2014/03/31,2012/01/08,388,8,0.940024707,9714,388,8,0
25846,2014/03/31,2012/08/05,338,6,0.792918548,11516,338,4,2
25847,2014/03/31,2011/04/03,68,12,0.64565903,14142,68,9,3
25848,2014/03/31,2011/03/14,387,7,0.760824098,12001,387,7,0
25849,2014/03/31,2010/07/21,62,9,0.773884557,11798,62,7,2
25850,2014/03/31,2010/11/18,95,7,0.583659145,15643,95,6,1
25851,2014/03/31,2011/10/07,58,12,0.739277733,12350,58,5,7
25852,2014/03/31,2009/04/10,3,13,0.439192322,20788,3,3,10
25853,2014/03/31,2011/11/25,119,19,0.748058014,12204,119,7,12
25854,2014/03/31,2011/09/26,127,14,0.481098345,18974,127,12,2
25855,2014/03/31,2012/01/19,39,9,0.675613204,13511,39,0,9
25856,2014/03/31,2012/02/05,66,11,0.780563537,11694,66,4,7
25857,2014/03/31,2012/01/01,86,10,0.600811007,15191,86,4,6
25858,2014/03/31,2012/03/07,207,9,0.8234864209999999,11083,207,7,2
25859,2014/03/31,2009/11/06,65,5,0.926536041,9850,65,0,5
25860,2014/03/31,2009/01/15,124,6,0.949997918,9606,124,1,5
25861,2014/03/31,2008/12/11,23,10,0.662800697,13768,23,7,3
25862,2014/03/31,2012/11/18,12,11,0.555869883,16416,12,0,11
25863,2014/03/31,2010/11/12,134,6,0.637959869,14303,134,0,6
25864,2014/03/31,2011/12/31,32,5,0.5232394770000001,17438,32,0,5
25865,2014/03/31,2012/12/13,252,5,0.818447255,11148,252,2,3
25866,2014/03/31,2013/02/05,56,9,0.6395976170000001,14265,56,0,9
25867,2014/03/31,2012/12/12,422,5,0.597029185,15282,422,5,0
25868,2014/03/31,2005/05/02,270,8,0.756130449,12066,270,4,4
25869,2014/03/31,2009/10/01,531,5,1.5,6082,531,5,0
25870,2014/03/31,2012/05/15,427,8,0.60625,15048,427,8,0
25871,2014/03/31,2006/07/05,103,10,0.936957683,9736,103,8,2
25872,2014/03/31,2009/11/13,205,8,0.927873055,9831,205,5,3
25873,2014/03/31,2012/10/20,327,6,0.634699416,14372,327,2,4
25874,2014/03/31,2012/10/21,113,9,0.747610852,12201,113,2,7
25875,2014/03/31,2010/11/01,86,6,0.6866199940000001,13284,86,2,4
25876,2014/03/31,2010/12/22,2,9,0.541309277,16849,2,4,5
25877,2014/03/31,2007/08/02,66,8,0.6751754520000001,13508,66,3,5
25878,2014/03/31,2005/11/21,141,10,0.918207452,9930,141,3,7
25879,2014/03/31,2012/11/12,468,6,0.906307157,10060,468,6,0
25880,2014/03/31,2011/12/04,310,8,0.965008467,9448,310,7,1
25881,2014/03/31,2007/05/12,47,10,0.8249705909999999,11051,47,4,6
25882,2014/03/31,2006/03/16,145,11,0.673491946,13534,145,2,9
25883,2014/03/31,2005/02/05,126,10,0.655076901,13914,126,2,8
25884,2014/03/31,2009/12/31,175,10,0.636988398,14308,175,6,4
25885,2014/03/31,2007/04/20,250,5,0.925166988,9851,250,3,2
25886,2014/03/31,2009/10/25,317,5,0.63,14465,317,3,2
25887,2014/03/31,2005/09/03,534,6,0.915675241,9952,534,6,0
25888,2014/03/31,2006/08/12,2,3,0.789908981,11536,2,0,3
25889,2014/03/31,2008/04/13,114,11,0.7547237640000001,12073,114,5,6
25890,2014/03/31,2005/10/03,145,7,0.922143508,9881,145,6,1
25891,2014/03/31,2011/12/01,8,16,0.492980197,18482,8,8,8
25892,2014/03/31,2011/11/17,116,9,0.603078247,15106,116,1,8
25893,2014/03/31,2007/02/27,157,8,0.7879517340000001,11561,157,5,3
25894,2014/03/31,2012/06/09,77,11,0.7186895459999999,12675,77,1,10
25895,2014/03/31,2010/12/10,412,9,0.769311655,11840,412,9,0
25896,2014/03/31,2006/09/06,85,9,0.846199368,10764,85,3,6
25897,2014/03/31,2011/04/30,51,3,1.136666667,8013,51,2,1
25898,2014/03/31,2012/03/20,9,13,0.819512327,11114,9,7,6
25899,2014/03/31,2012/05/19,56,8,0.80856179,11264,56,7,1
25900,2014/03/31,2012/07/21,55,9,0.514444444,17703,55,3,6
25901,2014/03/31,2007/06/08,1,11,0.5681247660000001,16030,1,2,9
25902,2014/03/31,2012/07/26,337,8,0.6985042570000001,13037,337,6,2
25903,2014/03/31,2012/04/11,21,6,1.214173333,7500,21,5,1
25904,2014/03/31,2005/10/22,86,14,0.609588885,14935,86,8,6
25905,2014/03/31,2009/01/18,133,10,0.587745642,15490,133,8,2
25906,2014/03/31,2011/04/29,35,21,0.722315138,12604,35,8,13
25907,2014/03/31,2008/01/09,61,9,0.775793779,11735,61,7,2
25908,2014/03/31,2010/11/11,139,12,0.62196625,14637,139,6,6
25909,2014/03/31,2012/08/08,475,6,0.875336538,10400,475,6,0
25910,2014/03/31,2012/04/11,83,12,0.6409279729999999,14203,83,5,7
25911,2014/03/31,2010/12/29,117,6,0.86868308,10479,117,2,4
25912,2014/03/31,2010/11/20,224,8,0.704069147,12929,224,5,3
25913,2014/03/31,2011/05/11,523,4,0.844973545,10773,523,4,0
25914,2014/03/31,2013/01/03,73,9,0.5686768289999999,16007,73,4,5
25915,2014/03/31,2012/05/15,197,7,0.916367663,9933,197,2,5
25916,2014/03/31,2006/06/27,182,11,0.639275881,14238,182,8,3
25917,2014/03/31,2010/02/19,22,7,0.700826211,12987,22,0,7
25918,2014/03/31,2011/05/02,101,13,0.763741714,11917,101,4,9
25919,2014/03/31,2010/09/23,39,14,0.584126444,15580,39,6,8
25920,2014/03/31,2011/08/06,40,13,0.620932724,14656,40,4,9
25921,2014/03/31,2009/10/19,104,13,0.714416268,12737,104,1,12
25922,2014/03/31,2007/11/01,143,8,0.692639111,13137,143,5,3
25923,2014/03/31,2008/08/18,89,9,0.630374809,14434,89,2,7
25924,2014/03/31,2011/03/24,209,9,0.961710179,9461,209,6,3
25925,2014/03/31,2012/10/30,4,11,0.7741342640000001,11753,4,3,8
25926,2014/03/31,2011/11/07,41,8,0.846654569,10746,41,0,8
25927,2014/03/31,2012/06/07,191,8,0.785731065,11579,191,1,7
25928,2014/03/31,2008/02/01,89,8,0.729649503,12468,89,1,7
25929,2014/03/31,2007/11/30,423,8,0.770475142,11807,423,8,0
25930,2014/03/31,2012/04/15,508,10,0.6684964729999999,13608,508,10,0
25931,2014/03/31,2004/12/02,30,12,0.578055538,15737,30,6,6
25932,2014/03/31,2010/10/16,126,9,0.886454882,10262,126,4,5
25933,2014/03/31,2010/12/20,33,7,0.611376437,14879,33,2,5
25934,2014/03/31,2008/01/20,244,12,0.7219523809999999,12600,244,10,2
25935,2014/03/31,2007/10/21,107,11,0.81466595,11166,107,7,4
25936,2014/03/31,2008/09/08,120,10,0.671425408,13547,120,6,4
25937,2014/03/31,2013/03/16,96,14,0.5898301020000001,15421,96,1,13
25938,2014/03/31,2006/10/30,67,13,0.575646835,15800,67,3,10
25939,2014/03/31,2008/03/15,18,6,0.7635580559999999,11911,18,1,5
25940,2014/03/31,2006/05/09,109,12,0.564268164,16117,109,5,7
25941,2014/03/31,2012/07/09,116,5,0.723831887,12563,116,4,1
25942,2014/03/31,2008/03/11,86,5,0.830064817,10954,86,3,2
25943,2014/03/31,2009/12/02,12,6,0.7012494220000001,12966,12,4,2
25944,2014/03/31,2011/06/02,8,9,0.638444632,14241,8,2,7
25945,2014/03/31,2012/05/11,172,5,0.887550761,10244,172,4,1
25946,2014/03/31,2012/03/15,13,15,0.6784768659999999,13400,13,4,11
25947,2014/03/31,2009/06/27,94,16,0.5624699910000001,16162,94,12,4
25948,2014/03/31,2012/11/20,238,5,1.1816170540000002,7693,238,3,2
25949,2014/03/31,2007/08/01,343,10,0.776268147,11710,343,9,1
25950,2014/03/31,2010/03/16,142,10,0.8378971140000001,10847,142,6,4
25951,2014/03/31,2008/10/09,77,6,0.921267106,9865,77,1,5
25952,2014/03/31,2011/05/31,117,10,0.660015978,13769,117,5,5
25953,2014/03/31,2007/05/31,193,5,0.924,9835,193,3,2
25954,2014/03/31,2008/02/06,381,8,0.651293629,13953,381,8,0
25955,2014/03/31,2013/02/02,67,10,0.703390355,12919,67,1,9
25956,2014/03/31,2012/04/21,79,12,0.782932104,11606,79,7,5
25957,2014/03/31,2008/07/07,3,15,0.48043938,18913,3,5,10
25958,2014/03/31,2012/12/15,161,7,0.704257364,12900,161,2,5
25959,2014/03/31,2010/11/10,162,18,0.447215576,20313,162,12,6
25960,2014/03/31,2008/05/16,36,10,0.7609809829999999,11937,36,6,4
25961,2014/03/31,2006/10/17,511,10,0.892025926,10183,511,10,0
25962,2014/03/31,2011/03/26,142,9,0.885029718,10263,142,5,4
25963,2014/03/31,2008/11/28,330,13,0.6846788779999999,13266,330,11,2
25964,2014/03/31,2008/04/10,19,13,0.623494199,14567,19,6,7
25965,2014/03/31,2013/01/01,42,13,0.719390891,12625,42,3,10
25966,2014/03/31,2012/10/11,8,8,0.549081016,16540,8,2,6
25967,2014/03/31,2007/05/01,9,14,0.727138053,12488,9,5,9
25968,2014/03/31,2009/11/29,254,8,0.5355798039999999,16954,254,5,3
25969,2014/03/31,2012/07/04,293,8,0.7593827879999999,11957,293,7,1
25970,2014/03/31,2012/09/01,49,8,1.215452477,7470,49,6,2
25971,2014/03/31,2006/06/29,95,8,0.829596126,10944,95,7,1
25972,2014/03/31,2011/04/15,262,4,0.6515214579999999,13934,262,2,2
25973,2014/03/31,2010/07/10,101,16,0.6831356759999999,13289,101,8,8
25974,2014/03/31,2007/06/19,307,2,0.993521944,9137,307,0,2
25975,2014/03/31,2008/09/11,233,5,1.102475404,8233,233,4,1
25976,2014/03/31,2008/09/26,34,13,0.8701591409999999,10431,34,4,9
25977,2014/03/31,2012/08/06,83,10,0.771683387,11762,83,3,7
25978,2014/03/31,2009/09/27,27,11,0.559959899,16209,27,10,1
25979,2014/03/31,2005/10/27,32,11,0.730832595,12419,32,2,9
25980,2014/03/31,2005/09/19,7,8,0.609304465,14895,7,7,1
25981,2014/03/31,2006/11/01,92,13,0.538424206,16855,92,5,8
25982,2014/03/31,2011/07/31,97,7,0.648960807,13982,97,1,6
25983,2014/03/31,2009/02/22,129,8,0.567065625,16000,129,7,1
25984,2014/03/31,2011/08/05,19,9,0.603880458,15024,19,5,4
25985,2014/03/31,2013/03/29,40,10,0.771224923,11764,40,0,10
25986,2014/03/31,2012/04/09,140,5,0.570601296,15899,140,3,2
25987,2014/03/31,2011/03/31,244,11,0.8229209000000001,11024,244,8,3
25988,2014/03/31,2012/06/16,35,23,0.5575814379999999,16270,35,6,17
25989,2014/03/31,2007/12/02,117,5,1.302676623,6964,117,0,5
25990,2014/03/31,2007/03/31,49,9,0.8810946,10296,49,3,6
25991,2014/03/31,2012/05/09,59,7,0.555126683,16340,59,2,5
25992,2014/03/31,2006/09/13,107,8,0.7506099479999999,12083,107,3,5
25993,2014/03/31,2007/12/10,118,12,0.81,11196,118,7,5
25994,2014/03/31,2011/05/19,22,8,0.622596458,14566,22,5,3
25995,2014/03/31,2005/10/29,233,8,0.817849026,11088,233,3,5
25996,2014/03/31,2011/10/14,1,10,0.654465935,13856,1,1,9
25997,2014/03/31,2006/01/01,93,14,0.810741171,11185,93,7,7
25998,2014/03/31,2012/04/13,18,13,0.577710099,15695,18,3,10
25999,2014/03/31,2010/09/22,108,12,0.859607509,10548,108,3,9
26000,2014/03/31,2010/12/14,223,6,0.820551131,11050,223,4,2
26001,2014/03/31,2012/08/01,152,8,0.7518101159999999,12060,152,5,3
26002,2014/03/31,2010/05/23,329,7,0.787582523,11512,329,6,1
26003,2014/03/31,2010/06/03,102,9,0.8190974790000001,11069,102,2,7
26004,2014/03/31,2012/09/06,135,8,0.58358329,15536,135,6,2
26005,2014/03/31,2012/08/25,154,9,0.856279751,10588,154,5,4
26006,2014/03/31,2012/08/18,73,9,0.46528971,19485,73,3,6
26007,2014/03/31,2012/07/06,626,2,0.75,12088,626,2,0
26008,2014/03/31,2013/03/09,193,4,0.7975,11368,193,1,3
26009,2014/03/31,2013/02/13,119,9,0.759279732,11940,119,2,7
26010,2014/03/31,2011/02/13,37,16,0.502900649,18027,37,3,13
26011,2014/03/31,2010/04/26,70,11,0.5667498120000001,15996,70,1,10
26012,2014/03/31,2010/09/30,64,6,0.82789589,10950,64,4,2
26013,2014/03/31,2006/11/24,50,8,0.8171207070000001,11093,50,5,3
26014,2014/03/31,2010/03/03,64,8,0.786015957,11531,64,2,6
26015,2014/03/31,2010/07/12,21,14,0.6861037090000001,13210,21,6,8
26016,2014/03/31,2005/08/17,30,3,1.44,6294,30,1,2
26017,2014/03/31,2012/07/10,86,11,0.553942913,16361,86,5,6
26018,2014/03/31,2010/01/03,216,9,0.764654067,11852,216,6,3
26019,2014/03/31,2009/10/22,533,12,0.94206341,9620,533,12,0
26020,2014/03/31,2012/08/02,66,6,0.803758758,11275,66,4,2
26021,2014/03/31,2012/04/13,45,8,0.7343549429999999,12340,45,6,2
26022,2014/03/31,2005/01/20,117,10,0.471169986,19231,117,5,5
26023,2014/03/31,2007/04/07,16,14,0.680851432,13307,16,5,9
26024,2014/03/31,2009/08/15,55,16,0.4468291,20275,55,8,8
26025,2014/03/31,2012/02/10,226,8,0.8799232640000001,10295,226,5,3
26026,2014/03/31,2011/08/12,163,11,0.805099102,11251,163,10,1
26027,2014/03/31,2013/03/23,47,8,0.7288203109999999,12427,47,0,8
26028,2014/03/31,2012/10/07,517,5,0.8605853290000001,10524,517,5,0
26029,2014/03/31,2013/01/11,47,15,0.6845457290000001,13230,47,4,11
26030,2014/03/31,2008/12/20,25,15,0.660843549,13704,25,8,7
26031,2014/03/31,2012/04/22,492,5,0.78,11610,492,5,0
26032,2014/03/31,2007/11/16,420,8,0.617128936,14674,420,8,0
26033,2014/03/31,2011/07/01,15,13,0.529263589,17110,15,8,5
26034,2014/03/31,2010/09/28,3,12,0.514038374,17616,3,9,3
26035,2014/03/31,2006/07/16,269,12,0.585479115,15466,269,9,3
26036,2014/03/31,2012/03/26,47,15,0.7148728879999999,12666,47,6,9
26037,2014/03/31,2009/04/27,18,12,0.742165574,12200,18,7,5
26038,2014/03/31,2012/02/15,313,8,0.81161915,11154,313,5,3
26039,2014/03/31,2011/03/17,144,9,0.687060565,13176,144,2,7
26040,2014/03/31,2009/01/02,258,7,0.791552116,11436,258,5,2
26041,2014/03/31,2013/01/23,14,10,0.593110995,15262,14,4,6
26042,2014/03/31,2007/10/25,8,12,0.850244223,10646,8,7,5
26043,2014/03/31,2007/03/08,18,9,0.561607619,16117,18,4,5
26044,2014/03/31,2011/08/19,188,11,0.91933164,9845,188,10,1
26045,2014/03/31,2010/01/09,6,9,0.751849144,12038,6,5,4
26046,2014/03/31,2010/08/06,211,5,1.1940058059999998,7579,211,0,5
26047,2014/03/31,2009/12/04,20,8,0.960716637,9419,20,4,4
26048,2014/03/31,2009/08/25,361,9,0.8188263509999999,11051,361,5,4
26049,2014/03/31,2006/03/09,165,8,0.709087846,12761,165,3,5
26050,2014/03/31,2012/10/22,38,11,0.6965204,12990,38,3,8
26051,2014/03/31,2010/11/08,135,6,0.718378593,12594,135,3,3
26052,2014/03/31,2012/07/10,5,10,0.784863364,11527,5,5,5
26053,2014/03/31,2006/10/24,157,9,0.7869078890000001,11497,157,7,2
26054,2014/03/31,2011/02/07,82,13,0.64275595,14075,82,1,12
26055,2014/03/31,2006/04/20,88,9,0.622308592,14537,88,6,3
26056,2014/03/31,2010/10/25,17,12,0.622329389,14536,17,3,9
26057,2014/03/31,2012/03/09,97,7,0.623344129,14512,97,3,4
26058,2014/03/31,2009/09/26,387,4,0.878915663,10292,387,4,0
26059,2014/03/31,2011/09/12,13,7,0.910071436,9939,13,3,4
26060,2014/03/31,2011/07/27,1,9,0.823337885,10986,1,1,8
26061,2014/03/31,2007/06/20,266,4,0.5542352939999999,16320,266,2,2
26062,2014/03/31,2006/07/01,221,11,0.5717084889999999,15821,221,5,6
26063,2014/03/31,2011/10/18,282,12,0.592366387,15268,282,9,3
26064,2014/03/31,2007/11/22,94,8,0.6898481959999999,13109,94,7,1
26065,2014/03/31,2010/12/27,143,11,0.834855059,10832,143,7,4
26066,2014/03/31,2012/03/30,471,5,0.8308526279999999,10884,471,5,0
26067,2014/03/31,2013/02/25,177,6,0.805775263,11222,177,0,6
26068,2014/03/31,2013/02/26,110,4,0.7538474359999999,11995,110,1,3
26069,2014/03/31,2005/04/15,32,12,0.735953117,12286,32,3,9
26070,2014/03/31,2009/02/24,123,13,0.7514069640000001,12033,123,2,11
26071,2014/03/31,2005/06/10,215,8,0.863904443,10465,215,3,5
26072,2014/03/31,2010/03/02,58,18,0.774963141,11666,58,8,10
26073,2014/03/31,2009/11/08,425,10,0.8847998429999999,10217,425,10,0
26074,2014/03/31,2011/05/25,75,11,0.602613826,15001,75,7,4
26075,2014/03/31,2005/07/31,128,11,0.843352305,10718,128,8,3
26076,2014/03/31,2011/09/12,145,13,0.56324838,16048,145,7,6
26077,2014/03/31,2011/09/13,249,9,0.71000707,12730,249,7,2
26078,2014/03/31,2012/05/26,118,5,0.782685779,11546,118,3,2
26079,2014/03/31,2010/11/29,279,4,1.478703976,6111,279,3,1
26080,2014/03/31,2007/05/29,79,10,0.64332123,14046,79,6,4
26081,2014/03/31,2012/03/14,193,18,0.763682387,11832,193,10,8
26082,2014/03/31,2011/05/23,29,14,0.5576055289999999,16204,29,3,11
26083,2014/03/31,2010/01/14,130,8,0.8892559059999999,10160,130,3,5
26084,2014/03/31,2008/08/09,41,12,0.5311505670000001,17009,41,5,7
26085,2014/03/31,2008/12/08,151,8,0.7076778440000001,12764,151,6,2
26086,2014/03/31,2008/06/03,141,4,0.883480387,10223,141,2,2
26087,2014/03/31,2005/10/23,172,7,1.319149869,6846,172,5,2
26088,2014/03/31,2011/06/02,56,7,0.7240843490000001,12472,56,2,5
26089,2014/03/31,2010/07/01,257,6,0.660522967,13672,257,5,1
26090,2014/03/31,2008/08/25,103,13,0.747994533,12072,103,8,5
26091,2014/03/31,2008/07/04,441,10,0.596636712,15134,441,10,0
26092,2014/03/31,2005/09/27,6,11,0.6997357409999999,12904,6,6,5
26093,2014/03/31,2012/03/16,11,9,0.533333333,16929,11,4,5
26094,2014/03/31,2005/06/21,98,12,0.549759484,16423,98,8,4
26095,2014/03/31,2012/09/19,257,9,0.657370759,13734,257,5,4
26096,2014/03/31,2012/07/21,271,7,0.919925616,9814,271,6,1
26097,2014/03/31,2007/04/27,20,8,0.864260412,10445,20,4,4
26098,2014/03/31,2007/07/21,13,9,0.660364301,13670,13,4,5
26099,2014/03/31,2006/11/30,91,14,0.746841234,12087,91,10,4
26100,2014/03/31,2005/08/06,207,9,0.571809198,15786,207,6,3
26101,2014/03/31,2008/12/04,117,4,0.808926235,11157,117,0,4
26102,2014/03/31,2012/01/01,122,7,0.7194044959999999,12544,122,1,6
26103,2014/03/31,2010/07/11,3,7,0.965266367,9348,3,4,3
26104,2014/03/31,2007/09/11,206,12,0.6185555629999999,14587,206,9,3
26105,2014/03/31,2010/10/07,43,7,0.6003626320000001,15029,43,3,4
26106,2014/03/31,2013/03/04,26,13,0.719773398,12533,26,2,11
26107,2014/03/31,2012/05/22,88,7,0.874508968,10315,88,6,1
26108,2014/03/31,2006/03/07,164,6,0.491931614,18337,164,5,1
26109,2014/03/31,2010/09/23,59,7,0.790502147,11411,59,3,4
26110,2014/03/31,2009/01/16,9,7,0.7841705790000001,11502,9,0,7
26111,2014/03/31,2012/08/31,56,13,0.799160907,11286,56,7,6
26112,2014/03/31,2012/03/30,401,5,1.0,9019,401,5,0
26113,2014/03/31,2012/09/14,307,11,0.8863636359999999,10175,307,9,2
26114,2014/03/31,2010/09/10,213,7,0.702115998,12845,213,4,3
26115,2014/03/31,2007/11/20,30,16,0.5700037920000001,15822,30,6,10
26116,2014/03/31,2008/04/12,154,9,0.808532233,11153,154,8,1
26117,2014/03/31,2011/06/26,11,21,0.682629826,13210,11,11,10
26118,2014/03/31,2007/06/11,158,11,0.598118201,15076,158,5,6
26119,2014/03/31,2011/11/23,28,16,0.464125701,19427,28,6,10
26120,2014/03/31,2011/02/01,373,9,0.35757515700000003,25214,373,9,0
26121,2014/03/31,2008/05/20,20,9,0.608093761,14825,20,5,4
26122,2014/03/31,2013/01/10,92,4,0.7773130979999999,11597,92,1,3
26123,2014/03/31,2013/02/01,258,3,0.85,10605,258,1,2
26124,2014/03/31,2011/12/13,186,14,0.701485603,12850,186,4,10
26125,2014/03/31,2010/10/22,38,7,0.604078542,14922,38,4,3
26126,2014/03/31,2005/09/16,322,9,0.5550120070000001,16241,322,8,1
26127,2014/03/31,2012/10/20,264,10,0.6833937370000001,13189,264,9,1
26128,2014/03/31,2009/06/13,202,15,0.599759116,15028,202,10,5
26129,2014/03/31,2008/01/31,2,17,0.553753994,16276,2,7,10
26130,2014/03/31,2010/07/11,541,9,0.958803191,9400,541,9,0
26131,2014/03/31,2009/08/26,215,5,0.644804665,13976,215,2,3
26132,2014/03/31,2011/06/01,18,8,0.8797110220000001,10243,18,6,2
26133,2014/03/31,2008/08/30,606,2,0.992165823,9082,606,2,0
26134,2014/03/31,2010/07/14,62,11,0.670150231,13446,62,6,5
26135,2014/03/31,2005/10/01,205,13,0.7478693559999999,12048,205,10,3
26136,2014/03/31,2010/03/04,178,4,0.8415981690000001,10706,178,2,2
26137,2014/03/31,2008/04/10,158,6,1.118577281,8055,158,2,4
26138,2014/03/31,2012/04/23,545,8,0.88153259,10218,545,8,0
26139,2014/03/31,2009/12/10,349,10,0.678925153,13267,349,8,2
26140,2014/03/31,2009/12/15,252,4,1.438371127,6262,252,1,3
26141,2014/03/31,2006/01/25,44,7,0.844296963,10668,44,3,4
26142,2014/03/31,2012/09/13,61,11,0.6202217329999999,14522,61,7,4
26143,2014/03/31,2007/05/24,44,6,0.8534321990000001,10553,44,0,6
26144,2014/03/31,2012/11/04,193,9,0.602451328,14947,193,4,5
26145,2014/03/31,2010/08/23,29,9,0.7269371109999999,12387,29,0,9
26146,2014/03/31,2009/11/17,621,3,0.45,20010,621,3,0
26147,2014/03/31,2013/01/31,82,8,0.920644172,9780,82,2,6
26148,2014/03/31,2009/01/25,110,8,0.6308864129999999,14271,110,0,8
26149,2014/03/31,2011/12/31,17,9,0.961365723,9365,17,6,3
26150,2014/03/31,2011/11/17,24,18,0.492777778,18270,24,11,7
26151,2014/03/31,2008/02/08,334,3,0.525569177,17130,334,2,1
26152,2014/03/31,2013/01/30,116,11,0.7552118109999999,11921,116,3,8
26153,2014/03/31,2011/03/17,221,13,0.5346148820000001,16839,221,10,3
26154,2014/03/31,2013/03/02,49,6,0.663141068,13575,49,2,4
26155,2014/03/31,2009/12/08,66,17,0.5545551999999999,16232,66,4,13
26156,2014/03/31,2010/12/04,453,8,0.8186067659999999,10996,453,8,0
26157,2014/03/31,2010/07/13,18,6,0.648182473,13887,18,2,4
26158,2014/03/31,2010/08/13,4,9,0.9035264,9962,4,3,6
26159,2014/03/31,2012/03/20,26,15,0.551059205,16333,26,9,6
26160,2014/03/31,2011/04/16,3,8,0.768648049,11709,3,3,5
26161,2014/03/31,2010/03/12,148,14,0.462146452,19474,148,8,6
26162,2014/03/31,2009/02/21,82,8,0.706373626,12740,82,1,7
26163,2014/03/31,2008/09/23,33,10,0.799757376,11252,33,6,4
26164,2014/03/31,2013/03/04,191,9,0.7813276029999999,11517,191,2,7
26165,2014/03/31,2007/12/26,262,12,0.651087554,13820,262,7,5
26166,2014/03/31,2009/07/11,122,8,0.5933579529999999,15164,122,1,7
26167,2014/03/31,2012/03/30,199,10,0.829239561,10849,199,8,2
26168,2014/03/31,2013/02/10,28,11,0.718790348,12516,28,0,11
26169,2014/03/31,2008/09/01,582,7,0.7767679820000001,11581,582,7,0
26170,2014/03/31,2011/06/02,242,11,0.7038430240000001,12779,242,4,7
26171,2014/03/31,2011/12/26,113,8,0.961444148,9355,113,6,2
26172,2014/03/31,2005/12/07,105,6,0.841051057,10694,105,3,3
26173,2014/03/31,2011/11/08,252,11,0.72225006,12453,252,8,3
26174,2014/03/31,2005/10/15,61,9,0.821521739,10948,61,6,3
26175,2014/03/31,2007/10/05,200,4,1.0474106,8585,200,2,2
26176,2014/03/31,2008/03/04,304,9,0.675934,13303,304,8,1
26177,2014/03/31,2012/08/07,42,7,0.5954360639999999,15101,42,4,3
26178,2014/03/31,2007/07/05,3,14,0.567190083,15851,3,3,11
26179,2014/03/31,2012/03/06,59,12,0.689550545,13038,59,7,5
26180,2014/03/31,2012/10/16,241,8,0.698916965,12862,241,4,4
26181,2014/03/31,2006/12/08,282,10,0.7857736009999999,11440,282,8,2
26182,2014/03/31,2007/01/18,212,11,0.830512797,10823,212,9,2
26183,2014/03/31,2007/06/14,30,16,0.74954045,11990,30,6,10
26184,2014/03/31,2009/12/09,233,13,0.948135683,9478,233,8,5
26185,2014/03/31,2008/02/27,37,5,0.774,11610,37,3,2
26186,2014/03/31,2010/02/14,491,7,0.937321373,9587,491,7,0
26187,2014/03/31,2012/04/03,211,16,0.429375,20928,211,11,5
26188,2014/03/31,2011/11/07,337,7,0.7907083770000001,11364,337,6,1
26189,2014/03/31,2008/08/26,67,8,0.701356647,12811,67,4,4
26190,2014/03/31,2008/08/12,89,13,0.754089307,11914,89,7,6
26191,2014/03/31,2011/07/09,14,8,0.697491265,12879,14,0,8
26192,2014/03/31,2011/09/30,299,9,0.7364256440000001,12198,299,5,4
26193,2014/03/31,2013/02/15,145,11,0.707554943,12695,145,3,8
26194,2014/03/31,2009/03/02,20,9,0.701925602,12796,20,0,9
26195,2014/03/31,2006/03/14,2,8,0.660424265,13600,2,0,8
26196,2014/03/31,2008/05/17,68,4,0.7652862990000001,11736,68,1,3
26197,2014/03/31,2007/05/07,188,10,0.7728821,11620,188,4,6
26198,2014/03/31,2009/09/15,28,11,0.5141432420000001,17467,28,4,7
26199,2014/03/31,2010/05/26,178,7,0.798621487,11244,178,6,1
26200,2014/03/31,2009/11/01,213,11,0.70081948,12813,213,8,3
26201,2014/03/31,2011/07/13,77,16,0.780655595,11501,77,6,10
26202,2014/03/31,2010/03/02,148,11,0.8156113740000001,11008,148,8,3
26203,2014/03/31,2005/07/18,306,11,1.0,8978,306,7,4
26204,2014/03/31,2011/08/23,97,7,1.259406566,7128,97,4,3
26205,2014/03/31,2012/04/28,34,10,0.624688239,14370,34,1,9
26206,2014/03/31,2011/09/13,53,10,0.641275988,13997,53,2,8
26207,2014/03/31,2013/03/22,67,11,0.816291951,10995,67,0,11
26208,2014/03/31,2005/04/29,25,10,0.554199704,16194,25,6,4
26209,2014/03/31,2007/08/01,17,13,0.671398968,13367,17,8,5
26210,2014/03/31,2013/01/23,6,14,0.714291627,12564,6,1,13
26211,2014/03/31,2011/03/09,25,10,0.6785377290000001,13226,25,4,6
26212,2014/03/31,2007/12/09,198,6,0.736562705,12184,198,3,3
26213,2014/03/31,2008/02/20,237,6,0.707175729,12690,237,4,2
26214,2014/03/31,2011/06/08,272,7,0.763820225,11748,272,6,1
26215,2014/03/31,2008/04/01,80,11,0.702634093,12771,80,6,5
26216,2014/03/31,2007/03/19,287,9,0.602679339,14888,287,6,3
26217,2014/03/31,2006/11/13,173,3,1.44,6231,173,0,3
26218,2014/03/31,2011/01/13,2,16,0.551196166,16277,2,6,10
26219,2014/03/31,2008/05/10,142,8,0.7359183000000001,12191,142,6,2
26220,2014/03/31,2006/04/12,105,9,0.500941984,17909,105,1,8
26221,2014/03/31,2009/11/18,29,8,0.520652931,17230,29,3,5
26222,2014/03/31,2010/02/26,80,8,0.813662585,11025,80,4,4
26223,2014/03/31,2010/07/11,48,13,0.66372771,13515,48,0,13
26224,2014/03/31,2008/04/12,111,10,0.760112702,11801,111,6,4
26225,2014/03/31,2011/03/21,674,4,0.759003215,11818,674,4,0
26226,2014/03/31,2011/09/19,167,12,0.57518566,15593,167,9,3
26227,2014/03/31,2012/10/24,186,11,0.560617577,15998,186,9,2
26228,2014/03/31,2011/01/22,79,9,0.651235204,13771,79,3,6
26229,2014/03/31,2009/05/12,2,16,0.8287781890000001,10820,2,5,11
26230,2014/03/31,2013/03/23,9,5,0.797917779,11238,9,1,4
26231,2014/03/31,2010/04/23,29,10,0.724227445,12381,29,4,6
26232,2014/03/31,2012/09/15,97,8,0.6904558759999999,12986,97,4,4
26233,2014/03/31,2010/04/15,90,9,0.688513939,13021,90,7,2
26234,2014/03/31,2008/03/14,113,8,0.7647445190000001,11723,113,4,4
26235,2014/03/31,2011/12/17,3,12,0.810551537,11060,3,4,8
26236,2014/03/31,2012/08/20,378,8,0.684092643,13104,378,8,0
26237,2014/03/31,2012/11/09,46,10,0.513649438,17452,46,4,6
26238,2014/03/31,2011/12/02,228,9,0.7663204240000001,11697,228,6,3
26239,2014/03/31,2012/04/18,284,8,0.689280221,13004,284,6,2
26240,2014/03/31,2012/10/27,31,14,0.927857143,9660,31,4,10
26241,2014/03/31,2013/01/04,29,6,0.7,12804,29,2,4
26242,2014/03/31,2012/09/11,116,7,0.724612337,12369,116,0,7
26243,2014/03/31,2005/07/15,25,13,0.79167653,11321,25,8,5
26244,2014/03/31,2011/01/13,30,17,0.557402202,16079,30,8,9
26245,2014/03/31,2010/07/30,155,17,0.596225135,15031,155,10,7
26246,2014/03/31,2008/05/30,190,6,1.369048274,6546,190,1,5
26247,2014/03/31,2011/11/01,82,9,0.8689429790000001,10312,82,4,5
26248,2014/03/31,2012/05/29,102,13,0.826155832,10845,102,3,10
26249,2014/03/31,2008/07/05,324,6,1.14412516,7830,324,5,1
26250,2014/03/31,2005/08/09,332,10,0.601807188,14885,332,8,2
26251,2014/03/31,2007/04/21,193,14,0.562216783,15933,193,10,4
26252,2014/03/31,2007/11/26,107,6,0.840548935,10657,107,2,4
26253,2014/03/31,2008/04/14,11,9,0.699331563,12806,11,8,1
26254,2014/03/31,2009/02/11,3,10,0.644700885,13891,3,4,6
26255,2014/03/31,2010/11/01,68,8,0.74134851,12080,68,6,2
26256,2014/03/31,2009/09/12,2,9,0.8711527240000001,10280,2,4,5
26257,2014/03/31,2012/03/02,528,5,0.697779336,12834,528,5,0
26258,2014/03/31,2007/01/03,110,10,0.605685877,14784,110,9,1
26259,2014/03/31,2011/10/24,135,5,0.656981437,13629,135,1,4
26260,2014/03/31,2012/05/30,174,9,0.512158792,17482,174,7,2
26261,2014/03/31,2013/01/17,153,11,0.735270592,12177,153,1,10
26262,2014/03/31,2008/12/24,242,19,0.466925684,19175,242,14,5
26263,2014/03/31,2012/04/20,36,12,0.6927609690000001,12923,36,0,12
26264,2014/03/31,2011/01/30,131,14,0.8589234309999999,10422,131,9,5
26265,2014/03/31,2007/12/17,72,8,0.725522775,12338,72,5,3
26266,2014/03/31,2012/03/08,11,34,0.976907126,9163,11,20,14
26267,2014/03/31,2010/09/10,159,8,0.834070071,10732,159,4,4
26268,2014/03/31,2010/05/22,441,13,0.6293327710000001,14223,441,13,0
26269,2014/03/31,2008/07/01,125,7,0.836900421,10695,125,6,1
26270,2014/03/31,2007/11/13,111,14,0.7473714090000001,11976,111,9,5
26271,2014/03/31,2008/11/03,25,7,0.640893663,13965,25,1,6
26272,2014/03/31,2007/09/14,109,15,0.575271278,15556,109,4,11
26273,2014/03/31,2010/11/25,117,6,0.772902056,11578,117,0,6
26274,2014/03/31,2007/06/15,8,6,1.3178630340000002,6790,8,0,6
26275,2014/03/31,2009/07/06,60,11,0.804497302,11120,60,5,6
26276,2014/03/31,2008/07/14,20,17,0.502118321,17816,20,4,13
26277,2014/03/31,2011/11/06,332,11,0.7205654909999999,12414,332,9,2
26278,2014/03/31,2011/11/14,400,5,0.889695644,10054,400,5,0
26279,2014/03/31,2005/10/21,116,5,1.098743398,8141,116,1,4
26280,2014/03/31,2006/01/21,40,7,0.680489957,13144,40,4,3
26281,2014/03/31,2009/03/10,10,18,0.494731456,18079,10,6,12
26282,2014/03/31,2007/09/12,185,11,0.7304467490000001,12244,185,7,4
26283,2014/03/31,2012/03/09,187,7,0.7228020690000001,12373,187,3,4
26284,2014/03/31,2007/06/10,414,9,0.8109685320000001,11027,414,9,0
26285,2014/03/31,2012/01/28,81,11,0.72892566,12268,81,6,5
26286,2014/03/31,2010/11/28,48,5,0.698866745,12795,48,0,5
26287,2014/03/31,2010/05/13,156,9,0.552178585,16194,156,1,8
26288,2014/03/31,2007/12/26,28,10,0.596479888,14991,28,5,5
26289,2014/03/31,2006/08/26,193,7,0.769251549,11624,193,4,3
26290,2014/03/31,2011/01/23,13,11,0.921729719,9701,13,8,3
26291,2014/03/31,2006/07/20,109,9,0.8513778329999999,10502,109,7,2
26292,2014/03/31,2008/04/01,27,5,0.719842203,12421,27,1,4
26293,2014/03/31,2011/10/08,66,8,0.594242324,15046,66,4,4
26294,2014/03/31,2005/10/10,17,12,0.510399041,17517,17,3,9
26295,2014/03/31,2012/01/25,7,8,0.6836904490000001,13077,7,0,8
26296,2014/03/31,2012/05/05,57,9,0.8357632979999999,10697,57,3,6
26297,2014/03/31,2011/01/13,677,2,0.55,16254,677,2,0
26298,2014/03/31,2012/09/25,417,2,0.55,16254,417,2,0
26299,2014/03/31,2013/01/20,422,2,0.55,16254,422,2,0
26300,2014/03/31,2012/10/30,449,5,0.77,11610,449,5,0
26301,2014/03/31,2011/05/17,37,11,0.697805792,12811,37,5,6
26302,2014/03/31,2010/10/13,79,10,0.919796275,9719,79,6,4
26303,2014/03/31,2007/04/18,119,17,0.8680316570000001,10298,119,15,2
26304,2014/03/31,2012/07/05,159,9,0.8852421509999999,10097,159,4,5
26305,2014/03/31,2008/08/28,32,6,0.8525524609999999,10484,32,0,6
26306,2014/03/31,2008/05/25,360,6,1.100480177,8122,360,5,1
26307,2014/03/31,2011/01/13,3,8,0.654292826,13660,3,0,8
26308,2014/03/31,2012/07/15,364,7,0.7172913320000001,12460,364,6,1
26309,2014/03/31,2012/05/29,14,10,0.48140125,18562,14,3,7
26310,2014/03/31,2011/12/17,317,3,1.4474323669999998,6173,317,0,3
26311,2014/03/31,2010/03/22,151,9,0.738853882,12093,151,2,7
26312,2014/03/31,2009/09/01,75,9,0.811796293,11006,75,1,8
26313,2014/03/31,2011/06/29,163,11,0.635881851,14050,163,4,7
26314,2014/03/31,2010/07/09,56,12,0.6174160329999999,14470,56,6,6
26315,2014/03/31,2005/11/09,1,15,0.5830824960000001,15322,1,0,15
26316,2014/03/31,2010/11/03,423,5,0.800896539,11154,423,5,0
26317,2014/03/31,2012/01/26,49,7,0.620659348,14393,49,5,2
26318,2014/03/31,2008/12/15,368,7,0.75827674,11780,368,7,0
26319,2014/03/31,2010/03/26,469,8,0.852941457,10471,469,8,0
26320,2014/03/31,2006/11/01,587,5,0.86,10385,587,5,0
26321,2014/03/31,2011/02/18,691,2,1.5,5954,691,2,0
26322,2014/03/31,2012/10/31,68,10,0.678363084,13165,68,4,6
26323,2014/03/31,2012/07/16,541,5,0.580064956,15395,541,5,0
26324,2014/03/31,2011/12/26,43,11,0.800324431,11158,43,0,11
26325,2014/03/31,2010/12/10,257,7,0.8173775740000001,10925,257,3,4
26326,2014/03/31,2012/01/06,26,8,0.620226436,14397,26,6,2
26327,2014/03/31,2008/11/14,324,10,0.643870782,13868,324,9,1
26328,2014/03/31,2006/02/21,155,14,0.6594652879999999,13540,155,11,3
26329,2014/03/31,2012/11/24,278,6,0.6555407089999999,13621,278,5,1
26330,2014/03/31,2009/09/08,103,14,0.75225714,11869,103,11,3
26331,2014/03/31,2010/01/06,94,9,0.818598148,10907,94,7,2
26332,2014/03/31,2012/12/17,190,3,0.589358331,15148,190,2,1
26333,2014/03/31,2008/01/22,32,12,0.592013926,15080,32,4,8
26334,2014/03/31,2009/11/19,377,6,0.612808896,14568,377,6,0
26335,2014/03/31,2013/02/05,2,5,0.570173086,15657,2,4,1
26336,2014/03/31,2013/03/09,13,30,0.7327366,12183,13,2,28
26337,2014/03/31,2013/01/25,33,3,0.7738228159999999,11536,33,1,2
26338,2014/03/31,2009/03/08,49,13,0.650205405,13729,49,3,10
26339,2014/03/31,2010/12/20,36,9,0.618993828,14421,36,4,5
26340,2014/03/31,2005/09/12,187,9,1.254737138,7114,187,4,5
26341,2014/03/31,2005/12/25,594,5,0.919174132,9711,594,5,0
26342,2014/03/31,2010/07/19,74,11,0.623373376,14318,74,5,6
26343,2014/03/31,2012/08/11,359,5,0.876460768,10183,359,4,1
26344,2014/03/31,2013/03/05,48,7,0.7601379779999999,11741,48,0,7
26345,2014/03/31,2012/08/10,400,12,0.863428793,10336,400,12,0
26346,2014/03/31,2008/11/09,68,4,0.785,11368,68,0,4
26347,2014/03/31,2010/06/29,16,15,0.678152595,13159,16,7,8
26348,2014/03/31,2005/10/14,386,7,0.6479559979999999,13772,386,7,0
26349,2014/03/31,2007/10/21,156,12,0.718323136,12422,156,8,4
26350,2014/03/31,2012/09/13,422,8,0.604949153,14750,422,8,0
26351,2014/03/31,2010/02/10,108,13,0.649452653,13739,108,8,5
26352,2014/03/31,2008/05/28,18,7,0.610804354,14608,18,4,3
26353,2014/03/31,2012/03/13,179,5,0.936854263,9524,179,2,3
26354,2014/03/31,2006/11/12,99,6,0.823214615,10838,99,5,1
26355,2014/03/31,2006/06/28,222,11,0.816497666,10927,222,8,3
26356,2014/03/31,2010/04/09,65,6,0.621451658,14356,65,3,3
26357,2014/03/31,2013/01/03,37,7,0.673873527,13236,37,3,4
26358,2014/03/31,2008/01/13,11,8,0.6058872279999999,14720,11,6,2
26359,2014/03/31,2005/09/14,31,20,0.654809457,13619,31,5,15
26360,2014/03/31,2012/07/05,32,10,0.525319588,16975,32,0,10
26361,2014/03/31,2009/09/10,71,7,0.804804152,11080,71,4,3
26362,2014/03/31,2011/10/13,214,8,0.559546938,15936,214,4,4
26363,2014/03/31,2009/09/13,82,7,0.6714096390000001,13280,82,1,6
26364,2014/03/31,2012/06/11,113,8,0.6314170379999999,14121,113,4,4
26365,2014/03/31,2010/02/19,5,17,0.750522727,11880,5,9,8
26366,2014/03/31,2011/11/29,263,8,0.612244043,14563,263,6,2
26367,2014/03/31,2011/02/17,116,10,0.7828545090000001,11389,116,8,2
26368,2014/03/31,2012/07/13,77,9,0.7311111109999999,12195,77,5,4
26369,2014/03/31,2013/02/18,187,11,0.7785443590000001,11452,187,0,11
26370,2014/03/31,2008/09/26,124,11,0.472914125,18853,124,3,8
26371,2014/03/31,2008/05/28,158,19,0.776842105,11476,158,9,10
26372,2014/03/31,2008/05/25,35,8,0.8756281309999999,10181,35,2,6
26373,2014/03/31,2013/01/13,34,8,0.7732729009999999,11528,34,0,8
26374,2014/03/31,2008/08/29,49,10,0.766839298,11624,49,2,8
26375,2014/03/31,2006/12/29,10,14,0.467152665,19081,10,3,11
26376,2014/03/31,2011/09/25,260,10,0.633569093,14068,260,7,3
26377,2014/03/31,2008/02/18,272,10,0.6851975709999999,13008,272,3,7
26378,2014/03/31,2009/01/24,286,8,0.752720209,11841,286,6,2
26379,2014/03/31,2007/05/09,171,6,1.3982146219999998,6374,171,3,3
26380,2014/03/31,2009/07/01,105,12,0.7547162940000001,11808,105,7,5
26381,2014/03/31,2008/01/16,31,12,0.818098779,10893,31,3,9
26382,2014/03/31,2012/02/18,128,12,0.794670055,11214,128,4,8
26383,2014/03/31,2012/08/30,5,10,0.59070529,15086,5,5,5
26384,2014/03/31,2010/02/11,208,11,0.8577668690000001,10389,208,7,4
26385,2014/03/31,2011/01/04,279,11,0.7537249429999999,11823,279,7,4
26386,2014/03/31,2012/07/15,129,8,0.773543403,11520,129,6,2
26387,2014/03/31,2009/09/25,94,15,0.802281444,11107,94,12,3
26388,2014/03/31,2006/10/10,3,11,0.786057692,11336,3,0,11
26389,2014/03/31,2008/02/04,137,8,0.7630958290000001,11677,137,5,3
26390,2014/03/31,2013/03/08,215,4,0.523042381,17036,215,0,4
26391,2014/03/31,2012/10/16,71,6,0.6835688529999999,13035,71,2,4
26392,2014/03/31,2012/09/15,43,7,0.864183723,10309,43,2,5
26393,2014/03/31,2010/11/22,84,6,0.61892872,14394,84,4,2
26394,2014/03/31,2011/01/10,200,8,0.663023221,13436,200,2,6
26395,2014/03/31,2010/10/15,377,10,0.656593204,13567,377,10,0
26396,2014/03/31,2011/06/22,145,6,0.606295943,14692,145,4,2
26397,2014/03/31,2013/02/01,4,7,0.653913075,13621,4,0,7
26398,2014/03/31,2012/10/18,180,5,0.674,13215,180,4,1
26399,2014/03/31,2013/03/25,20,12,0.7738613259999999,11509,20,0,12
26400,2014/03/31,2011/02/15,214,9,0.798700448,11150,214,6,3
26401,2014/03/31,2012/03/10,3,13,0.585367778,15213,3,11,2
26402,2014/03/31,2013/03/24,1,15,0.542334957,16420,1,0,15
26403,2014/03/31,2008/07/22,132,9,0.590252552,15086,132,4,5
26404,2014/03/31,2007/02/10,243,7,0.577014645,15432,243,5,2
26405,2014/03/31,2012/10/11,413,5,0.7329889690000001,12148,413,5,0
26406,2014/03/31,2013/01/06,131,7,0.574977075,15485,131,1,6
26407,2014/03/31,2013/03/05,218,7,0.813372008,10946,218,2,5
26408,2014/03/31,2012/10/27,8,14,0.5124335210000001,17374,8,2,12
26409,2014/03/31,2012/05/12,85,6,0.581969142,15296,85,2,4
26410,2014/03/31,2011/09/11,11,9,0.692893282,12847,11,6,3
26411,2014/03/31,2010/02/19,132,12,0.478860971,18586,132,4,8
26412,2014/03/31,2011/05/23,96,12,0.592053756,15031,96,5,7
26413,2014/03/31,2010/10/11,186,3,0.411572618,21620,186,2,1
26414,2014/03/31,2012/11/02,354,7,0.61051187,14574,354,4,3
26415,2014/03/31,2006/03/11,13,12,0.534492371,16646,13,7,5
26416,2014/03/31,2011/01/15,130,7,0.8416972559999999,10570,130,3,4
26417,2014/03/31,2006/06/20,13,6,0.749023322,11877,13,2,4
26418,2014/03/31,2007/08/05,142,6,0.860824543,10333,142,2,4
26419,2014/03/31,2006/12/12,1,9,0.583775925,15236,1,6,3
26420,2014/03/31,2004/12/21,25,5,0.805288845,11044,25,4,1
26421,2014/03/31,2007/07/15,114,10,0.649921806,13684,114,5,5
26422,2014/03/31,2007/08/01,161,11,0.732482497,12141,161,6,5
26423,2014/03/31,2006/04/29,78,10,0.710512943,12516,78,4,6
26424,2014/03/31,2012/09/29,41,8,0.752558395,11816,41,0,8
26425,2014/03/31,2012/05/01,60,7,0.536115164,16585,60,6,1
26426,2014/03/31,2006/01/24,72,8,0.633782435,14028,72,3,5
26427,2014/03/31,2009/11/20,139,12,0.579038687,15354,139,8,4
26428,2014/03/31,2010/11/03,133,7,0.6830910490000001,13015,133,2,5
26429,2014/03/31,2012/03/02,216,12,0.7827375190000001,11357,216,8,4
26430,2014/03/31,2011/06/27,64,9,0.816001102,10893,64,3,6
26431,2014/03/31,2013/03/25,30,14,0.555708034,15995,30,2,12
26432,2014/03/31,2009/02/26,8,8,0.78845915,11273,8,2,6
26433,2014/03/31,2012/08/16,242,8,0.645229038,13775,242,4,4
26434,2014/03/31,2009/01/29,3,7,0.740538244,12002,3,6,1
26435,2014/03/31,2012/09/28,57,8,0.563629273,15769,57,4,4
26436,2014/03/31,2013/03/11,193,7,0.956386527,9293,193,1,6
26437,2014/03/31,2005/02/09,72,10,0.673307069,13199,72,9,1
26438,2014/03/31,2005/06/19,356,10,0.660917745,13446,356,9,1
26439,2014/03/31,2012/07/26,2,9,0.772092276,11509,2,4,5
26440,2014/03/31,2010/08/02,124,6,0.6606698879999999,13450,124,2,4
26441,2014/03/31,2006/08/01,9,9,0.608572016,14601,9,1,8
26442,2014/03/31,2006/07/16,68,9,0.6564979679999999,13535,68,5,4
26443,2014/03/31,2006/07/21,9,6,0.748819316,11866,9,2,4
26444,2014/03/31,2011/07/07,163,6,0.617727336,14384,163,1,5
26445,2014/03/31,2008/04/11,31,18,0.685489894,12962,31,7,11
26446,2014/03/31,2011/05/23,93,8,0.929187408,9562,93,1,7
26447,2014/03/31,2009/01/15,343,13,0.5697845189999999,15593,343,12,1
26448,2014/03/31,2008/07/06,43,11,0.701551642,12664,43,6,5
26449,2014/03/31,2011/03/13,126,7,0.83951805,10582,126,2,5
26450,2014/03/31,2013/03/25,252,7,0.7160014509999999,12407,252,2,5
26451,2014/03/31,2007/06/27,134,2,1.044193018,8507,134,0,2
26452,2014/03/31,2012/03/16,541,3,0.916666667,9690,541,3,0
26453,2014/03/31,2008/11/17,279,10,0.6584846910000001,13489,279,8,2
26454,2014/03/31,2012/01/25,1,12,0.710947807,12492,1,7,5
26455,2014/03/31,2006/10/29,152,6,0.631337267,14066,152,2,4
26456,2014/03/31,2007/07/05,2,6,0.497229968,17859,2,0,6
26457,2014/03/31,2013/02/12,31,6,0.639701751,13881,31,2,4
26458,2014/03/31,2012/11/04,79,10,0.6772936690000001,13110,79,2,8
26459,2014/03/31,2007/07/10,49,7,0.724927335,12248,49,3,4
26460,2014/03/31,2007/04/13,65,17,0.820783027,10817,65,6,11
26461,2014/03/31,2013/03/13,9,8,0.685050154,12960,9,0,8
26462,2014/03/31,2012/10/19,173,10,0.8276904429999999,10725,173,4,6
26463,2014/03/31,2011/08/16,299,4,0.987751196,8987,299,3,1
26464,2014/03/31,2006/09/22,150,11,0.65605765,13530,150,6,5
26465,2014/03/31,2012/02/05,66,7,0.721922733,12295,66,4,3
26466,2014/03/31,2012/03/16,112,17,0.646093761,13737,112,16,1
26467,2014/03/31,2010/03/01,142,7,0.7575238990000001,11716,142,2,5
26468,2014/03/31,2010/10/11,46,12,0.557359,15922,46,4,8
26469,2014/03/31,2011/11/24,78,12,0.7002840909999999,12672,78,1,11
26470,2014/03/31,2012/03/10,29,15,0.606806619,14624,29,8,7
26471,2014/03/31,2010/09/20,142,10,0.45477423,19511,142,7,3
26472,2014/03/31,2007/03/01,8,12,0.692691077,12809,8,3,9
26473,2014/03/31,2010/02/10,10,9,0.493751461,17969,10,4,5
26474,2014/03/31,2006/11/27,435,6,0.677646654,13092,435,6,0
26475,2014/03/31,2005/12/28,23,10,0.5657282229999999,15682,23,4,6
26476,2014/03/31,2009/02/28,1,14,0.80388456,11036,1,3,11
26477,2014/03/31,2012/04/01,141,5,0.7539066879999999,11767,141,3,2
26478,2014/03/31,2012/07/31,130,9,0.685600124,12939,130,2,7
26479,2014/03/31,2012/02/15,75,9,0.722146695,12284,75,0,9
26480,2014/03/31,2012/08/18,29,13,0.7475686840000001,11866,29,7,6
26481,2014/03/31,2009/01/09,78,10,0.755426673,11742,78,4,6
26482,2014/03/31,2010/08/26,44,10,0.701309298,12648,44,6,4
26483,2014/03/31,2006/05/31,154,10,0.741705828,11959,154,4,6
26484,2014/03/31,2012/12/19,33,5,0.8540000000000001,10385,33,0,5
26485,2014/03/31,2012/11/06,49,11,0.677304109,13094,49,1,10
26486,2014/03/31,2008/08/20,284,4,1.248649676,7102,284,0,4
26487,2014/03/31,2012/07/24,617,2,0.669351551,13247,617,2,0
26488,2014/03/31,2011/12/01,4,16,0.652816964,13582,4,8,8
26489,2014/03/31,2012/09/11,479,4,0.429144683,20659,479,4,0
26490,2014/03/31,2005/03/22,34,9,0.686717273,12910,34,0,9
26491,2014/03/31,2010/04/02,11,10,0.645030559,13744,11,8,2
26492,2014/03/31,2011/07/09,248,6,0.520628964,17028,248,2,4
26493,2014/03/31,2010/03/11,425,6,0.8899508079999999,9961,425,6,0
26494,2014/03/31,2010/10/16,157,11,0.7128337090000001,12436,157,3,8
26495,2014/03/31,2008/11/27,121,10,0.7007383979999999,12649,121,6,4
26496,2014/03/31,2011/11/07,597,8,0.842627626,10519,597,8,0
26497,2014/03/31,2009/02/14,398,10,0.734429897,12068,398,10,0
26498,2014/03/31,2012/01/18,81,10,0.721248474,12287,81,4,6
26499,2014/03/31,2006/01/30,42,7,0.6808752109999999,13014,42,2,5
26500,2014/03/31,2011/05/10,13,7,0.936929259,9457,13,2,5
26501,2014/03/31,2006/08/12,65,9,0.619292654,14307,65,5,4
26502,2014/03/31,2012/09/12,168,7,0.895060107,9899,168,3,4
26503,2014/03/31,2009/08/31,546,8,0.7825353359999999,11320,546,8,0
26504,2014/03/31,2012/11/27,14,10,0.728285785,12163,14,3,7
26505,2014/03/31,2005/09/09,25,11,0.6744384379999999,13133,25,6,5
26506,2014/03/31,2008/06/30,26,12,0.569895123,15542,26,7,5
26507,2014/03/31,2013/03/23,73,7,0.86996464,10181,73,2,5
26508,2014/03/31,2009/10/03,69,19,0.803684211,11020,69,18,1
26509,2014/03/31,2008/01/18,151,13,0.8165778309999999,10844,151,9,4
26510,2014/03/31,2011/05/18,105,12,0.603607608,14669,105,6,6
26511,2014/03/31,2013/03/20,110,14,0.7690531620000001,11512,110,1,13
26512,2014/03/31,2012/06/09,287,6,0.667617827,13261,287,3,3
26513,2014/03/31,2011/05/04,30,12,0.649333284,13634,30,9,3
26514,2014/03/31,2012/10/02,102,10,0.7796230740000001,11355,102,6,4
26515,2014/03/31,2012/05/25,211,8,0.920371179,9618,211,4,4
26516,2014/03/31,2012/06/12,48,10,0.597320332,14819,48,9,1
26517,2014/03/31,2010/08/11,562,3,1.5,5901,562,3,0
26518,2014/03/31,2013/02/28,189,5,1.46833278,6028,189,2,3
26519,2014/03/31,2010/07/31,32,9,0.709970317,12465,32,3,6
26520,2014/03/31,2008/03/07,30,7,0.50191254,17631,30,3,4
26521,2014/03/31,2009/07/01,1,20,0.6089663479999999,14531,1,9,11
26522,2014/03/31,2012/10/14,27,9,0.5978535229999999,14801,27,2,7
26523,2014/03/31,2012/03/04,503,20,0.686157425,12895,503,20,0
26524,2014/03/31,2012/11/05,174,14,0.472860884,18711,174,0,14
26525,2014/03/31,2013/02/09,7,14,0.7675611659999999,11526,7,1,13
26526,2014/03/31,2009/07/31,62,4,0.989161355,8943,62,3,1
26527,2014/03/31,2006/08/20,140,6,0.495019867,17869,140,4,2
26528,2014/03/31,2010/08/01,370,4,0.8586990290000001,10300,370,4,0
26529,2014/03/31,2010/12/20,201,17,0.8749515240000001,10108,201,9,8
26530,2014/03/31,2012/09/30,175,7,0.8361204609999999,10576,175,4,3
26531,2014/03/31,2008/03/25,18,26,0.895,9880,18,13,13
26532,2014/03/31,2011/06/26,186,10,0.7124027070000001,12411,186,4,6
26533,2014/03/31,2010/05/29,77,12,0.574461339,15390,77,3,9
26534,2014/03/31,2008/08/30,71,11,1.068374622,8275,71,9,2
26535,2014/03/31,2004/12/16,544,6,0.69425161,12734,544,6,0
26536,2014/03/31,2008/11/04,467,7,0.848579382,10418,467,7,0
26537,2014/03/31,2008/09/21,4,7,1.366156699,6471,4,0,7
26538,2014/03/31,2006/07/07,443,5,0.921788321,9590,443,5,0
26539,2014/03/31,2009/09/14,76,9,0.627371895,14090,76,6,3
26540,2014/03/31,2010/09/01,433,6,0.916210614,9648,433,6,0
26541,2014/03/31,2010/01/13,179,13,0.671533845,13163,179,6,7
26542,2014/03/31,2011/12/14,95,9,0.834034724,10598,95,6,3
26543,2014/03/31,2010/02/07,124,5,0.8640000000000001,10230,124,3,2
26544,2014/03/31,2010/02/24,64,8,0.838740748,10538,64,5,3
26545,2014/03/31,2011/03/12,47,10,0.512911444,17232,47,6,4
26546,2014/03/31,2012/10/28,13,9,0.736867339,11993,13,4,5
26547,2014/03/31,2010/10/28,177,7,0.613091439,14414,177,3,4
26548,2014/03/31,2006/06/28,84,14,0.7333195020000001,12050,84,7,7
26549,2014/03/31,2009/06/25,34,12,0.690983735,12788,34,5,7
26550,2014/03/31,2008/09/21,118,10,0.689598845,12813,118,6,4
26551,2014/03/31,2004/12/23,33,12,0.493938953,17888,33,2,10
26552,2014/03/31,2007/03/31,230,11,0.8438076590000001,10471,230,7,4
26553,2014/03/31,2007/04/13,81,13,0.654327927,13503,81,5,8
26554,2014/03/31,2008/12/09,93,13,0.548708776,16101,93,5,8
26555,2014/03/31,2012/10/08,108,9,0.690836722,12788,108,6,3
26556,2014/03/31,2011/10/09,20,11,0.6998542109999999,12621,20,6,5
26557,2014/03/31,2006/08/24,165,6,0.906454228,9744,165,5,1
26558,2014/03/31,2011/06/09,132,10,0.7775385159999999,11359,132,1,9
26559,2014/03/31,2011/05/15,510,6,0.519781061,16991,510,6,0
26560,2014/03/31,2007/09/18,28,9,0.704022961,12543,28,6,3
26561,2014/03/31,2012/04/21,281,10,0.627981651,14061,281,7,3
26562,2014/03/31,2007/08/23,291,6,0.889021345,9932,291,5,1
26563,2014/03/31,2010/06/13,4,10,0.383610532,23016,4,3,7
26564,2014/03/31,2006/10/13,140,12,0.911378136,9687,140,5,7
26565,2014/03/31,2011/06/13,23,9,0.68082832,12966,23,4,5
26566,2014/03/31,2008/11/08,33,30,0.712333333,12390,33,17,13
26567,2014/03/31,2008/08/29,142,11,0.590584181,14944,142,3,8
26568,2014/03/31,2012/08/27,81,7,0.6236695170000001,14149,81,3,4
26569,2014/03/31,2012/06/13,48,12,0.90061237,9798,48,9,3
26570,2014/03/31,2010/06/11,278,4,0.984180236,8966,278,3,1
26571,2014/03/31,2012/12/23,363,5,0.76,11610,363,4,1
26572,2014/03/31,2009/01/02,21,8,0.701756939,12573,21,3,5
26573,2014/03/31,2011/11/05,4,7,0.900511485,9795,4,4,3
26574,2014/03/31,2013/03/02,77,7,0.747050902,11807,77,3,4
26575,2014/03/31,2008/11/17,96,10,0.554469035,15905,96,5,5
26576,2014/03/31,2007/08/19,69,12,0.549481523,16047,69,7,5
26577,2014/03/31,2007/09/05,98,8,0.673033588,13100,98,2,6
26578,2014/03/31,2012/08/28,16,14,0.507343885,17375,16,5,9
26579,2014/03/31,2009/06/22,320,7,0.601532005,14654,320,6,1
26580,2014/03/31,2008/02/18,413,6,0.70920428,12429,413,6,0
26581,2014/03/31,2012/09/15,19,5,0.66,13355,19,1,4
26582,2014/03/31,2012/07/20,133,9,0.834832812,10557,133,3,6
26583,2014/03/31,2010/04/21,5,17,0.587069678,15012,5,0,17
26584,2014/03/31,2010/10/22,9,12,0.728230871,12102,9,3,9
26585,2014/03/31,2012/09/06,172,4,0.775788732,11360,172,2,2
26586,2014/03/31,2011/08/13,427,8,0.4894301270000001,18004,427,8,0
26587,2014/03/31,2009/04/10,22,15,0.536642914,16419,22,6,9
26588,2014/03/31,2012/05/04,197,11,0.67035073,13144,197,7,4
26589,2014/03/31,2008/06/05,107,11,0.632743986,13925,107,0,11
26590,2014/03/31,2007/02/28,72,8,0.629702687,13992,72,4,4
26591,2014/03/31,2010/04/16,124,9,0.928828677,9485,124,0,9
26592,2014/03/31,2009/08/14,13,10,0.813386576,10831,13,4,6
26593,2014/03/31,2011/11/02,123,7,0.689002033,12786,123,4,3
26594,2014/03/31,2012/05/27,1,10,0.8270901409999999,10650,1,5,5
26595,2014/03/31,2007/02/11,378,8,0.669288048,13161,378,8,0
26596,2014/03/31,2007/03/24,343,8,0.793232169,11104,343,7,1
26597,2014/03/31,2011/01/20,6,7,1.143445411,7703,6,5,2
26598,2014/03/31,2012/12/24,44,11,0.603082717,14604,44,2,9
26599,2014/03/31,2012/03/19,423,10,0.938833813,9381,423,10,0
26600,2014/03/31,2007/04/11,468,6,0.719897,12233,468,6,0
26601,2014/03/31,2009/10/20,34,14,0.8610560279999999,10227,34,4,10
26602,2014/03/31,2011/01/04,62,10,0.659380007,13355,62,5,5
26603,2014/03/31,2011/11/30,124,11,0.706168404,12470,124,8,3
26604,2014/03/31,2006/10/12,18,16,0.836186497,10531,18,15,1
26605,2014/03/31,2011/12/15,35,16,0.861956735,10216,35,8,8
26606,2014/03/31,2012/01/20,25,7,0.721621046,12202,25,0,7
26607,2014/03/31,2012/11/01,128,7,0.936011481,9407,128,2,5
26608,2014/03/31,2008/04/27,579,7,0.65914059,13358,579,7,0
26609,2014/03/31,2009/10/19,217,8,0.899814001,9785,217,7,1
26610,2014/03/31,2009/11/06,18,17,0.719318627,12240,18,7,10
26611,2014/03/31,2007/02/23,1,15,0.579687253,15188,1,5,10
26612,2014/03/31,2007/12/05,83,10,0.6900407559999999,12759,83,4,6
26613,2014/03/31,2010/06/15,115,7,0.669879775,13142,115,3,4
26614,2014/03/31,2006/05/19,2,14,0.496080243,17746,2,8,6
26615,2014/03/31,2008/10/29,193,10,0.6559909070000001,13417,193,7,3
26616,2014/03/31,2010/08/04,161,7,0.771383995,11409,161,5,2
26617,2014/03/31,2009/02/28,7,8,0.724765278,12142,7,0,8
26618,2014/03/31,2012/06/19,48,8,0.7464913470000001,11788,48,0,8
26619,2014/03/31,2008/03/07,235,8,0.6798192209999999,12944,235,7,1
26620,2014/03/31,2011/08/31,80,10,0.5517490279999999,15946,80,4,6
26621,2014/03/31,2012/03/15,12,10,0.949511116,9266,12,2,8
26622,2014/03/31,2011/10/19,126,10,0.555821961,15828,126,7,3
26623,2014/03/31,2010/09/04,43,8,0.71875,12240,43,2,6
26624,2014/03/31,2010/03/18,230,10,0.887315917,9914,230,8,2
26625,2014/03/31,2009/11/06,20,8,0.743489139,11831,20,2,6
26626,2014/03/31,2012/10/30,90,12,0.620172049,14182,90,4,8
26627,2014/03/31,2008/06/14,9,7,0.688122213,12781,9,4,3
26628,2014/03/31,2008/10/31,63,6,0.740108558,11883,63,2,4
26629,2014/03/31,2007/06/16,188,5,0.749855023,11726,188,2,3
26630,2014/03/31,2008/02/07,62,14,0.818307893,10744,62,1,13
26631,2014/03/31,2012/05/29,424,6,0.8952041540000001,9821,424,6,0
26632,2014/03/31,2009/12/22,287,7,0.809074176,10866,287,6,1
26633,2014/03/31,2010/02/22,49,6,0.890966859,9867,49,4,2
26634,2014/03/31,2010/11/01,33,4,0.8290729040000001,10603,33,0,4
26635,2014/03/31,2011/05/24,2,22,0.795423944,11051,2,0,22
26636,2014/03/31,2006/07/17,34,10,0.647943388,13566,34,4,6
26637,2014/03/31,2012/01/01,275,12,0.710794922,12366,275,11,1
26638,2014/03/31,2008/10/18,513,6,0.695132078,12644,513,6,0
26639,2014/03/31,2008/11/14,200,7,0.737703542,11914,200,3,4
26640,2014/03/31,2012/08/26,311,5,0.5324609229999999,16506,311,4,1
26641,2014/03/31,2011/04/30,170,8,0.778190915,11293,170,3,5
26642,2014/03/31,2007/08/16,272,12,0.777001768,11310,272,9,3
26643,2014/03/31,2013/01/15,186,8,0.636397016,13808,186,3,5
26644,2014/03/31,2011/01/01,156,7,0.664418147,13225,156,3,4
26645,2014/03/31,2005/12/17,56,10,0.768879069,11428,56,6,4
26646,2014/03/31,2010/02/10,58,7,0.650011837,13517,58,6,1
26647,2014/03/31,2008/01/26,105,7,0.667142857,13167,105,3,4
26648,2014/03/31,2006/05/11,15,8,0.6491376,13532,15,0,8
26649,2014/03/31,2007/06/03,322,8,0.565979381,15520,322,7,1
26650,2014/03/31,2009/07/01,27,16,0.649815774,13516,27,9,7
26651,2014/03/31,2012/11/17,321,12,0.482789138,18192,321,8,4
26652,2014/03/31,2012/07/03,62,7,0.63653428,13798,62,4,3
26653,2014/03/31,2012/04/17,82,13,0.5148238470000001,17059,82,0,13
26654,2014/03/31,2007/04/18,198,4,0.885309476,9920,198,0,4
26655,2014/03/31,2011/10/15,20,7,0.9971886,8807,20,0,7
26656,2014/03/31,2010/04/28,2,8,0.614807813,14283,2,5,3
26657,2014/03/31,2007/01/21,208,4,0.97203919,9033,208,2,2
26658,2014/03/31,2012/09/29,99,6,0.804479568,10914,99,3,3
26659,2014/03/31,2010/09/30,21,4,0.889198906,9874,21,2,2
26660,2014/03/31,2011/10/27,71,10,0.514551955,17063,71,5,5
26661,2014/03/31,2007/02/26,480,6,0.844287363,10398,480,6,0
26662,2014/03/31,2007/11/29,108,8,0.779856077,11256,108,0,8
26663,2014/03/31,2012/05/10,39,10,0.627,14000,39,5,5
26664,2014/03/31,2008/11/14,49,9,0.780995729,11238,49,4,5
26665,2014/03/31,2007/09/02,69,7,0.7452522079999999,11776,69,0,7
26666,2014/03/31,2005/08/02,106,10,0.730573593,12012,106,3,7
26667,2014/03/31,2010/09/17,94,7,0.8209655690000001,10688,94,3,4
26668,2014/03/31,2007/03/23,166,11,0.735000419,11937,166,5,6
26669,2014/03/31,2012/03/10,247,9,0.689260743,12729,247,7,2
26670,2014/03/31,2011/02/15,46,14,0.796278816,11018,46,5,9
26671,2014/03/31,2011/06/29,128,6,0.818408582,10720,128,4,2
26672,2014/03/31,2010/11/16,24,17,0.813291925,10787,24,9,8
26673,2014/03/31,2012/11/26,87,5,0.686348772,12782,87,0,5
26674,2014/03/31,2010/11/03,61,7,0.72097551,12168,61,4,3
26675,2014/03/31,2006/06/15,212,5,0.643742845,13626,212,1,4
26676,2014/03/31,2010/12/20,116,11,0.584486206,15006,116,10,1
26677,2014/03/31,2011/08/12,305,11,0.642387754,13653,305,6,5
26678,2014/03/31,2008/12/08,101,7,0.581513725,15082,101,1,6
26679,2014/03/31,2006/04/29,213,13,0.5215319660000001,16815,213,8,5
26680,2014/03/31,2011/11/01,337,10,0.976851955,8977,337,8,2
26681,2014/03/31,2009/12/16,61,16,0.85435795,10264,61,8,8
26682,2014/03/31,2013/03/29,15,12,0.628741484,13945,15,0,12
26683,2014/03/31,2009/02/01,124,11,0.583107209,15036,124,6,5
26684,2014/03/31,2011/04/28,312,5,0.826737388,10605,312,2,3
26685,2014/03/31,2010/02/17,304,6,0.732264261,11973,304,5,1
26686,2014/03/31,2008/02/24,162,6,0.8052231809999999,10888,162,2,4
26687,2014/03/31,2012/10/07,49,8,0.753179553,11640,49,4,4
26688,2014/03/31,2005/06/08,126,6,0.71182608,12316,126,4,2
26689,2014/03/31,2005/11/01,37,19,0.408880183,21441,37,8,11
26690,2014/03/31,2012/06/01,213,6,0.759799792,11538,213,4,2
26691,2014/03/31,2007/11/26,13,6,0.599493913,14622,13,2,4
26692,2014/03/31,2010/03/12,115,11,0.5293978739999999,16558,115,3,8
26693,2014/03/31,2011/07/17,9,13,0.591738338,14813,9,6,7
26694,2014/03/31,2007/02/06,432,8,0.822782315,10653,432,8,0
26695,2014/03/31,2011/09/04,352,5,0.679562723,12898,352,4,1
26696,2014/03/31,2011/01/13,135,8,0.647758481,13531,135,5,3
26697,2014/03/31,2010/05/21,237,14,0.645093479,13586,237,9,5
26698,2014/03/31,2012/06/14,194,10,0.698433216,12548,194,6,4
26699,2014/03/31,2008/01/15,10,15,0.58493926,14982,10,10,5
26700,2014/03/31,2011/06/29,133,12,0.6875364820000001,12746,133,5,7
26701,2014/03/31,2013/03/19,4,14,0.581740574,15064,4,2,12
26702,2014/03/31,2011/11/18,121,7,0.7312467659999999,11983,121,4,3
26703,2014/03/31,2011/04/18,171,5,0.572297041,15311,171,4,1
26704,2014/03/31,2006/08/26,111,10,0.6708751239999999,13061,111,5,5
26705,2014/03/31,2010/11/26,11,7,0.726770902,12056,11,3,4
26706,2014/03/31,2009/07/25,36,11,0.529091787,16560,36,7,4
26707,2014/03/31,2010/05/09,61,10,0.751477477,11655,61,1,9
26708,2014/03/31,2010/03/20,7,10,0.73495091,11917,7,2,8
26709,2014/03/31,2007/11/11,187,11,0.8007900509999999,10936,187,9,2
26710,2014/03/31,2012/05/14,1,14,0.8449507909999999,10364,1,9,5
26711,2014/03/31,2009/10/01,75,18,0.813205795,10768,75,13,5
26712,2014/03/31,2005/05/20,114,5,0.7352649259999999,11909,114,1,4
26713,2014/03/31,2007/09/16,41,9,0.712518512,12289,41,2,7
26714,2014/03/31,2011/08/27,286,9,0.731295415,11973,286,8,1
26715,2014/03/31,2009/01/05,230,7,0.892055018,9815,230,5,2
26716,2014/03/31,2009/02/16,44,8,0.508374173,17222,44,6,2
26717,2014/03/31,2013/01/01,14,9,0.851225085,10285,14,0,9
26718,2014/03/31,2013/01/25,85,5,0.8376861240000001,10450,85,2,3
26719,2014/03/31,2012/03/16,26,9,0.717777778,12195,26,6,3
26720,2014/03/31,2012/03/01,412,5,0.89,9835,412,5,0
26721,2014/03/31,2006/03/16,4,7,0.574495274,15236,4,4,3
26722,2014/03/31,2011/07/12,155,7,0.602905359,14518,155,3,4
26723,2014/03/31,2009/07/19,131,8,0.725323222,12066,131,5,3
26724,2014/03/31,2010/07/17,127,12,0.6409462429999999,13654,127,9,3
26725,2014/03/31,2011/10/25,701,3,1.341947853,6520,701,3,0
26726,2014/03/31,2010/04/26,170,9,0.956034313,9151,170,7,2
26727,2014/03/31,2009/10/11,138,7,0.65686064,13318,138,3,4
26728,2014/03/31,2009/08/25,485,6,0.800869724,10923,485,6,0
26729,2014/03/31,2006/10/01,129,12,0.655608184,13343,129,8,4
26730,2014/03/31,2008/03/09,66,10,0.8042745490000001,10876,66,4,6
26731,2014/03/31,2010/12/20,177,7,0.689568748,12684,177,1,6
26732,2014/03/31,2010/05/11,286,11,0.570359961,15335,286,7,4
26733,2014/03/31,2006/06/09,57,8,0.632056656,13838,57,3,5
26734,2014/03/31,2010/07/05,90,12,0.667608579,13101,90,7,5
26735,2014/03/31,2008/09/22,295,9,0.900521005,9712,295,7,2
26736,2014/03/31,2005/01/12,137,6,0.7091048409999999,12333,137,1,5
26737,2014/03/31,2009/05/16,214,16,0.939737775,9305,214,14,2
26738,2014/03/31,2007/11/20,20,11,0.570386823,15330,20,5,6
26739,2014/03/31,2007/03/15,67,9,0.855077254,10226,67,6,3
26740,2014/03/31,2008/04/25,20,14,0.642942647,13600,20,1,13
26741,2014/03/31,2012/12/22,32,10,0.61606793,14191,32,1,9
26742,2014/03/31,2007/12/13,7,9,0.655926621,13328,7,4,5
26743,2014/03/31,2005/10/30,12,12,0.60419172,14469,12,5,7
26744,2014/03/31,2010/10/13,189,4,1.281530567,6821,189,2,2
26745,2014/03/31,2008/07/07,66,6,0.705660773,12387,66,1,5
26746,2014/03/31,2005/04/15,221,5,0.7349449259999999,11893,221,3,2
26747,2014/03/31,2009/08/14,112,11,0.8327756070000001,10495,112,3,8
26748,2014/03/31,2010/04/06,11,6,0.879267606,9940,11,0,6
26749,2014/03/31,2008/08/06,187,7,1.196242814,7306,187,2,5
26750,2014/03/31,2013/01/27,88,10,0.762319637,11463,88,2,8
26751,2014/03/31,2007/02/03,189,10,0.624999642,13981,189,8,2
26752,2014/03/31,2009/11/08,38,12,0.626262185,13952,38,6,6
26753,2014/03/31,2011/10/26,176,7,0.94672879,9229,176,4,3
26754,2014/03/31,2011/11/20,122,11,0.569546907,15339,122,0,11
26755,2014/03/31,2012/09/11,92,17,0.6915493629999999,12631,92,13,4
26756,2014/03/31,2007/09/03,159,7,0.8428350859999999,10363,159,2,5
26757,2014/03/31,2010/04/05,420,11,0.863118885,10119,420,11,0
26758,2014/03/31,2012/09/08,173,8,0.788250903,11080,173,3,5
26759,2014/03/31,2011/07/14,307,13,0.618344662,14124,307,12,1
26760,2014/03/31,2011/06/20,267,9,0.7367192509999999,11854,267,3,6
26761,2014/03/31,2012/11/05,443,8,0.541416615,16130,443,8,0
26762,2014/03/31,2011/05/22,122,9,0.717789742,12166,122,6,3
26763,2014/03/31,2013/03/10,19,8,0.578308609,15100,19,2,6
26764,2014/03/31,2011/09/14,22,6,0.536106097,16287,22,3,3
26765,2014/03/31,2007/08/01,33,9,0.7410073840000001,11783,33,2,7
26766,2014/03/31,2011/08/16,120,21,1.011096699,8635,120,13,8
26767,2014/03/31,2010/09/29,17,6,0.6266666670000001,13932,17,4,2
26768,2014/03/31,2012/07/24,1,16,0.8265874440000001,10561,1,8,8
26769,2014/03/31,2011/12/27,20,8,0.7364844340000001,11853,20,5,3
26770,2014/03/31,2011/01/24,83,10,0.698643349,12494,83,0,10
26771,2014/03/31,2012/02/24,41,7,0.531108001,16435,41,3,4
26772,2014/03/31,2008/02/07,201,7,0.982999212,8879,201,4,3
26773,2014/03/31,2013/02/02,121,9,0.535955173,16285,121,2,7
26774,2014/03/31,2008/12/10,1,15,0.554087735,15752,1,7,8
26775,2014/03/31,2011/07/10,137,14,0.710047999,12292,137,5,9
26776,2014/03/31,2008/06/06,91,15,0.45935,19000,91,14,1
26777,2014/03/31,2011/10/18,49,6,0.620971965,14054,49,2,4
26778,2014/03/31,2007/07/24,145,8,0.7533025459999999,11585,145,2,6
26779,2014/03/31,2010/12/29,95,4,0.817757263,10670,95,2,2
26780,2014/03/31,2013/03/26,189,5,1.457059118,5988,189,2,3
26781,2014/03/31,2007/06/01,149,10,0.695461575,12544,149,7,3
26782,2014/03/31,2009/09/27,43,8,0.648796668,13446,43,3,5
26783,2014/03/31,2008/01/25,168,6,0.780560129,11176,168,2,4
26784,2014/03/31,2009/11/09,3,13,0.559910783,15580,3,9,4
26785,2014/03/31,2008/10/14,101,7,0.7742517309999999,11266,101,3,4
26786,2014/03/31,2011/07/11,132,8,0.5411098010000001,16120,132,5,3
26787,2014/03/31,2010/11/02,619,4,0.825,10572,619,4,0
26788,2014/03/31,2012/06/02,354,4,0.825,10572,354,2,2
26789,2014/03/31,2007/11/04,3,12,0.604272154,14433,3,3,9
26790,2014/03/31,2012/09/15,551,3,0.9,9690,551,3,0
26791,2014/03/31,2009/08/05,156,8,0.682960294,12769,156,0,8
26792,2014/03/31,2008/01/10,108,9,0.701854326,12425,108,5,4
26793,2014/03/31,2005/11/02,136,8,0.591741874,14737,136,5,3
26794,2014/03/31,2012/05/18,265,7,0.736644703,11838,265,5,2
26795,2014/03/31,2011/03/01,77,9,0.8109420629999999,10753,77,2,7
26796,2014/03/31,2007/09/14,27,15,0.724051316,12043,27,5,10
26797,2014/03/31,2006/09/29,157,7,0.631148111,13814,157,3,4
26798,2014/03/31,2010/11/23,80,7,0.670770888,12998,80,2,5
26799,2014/03/31,2012/10/09,286,8,0.8747235879999999,9967,286,7,1
26800,2014/03/31,2010/02/18,27,11,0.777998394,11206,27,3,8
26801,2014/03/31,2009/10/15,116,11,0.903449062,9649,116,7,4
26802,2014/03/31,2006/11/04,148,20,0.680648083,12807,148,11,9
26803,2014/03/31,2008/05/10,89,11,0.688692423,12657,89,5,6
26804,2014/03/31,2012/09/09,206,11,0.483931149,18010,206,8,3
26805,2014/03/31,2013/02/24,47,5,0.766395533,11372,47,1,4
26806,2014/03/31,2010/12/07,61,6,0.7208121740000001,12091,61,4,2
26807,2014/03/31,2013/01/01,140,6,0.7457504709999999,11686,140,0,6
26808,2014/03/31,2009/04/09,103,10,0.717671086,12143,103,5,5
26809,2014/03/31,2012/09/04,225,11,0.656026046,13284,225,5,6
26810,2014/03/31,2011/04/05,36,5,0.5789641879999999,15051,36,0,5
26811,2014/03/31,2005/07/28,103,12,0.754048114,11556,103,8,4
26812,2014/03/31,2012/06/24,242,10,0.67415087,12925,242,6,4
26813,2014/03/31,2005/11/27,80,10,0.82879863,10513,80,4,6
26814,2014/03/31,2013/01/05,156,4,1.3603497269999998,6405,156,0,4
26815,2014/03/31,2011/05/24,117,10,0.687425438,12674,117,3,7
26816,2014/03/31,2010/03/08,19,16,0.565552743,15405,19,12,4
26817,2014/03/31,2011/08/01,75,13,0.460628106,18914,75,6,7
26818,2014/03/31,2007/06/25,36,9,0.7213448159999999,12076,36,4,5
26819,2014/03/31,2012/08/07,38,12,0.350985172,24818,38,9,3
26820,2014/03/31,2008/06/06,127,6,0.623325462,13974,127,4,2
26821,2014/03/31,2012/06/08,4,8,0.6987565179999999,12465,4,1,7
26822,2014/03/31,2012/06/01,67,16,0.839809046,10369,67,9,7
26823,2014/03/31,2012/07/03,93,7,0.78638761,11073,93,1,6
26824,2014/03/31,2012/08/19,371,5,0.75,11610,371,5,0
26825,2014/03/31,2010/11/30,410,9,0.657964334,13234,410,9,0
26826,2014/03/31,2012/09/10,23,15,0.7917568429999999,10997,23,5,10
26827,2014/03/31,2012/07/04,3,6,0.68,12804,3,3,3
26828,2014/03/31,2013/02/14,2,7,0.676684284,12866,2,1,6
26829,2014/03/31,2011/09/07,367,8,0.530597879,16408,367,8,0
26830,2014/03/31,2012/08/31,261,8,0.785081612,11089,261,3,5
26831,2014/03/31,2011/10/22,67,9,0.775556347,11225,67,4,5
26832,2014/03/31,2010/07/26,7,11,0.768903021,11322,7,2,9
26833,2014/03/31,2011/08/05,54,6,0.876345515,9933,54,5,1
26834,2014/03/31,2007/02/20,38,8,0.938754314,9272,38,4,4
26835,2014/03/31,2008/07/02,52,6,0.6905824009999999,12603,52,4,2
26836,2014/03/31,2012/01/01,128,10,0.649079654,13408,128,5,5
26837,2014/03/31,2012/04/17,226,9,0.773653658,11249,226,4,5
26838,2014/03/31,2013/03/09,31,14,0.903201868,9635,31,2,12
26839,2014/03/31,2012/07/05,16,7,0.574558299,15146,16,2,5
26840,2014/03/31,2011/09/27,158,9,0.847058022,10272,158,6,3
26841,2014/03/31,2005/04/19,12,9,0.546031756,15934,12,2,7
26842,2014/03/31,2013/02/07,30,13,0.585754393,14853,30,3,10
26843,2014/03/31,2012/12/11,1,12,0.640444641,13584,1,0,12
26844,2014/03/31,2012/09/01,10,10,0.7671575979999999,11339,10,6,4
26845,2014/03/31,2007/11/21,151,14,0.636259966,13671,151,8,6
26846,2014/03/31,2010/07/07,132,15,0.8770114940000001,9918,132,10,5
26847,2014/03/31,2012/10/15,410,2,0.685745822,12684,410,2,0
26848,2014/03/31,2012/09/22,171,8,0.937785445,9275,171,2,6
26849,2014/03/31,2011/12/31,58,7,0.7585714290000001,11466,58,4,3
26850,2014/03/31,2013/01/05,25,8,0.789620517,11015,25,2,6
26851,2014/03/31,2010/12/10,40,12,0.763024215,11398,40,7,5
26852,2014/03/31,2013/01/07,241,4,0.9025,9636,241,1,3
26853,2014/03/31,2009/07/20,52,10,0.611082923,14230,52,5,5
26854,2014/03/31,2009/09/02,10,8,0.549095674,15835,10,5,3
26855,2014/03/31,2012/08/08,113,10,0.645,13480,113,0,10
26856,2014/03/31,2011/02/27,153,5,0.784,11090,153,4,1
26857,2014/03/31,2009/08/18,152,8,0.824494073,10545,152,6,2
26858,2014/03/31,2013/01/26,25,7,0.865445495,10045,25,2,5
26859,2014/03/31,2010/01/21,556,5,0.654351099,13284,556,5,0
26860,2014/03/31,2007/11/29,45,6,0.7077324540000001,12282,45,0,6
26861,2014/03/31,2011/08/16,469,9,0.665766697,13056,469,9,0
26862,2014/03/31,2006/03/31,138,10,0.831524921,10453,138,4,6
26863,2014/03/31,2012/08/14,384,6,0.544282315,15968,384,6,0
26864,2014/03/31,2008/07/10,271,4,1.375110759,6320,271,0,4
26865,2014/03/31,2008/07/10,143,9,0.782940541,11100,143,7,2
26866,2014/03/31,2007/09/26,49,6,0.681375255,12754,49,2,4
26867,2014/03/31,2007/03/20,107,8,0.535226041,16236,107,5,3
26868,2014/03/31,2009/11/23,54,5,0.561032991,15489,54,1,4
26869,2014/03/31,2010/09/27,3,11,0.756623422,11485,3,0,11
26870,2014/03/31,2010/10/02,73,6,0.935109246,9291,73,5,1
26871,2014/03/31,2012/08/16,77,10,0.694648597,12507,77,5,5
26872,2014/03/31,2011/01/27,232,11,0.893636457,9721,232,8,3
26873,2014/03/31,2008/02/28,396,5,1.0,8687,396,5,0
26874,2014/03/31,2011/04/20,102,8,0.862978639,10065,102,7,1
26875,2014/03/31,2011/02/20,42,5,1.23192766,7050,42,1,4
26876,2014/03/31,2012/08/09,31,11,0.807753906,10752,31,0,11
26877,2014/03/31,2012/06/18,163,8,0.733707865,11837,163,5,3
26878,2014/03/31,2010/11/20,25,10,0.7524971840000001,11541,25,0,10
26879,2014/03/31,2012/07/26,519,7,0.662414188,13110,519,7,0
26880,2014/03/31,2007/09/20,164,9,0.536416085,16189,164,4,5
26881,2014/03/31,2012/01/23,379,8,0.40625,21376,379,8,0
26882,2014/03/31,2008/08/26,326,7,0.849921699,10217,326,6,1
26883,2014/03/31,2010/10/25,3,15,0.896461904,9686,3,9,6
26884,2014/03/31,2010/04/06,30,14,0.817142857,10626,30,6,8
26885,2014/03/31,2006/07/26,67,4,1.117914253,7767,67,1,3
26886,2014/03/31,2008/11/05,486,12,0.862738474,10064,486,12,0
26887,2014/03/31,2005/11/08,233,8,0.789159244,11002,233,7,1
26888,2014/03/31,2012/06/19,3,11,0.650367818,13349,3,1,10
26889,2014/03/31,2012/04/27,311,8,0.726712157,11944,311,3,5
26890,2014/03/31,2008/04/26,70,11,0.652460347,13303,70,6,5
26891,2014/03/31,2010/03/24,42,13,0.6658727839999999,13033,42,5,8
26892,2014/03/31,2011/09/18,285,15,0.8832685259999999,9824,285,13,2
26893,2014/03/31,2011/02/24,16,7,0.916561741,9467,16,3,4
26894,2014/03/31,2006/03/14,2,10,0.849483062,10214,2,5,5
26895,2014/03/31,2012/07/19,133,7,0.643656799,13479,133,5,2
26896,2014/03/31,2013/01/01,93,5,0.632744512,13711,93,0,5
26897,2014/03/31,2011/04/03,46,10,0.763482355,11363,46,5,5
26898,2014/03/31,2008/10/30,160,7,0.887417144,9776,160,1,6
26899,2014/03/31,2011/11/15,181,10,0.68203711,12719,181,6,4
26900,2014/03/31,2012/08/05,6,21,0.531768528,16313,6,7,14
26901,2014/03/31,2012/09/04,1,9,0.587668857,14761,1,2,7
26902,2014/03/31,2011/12/02,114,11,0.90031863,9635,114,9,2
26903,2014/03/31,2008/08/04,1,8,0.7389181359999999,11739,1,0,8
26904,2014/03/31,2007/05/18,3,15,0.638603401,13583,3,3,12
26905,2014/03/31,2011/04/14,24,14,0.649009353,13365,24,8,6
26906,2014/03/31,2006/04/17,348,12,0.675627045,12838,348,11,1
26907,2014/03/31,2007/06/27,10,12,0.474229234,18287,10,10,2
26908,2014/03/31,2010/07/27,34,8,0.82875,10464,34,4,4
26909,2014/03/31,2012/05/08,77,8,0.42898788,20215,77,4,4
26910,2014/03/31,2007/06/06,165,6,0.967830357,8960,165,4,2
26911,2014/03/31,2010/12/06,553,7,0.782298809,11084,553,7,0
26912,2014/03/31,2008/02/06,221,9,0.767472119,11298,221,6,3
26913,2014/03/31,2007/12/18,115,8,0.555814744,15600,115,3,5
26914,2014/03/31,2012/10/12,20,5,0.518111144,16735,20,3,2
26915,2014/03/31,2008/02/28,44,9,0.672705408,12889,44,5,4
26916,2014/03/31,2010/08/17,404,8,0.55088639,15738,404,8,0
26917,2014/03/31,2009/08/21,32,7,0.813023539,10663,32,5,2
26918,2014/03/31,2012/10/23,65,12,0.688683458,12586,65,7,5
26919,2014/03/31,2012/06/15,143,8,0.709944303,12209,143,4,4
26920,2014/03/31,2013/01/04,12,10,0.554434849,15633,12,4,6
26921,2014/03/31,2010/03/23,42,12,0.581116326,14915,42,7,5
26922,2014/03/31,2008/09/15,25,4,0.960691719,9021,25,3,1
26923,2014/03/31,2011/05/24,79,17,0.6317875629999999,13717,79,12,5
26924,2014/03/31,2009/02/21,280,5,0.6522482310000001,13286,280,4,1
26925,2014/03/31,2012/06/21,34,11,0.711532145,12179,34,7,4
26926,2014/03/31,2006/08/29,76,10,0.630050894,13754,76,0,10
26927,2014/03/31,2010/12/03,123,10,0.666898569,12994,123,7,3
26928,2014/03/31,2008/11/17,451,3,0.800545085,10824,451,3,0
26929,2014/03/31,2005/01/12,96,11,0.585327299,14803,96,6,5
26930,2014/03/31,2011/08/15,97,9,0.74612556,11612,97,5,4
26931,2014/03/31,2012/09/13,4,12,0.685470369,12639,4,7,5
26932,2014/03/31,2009/06/30,71,7,0.880342445,9841,71,4,3
26933,2014/03/31,2012/04/27,18,10,0.571791961,15151,18,2,8
26934,2014/03/31,2011/03/30,2,25,0.660400976,13118,2,5,20
26935,2014/03/31,2012/10/24,15,6,0.710500287,12193,15,3,3
26936,2014/03/31,2011/12/29,376,7,0.727104843,11913,376,7,0
26937,2014/03/31,2013/03/02,34,11,0.670313419,12922,34,2,9
26938,2014/03/31,2005/12/20,2,8,0.611608643,14161,2,4,4
26939,2014/03/31,2010/03/12,10,8,0.913475372,9481,10,3,5
26940,2014/03/31,2010/03/02,120,9,0.8613994429999999,10054,120,4,5
26941,2014/03/31,2006/04/26,35,5,0.8689464179999999,9966,35,0,5
26942,2014/03/31,2009/09/10,218,6,0.7484141390000001,11571,218,5,1
26943,2014/03/31,2005/01/15,51,15,0.561991044,15409,51,5,10
26944,2014/03/31,2013/01/08,49,8,0.77875,11120,49,2,6
26945,2014/03/31,2012/11/06,4,15,0.602152145,14381,4,2,13
26946,2014/03/31,2012/05/18,191,6,0.547550427,15815,191,4,2
26947,2014/03/31,2012/11/17,254,6,0.659462341,13131,254,4,2
26948,2014/03/31,2008/03/27,19,10,0.872917339,9920,19,6,4
26949,2014/03/31,2011/09/22,193,11,0.762194735,11359,193,9,2
26950,2014/03/31,2007/11/04,3,10,0.482135101,17957,3,5,5
26951,2014/03/31,2011/09/16,11,7,0.669294163,12935,11,1,6
26952,2014/03/31,2010/06/23,26,14,0.696583521,12428,26,4,10
26953,2014/03/31,2008/09/26,30,12,0.585687415,14780,30,6,6
26954,2014/03/31,2011/04/10,482,10,0.917272438,9437,482,10,0
26955,2014/03/31,2007/01/08,19,10,0.64919373,13333,19,8,2
26956,2014/03/31,2008/04/17,106,7,0.8533869059999999,10142,106,2,5
26957,2014/03/31,2011/12/14,5,9,0.802430002,10786,5,4,5
26958,2014/03/31,2007/09/08,27,10,0.8004901959999999,10812,27,7,3
26959,2014/03/31,2006/06/06,107,2,1.41,6138,107,0,2
26960,2014/03/31,2006/04/13,51,8,0.617945734,14005,51,3,5
26961,2014/03/31,2012/01/20,2,8,0.8338851420000001,10378,2,4,4
26962,2014/03/31,2011/08/08,70,6,0.822134714,10526,70,4,2
26963,2014/03/31,2012/05/11,9,13,0.66401857,13032,9,7,6
26964,2014/03/31,2011/05/23,102,7,0.8667337740000001,9984,102,3,4
26965,2014/03/31,2006/12/25,136,5,0.534217805,16198,136,4,1
26966,2014/03/31,2011/04/25,120,7,0.935765113,9247,120,5,2
26967,2014/03/31,2010/06/28,412,8,0.716240377,12081,412,8,0
26968,2014/03/31,2012/05/17,86,10,0.819074127,10563,86,6,4
26969,2014/03/31,2006/12/02,37,9,0.7341374629999999,11785,37,0,9
26970,2014/03/31,2012/05/02,476,7,0.636482013,13593,476,7,0
26971,2014/03/31,2008/06/06,76,6,0.774200447,11175,76,4,2
26972,2014/03/31,2010/09/22,168,9,0.830043174,10423,168,5,4
26973,2014/03/31,2011/07/09,105,16,0.652288321,13263,105,9,7
26974,2014/03/31,2013/03/31,44,12,0.686239886,12606,44,0,12
26975,2014/03/31,2011/06/08,154,12,0.7110933,12165,154,2,10
26976,2014/03/31,2011/02/17,124,13,0.787610853,10983,124,8,5
26977,2014/03/31,2007/07/25,105,18,0.641044168,13494,105,11,7
26978,2014/03/31,2010/03/18,381,12,0.720611514,12003,381,12,0
26979,2014/03/31,2012/07/10,33,7,0.770464101,11226,33,0,7
26980,2014/03/31,2009/08/21,2,9,0.743699054,11630,2,6,3
26981,2014/03/31,2012/08/30,41,7,0.897869822,9633,41,4,3
26982,2014/03/31,2011/03/03,5,10,0.785499955,11011,5,3,7
26983,2014/03/31,2011/12/12,89,13,0.8125314790000001,10642,89,5,8
26984,2014/03/31,2006/01/18,29,13,0.502263855,17214,29,6,7
26985,2014/03/31,2012/04/23,20,13,0.963846154,8970,20,12,1
26986,2014/03/31,2012/01/07,180,5,0.669391311,12913,180,3,2
26987,2014/03/31,2010/03/28,125,6,0.8036755,10755,125,3,3
26988,2014/03/31,2010/03/21,556,2,1.5,5762,556,2,0
26989,2014/03/31,2009/11/05,159,7,0.867731928,9960,159,2,5
26990,2014/03/31,2013/02/01,69,12,0.668583475,12926,69,0,12
26991,2014/03/31,2011/04/18,372,7,0.7527131779999999,11481,372,7,0
26992,2014/03/31,2011/07/24,4,6,1.236805496,6987,4,3,3
26993,2014/03/31,2011/08/24,47,12,0.507077049,17041,47,7,5
26994,2014/03/31,2008/05/22,56,10,0.8454491190000001,10220,56,7,3
26995,2014/03/31,2007/06/27,71,5,0.786920765,10980,71,3,2
26996,2014/03/31,2011/06/24,24,8,0.6554517870000001,13181,24,7,1
26997,2014/03/31,2005/02/09,294,8,0.593771134,14550,294,3,5
26998,2014/03/31,2011/07/09,195,8,0.661616757,13057,195,3,5
26999,2014/03/31,2010/10/12,132,12,0.636674528,13568,132,6,6
27000,2014/03/31,2011/10/25,150,6,0.679539805,12712,150,4,2
27001,2014/03/31,2008/10/04,186,10,0.717425249,12040,186,9,1
27002,2014/03/31,2010/08/18,183,5,0.60341322,14312,183,3,2
27003,2014/03/31,2011/04/13,125,8,0.623827482,13842,125,1,7
27004,2014/03/31,2013/01/17,7,7,0.6952170059999999,12419,7,3,4
27005,2014/03/31,2012/07/24,113,11,0.6481112529999999,13321,113,2,9
27006,2014/03/31,2010/10/17,95,6,0.65680843,13144,95,4,2
27007,2014/03/31,2010/02/22,4,19,0.585054215,14756,4,7,12
27008,2014/03/31,2007/11/18,11,8,0.7914228090000001,10908,11,2,6
27009,2014/03/31,2005/04/08,23,12,0.55,15696,23,1,11
27010,2014/03/31,2010/08/09,124,9,0.6910599629999999,12491,124,4,5
27011,2014/03/31,2009/11/26,86,9,0.8365015990000001,10319,86,4,5
27012,2014/03/31,2012/12/29,2,7,0.790519278,10919,2,2,5
27013,2014/03/31,2012/11/01,114,6,0.903479899,9552,114,2,4
27014,2014/03/31,2005/10/27,78,12,0.7452012090000001,11580,78,7,5
27015,2014/03/31,2008/03/06,23,11,0.7568441359999999,11401,23,2,9
27016,2014/03/31,2011/08/27,429,8,0.8164537190000001,10566,429,8,0
27017,2014/03/31,2012/12/06,6,8,0.6197736739999999,13918,6,1,7
27018,2014/03/31,2011/05/07,604,2,0.7085427959999999,12174,604,2,0
27019,2014/03/31,2005/11/25,37,3,1.41,6117,37,0,3
27020,2014/03/31,2007/02/09,250,9,0.62937313,13703,250,5,4
27021,2014/03/31,2012/08/23,89,14,0.532180326,16204,89,7,7
27022,2014/03/31,2008/08/11,175,6,0.893894475,9647,175,3,3
27023,2014/03/31,2010/03/25,514,9,0.647802569,13311,514,9,0
27024,2014/03/31,2012/03/29,401,10,0.8525706940000001,10114,401,10,0
27025,2014/03/31,2010/08/20,11,7,0.868793955,9925,11,2,5
27026,2014/03/31,2007/01/08,158,9,0.701483078,12292,158,5,4
27027,2014/03/31,2012/01/18,84,14,0.687372449,12544,84,3,11
27028,2014/03/31,2006/04/04,83,9,0.595170843,14487,83,4,5
27029,2014/03/31,2011/07/19,308,8,0.7599779640000001,11345,308,4,4
27030,2014/03/31,2011/12/16,274,8,0.532718117,16184,274,7,1
27031,2014/03/31,2012/12/28,67,6,0.74716762,11538,67,3,3
27032,2014/03/31,2012/08/22,213,5,0.768183033,11222,213,3,2
27033,2014/03/31,2007/07/31,6,6,0.770677693,11185,6,1,5
27034,2014/03/31,2007/03/31,194,12,0.763354587,11292,194,5,7
27035,2014/03/31,2011/04/15,24,9,0.7550560620000001,11416,24,3,6
27036,2014/03/31,2008/12/06,67,7,0.7678610240000001,11225,67,3,4
27037,2014/03/31,2008/06/12,156,10,0.603820233,14274,156,5,5
27038,2014/03/31,2011/01/21,70,12,0.731361168,11784,70,8,4
27039,2014/03/31,2012/04/30,339,9,0.5170826829999999,16666,339,8,1
27040,2014/03/31,2007/05/23,202,11,0.602184486,14310,202,4,7
27041,2014/03/31,2008/01/29,59,8,0.733230088,11752,59,5,3
27042,2014/03/31,2009/01/29,86,9,0.671658742,12829,86,5,4
27043,2014/03/31,2008/04/02,67,16,0.612412225,14070,67,10,6
27044,2014/03/31,2006/04/16,226,6,0.775774737,11107,226,3,3
27045,2014/03/31,2012/11/27,90,8,0.68794491,12525,90,4,4
27046,2014/03/31,2012/03/22,363,11,0.609062633,14146,363,9,2
27047,2014/03/31,2009/03/27,202,10,0.6359563,13547,202,6,4
27048,2014/03/31,2009/10/25,22,11,0.747762347,11521,22,4,7
27049,2014/03/31,2010/01/13,24,12,0.74834173,11512,24,6,6
27050,2014/03/31,2008/12/27,157,6,0.660510658,13042,157,5,1
27051,2014/03/31,2005/08/21,42,11,0.502757675,17134,42,5,6
27052,2014/03/31,2011/05/02,75,7,0.610928435,14099,75,5,2
27053,2014/03/31,2009/07/18,606,6,0.697328368,12352,606,6,0
27054,2014/03/31,2007/08/28,175,6,0.850003947,10133,175,3,3
27055,2014/03/31,2012/04/15,37,16,0.829375,10384,37,6,10
27056,2014/03/31,2010/06/15,259,11,0.53059639,16231,259,8,3
27057,2014/03/31,2012/09/14,141,6,0.8115730440000001,10610,141,3,3
27058,2014/03/31,2011/01/24,80,9,0.958010681,8988,80,4,5
27059,2014/03/31,2013/03/26,188,4,0.560546875,15360,188,0,4
27060,2014/03/31,2012/04/27,252,9,0.695537243,12378,252,4,5
27061,2014/03/31,2005/12/19,21,8,0.572458275,15039,21,7,1
27062,2014/03/31,2009/11/04,19,13,0.76422814,11265,19,4,9
27063,2014/03/31,2012/09/02,36,13,0.895021834,9618,36,7,6
27064,2014/03/31,2005/09/12,32,9,0.6047965989999999,14233,32,6,3
27065,2014/03/31,2011/11/06,35,8,0.616297702,13967,35,4,4
27066,2014/03/31,2006/09/04,85,14,0.5995736970000001,14356,85,1,13
27067,2014/03/31,2008/10/01,127,9,0.556309462,15472,127,3,6
27068,2014/03/31,2012/06/19,502,6,0.916244411,9394,502,6,0
27069,2014/03/31,2008/02/17,528,9,0.783500228,10985,528,9,0
27070,2014/03/31,2011/09/01,80,12,0.74749848,11513,80,1,11
27071,2014/03/31,2007/12/30,120,7,0.733340152,11733,120,3,4
27072,2014/03/31,2008/08/05,4,9,0.586228793,14677,4,3,6
27073,2014/03/31,2011/10/31,21,7,0.7361036959999999,11688,21,3,4
27074,2014/03/31,2012/11/29,309,2,1.175,7322,309,1,1
27075,2014/03/31,2008/07/26,205,11,0.7191932790000001,11962,205,6,5
27076,2014/03/31,2012/10/30,2,8,0.703482705,12229,2,2,6
27077,2014/03/31,2010/05/08,70,9,0.747419635,11510,70,8,1
27078,2014/03/31,2006/12/26,169,2,0.983513205,8747,169,1,1
27079,2014/03/31,2012/10/18,229,9,0.472799824,18194,229,4,5
27080,2014/03/31,2012/06/20,109,8,0.674196254,12759,109,3,5
27081,2014/03/31,2007/03/11,499,4,0.8410246379999999,10228,499,4,0
27082,2014/03/31,2012/03/13,77,8,0.759964658,11318,77,1,7
27083,2014/03/31,2012/11/19,5,13,0.497521981,17288,5,3,10
27084,2014/03/31,2010/05/18,34,8,0.6137839,14012,34,4,4
27085,2014/03/31,2007/11/02,71,13,0.786545637,10934,71,5,8
27086,2014/03/31,2009/04/09,4,17,0.6183137989999999,13907,4,7,10
27087,2014/03/31,2011/12/15,131,8,0.730847501,11764,131,7,1
27088,2014/03/31,2010/04/05,42,10,0.8311620259999999,10344,42,3,7
27089,2014/03/31,2013/01/27,15,8,0.6933940959999999,12398,15,3,5
27090,2014/03/31,2012/12/14,122,7,0.816761995,10525,122,2,5
27091,2014/03/31,2012/03/15,97,6,0.747894554,11494,97,4,2
27092,2014/03/31,2006/03/29,139,8,0.663128905,12963,139,2,6
27093,2014/03/31,2010/07/22,89,8,0.700232179,12275,89,5,3
27094,2014/03/31,2005/06/11,93,14,0.713352975,12049,93,9,5
27095,2014/03/31,2010/04/07,24,11,0.511846823,16791,24,8,3
27096,2014/03/31,2011/07/07,20,16,0.500224098,17180,20,10,6
27097,2014/03/31,2011/04/23,37,11,0.431982906,19890,37,6,5
27098,2014/03/31,2005/09/17,243,12,0.500227643,17176,243,8,4
27099,2014/03/31,2008/05/15,25,10,0.502127287,17111,25,3,7
27100,2014/03/31,2013/01/27,25,8,0.753913463,11394,25,0,8
27101,2014/03/31,2013/01/28,72,10,0.6888516440000001,12470,72,3,7
27102,2014/03/31,2011/01/11,266,8,0.894131363,9607,266,4,4
27103,2014/03/31,2007/07/04,242,7,0.860873923,9978,242,3,4
27104,2014/03/31,2009/10/27,144,9,0.654439619,13125,144,6,3
27105,2014/03/31,2013/03/05,247,5,0.8342797470000001,10295,247,2,3
27106,2014/03/31,2008/06/18,150,6,0.706265932,12161,150,5,1
27107,2014/03/31,2010/03/30,188,8,0.7431634509999999,11557,188,4,4
27108,2014/03/31,2010/10/18,159,11,0.74684087,11500,159,8,3
27109,2014/03/31,2009/11/09,319,9,0.584921338,14683,319,6,3
27110,2014/03/31,2008/12/14,64,9,0.802498598,10702,64,6,3
27111,2014/03/31,2007/05/29,3,10,0.779530683,11016,3,6,4
27112,2014/03/31,2011/12/24,597,6,0.890331778,9645,597,6,0
27113,2014/03/31,2011/10/12,7,10,0.572819025,14991,7,6,4
27114,2014/03/31,2011/10/11,30,10,0.538728744,15937,30,3,7
27115,2014/03/31,2012/01/09,409,7,0.836721567,10261,409,7,0
27116,2014/03/31,2011/09/24,367,10,0.685646965,12520,367,10,0
27117,2014/03/31,2013/02/06,33,14,0.5611905070000001,15296,33,3,11
27118,2014/03/31,2012/10/23,148,7,0.7485714290000001,11466,148,4,3
27119,2014/03/31,2010/05/04,151,8,0.5710453120000001,15029,151,2,6
27120,2014/03/31,2005/06/06,57,15,0.7192925990000001,11931,57,10,5
27121,2014/03/31,2010/08/25,1,14,0.734198323,11688,1,4,10
27122,2014/03/31,2007/05/10,21,8,0.852333135,10068,21,4,4
27123,2014/03/31,2012/12/02,6,10,0.719760926,11921,6,7,3
27124,2014/03/31,2007/06/21,43,11,0.794405556,10800,43,6,5
27125,2014/03/31,2009/03/05,307,13,0.8146031140000001,10532,307,11,2
27126,2014/03/31,2013/03/09,23,5,0.8522640570000001,10066,23,1,4
27127,2014/03/31,2008/12/17,174,10,0.671787421,12767,174,5,5
27128,2014/03/31,2010/11/26,17,8,0.787960309,10884,17,0,8
27129,2014/03/31,2010/05/19,170,10,0.436,19670,170,6,4
27130,2014/03/31,2011/12/25,400,12,0.558842695,15346,400,12,0
27131,2014/03/31,2011/12/19,171,8,0.826713583,10373,171,5,3
27132,2014/03/31,2008/01/17,46,4,0.7440905940000001,11524,46,2,2
27133,2014/03/31,2009/12/10,4,12,0.631292151,13582,4,10,2
27134,2014/03/31,2009/03/02,193,9,0.819601377,10461,193,5,4
27135,2014/03/31,2008/04/15,64,12,0.8619362620000001,9947,64,4,8
27136,2014/03/31,2010/01/06,4,11,0.7130375109999999,12023,4,0,11
27137,2014/03/31,2007/07/18,270,14,0.914805763,9370,270,11,3
27138,2014/03/31,2012/03/11,360,9,0.695956479,12316,360,7,2
27139,2014/03/31,2007/09/28,26,10,0.597334309,14349,26,8,2
27140,2014/03/31,2008/11/29,165,11,0.8197924440000001,10455,165,5,6
27141,2014/03/31,2006/08/13,40,9,0.685612351,12501,40,5,4
27142,2014/03/31,2012/07/13,62,11,0.8464592590000001,10125,62,8,3
27143,2014/03/31,2013/03/26,132,5,0.657385902,13037,132,1,4
27144,2014/03/31,2008/05/23,18,11,0.571831954,14984,18,3,8
27145,2014/03/31,2008/11/27,100,8,0.8619959759999999,9940,100,6,2
27146,2014/03/31,2013/01/04,114,6,0.794860377,10779,114,3,3
27147,2014/03/31,2011/06/05,555,8,0.8166428370000001,10491,555,8,0
27148,2014/03/31,2005/07/22,334,5,0.83924373,10208,334,4,1
27149,2014/03/31,2013/01/09,94,14,0.7891295140000001,10856,94,3,11
27150,2014/03/31,2007/04/01,133,9,0.817342811,10481,133,8,1
27151,2014/03/31,2010/06/25,99,13,0.6113640260000001,14010,99,7,6
27152,2014/03/31,2009/11/27,18,15,0.742142795,11541,18,3,12
27153,2014/03/31,2011/04/14,5,10,0.918,9330,5,3,7
27154,2014/03/31,2013/02/08,72,6,0.642014993,13340,72,1,5
27155,2014/03/31,2011/08/15,47,4,1.272485884,6730,47,0,4
27156,2014/03/31,2013/01/17,330,6,0.8238839720000001,10394,330,2,4
27157,2014/03/31,2007/09/06,306,8,0.7647789190000001,11195,306,7,1
27158,2014/03/31,2012/05/08,313,9,0.567034241,15099,313,7,2
27159,2014/03/31,2010/12/23,107,11,0.620532725,13797,107,4,7
27160,2014/03/31,2012/01/21,558,3,0.899264706,9520,558,3,0
27161,2014/03/31,2008/10/08,68,9,0.723228014,11837,68,7,2
27162,2014/03/31,2005/05/02,4,6,0.8918199809999999,9599,4,0,6
27163,2014/03/31,2012/11/23,140,10,0.587925137,14560,140,2,8
27164,2014/03/31,2008/06/07,148,7,0.554663384,15433,148,5,2
27165,2014/03/31,2010/02/25,104,11,0.7818156909999999,10949,104,5,6
27166,2014/03/31,2009/12/20,77,14,0.745171933,11487,77,8,6
27167,2014/03/31,2008/07/25,309,8,0.682196094,12545,309,6,2
27168,2014/03/31,2007/11/18,117,8,0.771695221,11090,117,1,7
27169,2014/03/31,2011/11/09,61,7,0.787720913,10864,61,2,5
27170,2014/03/31,2010/11/17,27,10,0.73145568,11699,27,2,8
27171,2014/03/31,2005/10/15,3,13,0.8794048720000001,9729,3,2,11
27172,2014/03/31,2009/12/04,559,8,0.812421652,10530,559,8,0
27173,2014/03/31,2009/04/21,68,5,0.709364737,12058,68,0,5
27174,2014/03/31,2011/09/14,6,11,0.655514678,13047,6,6,5
27175,2014/03/31,2011/01/16,211,6,0.8728848509999999,9796,211,3,3
27176,2014/03/31,2012/08/09,10,12,0.7208489290000001,11862,10,5,7
27177,2014/03/31,2005/10/25,11,14,0.621425976,13759,11,5,9
27178,2014/03/31,2009/03/17,61,6,0.546287138,15651,61,4,2
27179,2014/03/31,2010/03/12,8,11,0.449648154,19014,8,0,11
27180,2014/03/31,2008/10/24,3,12,0.525896284,16256,3,3,9
27181,2014/03/31,2006/07/05,4,11,0.518035996,16502,4,5,6
27182,2014/03/31,2010/06/15,17,12,0.856749524,9977,17,2,10
27183,2014/03/31,2008/08/12,372,4,0.725606961,11780,372,4,0
27184,2014/03/31,2009/11/11,160,9,0.839642436,10180,160,6,3
27185,2014/03/31,2012/04/26,120,14,0.7621428570000001,11214,120,4,10
27186,2014/03/31,2006/05/19,11,6,0.554959735,15398,11,5,1
27187,2014/03/31,2010/04/05,319,8,0.743258525,11496,319,6,2
27188,2014/03/31,2010/10/25,262,9,0.741770987,11519,262,7,2
27189,2014/03/31,2012/07/17,95,9,0.6291354929999999,13580,95,6,3
27190,2014/03/31,2012/01/09,265,11,0.616859474,13848,265,4,7
27191,2014/03/31,2013/01/31,69,12,0.567580066,15050,69,3,9
27192,2014/03/31,2013/03/05,47,13,0.502307692,17004,47,0,13
27193,2014/03/31,2007/11/25,124,10,0.554846359,15393,124,6,4
27194,2014/03/31,2012/05/06,25,9,0.7734776309999999,11042,25,1,8
27195,2014/03/31,2008/06/06,56,6,0.658752025,12965,56,2,4
27196,2014/03/31,2013/01/04,28,10,0.688156474,12411,28,1,9
27197,2014/03/31,2008/01/17,18,15,0.50943215,16765,18,6,9
27198,2014/03/31,2009/12/31,69,10,0.478652693,17843,69,1,9
27199,2014/03/31,2013/03/20,135,4,1.4633276219999998,5836,135,1,3
27200,2014/03/31,2011/11/10,80,6,0.700336231,12194,80,4,2
27201,2014/03/31,2012/02/07,175,13,0.617776894,13823,175,9,4
27202,2014/03/31,2011/04/19,112,11,0.744182135,11475,112,3,8
27203,2014/03/31,2013/02/01,30,18,0.821246513,10397,30,5,13
27204,2014/03/31,2009/03/12,498,8,0.70699793,12075,498,8,0
27205,2014/03/31,2007/10/22,11,15,0.660884106,12917,11,4,11
27206,2014/03/31,2005/10/22,89,9,0.3895696420000001,21912,89,6,3
27207,2014/03/31,2010/06/10,173,10,0.533879645,15986,173,6,4
27208,2014/03/31,2005/04/18,114,12,0.7084401459999999,12046,114,7,5
27209,2014/03/31,2009/09/10,216,8,0.6340575079999999,13459,216,5,3
27210,2014/03/31,2011/12/06,9,7,0.753253597,11329,9,2,5
27211,2014/03/31,2006/07/17,243,5,1.062003734,8035,243,2,3
27212,2014/03/31,2010/08/09,252,11,0.6563479729999999,13001,252,8,3
27213,2014/03/31,2007/05/22,91,11,0.552167864,15453,91,7,4
27214,2014/03/31,2008/07/16,12,10,0.53867298,15840,12,5,5
27215,2014/03/31,2007/06/20,109,8,0.6973641190000001,12235,109,4,4
27216,2014/03/31,2006/10/01,219,12,0.7276639659999999,11725,219,8,4
27217,2014/03/31,2012/07/10,157,14,0.73715483,11574,157,9,5
27218,2014/03/31,2012/07/17,56,8,0.7846964679999999,10872,56,2,6
27219,2014/03/31,2007/03/19,264,6,0.813695155,10484,264,4,2
27220,2014/03/31,2012/06/13,280,10,0.572589609,14898,280,4,6
27221,2014/03/31,2012/03/11,12,4,1.446885496,5895,12,2,2
27222,2014/03/31,2006/08/10,41,7,0.549304437,15527,41,5,2
27223,2014/03/31,2005/07/12,26,6,0.850635348,10026,26,5,1
27224,2014/03/31,2010/05/23,170,9,0.738201177,11552,170,5,4
27225,2014/03/31,2011/05/16,215,10,0.635727598,13414,215,5,5
27226,2014/03/31,2013/02/18,11,11,0.60927122,13996,11,4,7
27227,2014/03/31,2011/01/03,232,10,0.593102177,14377,232,8,2
27228,2014/03/31,2007/08/11,26,7,0.7255194420000001,11753,26,1,6
27229,2014/03/31,2010/06/02,105,6,0.799008528,10671,105,2,4
27230,2014/03/31,2010/05/12,130,12,0.5874266229999999,14514,130,6,6
27231,2014/03/31,2006/07/06,201,7,1.103629773,7725,201,3,4
27232,2014/03/31,2010/12/17,432,6,1.229137832,6936,432,6,0
27233,2014/03/31,2012/12/15,60,13,0.479283666,17785,60,2,11
27234,2014/03/31,2012/06/15,363,7,0.6820877009999999,12497,363,6,1
27235,2014/03/31,2010/06/10,19,9,0.672422689,12676,19,6,3
27236,2014/03/31,2011/10/05,576,9,0.8096237890000001,10526,576,9,0
27237,2014/03/31,2011/11/23,108,11,0.7673401759999999,11106,108,8,3
27238,2014/03/31,2008/06/09,70,12,0.7321219929999999,11640,70,6,6
27239,2014/03/31,2012/06/16,12,6,0.812257173,10491,12,2,4
27240,2014/03/31,2011/02/01,37,6,0.82432137,10337,37,5,1
27241,2014/03/31,2012/04/09,252,9,0.892500262,9547,252,6,3
27242,2014/03/31,2008/09/10,64,7,0.845007438,10083,64,3,4
27243,2014/03/31,2009/12/08,317,9,0.534928109,15927,317,6,3
27244,2014/03/31,2009/11/01,162,7,0.7692684909999999,11073,162,5,2
27245,2014/03/31,2012/04/13,31,13,0.681983187,12490,31,8,5
27246,2014/03/31,2012/02/10,222,11,0.6724125679999999,12667,222,8,3
27247,2014/03/31,2007/10/12,70,6,0.8063353209999999,10563,70,2,4
27248,2014/03/31,2006/11/26,60,7,0.618571429,13769,60,3,4
27249,2014/03/31,2013/03/28,18,8,0.640159351,13304,18,0,8
27250,2014/03/31,2011/08/31,39,11,0.872026418,9766,39,7,4
27251,2014/03/31,2008/08/26,152,9,0.7037567140000001,12101,152,8,1
27252,2014/03/31,2011/07/22,249,9,0.945947567,9002,249,6,3
27253,2014/03/31,2010/11/10,43,6,0.665,12804,43,2,4
27254,2014/03/31,2010/12/03,6,12,0.764957772,11130,6,8,4
27255,2014/03/31,2012/12/15,168,8,0.7364391379999999,11559,168,4,4
27256,2014/03/31,2009/10/02,408,7,0.8066189709999999,10553,408,7,0
27257,2014/03/31,2010/01/06,29,6,0.690715735,12323,29,2,4
27258,2014/03/31,2012/11/10,25,8,0.833065479,10217,25,2,6
27259,2014/03/31,2012/12/26,95,7,0.733984995,11596,95,0,7
27260,2014/03/31,2012/03/23,26,12,0.7063573740000001,12049,26,9,3
27261,2014/03/31,2008/06/21,8,4,1.200338505,7090,8,0,4
27262,2014/03/31,2008/12/26,109,5,0.6965556190000001,12217,109,1,4
27263,2014/03/31,2009/12/27,5,8,0.703224527,12101,5,7,1
27264,2014/03/31,2010/09/18,94,7,0.7793451779999999,10919,94,6,1
27265,2014/03/31,2006/07/17,138,8,0.839199211,10140,138,2,6
27266,2014/03/31,2012/03/19,34,10,0.7764668309999999,10959,34,7,3
27267,2014/03/31,2012/02/09,91,4,0.697590589,12198,91,0,4
27268,2014/03/31,2011/08/19,306,10,0.548366308,15517,306,9,1
27269,2014/03/31,2011/12/09,3,7,0.8383162559999999,10150,3,4,3
27270,2014/03/31,2012/12/13,15,13,0.743497029,11444,15,1,12
27271,2014/03/31,2009/11/04,7,5,1.09667569,7758,7,1,4
27272,2014/03/31,2009/09/22,148,6,0.533748432,15940,148,2,4
27273,2014/03/31,2011/12/13,126,13,0.7621535429999999,11163,126,4,9
27274,2014/03/31,2009/07/25,343,14,0.8428571429999999,10094,343,10,4
27275,2014/03/31,2009/07/22,183,7,0.839750271,10131,183,5,2
27276,2014/03/31,2011/02/01,100,5,0.817073288,10411,100,0,5
27277,2014/03/31,2011/12/12,82,15,0.7725247479999999,11011,82,2,13
27278,2014/03/31,2007/09/29,156,10,0.859121301,9901,156,2,8
27279,2014/03/31,2012/08/10,322,20,0.486966852,17467,322,19,1
27280,2014/03/31,2011/08/10,280,8,0.76560036,11110,280,6,2
27281,2014/03/31,2011/07/12,344,4,0.785600813,10827,344,3,1
27282,2014/03/31,2009/08/10,307,5,1.382989104,6149,307,2,3
27283,2014/03/31,2005/10/16,167,14,0.912239863,9322,167,6,8
27284,2014/03/31,2007/03/05,508,7,0.804584161,10569,508,7,0
27285,2014/03/31,2006/08/08,120,16,0.8569616040000001,9923,120,6,10
27286,2014/03/31,2008/10/20,11,9,0.594166725,14311,11,5,4
27287,2014/03/31,2006/10/16,491,8,0.493640058,17225,491,8,0
27288,2014/03/31,2011/02/14,170,6,0.701037184,12129,170,4,2
27289,2014/03/31,2009/01/01,451,10,0.4645386,18303,451,10,0
27290,2014/03/31,2009/12/02,144,13,0.563410868,15090,144,9,4
27291,2014/03/31,2005/07/15,284,9,0.615673836,13809,284,4,5
27292,2014/03/31,2013/03/20,9,10,0.638557158,13314,9,1,9
27293,2014/03/31,2009/12/10,4,8,0.80600493,10548,4,0,8
27294,2014/03/31,2012/10/03,154,9,0.466596048,18220,154,5,4
27295,2014/03/31,2005/08/02,74,14,0.793281075,10716,74,9,5
27296,2014/03/31,2008/05/14,402,5,1.276189761,6661,402,5,0
27297,2014/03/31,2010/09/22,34,10,0.520451234,16333,34,2,8
27298,2014/03/31,2008/03/23,98,9,0.7254788320000001,11716,98,3,6
27299,2014/03/31,2012/09/29,152,11,0.7995127459999999,10631,152,5,6
27300,2014/03/31,2008/04/24,504,9,0.5985668000000001,14199,504,9,0
27301,2014/03/31,2011/08/31,285,10,0.876172165,9700,285,7,3
27302,2014/03/31,2008/08/13,130,10,0.645491417,13166,130,1,9
27303,2014/03/31,2007/02/15,184,5,0.776781536,10940,184,2,3
27304,2014/03/31,2012/05/15,9,14,0.8059503029999999,10544,9,4,10
27305,2014/03/31,2010/12/29,2,12,0.633740025,13409,2,5,7
27306,2014/03/31,2010/12/13,63,8,0.7764309209999999,10944,63,4,4
27307,2014/03/31,2007/03/06,78,7,0.619268275,13721,78,4,3
27308,2014/03/31,2009/11/18,11,10,0.7059018029999999,12037,11,6,4
27309,2014/03/31,2008/08/28,110,9,0.75501244,11254,110,4,5
27310,2014/03/31,2008/10/30,31,13,0.5792555220000001,14668,31,4,9
27311,2014/03/31,2013/01/22,35,12,0.699892898,12138,35,2,10
27312,2014/03/31,2009/07/29,13,5,0.929335886,9140,13,2,3
27313,2014/03/31,2012/03/13,245,8,0.799176703,10628,245,6,2
27314,2014/03/31,2009/08/13,188,13,0.678719834,12514,188,11,2
27315,2014/03/31,2013/03/07,247,6,0.905791382,9376,247,2,4
27316,2014/03/31,2008/02/24,141,9,0.5976108370000001,14210,141,4,5
27317,2014/03/31,2012/06/18,39,12,0.8228207359999999,10320,39,8,4
27318,2014/03/31,2012/02/08,265,6,0.784273575,10827,265,5,1
27319,2014/03/31,2009/08/16,369,7,0.7672314090000001,11067,369,7,0
27320,2014/03/31,2009/10/13,155,5,0.80555408,10540,155,2,3
27321,2014/03/31,2007/04/01,47,10,0.742103837,11441,47,1,9
27322,2014/03/31,2009/09/23,58,8,0.837728439,10134,58,4,4
27323,2014/03/31,2013/01/30,16,7,0.696862584,12182,16,4,3
27324,2014/03/31,2008/01/10,223,10,0.746198136,11376,223,4,6
27325,2014/03/31,2009/05/22,70,11,0.832853218,10192,70,6,5
27326,2014/03/31,2008/08/20,42,13,0.946153846,8970,42,5,8
27327,2014/03/31,2008/09/24,231,10,0.84836649,10003,231,7,3
27328,2014/03/31,2010/08/06,74,8,0.7871370259999999,10779,74,4,4
27329,2014/03/31,2007/04/24,196,10,0.668680643,12688,196,7,3
27330,2014/03/31,2013/01/02,156,11,0.730771815,11609,156,3,8
27331,2014/03/31,2010/08/11,118,6,0.5767147229999999,14705,118,5,1
27332,2014/03/31,2012/11/02,401,3,0.908646737,9333,401,3,0
27333,2014/03/31,2008/03/08,119,10,0.657955921,12886,119,6,4
27334,2014/03/31,2012/04/26,377,6,0.785809621,10789,377,6,0
27335,2014/03/31,2009/08/16,37,10,0.658532702,12874,37,0,10
27336,2014/03/31,2012/10/25,13,12,0.7144613959999999,11864,13,9,3
27337,2014/03/31,2011/04/19,86,9,0.74033543,11448,86,6,3
27338,2014/03/31,2005/01/28,58,12,0.686208404,12351,58,6,6
27339,2014/03/31,2012/08/20,220,10,0.659,12860,220,3,7
27340,2014/03/31,2006/10/30,4,9,0.724694715,11694,4,5,4
27341,2014/03/31,2007/12/29,228,8,0.789298556,10735,228,4,4
27342,2014/03/31,2009/04/15,109,8,0.737271145,11492,109,5,3
27343,2014/03/31,2010/01/11,94,12,0.611222855,13861,94,2,10
27344,2014/03/31,2009/07/02,203,7,0.691709667,12248,203,4,3
27345,2014/03/31,2009/08/16,11,12,0.7732806940000001,10955,11,2,10
27346,2014/03/31,2010/12/09,128,6,0.97072771,8726,128,5,1
27347,2014/03/31,2013/01/01,44,12,0.676155504,12527,44,3,9
27348,2014/03/31,2009/07/30,139,8,0.7095727209999999,11936,139,2,6
27349,2014/03/31,2012/01/09,5,7,0.838822306,10096,5,3,4
27350,2014/03/31,2006/07/03,95,4,0.979412445,8646,95,3,1
27351,2014/03/31,2006/10/27,331,11,0.678789579,12475,331,6,5
27352,2014/03/31,2006/09/13,74,10,0.5068334729999999,16706,74,3,7
27353,2014/03/31,2012/10/18,64,7,0.897899873,9428,64,4,3
27354,2014/03/31,2007/07/27,281,7,0.7450607290000001,11362,281,6,1
27355,2014/03/31,2012/08/11,51,14,0.684768646,12362,51,5,9
27356,2014/03/31,2009/10/27,397,12,0.605501109,13979,397,12,0
27357,2014/03/31,2011/11/02,164,7,0.788121799,10739,164,2,5
27358,2014/03/31,2010/09/28,73,5,0.827726161,10225,73,4,1
27359,2014/03/31,2012/11/23,296,6,0.626669876,13504,296,5,1
27360,2014/03/31,2008/07/18,561,4,1.410333333,6000,561,4,0
27361,2014/03/31,2013/01/15,92,6,0.601109611,14077,92,2,4
27362,2014/03/31,2007/11/27,109,7,0.631613794,13397,109,2,5
27363,2014/03/31,2012/04/05,248,7,0.613828799,13785,248,2,5
27364,2014/03/31,2008/05/08,39,7,0.722467555,11712,39,1,6
27365,2014/03/31,2011/11/25,81,10,0.950626896,8901,81,3,7
27366,2014/03/31,2007/09/07,79,12,0.7358792829999999,11498,79,5,7
27367,2014/03/31,2012/08/09,38,10,0.541886128,15614,38,5,5
27368,2014/03/31,2012/04/13,313,5,1.0,8461,313,3,2
27369,2014/03/31,2006/04/02,7,12,0.548821774,15413,7,7,5
27370,2014/03/31,2008/11/12,588,4,0.8,10572,588,4,0
27371,2014/03/31,2013/03/25,109,8,0.986876313,8570,109,1,7
27372,2014/03/31,2012/11/25,65,10,0.64279091,13157,65,4,6
27373,2014/03/31,2005/09/15,100,7,0.582760474,14512,100,4,3
27374,2014/03/31,2010/05/23,104,10,0.548221603,15424,104,3,7
27375,2014/03/31,2010/12/16,200,7,0.595418632,14201,200,0,7
27376,2014/03/31,2008/11/19,179,9,0.891109823,9488,179,6,3
27377,2014/03/31,2006/04/20,29,8,0.7766844279999999,10885,29,5,3
27378,2014/03/31,2011/01/13,3,11,0.513190069,16473,3,0,11
27379,2014/03/31,2012/04/21,257,8,0.7309641159999999,11565,257,7,1
27380,2014/03/31,2012/11/29,144,8,0.824339347,10255,144,4,4
27381,2014/03/31,2011/09/30,191,4,1.0175,8308,191,3,1
27382,2014/03/31,2006/01/03,73,8,0.561396028,15057,73,0,8
27383,2014/03/31,2012/11/16,2,8,0.608156702,13899,2,4,4
27384,2014/03/31,2007/11/08,43,5,0.7227026329999999,11696,43,1,4
27385,2014/03/31,2009/08/29,5,13,0.879371619,9612,5,8,5
27386,2014/03/31,2007/06/02,116,12,0.665859461,12694,116,5,7
27387,2014/03/31,2011/08/22,156,5,0.760568703,11113,156,2,3
27388,2014/03/31,2007/09/22,52,9,0.496432305,17025,52,2,7
27389,2014/03/31,2009/07/04,15,14,0.577142857,14644,15,5,9
27390,2014/03/31,2006/04/09,112,15,0.5068443779999999,16675,112,10,5
27391,2014/03/31,2011/04/06,10,10,0.628494832,13447,10,5,5
27392,2014/03/31,2012/06/09,177,7,0.784106513,10778,177,3,4
27393,2014/03/31,2010/10/11,311,7,0.705472076,11979,311,6,1
27394,2014/03/31,2013/03/25,93,3,0.770298113,10969,93,1,2
27395,2014/03/31,2007/03/13,151,10,0.761369863,11096,151,2,8
27396,2014/03/31,2011/02/04,196,13,0.7535340290000001,11211,196,5,8
27397,2014/03/31,2009/03/04,263,10,0.683689705,12356,263,7,3
27398,2014/03/31,2011/10/15,5,10,0.546140169,15467,5,3,7
27399,2014/03/31,2011/05/15,190,7,0.426835616,19789,190,0,7
27400,2014/03/31,2011/12/16,277,8,0.842638667,10024,277,6,2
27401,2014/03/31,2012/10/19,112,10,0.6818090090000001,12388,112,4,6
27402,2014/03/31,2011/03/14,16,9,0.768217209,10994,16,3,6
27403,2014/03/31,2012/08/18,56,8,0.648456695,13024,56,4,4
27404,2014/03/31,2012/10/28,84,10,0.726027338,11632,84,3,7
27405,2014/03/31,2011/11/03,114,10,0.6916751309999999,12208,114,4,6
27406,2014/03/31,2012/04/15,516,5,0.7227210479999999,11683,516,5,0
27407,2014/03/31,2011/04/23,23,9,0.943283432,8951,23,8,1
27408,2014/03/31,2011/07/09,45,12,0.652358578,12940,45,3,9
27409,2014/03/31,2009/09/09,363,15,0.585835242,14409,363,14,1
27410,2014/03/31,2013/01/29,85,7,0.670419347,12591,85,2,5
27411,2014/03/31,2011/03/24,118,10,0.767310245,11001,118,5,5
27412,2014/03/31,2007/07/02,14,8,0.659401563,12800,14,1,7
27413,2014/03/31,2010/11/29,121,4,0.7505139609999999,11246,121,2,2
27414,2014/03/31,2007/02/01,113,7,0.402715908,20958,113,4,3
27415,2014/03/31,2013/03/03,133,8,0.726765694,11613,133,1,7
27416,2014/03/31,2011/07/29,309,9,0.630879055,13378,309,5,4
27417,2014/03/31,2012/06/15,391,7,0.626706022,13467,391,7,0
27418,2014/03/31,2012/10/16,211,7,0.531806553,15870,211,0,7
27419,2014/03/31,2013/03/16,30,5,0.7319687770000001,11530,30,2,3
27420,2014/03/31,2010/04/15,69,7,0.76994526,10961,69,5,2
27421,2014/03/31,2007/11/09,12,4,0.55,15344,12,0,4
27422,2014/03/31,2010/06/11,142,11,0.8579198859999999,9836,142,9,2
27423,2014/03/31,2005/07/20,102,11,0.646974622,13043,102,4,7
27424,2014/03/31,2009/06/25,148,5,0.446960483,18878,148,4,1
27425,2014/03/31,2010/11/11,242,14,0.790849189,10669,242,12,2
27426,2014/03/31,2012/04/15,320,9,0.562803495,14992,320,6,3
27427,2014/03/31,2011/10/10,461,5,0.783320954,10771,461,5,0
27428,2014/03/31,2011/04/27,175,5,0.7123497129999999,11844,175,2,3
27429,2014/03/31,2010/09/17,233,10,0.652643509,12926,233,4,6
27430,2014/03/31,2010/07/13,382,7,0.955767052,8826,382,7,0
27431,2014/03/31,2012/09/23,223,9,0.7726307590000001,10917,223,1,8
27432,2014/03/31,2012/12/23,101,3,0.696169528,12116,101,1,2
27433,2014/03/31,2009/07/20,96,11,0.752156233,11214,96,6,5
27434,2014/03/31,2012/05/25,7,5,0.692898217,12173,7,4,1
27435,2014/03/31,2012/07/25,161,9,0.61075965,13809,161,3,6
27436,2014/03/31,2011/09/05,144,10,0.8356866829999999,10092,144,2,8
27437,2014/03/31,2009/10/15,106,11,0.722667524,11670,106,7,4
27438,2014/03/31,2008/07/02,227,12,0.665220478,12677,227,9,3
27439,2014/03/31,2006/08/01,433,4,1.027308723,8208,433,4,0
27440,2014/03/31,2012/03/21,11,11,0.7196935809999999,11716,11,6,5
27441,2014/03/31,2009/02/25,159,6,0.6276818279999999,13433,159,0,6
27442,2014/03/31,2012/04/12,212,12,0.762349005,11060,212,11,1
27443,2014/03/31,2008/07/14,43,8,0.764205565,11033,43,2,6
27444,2014/03/31,2012/03/02,323,11,0.620053692,13596,323,9,2
27445,2014/03/31,2007/07/13,89,16,0.5359628710000001,15729,89,6,10
27446,2014/03/31,2007/07/08,192,7,0.7015830209999999,12015,192,4,3
27447,2014/03/31,2009/04/16,149,8,0.850064542,9916,149,5,3
27448,2014/03/31,2007/12/13,372,5,0.656288451,12841,372,5,0
27449,2014/03/31,2012/09/29,264,6,0.886586007,9505,264,4,2
27450,2014/03/31,2012/02/13,6,6,0.740952255,11373,6,0,6
27451,2014/03/31,2009/12/19,50,9,0.6727231359999999,12526,50,3,6
27452,2014/03/31,2010/06/05,5,9,0.6330456010000001,13311,5,5,4
27453,2014/03/31,2009/07/02,115,11,0.69732434,12083,115,5,6
27454,2014/03/31,2013/03/19,26,11,1.11,7590,26,1,10
27455,2014/03/31,2012/01/01,3,5,1.283249048,6565,3,1,4
27456,2014/03/31,2011/09/24,341,7,0.851369378,9895,341,5,2
27457,2014/03/31,2007/04/29,52,7,0.685666612,12286,52,1,6
27458,2014/03/31,2009/03/03,65,8,0.7823674190000001,10767,65,7,1
27459,2014/03/31,2008/03/31,12,10,0.800634981,10520,12,0,10
27460,2014/03/31,2008/09/09,36,8,0.628029828,13410,36,4,4
27461,2014/03/31,2008/05/20,13,10,0.601729065,13996,13,2,8
27462,2014/03/31,2009/11/05,181,12,0.4403262570000001,19126,181,8,4
27463,2014/03/31,2008/03/19,278,11,0.696218585,12096,278,8,3
27464,2014/03/31,2006/12/23,123,8,0.6129434460000001,13739,123,5,3
27465,2014/03/31,2008/03/29,173,12,0.560552523,15022,173,11,1
27466,2014/03/31,2011/06/14,24,8,1.422486907,5919,24,3,5
27467,2014/03/31,2008/09/28,208,14,0.70244869,11986,208,9,5
27468,2014/03/31,2011/08/01,224,5,0.992263995,8485,224,2,3
27469,2014/03/31,2012/12/07,98,14,0.8714285709999999,9660,98,3,11
27470,2014/03/31,2006/05/28,429,5,1.0,8416,429,5,0
27471,2014/03/31,2007/06/15,16,16,0.698709008,12045,16,7,9
27472,2014/03/31,2007/01/14,183,4,1.4692771080000002,5727,183,1,3
27473,2014/03/31,2012/06/19,171,4,0.724993969,11606,171,0,4
27474,2014/03/31,2012/09/08,78,4,0.822980534,10223,78,0,4
27475,2014/03/31,2006/03/08,183,6,0.791797647,10625,183,4,2
27476,2014/03/31,2009/04/19,12,15,0.646917634,13003,12,2,13
27477,2014/03/31,2011/01/31,188,5,0.607425621,13848,188,2,3
27478,2014/03/31,2011/12/06,4,9,0.7157403,11752,4,3,6
27479,2014/03/31,2013/01/08,60,12,0.7898948159999999,10648,60,3,9
27480,2014/03/31,2012/07/01,30,7,0.381264733,22060,30,3,4
27481,2014/03/31,2005/11/27,32,7,0.5856611660000001,14361,32,2,5
27482,2014/03/31,2008/05/07,484,12,0.872448133,9640,484,12,0
27483,2014/03/31,2005/10/10,92,9,0.560055278,15015,92,8,1
27484,2014/03/31,2011/04/10,94,11,0.511444559,16441,94,8,3
27485,2014/03/31,2007/10/24,99,9,0.79402021,10589,99,4,5
27486,2014/03/31,2007/08/01,24,10,0.494,17020,24,0,10
27487,2014/03/31,2009/12/05,192,11,0.590931262,14228,192,8,3
27488,2014/03/31,2010/05/20,113,16,0.6898892259999999,12187,113,10,6
27489,2014/03/31,2012/02/07,227,11,0.689357166,12196,227,7,4
27490,2014/03/31,2010/07/16,61,11,0.7235232359999999,11620,61,5,6
27491,2014/03/31,2010/05/15,21,14,0.717082054,11724,21,7,7
27492,2014/03/31,2009/02/10,160,13,0.7336734159999999,11458,160,6,7
27493,2014/03/31,2010/05/07,87,18,0.681162791,12341,87,11,7
27494,2014/03/31,2010/07/01,451,9,0.966785509,8695,451,9,0
27495,2014/03/31,2012/05/11,100,11,0.685639938,12259,100,7,4
27496,2014/03/31,2006/12/01,153,7,0.72686673,11563,153,5,2
27497,2014/03/31,2012/08/09,252,9,0.726459504,11569,252,8,1
27498,2014/03/31,2010/04/13,246,15,0.4657720870000001,18042,246,12,3
27499,2014/03/31,2009/11/11,19,14,0.8534328659999999,9846,19,9,5
27500,2014/03/31,2010/10/09,48,8,0.459345651,18293,48,3,5
27501,2014/03/31,2008/05/10,4,11,0.568475069,14781,4,6,5
27502,2014/03/31,2009/08/14,81,15,0.670307938,12535,81,5,10
27503,2014/03/31,2007/05/10,4,6,0.899013482,9346,4,1,5
27504,2014/03/31,2008/04/07,11,7,0.782434345,10738,11,4,3
27505,2014/03/31,2011/08/30,34,14,0.579335264,14502,34,8,6
27506,2014/03/31,2011/06/08,75,10,0.74006871,11352,75,8,2
27507,2014/03/31,2006/10/22,175,12,0.7449042379999999,11278,175,9,3
27508,2014/03/31,2007/11/19,39,6,0.747882133,11233,39,3,3
27509,2014/03/31,2008/04/05,153,9,0.648402285,12956,153,7,2
27510,2014/03/31,2011/12/21,57,6,0.96770303,8681,57,3,3
27511,2014/03/31,2011/12/29,25,12,0.668230849,12571,25,5,7
27512,2014/03/31,2010/10/09,21,8,0.7186601640000001,11688,21,1,7
27513,2014/03/31,2011/09/10,206,12,0.625331298,13432,206,7,5
27514,2014/03/31,2009/03/01,27,8,0.5556870660000001,15115,27,4,4
27515,2014/03/31,2011/07/25,119,11,0.897785142,9355,119,7,4
27516,2014/03/31,2005/08/26,218,7,1.01849139,8246,218,5,2
27517,2014/03/31,2012/10/01,41,6,1.368468307,6137,41,2,4
27518,2014/03/31,2010/10/22,62,10,0.585031696,14355,62,2,8
27519,2014/03/31,2008/05/06,255,9,0.695033518,12083,255,5,4
27520,2014/03/31,2007/01/18,33,9,0.678688379,12374,33,4,5
27521,2014/03/31,2013/01/26,30,10,0.772516788,10871,30,1,9
27522,2014/03/31,2010/10/06,379,16,0.69489036,12085,379,16,0
27523,2014/03/31,2005/10/09,115,11,0.769471273,10913,115,7,4
27524,2014/03/31,2010/04/29,22,10,0.713359952,11771,22,2,8
27525,2014/03/31,2013/03/13,287,8,0.514806867,16310,287,3,5
27526,2014/03/31,2012/10/11,272,8,0.781813949,10739,272,5,3
27527,2014/03/31,2012/04/20,254,8,0.818342757,10258,254,6,2
27528,2014/03/31,2013/01/15,50,8,0.90842316,9240,50,2,6
27529,2014/03/31,2008/03/20,130,8,0.906497462,9259,130,2,6
27530,2014/03/31,2005/09/20,67,8,0.7808578340000001,10748,67,3,5
27531,2014/03/31,2012/12/01,190,6,0.7203364520000001,11651,190,2,4
27532,2014/03/31,2006/01/07,60,14,0.561193661,14954,60,5,9
27533,2014/03/31,2011/04/09,343,13,0.825486917,10166,343,12,1
27534,2014/03/31,2008/01/26,158,6,0.988866368,8486,158,5,1
27535,2014/03/31,2012/01/09,34,8,0.860130176,9756,34,4,4
27536,2014/03/31,2010/11/14,18,9,0.670419463,12516,18,1,8
27537,2014/03/31,2012/12/22,76,10,0.585607203,14328,76,1,9
27538,2014/03/31,2008/08/07,264,11,0.7811516620000001,10741,264,8,3
27539,2014/03/31,2006/05/29,219,11,0.7388927059999999,11352,219,6,5
27540,2014/03/31,2012/12/25,18,9,0.8028247340000001,10447,18,4,5
27541,2014/03/31,2008/11/07,282,7,0.548744439,15284,282,5,2
27542,2014/03/31,2006/05/02,226,8,0.511408622,16399,226,4,4
27543,2014/03/31,2007/11/01,40,9,0.663679462,12635,40,2,7
27544,2014/03/31,2012/05/18,598,7,0.619634939,13532,598,7,0
27545,2014/03/31,2012/08/27,490,6,0.6576998510000001,12747,490,6,0
27546,2014/03/31,2011/11/25,195,8,0.7629010829999999,10989,195,4,4
27547,2014/03/31,2009/12/04,67,5,0.6772871220000001,12378,67,1,4
27548,2014/03/31,2009/10/27,84,11,0.7523386879999999,11143,84,3,8
27549,2014/03/31,2011/04/28,50,7,0.742625797,11288,50,0,7
27550,2014/03/31,2010/10/21,164,9,0.784299214,10688,164,5,4
27551,2014/03/31,2012/03/27,90,16,0.930660597,9007,90,14,2
27552,2014/03/31,2007/07/03,10,5,1.283655436,6530,10,1,4
27553,2014/03/31,2013/01/12,88,7,0.777259829,10784,88,3,4
27554,2014/03/31,2013/03/08,127,11,0.6703063020000001,12504,127,0,11
27555,2014/03/31,2012/04/24,59,8,0.5529961729999999,15156,59,3,5
27556,2014/03/31,2012/07/12,25,7,0.777679317,10777,25,2,5
27557,2014/03/31,2011/08/29,25,13,0.751751884,11148,25,5,8
27558,2014/03/31,2011/09/12,196,10,0.6944356979999999,12068,196,7,3
27559,2014/03/31,2007/01/19,36,8,0.705084147,11884,36,1,7
27560,2014/03/31,2008/10/09,548,4,0.75,11172,548,4,0
27561,2014/03/31,2012/11/05,59,8,0.681419161,12296,59,4,4
27562,2014/03/31,2011/04/04,309,10,0.94008079,8912,309,5,5
27563,2014/03/31,2009/07/20,191,8,0.821806945,10194,191,7,1
27564,2014/03/31,2012/05/19,107,8,0.855169457,9796,107,3,5
27565,2014/03/31,2005/08/25,102,10,0.668518873,12531,102,3,7
27566,2014/03/31,2009/09/27,110,5,1.187828985,7052,110,1,4
27567,2014/03/31,2007/05/16,73,4,1.069379548,7833,73,0,4
27568,2014/03/31,2005/11/19,138,11,0.716694335,11686,138,6,5
27569,2014/03/31,2011/07/01,570,7,0.870602911,9620,570,7,0
27570,2014/03/31,2009/09/13,202,10,0.76814363,10903,202,4,6
27571,2014/03/31,2013/02/11,411,2,0.815018493,10274,411,2,0
27572,2014/03/31,2007/04/26,106,17,0.7091691370000001,11807,106,10,7
27573,2014/03/31,2011/11/16,118,6,0.46233683,18110,118,4,2
27574,2014/03/31,2013/01/26,100,8,0.8369352259999999,10004,100,1,7
27575,2014/03/31,2006/09/21,11,10,0.591994626,14143,11,3,7
27576,2014/03/31,2005/04/17,134,7,0.702475455,11917,134,3,4
27577,2014/03/31,2011/06/21,194,7,0.826258638,10130,194,6,1
27578,2014/03/31,2012/03/04,202,10,0.762025858,10983,202,8,2
27579,2014/03/31,2006/12/21,29,13,0.493150669,16971,29,4,9
27580,2014/03/31,2012/05/18,203,8,0.645518704,12965,203,5,3
27581,2014/03/31,2005/11/20,62,6,0.5954632129999999,14054,62,0,6
27582,2014/03/31,2007/06/15,17,17,0.697728675,11993,17,6,11
27583,2014/03/31,2010/11/17,8,7,0.713553338,11727,8,2,5
27584,2014/03/31,2011/07/18,45,8,0.916183072,9133,45,2,6
27585,2014/03/31,2013/03/23,18,9,0.576927532,14503,18,1,8
27586,2014/03/31,2011/03/28,154,11,0.734006492,11399,154,4,7
27587,2014/03/31,2008/06/15,24,6,0.673326895,12426,24,0,6
27588,2014/03/31,2010/11/11,191,11,0.58028298,14418,191,7,4
27589,2014/03/31,2010/07/24,52,11,0.6927639309999999,12077,52,1,10
27590,2014/03/31,2011/06/15,60,4,0.8244294440000001,10148,60,2,2
27591,2014/03/31,2010/11/03,177,9,0.658219372,12709,177,4,5
27592,2014/03/31,2008/05/03,264,6,0.7060229570000001,11848,264,3,3
27593,2014/03/31,2006/10/31,1,12,0.7598246890000001,11009,1,1,11
27594,2014/03/31,2012/04/06,224,10,0.586937759,14251,224,6,4
27595,2014/03/31,2006/04/18,32,18,0.444936965,18799,32,8,10
27596,2014/03/31,2010/12/06,42,13,0.754619688,11083,42,6,7
27597,2014/03/31,2011/06/21,301,10,0.6090823679999999,13731,301,8,2
27598,2014/03/31,2011/09/04,368,12,0.875696335,9550,368,12,0
27599,2014/03/31,2013/03/30,12,7,0.712888321,11730,12,1,6
27600,2014/03/31,2007/04/25,134,5,0.686769875,12176,134,4,1
27601,2014/03/31,2010/05/12,69,8,0.68284606,12245,69,5,3
27602,2014/03/31,2011/03/27,438,11,0.879832684,9503,438,11,0
27603,2014/03/31,2012/03/02,97,15,0.962666667,8685,97,7,8
27604,2014/03/31,2012/08/28,64,6,0.565174745,14793,64,1,5
27605,2014/03/31,2011/09/27,187,11,0.49703805,16820,187,6,5
27606,2014/03/31,2010/05/08,76,5,0.867856327,9633,76,2,3
27607,2014/03/31,2011/12/02,230,8,0.368121973,22710,230,2,6
27608,2014/03/31,2012/07/17,122,6,0.708333333,11802,122,5,1
27609,2014/03/31,2010/04/17,402,6,0.5083120520000001,16446,402,6,0
27610,2014/03/31,2010/04/14,162,7,0.856702193,9758,162,4,3
27611,2014/03/31,2008/03/25,114,10,0.562169615,14869,114,5,5
27612,2014/03/31,2012/07/16,332,7,0.477284148,17512,332,4,3
27613,2014/03/31,2011/06/23,402,6,0.8703269809999999,9603,402,6,0
27614,2014/03/31,2006/11/02,35,5,0.7809681340000001,10701,35,2,3
27615,2014/03/31,2007/12/07,27,12,0.580553664,14395,27,6,6
27616,2014/03/31,2012/09/11,42,10,0.8096241040000001,10322,42,4,6
27617,2014/03/31,2011/02/04,391,10,0.756262443,11050,391,10,0
27618,2014/03/31,2007/05/28,106,5,0.565404601,14780,106,0,5
27619,2014/03/31,2011/12/17,136,14,0.6212177529999999,13451,136,12,2
27620,2014/03/31,2013/01/21,43,8,0.521359666,16026,43,4,4
27621,2014/03/31,2012/05/27,431,12,0.8,10444,431,12,0
27622,2014/03/31,2011/05/11,128,11,0.701836358,11904,128,8,3
27623,2014/03/31,2006/05/28,27,9,0.88679758,9421,27,1,8
27624,2014/03/31,2008/05/23,198,10,0.71323999,11713,198,8,2
27625,2014/03/31,2012/12/03,98,11,0.692385412,12065,98,7,4
27626,2014/03/31,2006/11/01,44,9,0.640141007,13049,44,0,9
27627,2014/03/31,2008/03/09,72,10,0.661481628,12628,72,6,4
27628,2014/03/31,2006/02/21,17,11,0.452937859,18442,17,4,7
27629,2014/03/31,2011/04/27,185,9,0.889752876,9388,185,4,5
27630,2014/03/31,2011/10/30,125,12,0.669485412,12476,125,7,5
27631,2014/03/31,2006/04/23,5,12,0.7839750329999999,10654,5,8,4
27632,2014/03/31,2010/11/21,9,7,0.6954554540000001,12010,9,0,7
27633,2014/03/31,2008/03/28,37,9,0.586202007,14247,37,5,4
27634,2014/03/31,2012/01/14,153,5,0.7970984059999999,10477,153,3,2
27635,2014/03/31,2008/12/12,12,15,0.7118557670000001,11731,12,3,12
27636,2014/03/31,2007/07/30,460,8,0.633373786,13184,460,8,0
27637,2014/03/31,2009/02/11,67,13,0.768864641,10860,67,3,10
27638,2014/03/31,2012/07/12,236,8,0.740298785,11279,236,6,2
27639,2014/03/31,2013/03/23,129,6,1.358955078,6144,129,0,6
27640,2014/03/31,2010/02/18,7,9,0.6292839379999999,13267,7,3,6
27641,2014/03/31,2012/09/16,315,11,0.659647598,12656,315,8,3
27642,2014/03/31,2006/03/01,38,4,0.68,12276,38,0,4
27643,2014/03/31,2011/04/04,104,10,0.609417391,13697,104,6,4
27644,2014/03/31,2009/06/12,8,12,0.650289855,12834,8,7,5
27645,2014/03/31,2010/11/28,79,5,0.5305333760000001,15730,79,3,2
27646,2014/03/31,2008/08/22,109,9,0.717981588,11623,109,7,2
27647,2014/03/31,2005/08/26,124,13,0.613364699,13603,124,9,4
27648,2014/03/31,2012/08/27,80,8,0.69251245,12048,80,2,6
27649,2014/03/31,2005/09/09,82,11,0.363676823,22941,82,7,4
27650,2014/03/31,2005/09/02,133,10,0.701828201,11886,133,3,7
27651,2014/03/31,2011/11/08,31,10,0.556498332,14990,31,0,10
27652,2014/03/31,2011/10/26,261,7,0.728394167,11452,261,5,2
27653,2014/03/31,2012/08/29,72,6,0.7957727529999999,10482,72,0,6
27654,2014/03/31,2010/03/02,34,10,0.767367985,10870,34,0,10
27655,2014/03/31,2012/10/24,145,8,0.562171744,14836,145,3,5
27656,2014/03/31,2012/01/09,234,8,0.8308418009999999,10038,234,3,5
27657,2014/03/31,2012/08/21,33,12,0.526771097,15832,33,1,11
27658,2014/03/31,2012/02/07,224,9,0.7039166029999999,11847,224,7,2
27659,2014/03/31,2012/12/29,139,7,0.631736364,13200,139,2,5
27660,2014/03/31,2011/08/20,580,3,0.5798748260000001,14380,580,3,0
27661,2014/03/31,2011/11/20,400,8,0.768657817,10848,400,8,0
27662,2014/03/31,2009/01/07,32,10,0.543140959,15352,32,7,3
27663,2014/03/31,2009/01/05,28,8,0.610306713,13661,28,2,6
27664,2014/03/31,2008/10/06,375,10,0.791324158,10535,375,10,0
27665,2014/03/31,2004/11/24,34,9,0.838595715,9941,34,7,2
27666,2014/03/31,2013/03/21,2,13,0.506705775,16450,2,2,11
27667,2014/03/31,2010/02/03,13,27,0.532222222,15660,13,7,20
27668,2014/03/31,2012/01/28,118,10,0.566021462,14724,118,3,7
27669,2014/03/31,2007/04/01,31,12,0.732603727,11376,31,1,11
27670,2014/03/31,2012/11/26,124,9,0.6644868829999999,12541,124,3,6
27671,2014/03/31,2011/12/15,30,9,0.685412074,12158,30,7,2
27672,2014/03/31,2010/02/26,27,9,0.86775591,9603,27,3,6
27673,2014/03/31,2005/11/02,8,15,0.7520034290000001,11081,8,6,9
27674,2014/03/31,2011/02/16,296,8,0.63609771,13100,296,6,2
27675,2014/03/31,2009/06/10,387,8,0.621219803,13412,387,8,0
27676,2014/03/31,2012/04/09,34,11,0.930905028,8950,34,7,4
27677,2014/03/31,2010/08/03,88,9,0.584289221,14259,88,7,2
27678,2014/03/31,2009/09/05,128,10,0.707320822,11776,128,3,7
27679,2014/03/31,2006/09/19,68,8,0.7586601690000001,10979,68,1,7
27680,2014/03/31,2011/02/01,575,3,0.721509009,11544,575,3,0
27681,2014/03/31,2013/03/15,158,9,0.7202594259999999,11564,158,1,8
27682,2014/03/31,2007/08/31,153,9,0.658395257,12650,153,6,3
27683,2014/03/31,2010/08/26,376,12,0.7946474570000001,10481,376,12,0
27684,2014/03/31,2006/05/16,459,7,0.614732802,13548,459,7,0
27685,2014/03/31,2011/11/02,150,7,0.657668009,12663,150,5,2
27686,2014/03/31,2007/11/01,78,8,0.7207919340000001,11554,78,3,5
27687,2014/03/31,2010/11/26,26,8,0.744953931,11179,26,0,8
27688,2014/03/31,2012/09/14,152,12,0.679194127,12260,152,5,7
27689,2014/03/31,2005/12/07,216,7,0.8139368459999999,10229,216,4,3
27690,2014/03/31,2011/01/29,35,8,0.66789651,12465,35,0,8
27691,2014/03/31,2007/05/30,138,9,0.7348609759999999,11329,138,7,2
27692,2014/03/31,2011/05/24,354,9,0.506614739,16433,354,6,3
27693,2014/03/31,2012/03/14,442,5,0.59,14110,442,5,0
27694,2014/03/31,2011/07/22,23,8,0.724606546,11488,23,1,7
27695,2014/03/31,2010/04/28,4,10,0.825491868,10084,4,0,10
27696,2014/03/31,2011/09/01,122,14,0.474856246,17530,122,3,11
27697,2014/03/31,2013/03/31,44,5,0.690863142,12049,44,1,4
27698,2014/03/31,2013/02/01,109,8,1.458493079,5707,109,1,7
27699,2014/03/31,2009/04/20,8,12,0.6975,11932,8,0,12
27700,2014/03/31,2012/08/25,504,4,0.855753213,9725,504,4,0
27701,2014/03/31,2011/04/20,21,10,0.6825342409999999,12193,21,4,6
27702,2014/03/31,2007/10/06,1,12,0.605366262,13747,1,0,12
27703,2014/03/31,2008/06/29,244,8,0.7204345940000001,11551,244,4,4
27704,2014/03/31,2011/05/12,146,8,0.78602437,10587,146,7,1
27705,2014/03/31,2012/08/11,7,10,0.74284592,11202,7,9,1
27706,2014/03/31,2011/08/25,251,8,0.7605639340000001,10941,251,2,6
27707,2014/03/31,2011/07/31,100,21,0.834613842,9970,100,13,8
27708,2014/03/31,2010/02/26,3,5,0.492910965,16881,3,1,4
27709,2014/03/31,2012/01/11,172,5,0.846,9835,172,1,4
27710,2014/03/31,2012/11/06,44,9,0.627119487,13265,44,7,2
27711,2014/03/31,2012/03/22,121,6,0.554819582,14993,121,2,4
27712,2014/03/31,2013/02/27,10,6,0.61757443,13469,10,1,5
27713,2014/03/31,2006/05/23,165,6,0.876415552,9491,165,5,1
27714,2014/03/31,2008/09/04,13,19,0.824054884,10094,13,8,11
27715,2014/03/31,2012/09/20,186,9,0.635197404,13095,186,6,3
27716,2014/03/31,2010/09/30,113,8,0.8288340809999999,10035,113,3,5
27717,2014/03/31,2006/09/25,105,7,0.676138525,12301,105,2,5
27718,2014/03/31,2007/11/07,186,6,0.783224409,10619,186,3,3
27719,2014/03/31,2012/02/04,396,6,0.908333333,9156,396,6,0
27720,2014/03/31,2012/05/22,21,13,0.639715385,13000,21,5,8
27721,2014/03/31,2012/06/19,76,14,0.554588863,14995,76,5,9
27722,2014/03/31,2009/10/31,13,12,0.654958652,12697,13,7,5
27723,2014/03/31,2007/04/24,37,5,0.912354878,9113,37,2,3
27724,2014/03/31,2012/07/11,50,8,0.652240527,12747,50,4,4
27725,2014/03/31,2011/08/06,112,12,0.75318536,11038,112,6,6
27726,2014/03/31,2011/10/06,29,10,0.622593425,13353,29,3,7
27727,2014/03/31,2012/10/03,18,12,0.643992098,12908,18,6,6
27728,2014/03/31,2012/04/17,438,4,1.0,8312,438,4,0
27729,2014/03/31,2009/11/23,17,8,0.43875,18944,17,5,3
27730,2014/03/31,2009/04/24,61,7,0.581796164,14286,61,3,4
27731,2014/03/31,2012/03/18,266,8,0.574679851,14462,266,2,6
27732,2014/03/31,2012/04/21,10,10,0.614350237,13528,10,6,4
27733,2014/03/31,2012/05/12,93,12,0.5043403329999999,16478,93,6,6
27734,2014/03/31,2010/10/17,346,5,0.8,10386,346,3,2
27735,2014/03/31,2011/08/30,19,10,0.716337615,11599,19,5,5
27736,2014/03/31,2012/12/05,81,14,0.8744001259999999,9502,81,3,11
27737,2014/03/31,2013/03/12,25,6,0.62911934,13206,25,0,6
27738,2014/03/31,2010/05/03,264,6,0.72016645,11535,264,5,1
27739,2014/03/31,2007/03/23,343,10,0.557163458,14909,343,9,1
27740,2014/03/31,2011/01/09,248,10,0.715283734,11613,248,7,3
27741,2014/03/31,2008/11/28,303,6,0.719205923,11548,303,4,2
27742,2014/03/31,2011/10/09,75,7,0.582792085,14251,75,4,3
27743,2014/03/31,2008/09/09,205,9,0.70097738,11848,205,6,3
27744,2014/03/31,2005/08/14,118,8,0.643222059,12911,118,2,6
27745,2014/03/31,2008/02/04,18,11,0.735576225,11289,18,5,6
27746,2014/03/31,2010/01/11,34,12,0.642368095,12926,34,6,6
27747,2014/03/31,2008/11/21,115,11,0.707640842,11733,115,2,9
27748,2014/03/31,2006/06/03,100,14,0.483198114,17182,100,4,10
27749,2014/03/31,2012/09/09,31,11,0.709525682,11701,31,4,7
27750,2014/03/31,2013/02/28,91,8,0.599894493,13838,91,3,5
27751,2014/03/31,2012/12/11,18,10,0.735753413,11282,18,0,10
27752,2014/03/31,2012/10/08,43,12,0.7205381940000001,11520,43,7,5
27753,2014/03/31,2011/09/27,24,10,0.7672545759999999,10818,24,4,6
27754,2014/03/31,2011/04/01,309,12,0.651928364,12731,309,11,1
27755,2014/03/31,2004/11/27,114,9,0.674333767,12308,114,1,8
27756,2014/03/31,2008/08/04,142,12,0.946762491,8766,142,6,6
27757,2014/03/31,2009/09/24,111,9,0.740787289,11203,111,7,2
27758,2014/03/31,2011/07/27,22,4,0.520010026,15959,22,1,3
27759,2014/03/31,2013/03/03,39,6,0.888333333,9342,39,0,6
27760,2014/03/31,2005/05/27,148,7,0.7364669859999999,11268,148,5,2
27761,2014/03/31,2012/09/09,6,10,0.669719151,12391,6,2,8
27762,2014/03/31,2011/04/12,65,8,0.6413859470000001,12937,65,0,8
27763,2014/03/31,2012/05/01,135,7,0.6949853420000001,11939,135,4,3
27764,2014/03/31,2010/08/17,47,8,0.712590175,11644,47,3,5
27765,2014/03/31,2012/09/20,12,12,0.549897276,15089,12,3,9
27766,2014/03/31,2012/01/17,429,11,0.71580968,11591,429,11,0
27767,2014/03/31,2012/06/17,2,6,0.67548282,12282,2,1,5
27768,2014/03/31,2005/01/07,98,7,0.818088757,10140,98,2,5
27769,2014/03/31,2005/11/21,154,5,0.644,12880,154,2,3
27770,2014/03/31,2012/10/30,321,8,0.844072453,9827,321,5,3
27771,2014/03/31,2009/12/22,250,7,0.817909476,10141,250,4,3
27772,2014/03/31,2013/01/11,159,8,0.759485395,10921,159,1,7
27773,2014/03/31,2012/02/10,5,10,0.793482254,10453,5,5,5
27774,2014/03/31,2009/03/31,36,7,0.891555412,9303,36,3,4
27775,2014/03/31,2011/12/27,6,6,0.793306552,10455,6,3,3
27776,2014/03/31,2006/09/10,9,8,0.733004861,11315,9,1,7
27777,2014/03/31,2012/04/08,14,9,0.7337335220000001,11303,14,4,5
27778,2014/03/31,2009/12/24,82,8,0.8343259559999999,9940,82,6,2
27779,2014/03/31,2012/08/24,261,9,0.660493827,12555,261,4,5
27780,2014/03/31,2010/06/16,62,10,0.6652350770000001,12464,62,7,3
27781,2014/03/31,2011/11/09,49,8,0.655116555,12655,49,5,3
27782,2014/03/31,2008/07/03,13,11,0.759205055,10919,13,2,9
27783,2014/03/31,2011/12/05,413,5,0.878704685,9434,413,5,0
27784,2014/03/31,2010/06/07,4,13,0.634508918,13063,4,3,10
27785,2014/03/31,2012/03/08,21,6,1.419743063,5838,21,4,2
27786,2014/03/31,2009/02/28,65,3,1.362531646,6083,65,0,3
27787,2014/03/31,2012/12/22,4,15,0.616914775,13435,4,6,9
27788,2014/03/31,2012/11/14,30,12,0.583289464,14209,30,5,7
27789,2014/03/31,2013/03/13,45,10,0.534321449,15511,45,2,8
27790,2014/03/31,2009/06/14,16,14,0.692578138,11966,16,7,7
27791,2014/03/31,2012/01/23,206,6,0.761277905,10885,206,4,2
27792,2014/03/31,2006/05/17,8,17,0.793094372,10448,8,8,9
27793,2014/03/31,2010/06/08,609,8,0.760201835,10900,609,8,0
27794,2014/03/31,2010/08/25,166,10,0.688710723,12030,166,6,4
27795,2014/03/31,2010/09/26,74,10,0.654021156,12668,74,7,3
27796,2014/03/31,2010/06/27,33,8,0.706081657,11732,33,5,3
27797,2014/03/31,2010/05/12,683,5,0.900619767,9197,683,5,0
27798,2014/03/31,2010/03/04,50,10,0.598252799,13845,50,4,6
27799,2014/03/31,2013/03/26,50,12,0.5115632139999999,16191,50,1,11
27800,2014/03/31,2011/07/18,70,7,0.627045196,13209,70,3,4
27801,2014/03/31,2011/11/02,241,6,0.5479095,15116,241,5,1
27802,2014/03/31,2006/09/08,108,7,0.638465156,12972,108,4,3
27803,2014/03/31,2012/03/05,388,9,0.807060027,10262,388,9,0
27804,2014/03/31,2008/12/07,206,7,0.669358228,12372,206,4,3
27805,2014/03/31,2010/12/15,32,12,0.8051618859999999,10285,32,5,7
27806,2014/03/31,2013/02/12,38,7,0.697461467,11873,38,0,7
27807,2014/03/31,2011/09/20,129,7,0.996042343,8313,129,5,2
27808,2014/03/31,2012/01/24,25,8,0.471975372,17541,25,3,5
27809,2014/03/31,2010/05/04,58,8,0.614484115,13472,58,1,7
27810,2014/03/31,2012/09/17,93,9,0.615277241,13454,93,3,6
27811,2014/03/31,2008/09/04,321,7,0.929468897,8906,321,6,1
27812,2014/03/31,2013/01/11,258,7,0.7044740429999999,11750,258,5,2
27813,2014/03/31,2010/06/07,55,11,0.499513005,16571,55,4,7
27814,2014/03/31,2010/08/09,46,8,0.820812178,10084,46,7,1
27815,2014/03/31,2007/10/31,101,8,0.837107313,9887,101,1,7
27816,2014/03/31,2011/07/26,153,12,0.7932173659999999,10434,153,9,3
27817,2014/03/31,2009/07/09,449,9,0.81467172,10159,449,9,0
27818,2014/03/31,2009/12/18,39,13,0.76640489,10798,39,7,6
27819,2014/03/31,2010/09/19,88,7,0.637792678,12975,88,6,1
27820,2014/03/31,2011/08/22,223,7,0.766717013,10792,223,6,1
27821,2014/03/31,2011/04/27,149,9,0.488460948,16939,149,5,4
27822,2014/03/31,2011/07/15,8,13,0.448445902,18448,8,8,5
27823,2014/03/31,2011/11/18,140,7,0.7492509740000001,11041,140,3,4
27824,2014/03/31,2012/10/17,11,10,0.678400033,12194,11,3,7
27825,2014/03/31,2012/05/25,5,11,0.80544888,10270,5,3,8
27826,2014/03/31,2010/09/13,259,11,0.547793894,15099,259,9,2
27827,2014/03/31,2013/01/07,44,7,0.817142857,10122,44,2,5
27828,2014/03/31,2009/06/28,59,12,0.6328637020000001,13067,59,10,2
27829,2014/03/31,2008/07/05,289,3,0.814930521,10147,289,2,1
27830,2014/03/31,2006/05/17,1,5,0.819759096,10087,1,0,5
27831,2014/03/31,2005/05/10,86,13,0.63937906,12932,86,4,9
27832,2014/03/31,2005/10/23,7,14,0.508189194,16269,7,4,10
27833,2014/03/31,2012/10/21,29,7,0.5989075629999999,13804,29,0,7
27834,2014/03/31,2006/05/15,25,10,0.64719117,12774,25,6,4
27835,2014/03/31,2006/10/18,72,10,0.796813494,10375,72,4,6
27836,2014/03/31,2006/12/01,311,11,0.548130221,15082,311,9,2
27837,2014/03/31,2011/06/23,7,5,1.278320705,6467,7,1,4
27838,2014/03/31,2005/10/22,284,8,0.58072924,14234,284,6,2
27839,2014/03/31,2008/03/22,23,8,0.989112122,8357,23,1,7
27840,2014/03/31,2005/02/23,607,6,1.0,8266,607,6,0
27841,2014/03/31,2012/11/07,13,16,0.6978022629999999,11844,13,3,13
27842,2014/03/31,2006/08/13,142,5,0.682815237,12102,142,4,1
27843,2014/03/31,2012/08/30,167,10,0.70891987,11656,167,6,4
27844,2014/03/31,2010/07/28,32,9,0.7808372709999999,10582,32,5,4
27845,2014/03/31,2011/05/13,12,13,0.545999207,15132,12,6,7
27846,2014/03/31,2007/02/19,22,13,0.761747188,10846,22,6,7
27847,2014/03/31,2010/03/24,61,8,0.808927837,10213,61,4,4
27848,2014/03/31,2012/06/19,98,9,0.538527475,15341,98,5,4
27849,2014/03/31,2011/10/02,21,7,0.7082536009999999,11664,21,0,7
27850,2014/03/31,2009/12/08,229,6,0.8592188479999999,9614,229,2,4
27851,2014/03/31,2006/04/02,254,4,1.480864109,5578,254,2,2
27852,2014/03/31,2012/12/01,127,4,0.705627883,11706,127,1,3
27853,2014/03/31,2008/01/01,591,6,0.7412187020000001,11143,591,6,0
27854,2014/03/31,2011/12/31,195,8,0.82752505,9980,195,6,2
27855,2014/03/31,2012/05/05,54,11,0.607643293,13591,54,4,7
27856,2014/03/31,2012/06/22,4,9,0.495076434,16681,4,4,5
27857,2014/03/31,2005/04/20,430,14,0.523380657,15778,430,14,0
27858,2014/03/31,2007/03/26,34,12,0.611694815,13500,34,4,8
27859,2014/03/31,2011/09/20,402,11,0.672120472,12285,402,11,0
27860,2014/03/31,2006/06/01,30,11,0.754016438,10950,30,4,7
27861,2014/03/31,2010/09/26,6,7,0.736180116,11215,6,0,7
27862,2014/03/31,2011/12/19,28,8,0.8240013970000001,10019,28,6,2
27863,2014/03/31,2005/03/14,136,16,0.521795715,15821,136,12,4
27864,2014/03/31,2010/12/04,168,5,0.575395553,14347,168,1,4
27865,2014/03/31,2008/01/21,17,8,0.568650455,14516,17,4,4
27866,2014/03/31,2012/03/22,117,8,0.663528939,12440,117,3,5
27867,2014/03/31,2011/06/25,368,9,0.554931424,14874,368,9,0
27868,2014/03/31,2010/11/02,116,7,0.76310466,10816,116,5,2
27869,2014/03/31,2005/11/27,184,8,0.876088526,9421,184,2,6
27870,2014/03/31,2012/04/18,299,5,1.31457152,6278,299,4,1
27871,2014/03/31,2012/12/01,11,10,0.6486049979999999,12724,11,2,8
27872,2014/03/31,2012/07/21,12,12,0.707999314,11656,12,3,9
27873,2014/03/31,2012/03/22,395,9,0.517645214,15942,395,9,0
27874,2014/03/31,2013/03/07,36,7,0.7391034479999999,11165,36,1,6
27875,2014/03/31,2008/06/27,206,8,0.64686525,12757,206,6,2
27876,2014/03/31,2011/08/10,318,14,0.483417306,17069,318,12,2
27877,2014/03/31,2011/01/28,420,8,0.7659038159999999,10771,420,8,0
27878,2014/03/31,2012/08/10,234,19,0.6157587520000001,13397,234,8,11
27879,2014/03/31,2013/03/21,97,9,0.8558138809999999,9639,97,0,9
27880,2014/03/31,2012/08/07,92,9,0.570317362,14463,92,4,5
27881,2014/03/31,2010/11/30,113,9,0.840834947,9809,113,6,3
27882,2014/03/31,2009/01/26,67,3,0.716666667,11508,67,1,2
27883,2014/03/31,2009/02/16,171,8,0.707567568,11655,171,7,1
27884,2014/03/31,2012/03/29,5,10,0.809747643,10184,5,7,3
27885,2014/03/31,2006/10/04,7,9,0.65975198,12499,7,0,9
27886,2014/03/31,2008/02/15,11,9,0.6194995870000001,13309,11,6,3
27887,2014/03/31,2012/03/19,260,11,0.739487846,11149,260,9,2
27888,2014/03/31,2011/05/12,10,20,0.593334293,13895,10,7,13
27889,2014/03/31,2009/06/01,50,9,0.714739032,11534,50,3,6
27890,2014/03/31,2010/02/17,421,7,0.685137157,12030,421,7,0
27891,2014/03/31,2007/08/27,19,8,0.7753697079999999,10630,19,1,7
27892,2014/03/31,2012/10/29,64,6,1.421517765,5798,64,3,3
27893,2014/03/31,2012/04/01,4,8,0.667159165,12352,4,4,4
27894,2014/03/31,2008/04/09,319,8,0.636589417,12945,319,5,3
27895,2014/03/31,2012/11/04,485,6,0.94156475,8749,485,6,0
27896,2014/03/31,2006/12/19,39,6,1.1639706090000002,7077,39,2,4
27897,2014/03/31,2012/09/06,12,9,1.051891202,7831,12,4,5
27898,2014/03/31,2010/04/26,70,10,0.821747805,10024,70,8,2
27899,2014/03/31,2005/09/17,150,7,0.625115732,13177,150,2,5
27900,2014/03/31,2010/07/02,15,13,0.419344771,19642,15,0,13
27901,2014/03/31,2012/02/14,271,3,0.85,9690,271,2,1
27902,2014/03/31,2012/05/28,612,3,0.85,9690,612,3,0
27903,2014/03/31,2013/02/02,28,7,0.641569559,12838,28,1,6
27904,2014/03/31,2009/07/11,136,12,0.533285418,15444,136,6,6
27905,2014/03/31,2007/06/27,102,6,0.816706664,10084,102,3,3
27906,2014/03/31,2012/04/14,28,12,0.599219296,13744,28,8,4
27907,2014/03/31,2011/01/10,151,2,0.58,14199,151,0,2
27908,2014/03/31,2010/01/19,53,7,0.713184377,11547,53,3,4
27909,2014/03/31,2012/06/18,287,7,0.883099196,9325,287,4,3
27910,2014/03/31,2009/06/14,13,8,0.733351144,11229,13,1,7
27911,2014/03/31,2012/09/20,2,9,0.6938498479999999,11868,2,4,5
27912,2014/03/31,2011/08/15,6,9,0.981856666,8386,6,5,4
27913,2014/03/31,2008/09/19,151,4,1.238144361,6650,151,3,1
27914,2014/03/31,2007/02/09,268,14,0.960850741,8569,268,10,4
27915,2014/03/31,2011/05/20,258,9,0.686217388,11997,258,6,3
27916,2014/03/31,2008/06/16,27,13,0.491125761,16762,27,4,9
27917,2014/03/31,2011/07/31,96,9,0.7567628940000001,10877,96,6,3
27918,2014/03/31,2007/09/21,40,12,0.764333736,10769,40,7,5
27919,2014/03/31,2012/08/07,193,6,0.7877871359999999,10448,193,5,1
27920,2014/03/31,2012/08/07,359,5,0.625155704,13166,359,3,2
27921,2014/03/31,2012/01/11,12,14,0.571661573,14396,12,5,9
27922,2014/03/31,2011/12/29,9,15,0.527901084,15589,9,6,9
27923,2014/03/31,2012/03/22,160,12,1.160960779,7088,160,9,3
27924,2014/03/31,2013/03/07,35,5,0.928241399,8865,35,3,2
27925,2014/03/31,2007/09/09,154,10,0.727949398,11304,154,4,6
27926,2014/03/31,2010/02/09,199,5,0.692557865,11881,199,1,4
27927,2014/03/31,2013/01/12,3,10,0.5421017260000001,15178,3,4,6
27928,2014/03/31,2012/09/16,27,8,0.62214896,13225,27,5,3
27929,2014/03/31,2012/07/19,142,12,0.7559955890000001,10883,142,8,4
27930,2014/03/31,2010/09/14,257,7,0.511145769,16094,257,4,3
27931,2014/03/31,2011/02/07,573,4,0.9,9140,573,4,0
27932,2014/03/31,2011/08/17,204,11,0.709244697,11598,204,9,2
27933,2014/03/31,2008/08/06,35,10,0.700464106,11743,35,8,2
27934,2014/03/31,2010/05/14,149,7,0.7280702840000001,11297,149,4,3
27935,2014/03/31,2010/04/23,7,4,0.62677793,13122,7,0,4
27936,2014/03/31,2011/04/22,30,18,0.810200965,10151,30,10,8
27937,2014/03/31,2010/10/19,178,10,0.573684431,14336,178,5,5
27938,2014/03/31,2010/08/24,286,5,0.655740711,12542,286,3,2
27939,2014/03/31,2013/02/13,234,2,0.85,9675,234,0,2
27940,2014/03/31,2007/02/16,279,14,0.647488387,12701,279,11,3
27941,2014/03/31,2013/01/25,99,5,0.800321168,10275,99,1,4
27942,2014/03/31,2009/02/13,89,6,0.8310895490000001,9894,89,5,1
27943,2014/03/31,2008/02/13,69,8,0.5312534729999999,15477,69,0,8
27944,2014/03/31,2012/09/19,95,12,0.7896734540000001,10412,95,1,11
27945,2014/03/31,2007/09/09,241,15,0.769549752,10683,241,12,3
27946,2014/03/31,2005/01/16,78,14,0.623067303,13194,78,6,8
27947,2014/03/31,2008/03/08,32,10,0.677486402,12134,32,8,2
27948,2014/03/31,2008/06/22,16,8,0.743135057,11062,16,1,7
27949,2014/03/31,2007/09/23,16,12,0.498315955,16496,16,7,5
27950,2014/03/31,2009/10/14,44,6,1.055027596,7791,44,4,2
27951,2014/03/31,2008/04/20,7,7,0.685316825,11994,7,0,7
27952,2014/03/31,2011/04/25,10,10,0.650143965,12642,10,4,6
27953,2014/03/31,2011/01/26,107,11,0.645876621,12725,107,4,7
27954,2014/03/31,2010/10/31,15,11,0.656394058,12521,15,4,7
27955,2014/03/31,2009/12/17,248,5,0.780919802,10524,248,4,1
27956,2014/03/31,2008/04/11,86,7,0.819204545,10032,86,5,2
27957,2014/03/31,2011/11/30,117,10,0.6574439999999999,12500,117,7,3
27958,2014/03/31,2007/03/26,106,9,0.8086086790000001,10163,106,5,4
27959,2014/03/31,2012/10/10,28,8,0.7155538140000001,11484,28,3,5
27960,2014/03/31,2013/01/03,6,10,0.765556694,10733,6,8,2
27961,2014/03/31,2012/05/01,178,13,0.933079718,8806,178,11,2
27962,2014/03/31,2011/02/21,35,9,0.739104075,11117,35,3,6
27963,2014/03/31,2011/07/06,68,12,0.721557039,11387,68,6,6
27964,2014/03/31,2012/02/26,35,16,0.79125,10384,35,8,8
27965,2014/03/31,2012/03/11,71,10,0.775079245,10600,71,6,4
27966,2014/03/31,2012/06/08,112,10,0.7214850270000001,11387,112,4,6
27967,2014/03/31,2008/03/17,116,10,0.549446228,14952,116,7,3
27968,2014/03/31,2006/03/12,92,7,0.53862182,15252,92,5,2
27969,2014/03/31,2009/11/12,9,6,0.8667208270000001,9478,9,1,5
27970,2014/03/31,2010/01/14,25,6,0.701232713,11714,25,5,1
27971,2014/03/31,2013/01/23,104,6,0.6798294979999999,12082,104,1,5
27972,2014/03/31,2007/03/28,144,8,0.726995928,11298,144,2,6
27973,2014/03/31,2012/10/27,14,11,0.506632741,16212,14,8,3
27974,2014/03/31,2005/03/12,101,9,0.747902932,10982,101,5,4
27975,2014/03/31,2013/01/06,5,12,0.6490169889999999,12655,5,1,11
27976,2014/03/31,2008/07/31,256,12,0.805358894,10198,256,9,3
27977,2014/03/31,2008/06/01,361,7,0.787482021,10429,361,6,1
27978,2014/03/31,2009/01/25,286,9,0.666539242,12321,286,5,4
27979,2014/03/31,2007/04/26,5,7,1.3844258980000002,5931,5,2,5
27980,2014/03/31,2009/06/03,231,8,0.763885736,10747,231,5,3
27981,2014/03/31,2011/12/30,539,8,0.648483053,12657,539,8,0
27982,2014/03/31,2009/10/25,229,10,0.745181587,11014,229,4,6
27983,2014/03/31,2011/09/02,60,7,0.5202243910000001,15776,60,2,5
27984,2014/03/31,2006/08/19,224,6,0.8627802309999999,9510,224,2,4
27985,2014/03/31,2007/04/23,68,7,0.5642857139999999,14539,68,3,4
27986,2014/03/31,2010/11/01,39,9,0.525770956,15604,39,4,5
27987,2014/03/31,2009/03/08,240,3,0.71661775,11448,240,1,2
27988,2014/03/31,2010/09/01,347,7,1.5,5469,347,6,1
27989,2014/03/31,2012/01/04,354,4,0.484548139,16930,354,0,4
27990,2014/03/31,2012/08/20,20,9,0.608839902,13473,20,3,6
27991,2014/03/31,2009/01/13,157,14,0.5761083020000001,14238,157,8,6
27992,2014/03/31,2007/04/20,538,7,0.928924122,8830,538,7,0
27993,2014/03/31,2006/05/23,185,7,0.805008342,10189,185,0,7
27994,2014/03/31,2011/04/04,187,9,0.986717998,8312,187,6,3
27995,2014/03/31,2008/05/14,19,10,0.550354986,14902,19,5,5
27996,2014/03/31,2008/05/23,14,10,0.745872669,10995,14,3,7
27997,2014/03/31,2009/02/15,17,11,0.7908515770000001,10369,17,4,7
27998,2014/03/31,2006/04/11,464,4,0.923679171,8877,464,4,0
27999,2014/03/31,2011/10/09,85,8,0.575222394,14254,85,1,7
28000,2014/03/31,2012/07/01,179,9,0.5047817520000001,16243,179,4,5
28001,2014/03/31,2008/05/06,129,4,1.4256911840000002,5751,129,3,1
28002,2014/03/31,2010/11/19,85,6,0.470809119,17414,85,4,2
28003,2014/03/31,2007/03/18,272,5,0.849745025,9648,272,2,3
28004,2014/03/31,2012/11/20,68,8,0.7771333779999999,10549,68,4,4
28005,2014/03/31,2012/09/05,414,8,0.79375,10328,414,8,0
28006,2014/03/31,2012/02/23,438,6,0.741886878,11050,438,6,0
28007,2014/03/31,2009/02/07,56,7,0.691618156,11853,56,2,5
28008,2014/03/31,2012/04/15,337,5,0.6587559270000001,12443,337,3,2
28009,2014/03/31,2005/08/18,34,6,0.926483554,8847,34,4,2
28010,2014/03/31,2007/09/01,401,5,0.785310464,10436,401,5,0
28011,2014/03/31,2006/08/22,63,5,0.7970686640000001,10282,63,1,4
28012,2014/03/31,2008/11/03,195,11,0.556841748,14717,195,4,7
28013,2014/03/31,2008/04/14,250,10,0.611172434,13408,250,7,3
28014,2014/03/31,2012/05/10,176,16,0.7749555509999999,10574,176,10,6
28015,2014/03/31,2010/02/09,691,3,1.0847498009999998,7554,691,3,0
28016,2014/03/31,2011/09/12,67,14,0.657346169,12465,67,3,11
28017,2014/03/31,2010/05/11,591,3,1.033333333,7929,591,3,0
28018,2014/03/31,2012/05/22,513,4,0.775,10572,513,4,0
28019,2014/03/31,2012/05/14,496,4,0.775,10572,496,4,0
28020,2014/03/31,2010/11/25,178,9,0.649515618,12614,178,2,7
28021,2014/03/31,2012/07/25,111,7,0.789673253,10375,111,2,5
28022,2014/03/31,2010/05/23,42,12,0.7100442020000001,11538,42,5,7
28023,2014/03/31,2012/01/15,117,11,0.476980495,17175,117,8,3
28024,2014/03/31,2012/01/15,33,12,0.629013284,13023,33,6,6
28025,2014/03/31,2008/05/09,101,5,0.7972379559999999,10275,101,3,2
28026,2014/03/31,2007/10/06,134,7,0.520559227,15736,134,2,5
28027,2014/03/31,2011/08/05,9,9,0.684550393,11966,9,2,7
28028,2014/03/31,2012/08/20,145,8,0.8885354740000001,9218,145,3,5
28029,2014/03/31,2013/01/20,144,9,0.622608894,13155,144,1,8
28030,2014/03/31,2011/11/22,189,11,0.655852819,12488,189,8,3
28031,2014/03/31,2007/05/20,187,11,0.740053312,11067,187,9,2
28032,2014/03/31,2008/08/20,27,11,0.7099384540000001,11536,27,5,6
28033,2014/03/31,2006/10/01,78,14,0.718368421,11400,78,10,4
28034,2014/03/31,2011/09/09,63,12,0.5152510379999999,15894,63,10,2
28035,2014/03/31,2011/11/16,219,8,0.7807226620000001,10489,219,6,2
28036,2014/03/31,2010/04/14,57,8,0.68375,11976,57,7,1
28037,2014/03/31,2013/01/01,149,8,0.5241323689999999,15623,149,0,8
28038,2014/03/31,2011/11/10,78,10,0.411275239,19910,78,0,10
28039,2014/03/31,2005/07/19,44,6,0.8921880790000001,9177,44,5,1
28040,2014/03/31,2012/05/29,129,9,0.661540886,12376,129,4,5
28041,2014/03/31,2007/12/17,30,10,0.7968,10275,30,5,5
28042,2014/03/31,2009/02/16,1,11,0.586135892,13967,1,6,5
28043,2014/03/31,2011/05/18,30,3,0.7264397909999999,11269,30,1,2
28044,2014/03/31,2011/06/11,178,20,0.674308896,12140,178,15,5
28045,2014/03/31,2009/07/03,197,7,0.502673626,16285,197,6,1
28046,2014/03/31,2012/01/26,407,11,0.768519388,10651,407,11,0
28047,2014/03/31,2010/05/10,38,9,0.591725584,13833,38,4,5
28048,2014/03/31,2012/12/25,273,8,0.86125,9504,273,4,4
28049,2014/03/31,2008/05/30,120,7,0.696711781,11748,120,4,3
28050,2014/03/31,2012/07/06,105,10,0.690125632,11860,105,4,6
28051,2014/03/31,2012/01/06,16,13,0.716712785,11420,16,9,4
28052,2014/03/31,2012/08/02,199,7,0.707356958,11570,199,1,6
28053,2014/03/31,2012/06/10,134,6,0.8548929279999999,9573,134,2,4
28054,2014/03/31,2012/01/04,124,6,0.643025851,12727,124,3,3
28055,2014/03/31,2010/04/19,44,12,0.685220631,11943,44,3,9
28056,2014/03/31,2009/12/13,8,8,0.750266801,10907,8,0,8
28057,2014/03/31,2012/06/19,3,7,0.7828250259999999,10453,3,3,4
28058,2014/03/31,2007/11/08,63,6,0.693333333,11802,63,1,5
28059,2014/03/31,2011/10/30,19,16,0.782624833,10454,19,8,8
28060,2014/03/31,2008/06/07,186,10,0.731427805,11185,186,6,4
28061,2014/03/31,2005/03/14,52,10,0.574809584,14232,52,4,6
28062,2014/03/31,2011/10/15,28,7,0.5516264329999999,14830,28,3,4
28063,2014/03/31,2012/05/25,41,7,0.8070020720000001,10137,41,5,2
28064,2014/03/31,2011/12/30,246,10,0.928835018,8807,246,9,1
28065,2014/03/31,2005/11/27,184,7,0.846338334,9665,184,2,5
28066,2014/03/31,2013/02/07,187,7,0.924027338,8852,187,2,5
28067,2014/03/31,2011/09/10,143,12,0.809151167,10108,143,6,6
28068,2014/03/31,2011/10/25,106,10,0.608707205,13436,106,4,6
28069,2014/03/31,2012/06/08,196,9,0.8994215329999999,9093,196,7,2
28070,2014/03/31,2011/11/24,176,9,0.665316466,12292,176,7,2
28071,2014/03/31,2010/07/28,145,7,0.690288681,11847,145,4,3
28072,2014/03/31,2011/01/14,118,10,0.724323295,11290,118,1,9
28073,2014/03/31,2011/10/07,339,7,0.850031185,9620,339,5,2
28074,2014/03/31,2012/01/18,108,33,0.6573159160000001,12440,108,25,8
28075,2014/03/31,2013/01/03,7,11,0.604402395,13529,7,1,10
28076,2014/03/31,2012/08/24,240,4,0.7860892140000001,10402,240,3,1
28077,2014/03/31,2007/03/06,179,11,0.59188346,13815,179,7,4
28078,2014/03/31,2012/05/18,148,7,0.8181699020000001,9994,148,4,3
28079,2014/03/31,2008/11/04,419,7,0.566681683,14429,419,7,0
28080,2014/03/31,2012/03/29,148,12,0.578523105,14131,148,6,6
28081,2014/03/31,2005/05/17,37,9,0.435170615,18785,37,7,2
28082,2014/03/31,2010/03/24,74,14,0.6176741729999999,13234,74,6,8
28083,2014/03/31,2010/06/11,285,6,0.7862908809999999,10396,285,5,1
28084,2014/03/31,2009/07/11,326,8,0.85682914,9540,326,5,3
28085,2014/03/31,2012/05/26,156,9,0.651405802,12548,156,4,5
28086,2014/03/31,2012/03/25,527,6,0.607567648,13452,527,6,0
28087,2014/03/31,2011/12/11,159,8,0.600279859,13614,159,6,2
28088,2014/03/31,2011/10/21,25,8,0.7707734390000001,10602,25,4,4
28089,2014/03/31,2007/01/03,127,9,0.855138133,9556,127,4,5
28090,2014/03/31,2010/09/28,156,8,0.718360295,11374,156,3,5
28091,2014/03/31,2010/05/11,425,5,0.619566207,13186,425,5,0
28092,2014/03/31,2010/09/27,61,5,0.8431200329999999,9689,61,2,3
28093,2014/03/31,2006/09/29,26,8,0.508286977,16071,26,0,8
28094,2014/03/31,2009/06/13,74,22,0.613492302,13315,74,10,12
28095,2014/03/31,2007/04/26,41,11,0.580466885,14072,41,4,7
28096,2014/03/31,2008/04/26,107,7,0.7715879459999999,10586,107,3,4
28097,2014/03/31,2010/03/06,218,7,0.914622536,8928,218,3,4
28098,2014/03/31,2011/08/02,258,4,0.689422492,11844,258,3,1
28099,2014/03/31,2012/12/01,192,4,0.577382973,14142,192,0,4
28100,2014/03/31,2013/01/29,160,10,0.716250877,11400,160,3,7
28101,2014/03/31,2012/09/24,149,8,0.715217696,11415,149,1,7
28102,2014/03/31,2012/05/07,582,6,0.694293732,11759,582,6,0
28103,2014/03/31,2008/01/27,367,6,0.7200211679999999,11338,367,6,0
28104,2014/03/31,2012/03/24,226,8,0.742546844,10994,226,4,4
28105,2014/03/31,2011/01/24,562,3,0.851732053,9584,562,3,0
28106,2014/03/31,2006/06/07,81,10,0.5765216470000001,14159,81,2,8
28107,2014/03/31,2012/03/12,62,6,0.683432136,11943,62,2,4
28108,2014/03/31,2008/03/20,109,9,0.513246557,15903,109,5,4
28109,2014/03/31,2007/11/22,22,6,0.665174438,12268,22,3,3
28110,2014/03/31,2008/11/28,43,8,0.7866853070000001,10372,43,0,8
28111,2014/03/31,2008/06/17,6,8,0.779165393,10472,6,5,3
28112,2014/03/31,2010/11/17,6,11,0.5212591839999999,15653,6,6,5
28113,2014/03/31,2007/10/01,51,11,0.8143766840000001,10019,51,3,8
28114,2014/03/31,2012/01/20,1,9,0.79323741,10286,1,5,4
28115,2014/03/31,2010/10/14,119,8,0.7353280459999999,11096,119,5,3
28116,2014/03/31,2007/11/25,113,8,0.560725036,14551,113,2,6
28117,2014/03/31,2005/03/12,45,14,0.932037926,8754,45,6,8
28118,2014/03/31,2011/08/06,291,22,0.6568515979999999,12419,291,18,4
28119,2014/03/31,2009/09/23,102,10,0.711806598,11458,102,2,8
28120,2014/03/31,2009/09/07,5,19,0.531736863,15338,5,4,15
28121,2014/03/31,2010/03/17,18,10,0.6540781139999999,12469,18,6,4
28122,2014/03/31,2008/11/20,292,9,0.7932448209999999,10281,292,7,2
28123,2014/03/31,2005/01/28,224,16,0.51219696,15922,224,7,9
28124,2014/03/31,2010/09/10,4,8,0.625509703,13037,4,6,2
28125,2014/03/31,2011/06/05,170,28,0.726672607,11222,170,16,12
28126,2014/03/31,2012/09/22,165,9,0.8829464,9235,165,3,6
28127,2014/03/31,2013/03/28,24,12,0.715089458,11402,24,1,11
28128,2014/03/31,2012/09/25,331,7,0.644819268,12643,331,3,4
28129,2014/03/31,2007/09/17,125,15,0.82086094,9931,125,10,5
28130,2014/03/31,2010/09/27,90,7,1.477520392,5517,90,5,2
28131,2014/03/31,2011/06/03,88,9,0.6760208990000001,12058,88,7,2
28132,2014/03/31,2007/10/11,340,5,0.6443754939999999,12650,340,4,1
28133,2014/03/31,2006/05/11,177,10,0.591091371,13790,177,5,5
28134,2014/03/31,2008/05/27,299,7,0.79743078,10221,299,4,3
28135,2014/03/31,2012/10/20,112,10,0.5530051570000001,14738,112,5,5
28136,2014/03/31,2005/03/04,153,7,0.6104876770000001,13349,153,4,3
28137,2014/03/31,2005/07/02,231,11,0.593583655,13729,231,6,5
28138,2014/03/31,2012/09/10,38,9,0.625729863,13023,38,2,7
28139,2014/03/31,2010/06/20,102,8,0.830912613,9807,102,4,4
28140,2014/03/31,2012/08/22,517,6,0.944085274,8631,517,6,0
28141,2014/03/31,2012/08/15,34,10,0.539766163,15096,34,4,6
28142,2014/03/31,2010/11/27,178,7,0.7751369859999999,10512,178,4,3
28143,2014/03/31,2006/06/12,6,12,0.6854546979999999,11887,6,6,6
28144,2014/03/31,2012/07/10,356,8,0.6371705639999999,12787,356,6,2
28145,2014/03/31,2013/03/21,75,9,0.758679456,10738,75,1,8
28146,2014/03/31,2011/03/22,160,10,0.60592116,13445,160,9,1
28147,2014/03/31,2011/09/01,121,7,0.732739701,11118,121,6,1
28148,2014/03/31,2012/11/03,187,9,0.619039514,13160,187,3,6
28149,2014/03/31,2012/12/04,160,13,0.7303003140000001,11155,160,2,11
28150,2014/03/31,2013/01/14,54,11,0.7624164720000001,10685,54,1,10
28151,2014/03/31,2011/01/08,174,8,0.7204651990000001,11307,174,5,3
28152,2014/03/31,2006/11/29,15,11,0.676039834,12050,15,0,11
28153,2014/03/31,2009/08/17,537,7,0.568385431,14332,537,7,0
28154,2014/03/31,2011/12/18,203,6,0.8493680920000001,9590,203,4,2
28155,2014/03/31,2010/12/24,60,4,0.7195556540000001,11320,60,0,4
28156,2014/03/31,2005/06/17,202,5,0.64509703,12625,202,3,2
28157,2014/03/31,2010/09/03,179,12,0.809545726,10060,179,5,7
28158,2014/03/31,2007/04/24,118,20,0.57132744,14253,118,13,7
28159,2014/03/31,2013/02/10,61,6,0.896054804,9087,61,0,6
28160,2014/03/31,2008/05/08,199,9,0.594112668,13704,199,7,2
28161,2014/03/31,2011/08/24,87,9,0.831030928,9797,87,6,3
28162,2014/03/31,2010/01/09,51,8,0.7996719379999999,10181,51,3,5
28163,2014/03/31,2011/07/17,426,4,0.760954295,10699,426,4,0
28164,2014/03/31,2012/06/07,144,12,0.6941094720000001,11729,144,4,8
28165,2014/03/31,2008/11/09,353,10,0.7268928570000001,11200,353,7,3
28166,2014/03/31,2009/12/14,40,11,0.7362521479999999,11057,40,1,10
28167,2014/03/31,2011/07/20,110,11,0.652800321,12470,110,4,7
28168,2014/03/31,2011/04/14,76,9,0.6270443689999999,12982,76,5,4
28169,2014/03/31,2008/03/02,36,11,0.5372693070000001,15150,36,7,4
28170,2014/03/31,2010/11/11,135,8,0.761016363,10695,135,4,4
28171,2014/03/31,2012/09/14,42,10,0.456193039,17841,42,3,7
28172,2014/03/31,2005/08/16,43,9,0.6915226440000001,11769,43,4,5
28173,2014/03/31,2010/11/17,213,11,0.549217843,14818,213,4,7
28174,2014/03/31,2012/08/16,139,12,0.73,11148,139,9,3
28175,2014/03/31,2010/09/09,232,6,0.8947899709999999,9094,232,4,2
28176,2014/03/31,2011/11/30,262,7,0.645171265,12612,262,6,1
28177,2014/03/31,2010/03/23,76,5,1.190020477,6837,76,1,4
28178,2014/03/31,2005/09/01,110,9,0.603323693,13485,110,5,4
28179,2014/03/31,2007/07/10,104,3,1.491141862,5456,104,1,2
28180,2014/03/31,2011/11/05,7,9,0.531111111,15318,7,2,7
28181,2014/03/31,2010/10/22,172,8,0.671849038,12109,172,7,1
28182,2014/03/31,2011/02/15,86,11,0.531917092,15294,86,8,3
28183,2014/03/31,2012/05/23,9,8,0.74749127,10882,9,6,2
28184,2014/03/31,2007/08/14,102,8,0.8706101479999999,9342,102,6,2
28185,2014/03/31,2011/01/11,13,7,0.841149033,9669,13,4,3
28186,2014/03/31,2012/06/27,114,10,1.018367142,7986,114,4,6
28187,2014/03/31,2013/03/28,12,10,0.857483129,9484,12,1,9
28188,2014/03/31,2012/01/15,116,4,0.53,15344,116,2,2
28189,2014/03/31,2010/01/14,6,15,0.601973645,13508,6,10,5
28190,2014/03/31,2012/05/21,93,10,0.6334792770000001,12836,93,9,1
28191,2014/03/31,2009/10/18,51,6,0.79247271,10260,51,0,6
28192,2014/03/31,2008/03/05,31,14,0.57274956,14195,31,5,9
28193,2014/03/31,2005/04/27,153,11,0.6469871079999999,12566,153,4,7
28194,2014/03/31,2007/11/14,4,3,1.43740099,5656,4,1,2
28195,2014/03/31,2006/09/15,24,7,0.695321587,11692,24,3,4
28196,2014/03/31,2011/08/24,18,8,0.7337295779999999,11079,18,4,4
28197,2014/03/31,2004/12/10,226,14,0.634808278,12805,226,3,11
28198,2014/03/31,2010/10/06,97,5,0.68167729,11924,97,2,3
28199,2014/03/31,2007/05/20,361,10,0.912672656,8905,361,9,1
28200,2014/03/31,2011/06/03,25,5,1.41,5764,25,0,5
28201,2014/03/31,2011/09/23,625,5,0.7,11610,625,5,0
28202,2014/03/31,2012/03/29,277,5,0.752351416,10802,277,0,5
28203,2014/03/31,2011/01/15,8,8,0.570465426,14245,8,0,8
28204,2014/03/31,2005/07/03,110,7,0.5997579160000001,13549,110,2,5
28205,2014/03/31,2011/12/18,265,6,0.981960121,8275,265,4,2
28206,2014/03/31,2012/07/25,31,10,0.784301158,10360,31,9,1
28207,2014/03/31,2010/11/29,222,8,0.7356269809999999,11045,222,6,2
28208,2014/03/31,2006/10/19,274,12,0.447239595,18164,274,9,3
28209,2014/03/31,2007/09/24,167,4,1.477475446,5498,167,3,1
28210,2014/03/31,2011/08/20,7,10,0.739265562,10988,7,6,4
28211,2014/03/31,2007/12/05,250,8,0.581626808,13966,250,6,2
28212,2014/03/31,2012/12/03,146,9,0.826253687,9831,146,1,8
28213,2014/03/31,2010/04/29,166,4,0.76,10688,166,3,1
28214,2014/03/31,2012/08/21,31,13,0.5696136039999999,14260,31,3,10
28215,2014/03/31,2012/05/12,6,8,0.680276405,11939,6,3,5
28216,2014/03/31,2012/08/15,107,8,0.54098934,15010,107,7,1
28217,2014/03/31,2011/06/23,138,7,0.8490286490000001,9564,138,2,5
28218,2014/03/31,2011/01/21,17,7,0.756828223,10729,17,5,2
28219,2014/03/31,2010/11/09,80,8,0.642009963,12647,80,6,2
28220,2014/03/31,2012/05/16,535,6,0.8857298709999999,9166,535,6,0
28221,2014/03/31,2011/05/24,59,6,0.751507914,10803,59,3,3
28222,2014/03/31,2012/04/12,52,8,0.667839572,12155,52,7,1
28223,2014/03/31,2013/02/16,185,6,0.712816122,11388,185,2,4
28224,2014/03/31,2011/07/05,83,8,0.8538340170000001,9507,83,2,6
28225,2014/03/31,2012/10/12,38,17,0.67530782,12020,38,1,16
28226,2014/03/31,2011/12/12,197,8,0.722407655,11235,197,7,1
28227,2014/03/31,2013/03/26,19,12,0.769947823,10541,19,3,9
28228,2014/03/31,2008/08/03,45,3,1.456235421,5573,45,2,1
28229,2014/03/31,2010/05/09,197,9,0.8435121090000001,9621,197,7,2
28230,2014/03/31,2010/03/02,169,8,0.743499771,10915,169,2,6
28231,2014/03/31,2010/04/28,11,5,0.599134672,13544,11,0,5
28232,2014/03/31,2008/03/17,146,6,0.549342631,14771,146,0,6
28233,2014/03/31,2008/01/16,46,8,0.559278329,14508,46,3,5
28234,2014/03/31,2007/09/02,348,8,0.814772043,9958,348,7,1
28235,2014/03/31,2007/02/28,115,15,0.623376104,13015,115,1,14
28236,2014/03/31,2005/09/22,89,11,0.476396359,17030,89,0,11
28237,2014/03/31,2008/03/22,5,8,0.7971877759999999,10177,5,5,3
28238,2014/03/31,2012/10/15,114,7,0.634512748,12786,114,0,7
28239,2014/03/31,2012/08/16,215,5,0.796154073,10190,215,4,1
28240,2014/03/31,2009/10/31,201,11,0.7489595640000001,10832,201,7,4
28241,2014/03/31,2011/12/20,529,9,0.5392308720000001,15043,529,9,0
28242,2014/03/31,2012/06/04,14,11,0.602739095,13457,14,2,9
28243,2014/03/31,2012/01/13,208,8,0.983156364,8250,208,5,3
28244,2014/03/31,2012/04/20,275,7,0.580715257,13967,275,3,4
28245,2014/03/31,2006/12/12,6,7,0.822660513,9859,6,0,7
28246,2014/03/31,2010/12/13,448,8,0.602026425,13472,448,8,0
28247,2014/03/31,2011/11/13,329,12,0.70991334,11424,329,10,2
28248,2014/03/31,2009/03/14,572,9,0.784578173,10336,572,9,0
28249,2014/03/31,2013/01/18,12,11,0.625980854,12953,12,2,9
28250,2014/03/31,2008/04/17,6,6,1.4378666430000002,5639,6,1,5
28251,2014/03/31,2009/01/05,11,11,0.826337138,9812,11,6,5
28252,2014/03/31,2013/03/01,117,11,0.687250996,11797,117,0,11
28253,2014/03/31,2006/08/20,10,6,0.620630789,13063,10,5,1
28254,2014/03/31,2011/07/20,171,17,0.528297276,15346,171,13,4
28255,2014/03/31,2010/07/16,8,16,0.7952103970000001,10195,8,4,12
28256,2014/03/31,2010/08/19,185,10,0.835490055,9703,185,6,4
28257,2014/03/31,2005/08/31,99,10,0.7869663140000001,10301,99,5,5
28258,2014/03/31,2010/05/22,133,9,0.824698342,9829,133,5,4
28259,2014/03/31,2012/09/11,79,9,0.611556511,13254,79,5,4
28260,2014/03/31,2012/05/27,61,19,0.612978144,13223,61,2,17
28261,2014/03/31,2006/11/10,215,7,0.966496542,8386,215,2,5
28262,2014/03/31,2010/12/11,44,5,0.661390566,12254,44,1,4
28263,2014/03/31,2011/07/19,5,6,0.818261309,9904,5,0,6
28264,2014/03/31,2006/09/04,155,5,0.8240000000000001,9835,155,4,1
28265,2014/03/31,2012/12/01,100,12,0.939135473,8629,100,8,4
28266,2014/03/31,2008/04/15,65,16,0.6818773140000001,11884,65,1,15
28267,2014/03/31,2007/06/24,45,12,0.6077685270000001,13332,45,7,5
28268,2014/03/31,2011/01/01,25,7,0.644295483,12576,25,4,3
28269,2014/03/31,2009/12/24,83,10,0.579478615,13982,83,7,3
28270,2014/03/31,2009/09/21,51,11,0.570041514,14212,51,5,6
28271,2014/03/31,2008/09/09,56,7,0.822431472,9850,56,4,3
28272,2014/03/31,2012/12/21,59,4,0.7,11572,59,2,2
28273,2014/03/31,2006/04/20,232,4,0.975,8308,232,3,1
28274,2014/03/31,2012/05/30,11,8,0.8299948770000001,9759,11,3,5
28275,2014/03/31,2011/03/03,538,6,1.262784534,6414,538,6,0
28276,2014/03/31,2009/10/20,121,9,0.592707114,13664,121,6,3
28277,2014/03/31,2011/12/03,621,4,0.75,10798,621,4,0
28278,2014/03/31,2009/04/18,10,16,0.645911629,12538,10,4,12
28279,2014/03/31,2008/11/20,235,8,0.872858375,9278,235,4,4
28280,2014/03/31,2010/06/25,58,11,0.829830925,9759,58,6,5
28281,2014/03/31,2009/11/05,25,6,0.6996880940000001,11574,25,3,3
28282,2014/03/31,2010/07/24,416,8,0.657625467,12314,416,8,0
28283,2014/03/31,2008/10/14,150,6,0.60636316,13355,150,1,5
28284,2014/03/31,2009/03/25,146,8,0.6829653370000001,11857,146,1,7
28285,2014/03/31,2009/03/28,12,9,0.714402682,11334,12,6,3
28286,2014/03/31,2012/05/27,135,6,0.695345242,11644,135,3,3
28287,2014/03/31,2007/11/07,71,8,0.61777871,13105,71,3,5
28288,2014/03/31,2011/09/05,66,12,0.772978134,10473,66,7,5
28289,2014/03/31,2010/03/27,215,7,0.69119877,11712,215,1,6
28290,2014/03/31,2006/04/15,68,9,0.591560216,13684,68,3,6
28291,2014/03/31,2010/09/23,140,6,0.7741922529999999,10455,140,3,3
28292,2014/03/31,2005/09/29,28,10,0.665237939,12167,28,5,5
28293,2014/03/31,2012/03/21,16,8,0.640830562,12630,16,2,6
28294,2014/03/31,2008/05/31,310,6,0.730671662,11077,310,2,4
28295,2014/03/31,2008/12/15,79,6,0.675126387,11987,79,3,3
28296,2014/03/31,2012/08/09,96,6,0.785665049,10300,96,1,5
28297,2014/03/31,2008/02/21,90,6,0.6455840110000001,12534,90,2,4
28298,2014/03/31,2013/03/02,25,11,0.625324575,12940,25,3,8
28299,2014/03/31,2007/10/08,94,5,0.896279353,9028,94,2,3
28300,2014/03/31,2012/09/30,79,13,0.4622457720000001,17504,79,1,12
28301,2014/03/31,2011/03/17,146,10,0.655225948,12348,146,8,2
28302,2014/03/31,2007/12/30,70,12,0.895385126,9036,70,2,10
28303,2014/03/31,2011/02/01,2,13,0.796858072,10153,2,6,7
28304,2014/03/31,2005/09/05,159,10,0.55664098,14534,159,2,8
28305,2014/03/31,2013/03/17,131,2,0.537595029,15048,131,1,1
28306,2014/03/31,2012/07/21,185,9,0.767176593,10544,185,4,5
28307,2014/03/31,2011/06/24,138,8,0.676886192,11950,138,3,5
28308,2014/03/31,2011/10/01,206,7,0.8527622559999999,9485,206,5,2
28309,2014/03/31,2008/06/12,74,10,0.759190914,10654,74,4,6
28310,2014/03/31,2007/06/18,570,7,0.614200015,13169,570,7,0
28311,2014/03/31,2010/02/09,128,4,0.677984912,11930,128,0,4
28312,2014/03/31,2012/12/19,12,8,0.922856002,8764,12,0,8
28313,2014/03/31,2010/04/12,428,10,0.649823236,12446,428,10,0
28314,2014/03/31,2010/09/16,73,10,0.701869305,11523,73,5,5
28315,2014/03/31,2013/03/26,93,7,0.646331229,12511,93,0,7
28316,2014/03/31,2012/06/19,418,5,0.909845842,8887,418,5,0
28317,2014/03/31,2006/05/26,254,7,0.739889275,10928,254,3,4
28318,2014/03/31,2013/02/16,262,6,0.685,11802,262,3,3
28319,2014/03/31,2012/10/27,61,7,0.8933837990000001,9049,61,3,4
28320,2014/03/31,2009/04/22,650,8,0.6549910870000001,12342,650,8,0
28321,2014/03/31,2010/10/07,177,8,0.906907887,8913,177,6,2
28322,2014/03/31,2011/09/19,19,10,0.531199395,15216,19,0,10
28323,2014/03/31,2012/07/30,63,8,0.913684151,8846,63,4,4
28324,2014/03/31,2005/02/09,44,10,0.7144943420000001,11312,44,3,7
28325,2014/03/31,2008/11/01,134,6,0.604016442,13380,134,4,2
28326,2014/03/31,2012/07/03,2,14,0.650053089,12432,2,4,10
28327,2014/03/31,2007/07/04,23,16,0.654478011,12347,23,6,10
28328,2014/03/31,2011/02/04,74,10,0.5029818229999999,16064,74,8,2
28329,2014/03/31,2007/12/09,299,12,0.975833333,8280,299,5,7
28330,2014/03/31,2010/09/04,574,9,0.839141047,9628,574,9,0
28331,2014/03/31,2006/07/03,394,13,0.5941388439999999,13598,394,13,0
28332,2014/03/31,2005/01/07,37,9,0.542892279,14881,37,2,7
28333,2014/03/31,2012/04/26,66,7,0.7621898290000001,10599,66,3,4
28334,2014/03/31,2013/01/25,243,7,0.632953851,12763,243,4,3
28335,2014/03/31,2011/02/11,102,11,0.661020375,12221,102,2,9
28336,2014/03/31,2011/09/11,593,8,0.387394495,20852,593,8,0
28337,2014/03/31,2006/07/24,126,4,0.801668486,10075,126,2,2
28338,2014/03/31,2007/09/19,426,7,0.5498025870000001,14690,426,7,0
28339,2014/03/31,2012/04/17,412,12,0.8712405609999999,9270,412,12,0
28340,2014/03/31,2011/11/11,73,16,0.775938701,10408,73,9,7
28341,2014/03/31,2012/02/17,262,9,0.524574212,15395,262,5,4
28342,2014/03/31,2005/03/09,186,6,0.8283105959999999,9749,186,3,3
28343,2014/03/31,2007/10/09,184,6,0.834558702,9676,184,4,2
28344,2014/03/31,2010/05/30,674,3,0.833333333,9690,674,3,0
28345,2014/03/31,2013/02/27,86,5,0.940800419,8583,86,2,3
28346,2014/03/31,2012/09/28,250,5,0.5073121389999999,15916,250,3,2
28347,2014/03/31,2005/04/01,207,5,1.068689436,7554,207,1,4
28348,2014/03/31,2011/02/03,80,9,0.7660258109999999,10538,80,4,5
28349,2014/03/31,2008/04/06,157,7,0.7880845459999999,10243,157,2,5
28350,2014/03/31,2012/11/04,97,9,0.779236413,10359,97,6,3
28351,2014/03/31,2008/11/09,15,4,0.72014185,11209,15,0,4
28352,2014/03/31,2012/02/07,15,4,0.72014185,11209,15,0,4
28353,2014/03/31,2012/02/22,208,9,0.6678818470000001,12086,208,7,2
28354,2014/03/31,2012/06/14,117,8,0.658223781,12262,117,3,5
28355,2014/03/31,2013/02/18,225,6,0.677528543,11912,225,1,5
28356,2014/03/31,2012/07/15,88,12,0.5997280229999999,13457,88,4,8
28357,2014/03/31,2007/02/18,30,10,0.6007809129999999,13433,30,3,7
28358,2014/03/31,2008/06/21,402,9,0.7169050370000001,11257,402,9,0
28359,2014/03/31,2011/08/06,386,8,0.614802682,13126,386,8,0
28360,2014/03/31,2012/04/21,171,5,0.592200205,13626,171,4,1
28361,2014/03/31,2012/05/12,504,10,0.726100063,11113,504,10,0
28362,2014/03/31,2012/11/04,22,14,0.7219370140000001,11177,22,12,2
28363,2014/03/31,2006/09/25,164,4,0.695247286,11606,164,0,4
28364,2014/03/31,2012/01/18,87,11,0.7571875,10656,87,5,6
28365,2014/03/31,2012/03/29,8,10,0.649705953,12413,8,1,9
28366,2014/03/31,2008/11/16,82,5,0.82,9835,82,0,5
28367,2014/03/31,2012/04/24,557,7,0.585714286,13769,557,7,0
28368,2014/03/31,2012/04/15,350,8,0.5125,15736,350,7,1
28369,2014/03/31,2012/03/05,211,13,0.635165,12697,211,10,3
28370,2014/03/31,2008/03/29,92,7,0.746400407,10804,92,3,4
28371,2014/03/31,2012/02/21,303,11,0.734640547,10975,303,10,1
28372,2014/03/31,2012/01/07,172,11,0.522673755,15424,172,8,3
28373,2014/03/31,2012/12/09,11,6,0.6983419959999999,11544,11,1,5
28374,2014/03/31,2012/06/27,208,2,0.889701987,9060,208,1,1
28375,2014/03/31,2011/12/09,111,8,1.077612299,7480,111,4,4
28376,2014/03/31,2006/12/10,197,3,1.466000364,5498,197,1,2
28377,2014/03/31,2009/10/10,136,12,0.779047941,10346,136,3,9
28378,2014/03/31,2009/01/06,94,15,0.641157426,12571,94,5,10
28379,2014/03/31,2012/08/05,90,11,0.707837505,11385,90,8,3
28380,2014/03/31,2011/11/11,536,5,0.880427182,9153,536,5,0
28381,2014/03/31,2011/04/15,314,5,0.972649366,8285,314,4,1
28382,2014/03/31,2012/06/05,346,7,0.55072444,14632,346,2,5
28383,2014/03/31,2006/04/18,109,15,0.645644231,12480,109,7,8
28384,2014/03/31,2009/10/08,181,9,0.679829565,11852,181,5,4
28385,2014/03/31,2011/08/23,61,4,1.050461538,7670,61,2,2
28386,2014/03/31,2005/09/09,557,11,0.8319909129999999,9684,557,11,0
28387,2014/03/31,2007/06/21,148,8,0.715461327,11261,148,6,2
28388,2014/03/31,2010/11/30,8,7,1.146760142,7025,8,0,7
28389,2014/03/31,2008/06/13,14,10,0.6063435189999999,13286,14,9,1
28390,2014/03/31,2010/06/28,14,12,0.737541659,10922,14,4,8
28391,2014/03/31,2012/08/25,22,11,0.8072381999999999,9979,22,5,6
28392,2014/03/31,2012/06/26,251,3,0.7548823920000001,10671,251,1,2
28393,2014/03/31,2011/07/12,24,17,0.479855832,16786,24,8,9
28394,2014/03/31,2007/11/08,177,9,0.5917801779999999,13611,177,7,2
28395,2014/03/31,2012/09/08,98,5,1.039359917,7749,98,3,2
28396,2014/03/31,2009/05/26,104,8,0.63546552,12674,104,5,3
28397,2014/03/31,2009/08/10,69,10,0.582173064,13833,69,2,8
28398,2014/03/31,2011/07/11,111,10,0.8886040609999999,9062,111,7,3
28399,2014/03/31,2012/04/21,157,11,0.599965725,13421,157,6,5
28400,2014/03/31,2011/07/02,160,13,0.415399298,19384,160,3,10
28401,2014/03/31,2007/05/30,14,17,0.706315466,11399,14,0,17
28402,2014/03/31,2007/04/06,80,10,0.527420242,15265,80,8,2
28403,2014/03/31,2006/05/07,15,9,0.602263544,13364,15,1,8
28404,2014/03/31,2010/03/11,379,7,0.758081379,10617,379,7,0
28405,2014/03/31,2011/07/03,371,8,0.3871434070000001,20787,371,8,0
28406,2014/03/31,2012/08/25,184,8,0.823692938,9770,184,5,3
28407,2014/03/31,2007/04/30,593,9,0.7977941909999999,10087,593,9,0
28408,2014/03/31,2011/07/11,214,8,0.747299155,10767,214,6,2
28409,2014/03/31,2013/01/14,136,10,1.290577478,6234,136,2,8
28410,2014/03/31,2011/04/14,279,8,0.790229862,10180,279,1,7
28411,2014/03/31,2012/03/17,25,9,0.640584488,12558,25,2,7
28412,2014/03/31,2012/12/16,82,8,0.616323169,13052,82,6,2
28413,2014/03/31,2013/02/11,42,10,0.666125373,12076,42,1,9
28414,2014/03/31,2012/06/23,238,5,0.760015117,10584,238,3,2
28415,2014/03/31,2010/05/04,257,12,0.608499887,13219,257,9,3
28416,2014/03/31,2006/12/10,314,7,0.6372167639999999,12622,314,6,1
28417,2014/03/31,2012/12/23,164,4,0.7125,11288,164,2,2
28418,2014/03/31,2011/02/22,263,11,0.6946536529999999,11578,263,4,7
28419,2014/03/31,2011/12/18,119,15,0.588130165,13675,119,11,4
28420,2014/03/31,2011/04/08,75,6,0.674875388,11917,75,2,4
28421,2014/03/31,2008/02/21,203,3,0.635317166,12659,203,1,2
28422,2014/03/31,2011/04/03,75,8,0.762883028,10541,75,6,2
28423,2014/03/31,2012/02/23,286,4,1.206507127,6665,286,2,2
28424,2014/03/31,2011/12/25,89,8,0.767228318,10481,89,1,7
28425,2014/03/31,2011/10/01,108,9,0.822543985,9776,108,6,3
28426,2014/03/31,2012/04/07,98,5,1.3442276830000002,5982,98,4,1
28427,2014/03/31,2012/08/20,179,11,0.621296654,12941,179,5,6
28428,2014/03/31,2012/05/08,101,10,0.629223605,12777,101,4,6
28429,2014/03/31,2012/06/05,84,10,0.482374895,16666,84,2,8
28430,2014/03/31,2007/09/30,34,8,0.658198788,12214,34,1,7
28431,2014/03/31,2013/02/09,133,12,0.8205767070000001,9797,133,3,9
28432,2014/03/31,2011/08/31,8,8,0.8517758,9438,8,0,8
28433,2014/03/31,2009/12/28,10,14,0.820732081,9794,10,0,14
28434,2014/03/31,2008/04/06,181,6,0.699881585,11485,181,3,3
28435,2014/03/31,2009/05/09,81,5,0.629743811,12764,81,0,5
28436,2014/03/31,2007/11/29,1,5,1.374490424,5848,1,2,3
28437,2014/03/31,2012/05/08,17,11,0.7960816159999999,10096,17,6,5
28438,2014/03/31,2011/01/22,88,7,0.7330280920000001,10964,88,4,3
28439,2014/03/31,2011/06/23,285,4,0.7007454879999999,11469,285,1,3
28440,2014/03/31,2012/09/28,48,11,0.656638614,12239,48,5,6
28441,2014/03/31,2013/01/30,99,16,0.767212144,10474,99,4,12
28442,2014/03/31,2007/07/02,67,7,0.595198133,13501,67,2,5
28443,2014/03/31,2005/11/14,27,13,0.824620279,9744,27,0,13
28444,2014/03/31,2010/05/12,4,12,0.489431078,16417,4,5,7
28445,2014/03/31,2011/03/15,206,4,0.76,10572,206,2,2
28446,2014/03/31,2008/04/17,101,8,0.7322190829999999,10973,101,2,6
28447,2014/03/31,2010/01/14,62,6,0.815932771,9847,62,1,5
28448,2014/03/31,2011/09/06,14,4,1.1180754240000002,7186,14,1,3
28449,2014/03/31,2007/06/11,139,8,0.5925,13560,139,5,3
28450,2014/03/31,2011/12/19,4,11,0.6980260640000001,11510,4,5,6
28451,2014/03/31,2012/11/12,206,9,0.662222222,12132,206,3,6
28452,2014/03/31,2013/02/09,46,5,0.7406508709999999,10847,46,2,3
28453,2014/03/31,2009/07/23,15,11,0.595507451,13489,15,7,4
28454,2014/03/31,2012/04/11,14,6,0.7060970459999999,11376,14,4,2
28455,2014/03/31,2012/02/03,100,6,0.7469202159999999,10754,100,4,2
28456,2014/03/31,2012/03/14,15,17,0.6058603,13257,15,15,2
28457,2014/03/31,2010/05/21,37,10,0.602671269,13327,37,6,4
28458,2014/03/31,2010/12/13,303,8,0.7675,10464,303,7,1
28459,2014/03/31,2009/02/26,62,11,0.7803118929999999,10292,62,9,2
28460,2014/03/31,2010/01/01,178,14,0.563452606,14253,178,10,4
28461,2014/03/31,2011/12/29,238,9,0.919487062,8734,238,7,2
28462,2014/03/31,2010/07/13,200,6,0.80408431,9987,200,5,1
28463,2014/03/31,2007/03/20,58,6,0.615713848,13042,58,0,6
28464,2014/03/31,2007/08/22,138,14,0.794666007,10105,138,4,10
28465,2014/03/31,2013/01/07,32,15,0.839501307,9565,32,0,15
28466,2014/03/31,2011/03/28,445,9,0.592816537,13545,445,9,0
28467,2014/03/31,2006/12/14,149,8,0.911014295,8814,149,4,4
28468,2014/03/31,2011/11/27,71,9,0.632096355,12703,71,0,9
28469,2014/03/31,2008/12/19,154,9,0.753656843,10654,154,6,3
28470,2014/03/31,2010/11/01,189,8,0.747595903,10740,189,2,6
28471,2014/03/31,2012/09/11,28,7,0.743978873,10792,28,1,6
28472,2014/03/31,2008/12/28,122,6,0.867033477,9260,122,5,1
28473,2014/03/31,2010/06/10,147,7,0.76281642,10524,147,4,3
28474,2014/03/31,2012/05/30,5,5,0.98252571,8168,5,4,1
28475,2014/03/31,2012/10/25,1,9,0.852027816,9419,1,1,8
28476,2014/03/31,2013/02/21,194,11,0.7907449740000001,10148,194,2,9
28477,2014/03/31,2011/06/30,117,4,1.477201767,5432,117,2,2
28478,2014/03/31,2007/11/01,505,6,0.7338790820000001,10933,505,6,0
28479,2014/03/31,2012/02/05,170,19,0.6903708479999999,11622,170,10,9
28480,2014/03/31,2006/12/07,213,13,0.521644993,15380,213,10,3
28481,2014/03/31,2005/10/17,199,8,0.8919913279999999,8994,199,6,2
28482,2014/03/31,2010/06/15,153,7,0.8234766990000001,9742,153,3,4
28483,2014/03/31,2012/07/24,511,7,0.978571429,8197,511,7,0
28484,2014/03/31,2007/09/09,281,9,0.520952134,15397,281,7,2
28485,2014/03/31,2011/03/10,105,17,0.835777847,9597,105,8,9
28486,2014/03/31,2007/11/15,26,7,0.69535674,11535,26,0,7
28487,2014/03/31,2012/08/12,217,11,0.717423971,11180,217,4,7
28488,2014/03/31,2011/04/17,43,6,0.7505165640000001,10686,43,3,3
28489,2014/03/31,2011/08/05,671,4,0.771819057,10390,671,4,0
28490,2014/03/31,2010/03/01,544,7,0.950248845,8439,544,7,0
28491,2014/03/31,2009/10/15,51,9,0.60959328,13154,51,7,2
28492,2014/03/31,2010/12/06,159,11,0.419340481,19120,159,6,5
28493,2014/03/31,2011/08/08,1,8,0.733422377,10931,1,5,3
28494,2014/03/31,2005/08/27,81,9,0.773290248,10367,81,5,4
28495,2014/03/31,2010/05/01,23,9,0.802864296,9985,23,0,9
28496,2014/03/31,2011/12/13,466,9,0.870896252,9205,466,9,0
28497,2014/03/31,2006/02/18,650,2,1.5,5344,650,2,0
28498,2014/03/31,2012/08/09,248,9,0.560441228,14301,248,4,5
28499,2014/03/31,2013/01/12,142,4,0.628500627,12752,142,2,2
28500,2014/03/31,2009/05/01,2,2,1.41,5684,2,0,2
28501,2014/03/31,2009/04/10,142,9,0.874685658,9162,142,7,2
28502,2014/03/31,2006/07/26,171,5,0.831694862,9635,171,1,4
28503,2014/03/31,2012/02/27,361,6,0.834279021,9605,361,5,1
28504,2014/03/31,2011/03/16,283,6,0.586184345,13670,283,4,2
28505,2014/03/31,2009/08/06,94,9,0.738784805,10846,94,5,4
28506,2014/03/31,2008/08/22,98,10,0.6356950170000001,12604,98,6,4
28507,2014/03/31,2012/05/25,601,7,0.7877531959999999,10170,601,7,0
28508,2014/03/31,2012/01/10,46,6,0.923333333,8676,46,5,1
28509,2014/03/31,2008/05/25,38,7,0.8819577190000001,9082,38,3,4
28510,2014/03/31,2011/10/18,61,13,0.927775976,8633,61,8,5
28511,2014/03/31,2006/06/14,148,17,0.56718646,14121,148,9,8
28512,2014/03/31,2008/09/19,198,7,0.723396261,11071,198,1,6
28513,2014/03/31,2011/09/21,134,7,0.672916562,11901,134,0,7
28514,2014/03/31,2007/08/09,95,6,0.625343589,12806,95,3,3
28515,2014/03/31,2012/07/01,311,6,0.596706408,13420,311,4,2
28516,2014/03/31,2010/10/12,159,9,0.768988764,10413,159,2,7
28517,2014/03/31,2012/07/20,18,14,0.855277718,9362,18,5,9
28518,2014/03/31,2009/11/23,38,14,0.7467216940000001,10722,38,5,9
28519,2014/03/31,2013/01/17,164,6,0.532943683,15022,164,4,2
28520,2014/03/31,2010/11/20,450,9,0.968287373,8268,450,9,0
28521,2014/03/31,2005/04/09,256,9,0.672793747,11898,256,7,2
28522,2014/03/31,2009/11/16,222,10,0.471763319,16968,222,7,3
28523,2014/03/31,2010/08/11,34,10,0.677503174,11815,34,4,6
28524,2014/03/31,2004/12/18,372,6,1.022025026,7832,372,6,0
28525,2014/03/31,2012/09/01,34,11,0.742029295,10787,34,2,9
28526,2014/03/31,2011/02/07,28,6,0.781397052,10243,28,3,3
28527,2014/03/31,2012/04/18,103,8,0.7473639,10709,103,6,2
28528,2014/03/31,2008/05/01,115,5,0.903019294,8863,115,2,3
28529,2014/03/31,2007/06/29,420,5,0.75,10670,420,5,0
28530,2014/03/31,2007/12/31,112,10,0.856495772,9343,112,0,10
28531,2014/03/31,2006/08/28,109,9,0.8154713140000001,9813,109,1,8
28532,2014/03/31,2009/06/30,14,12,0.55182815,14501,14,4,8
28533,2014/03/31,2012/09/14,163,10,0.628076138,12740,163,2,8
28534,2014/03/31,2011/10/31,33,10,0.7855016690000001,10186,33,0,10
28535,2014/03/31,2011/11/28,23,7,0.391428571,20440,23,4,3
28536,2014/03/31,2009/09/26,98,9,0.987338023,8103,98,6,3
28537,2014/03/31,2013/03/14,1,14,0.802923818,9963,1,1,13
28538,2014/03/31,2011/08/10,431,13,0.82408056,9707,431,13,0
28539,2014/03/31,2009/03/17,85,9,0.731293655,10938,85,4,5
28540,2014/03/31,2013/01/13,155,7,0.637201466,12553,155,2,5
28541,2014/03/31,2012/03/24,1,14,0.679809621,11766,1,5,9
28542,2014/03/31,2012/09/06,245,12,0.6807234040000001,11750,245,10,2
28543,2014/03/31,2011/05/27,82,9,0.443619169,18029,82,4,5
28544,2014/03/31,2012/04/17,514,7,0.891937103,8967,514,7,0
28545,2014/03/31,2011/12/06,105,4,0.831728369,9616,105,0,4
28546,2014/03/31,2006/11/27,2,4,0.650532824,12293,2,0,4
28547,2014/03/31,2008/10/04,178,11,0.72122114,11088,178,5,6
28548,2014/03/31,2009/03/19,193,9,0.7615514290000001,10500,193,8,1
28549,2014/03/31,2006/09/28,4,12,0.567720108,14084,4,7,5
28550,2014/03/31,2012/03/11,159,10,0.7548767820000001,10591,159,4,6
28551,2014/03/31,2009/09/26,100,25,0.633958763,12610,100,13,12
28552,2014/03/31,2013/01/29,7,7,0.878440659,9100,7,3,4
28553,2014/03/31,2013/01/06,49,5,0.674,11860,49,2,3
28554,2014/03/31,2010/09/14,111,5,0.937053927,8530,111,0,5
28555,2014/03/31,2010/10/24,114,9,0.847171171,9435,114,6,3
28556,2014/03/31,2005/08/24,147,9,0.677652395,11795,147,6,3
28557,2014/03/31,2010/09/22,125,6,0.5953284670000001,13426,125,4,2
28558,2014/03/31,2012/09/28,23,13,0.709027765,11273,23,4,9
28559,2014/03/31,2011/11/10,162,8,0.759614105,10521,162,5,3
28560,2014/03/31,2012/09/12,12,8,0.762497853,10481,12,2,6
28561,2014/03/31,2011/08/18,549,5,0.71601111,11161,549,5,0
28562,2014/03/31,2012/02/19,111,3,0.73,10947,111,0,3
28563,2014/03/31,2008/03/09,39,8,0.7659474740000001,10433,39,4,4
28564,2014/03/31,2011/07/25,616,4,0.696556834,11472,616,4,0
28565,2014/03/31,2012/08/30,20,22,0.528734864,15113,20,10,12
28566,2014/03/31,2007/08/02,13,9,0.499516129,15996,13,4,5
28567,2014/03/31,2007/07/11,32,10,0.611729841,13059,32,0,10
28568,2014/03/31,2013/03/01,48,5,0.934220559,8551,48,1,4
28569,2014/03/31,2011/06/16,81,11,0.540628722,14776,81,3,8
28570,2014/03/31,2013/03/15,240,11,0.7345870879999999,10874,240,3,8
28571,2014/03/31,2010/10/14,130,14,0.666554285,11983,130,6,8
28572,2014/03/31,2011/09/14,84,16,0.706926005,11298,84,3,13
28573,2014/03/31,2007/02/22,102,8,0.871540812,9164,102,5,3
28574,2014/03/31,2010/06/15,1,11,0.608215129,13127,1,2,9
28575,2014/03/31,2012/10/14,32,9,0.649781883,12287,32,3,6
28576,2014/03/31,2011/01/13,10,10,0.843081635,9469,10,0,10
28577,2014/03/31,2009/08/31,160,5,0.7357281109999999,10850,160,0,5
28578,2014/03/31,2009/01/12,21,11,0.595440101,13406,21,7,4
28579,2014/03/31,2009/10/04,172,8,0.6845051459999999,11660,172,1,7
28580,2014/03/31,2012/03/14,578,8,0.7125,11200,578,8,0
28581,2014/03/31,2006/06/30,596,9,0.6740496709999999,11838,596,9,0
28582,2014/03/31,2009/09/13,279,10,0.798488942,9993,279,6,4
28583,2014/03/31,2010/04/13,247,5,0.885479969,9011,247,4,1
28584,2014/03/31,2011/12/29,15,10,0.603824731,13214,15,2,8
28585,2014/03/31,2011/07/18,1,11,0.5923580070000001,13469,1,0,11
28586,2014/03/31,2012/08/16,186,4,0.7876522859999999,10129,186,1,3
28587,2014/03/31,2010/12/14,258,3,0.823333333,9690,258,0,3
28588,2014/03/31,2005/11/24,9,9,0.465996495,17120,9,2,7
28589,2014/03/31,2012/06/11,457,6,0.705697098,11304,457,6,0
28590,2014/03/31,2012/07/10,59,8,0.747125328,10676,59,3,5
28591,2014/03/31,2007/01/13,112,9,0.6804931740000001,11720,112,1,8
28592,2014/03/31,2011/04/19,8,15,0.660156444,12081,8,5,10
28593,2014/03/31,2012/07/23,33,8,0.7733288079999999,10313,33,5,3
28594,2014/03/31,2010/05/28,286,3,0.517305572,15417,286,2,1
28595,2014/03/31,2011/02/09,501,7,1.121487836,7111,501,7,0
28596,2014/03/31,2009/08/26,74,8,0.656720744,12143,74,4,4
28597,2014/03/31,2012/06/01,138,8,0.968323012,8235,138,4,4
28598,2014/03/31,2011/12/22,118,8,0.45982354,17341,118,1,7
28599,2014/03/31,2013/01/27,26,10,0.724489369,11006,26,2,8
28600,2014/03/31,2012/12/31,360,13,0.818188815,9745,360,12,1
28601,2014/03/31,2010/12/19,30,4,0.771167424,10339,30,2,2
28602,2014/03/31,2010/09/21,471,5,0.926781355,8603,471,5,0
28603,2014/03/31,2011/06/30,69,8,0.8510043759999999,9369,69,2,6
28604,2014/03/31,2012/02/11,418,6,0.6333333329999999,12588,418,6,0
28605,2014/03/31,2007/06/07,134,8,0.571099011,13958,134,3,5
28606,2014/03/31,2010/04/05,39,13,0.5744486879999999,13876,39,7,6
28607,2014/03/31,2007/05/11,106,7,0.777691482,10249,106,3,4
28608,2014/03/31,2013/02/05,27,13,0.425338065,18739,27,0,13
28609,2014/03/31,2012/10/03,276,12,0.717922897,11102,276,7,5
28610,2014/03/31,2008/03/23,18,8,0.762231255,10456,18,5,3
28611,2014/03/31,2009/06/29,230,8,0.977981347,8149,230,7,1
28612,2014/03/31,2005/12/23,109,13,0.670404644,11887,109,10,3
28613,2014/03/31,2013/02/07,50,9,0.8365064040000001,9526,50,1,8
28614,2014/03/31,2011/09/24,447,5,0.666309892,11959,447,5,0
28615,2014/03/31,2012/07/17,18,9,0.723862439,11006,18,7,2
28616,2014/03/31,2011/11/25,72,7,0.72721497,10955,72,4,3
28617,2014/03/31,2006/07/02,5,7,0.804112244,9907,5,4,3
28618,2014/03/31,2007/03/01,230,7,0.577051793,13805,230,5,2
28619,2014/03/31,2009/01/23,37,15,0.8116332140000001,9815,37,7,8
28620,2014/03/31,2013/03/01,72,8,0.507232728,15705,72,2,6
28621,2014/03/31,2011/01/27,147,7,0.916376395,8693,147,2,5
28622,2014/03/31,2006/06/10,109,8,0.868697644,9168,109,4,4
28623,2014/03/31,2013/02/01,6,10,0.617012474,12907,6,0,10
28624,2014/03/31,2012/07/22,202,12,0.736253698,10816,202,5,7
28625,2014/03/31,2013/02/13,26,9,0.692026945,11505,26,0,9
28626,2014/03/31,2007/10/25,108,10,0.494575102,16098,108,4,6
28627,2014/03/31,2008/10/10,111,8,0.679298635,11720,111,5,3
28628,2014/03/31,2007/11/01,30,10,0.61762917,12890,30,1,9
28629,2014/03/31,2012/09/05,113,18,0.5909674070000001,13469,113,13,5
28630,2014/03/31,2006/08/08,210,19,0.8422920629999999,9450,210,14,5
28631,2014/03/31,2011/01/15,36,10,0.585211765,13600,36,4,6
28632,2014/03/31,2012/05/23,17,11,0.6748800140000001,11793,17,7,4
28633,2014/03/31,2013/01/22,59,8,0.637161957,12491,59,2,6
28634,2014/03/31,2007/01/08,556,6,1.142670495,6965,556,6,0
28635,2014/03/31,2004/11/23,19,9,0.804934763,9887,19,4,5
28636,2014/03/31,2011/09/30,93,10,0.5495670189999999,14481,93,4,6
28637,2014/03/31,2012/04/16,16,12,0.812061224,9800,16,4,8
28638,2014/03/31,2007/08/21,39,5,0.564,14110,39,1,4
28639,2014/03/31,2011/03/18,7,7,0.71281082,11164,7,5,2
28640,2014/03/31,2012/05/12,601,3,0.933333333,8526,601,3,0
28641,2014/03/31,2007/08/10,7,6,0.861096202,9241,7,0,6
28642,2014/03/31,2010/11/29,29,12,0.805722965,9876,29,5,7
28643,2014/03/31,2008/02/01,23,11,0.7140895629999999,11143,23,7,4
28644,2014/03/31,2008/10/22,40,16,0.600625,13248,40,8,8
28645,2014/03/31,2012/07/24,25,15,0.593013117,13418,25,7,8
28646,2014/03/31,2009/01/21,268,10,0.819888717,9705,268,8,2
28647,2014/03/31,2012/08/07,16,5,0.767081847,10373,16,3,2
28648,2014/03/31,2011/10/08,93,4,1.125866704,7067,93,3,1
28649,2014/03/31,2012/07/19,292,10,0.575651954,13820,292,8,2
28650,2014/03/31,2010/03/23,7,19,0.723157895,11001,7,12,7
28651,2014/03/31,2013/02/22,186,8,0.6751442879999999,11782,186,0,8
28652,2014/03/31,2009/09/28,292,7,0.948415405,8387,292,5,2
28653,2014/03/31,2010/05/31,177,8,0.7771731479999999,10234,177,0,8
28654,2014/03/31,2008/10/15,95,7,0.737206155,10788,95,0,7
28655,2014/03/31,2012/10/13,98,9,0.837115789,9500,98,2,7
28656,2014/03/31,2008/03/15,5,6,0.564801847,14080,5,1,5
28657,2014/03/31,2005/07/26,35,10,0.597796572,13302,35,6,4
28658,2014/03/31,2010/10/31,63,10,0.851836101,9335,63,6,4
28659,2014/03/31,2012/10/30,159,6,0.89672268,8867,159,0,6
28660,2014/03/31,2010/07/27,164,10,0.645474915,12318,164,4,6
28661,2014/03/31,2009/02/10,2,10,0.7574876140000001,10496,2,6,4
28662,2014/03/31,2009/07/20,485,6,0.83512605,9520,485,6,0
28663,2014/03/31,2012/11/21,22,13,0.697748815,11394,22,10,3
28664,2014/03/31,2007/07/27,4,4,1.295815811,6135,4,0,4
28665,2014/03/31,2010/03/18,9,7,0.58754102,13530,9,0,7
28666,2014/03/31,2008/11/28,8,11,0.616467623,12895,8,1,10
28667,2014/03/31,2011/10/16,42,8,0.701791295,11327,42,4,4
28668,2014/03/31,2010/01/06,167,9,0.682324464,11650,167,3,6
28669,2014/03/31,2012/12/03,29,6,0.77215951,10294,29,2,4
28670,2014/03/31,2006/08/24,347,7,0.6532380010000001,12168,347,5,2
28671,2014/03/31,2012/12/31,59,8,0.737482368,10776,59,1,7
28672,2014/03/31,2011/01/15,113,8,0.753553954,10546,113,6,2
28673,2014/03/31,2007/12/02,202,8,0.622023325,12776,202,3,5
28674,2014/03/31,2009/11/22,350,8,0.6584983839999999,12067,350,6,2
28675,2014/03/31,2005/08/27,113,12,0.661671386,12008,113,7,5
28676,2014/03/31,2007/06/17,174,3,1.468608133,5410,174,2,1
28677,2014/03/31,2012/07/17,212,10,0.5112296510000001,15541,212,7,3
28678,2014/03/31,2010/06/21,368,7,0.6950918640000001,11430,368,7,0
28679,2014/03/31,2006/10/16,112,15,0.661457119,12010,112,5,10
28680,2014/03/31,2008/06/19,274,6,0.767231022,10354,274,3,3
28681,2014/03/31,2011/06/18,145,9,0.599479285,13251,145,4,5
28682,2014/03/31,2007/03/07,294,14,0.638298915,12445,294,9,5
28683,2014/03/31,2013/01/05,7,6,0.8015338040000001,9910,7,2,4
28684,2014/03/31,2013/01/21,17,11,0.784583169,10124,17,2,9
28685,2014/03/31,2005/09/09,120,3,0.936568396,8480,120,2,1
28686,2014/03/31,2012/09/06,63,7,0.640563039,12397,63,4,3
28687,2014/03/31,2011/09/19,152,15,0.55223729,14379,152,9,6
28688,2014/03/31,2008/01/01,250,8,0.849476837,9347,250,5,3
28689,2014/03/31,2012/05/17,30,12,0.715731542,11093,30,5,7
28690,2014/03/31,2011/04/06,119,6,0.915,8676,119,5,1
28691,2014/03/31,2010/03/16,10,6,0.622949302,12742,10,2,4
28692,2014/03/31,2006/03/30,335,8,0.817805255,9705,335,7,1
28693,2014/03/31,2012/11/22,177,7,0.704334783,11267,177,3,4
28694,2014/03/31,2012/06/28,20,11,0.7405618820000001,10714,20,5,6
28695,2014/03/31,2007/05/30,474,4,0.697520879,11375,474,4,0
28696,2014/03/31,2011/09/20,121,4,0.93267897,8507,121,1,3
28697,2014/03/31,2007/09/22,111,8,0.602240777,13174,111,3,5
28698,2014/03/31,2009/04/15,110,7,0.636851822,12458,110,3,4
28699,2014/03/31,2011/11/27,23,10,0.457187806,17353,23,1,9
28700,2014/03/31,2009/11/11,67,12,0.520182283,15251,67,6,6
28701,2014/03/31,2007/05/30,501,7,0.742600393,10683,501,7,0
28702,2014/03/31,2008/06/03,468,7,0.788637041,10059,468,7,0
28703,2014/03/31,2008/08/28,116,9,0.726437076,10918,116,1,8
28704,2014/03/31,2007/05/30,189,15,0.587455003,13501,189,8,7
28705,2014/03/31,2013/02/16,92,6,0.779392689,10176,92,5,1
28706,2014/03/31,2009/11/24,23,7,1.002430793,7911,23,0,7
28707,2014/03/31,2012/11/13,480,4,0.75,10572,480,4,0
28708,2014/03/31,2012/08/25,470,4,0.75,10572,470,4,0
28709,2014/03/31,2012/05/13,665,4,0.75,10572,665,4,0
28710,2014/03/31,2012/12/18,154,4,0.75,10572,154,2,2
28711,2014/03/31,2013/01/01,178,3,1.17701158,6736,178,1,2
28712,2014/03/31,2013/01/08,131,8,0.701918548,11295,131,3,5
28713,2014/03/31,2011/11/29,36,6,0.7489278290000001,10586,36,3,3
28714,2014/03/31,2012/02/25,310,9,0.7575728620000001,10465,310,7,2
28715,2014/03/31,2007/02/03,231,8,0.815583333,9720,231,7,1
28716,2014/03/31,2012/04/29,695,4,0.837609638,9463,695,4,0
28717,2014/03/31,2011/10/15,134,6,0.693881642,11423,134,2,4
28718,2014/03/31,2012/04/20,411,4,0.561241326,14122,411,4,0
28719,2014/03/31,2011/10/09,185,4,1.475932961,5370,185,2,2
28720,2014/03/31,2009/12/11,152,8,0.5894785779999999,13444,152,6,2
28721,2014/03/31,2012/04/06,26,14,0.7586023359999999,10446,26,4,10
28722,2014/03/31,2010/12/09,153,17,0.7182352940000001,11033,153,9,8
28723,2014/03/31,2010/10/25,19,8,1.0552923159999998,7509,19,3,5
28724,2014/03/31,2010/12/13,56,6,0.7192973859999999,11016,56,3,3
28725,2014/03/31,2009/07/03,173,15,0.923007922,8584,173,8,7
28726,2014/03/31,2006/08/06,137,8,0.7498930429999999,10565,137,4,4
28727,2014/03/31,2006/08/30,267,16,0.586238715,13514,267,10,6
28728,2014/03/31,2012/12/06,118,14,0.573157514,13821,118,4,10
28729,2014/03/31,2006/01/12,137,11,0.7778798000000001,10183,137,10,1
28730,2014/03/31,2012/02/04,12,3,0.587269425,13488,12,0,3
28731,2014/03/31,2010/02/28,154,9,0.766029981,10340,154,0,9
28732,2014/03/31,2013/01/28,255,10,0.75000947,10560,255,7,3
28733,2014/03/31,2013/01/02,1,7,0.6720850309999999,11784,1,3,4
28734,2014/03/31,2005/08/20,111,9,0.6335744000000001,12500,111,4,5
28735,2014/03/31,2006/11/01,285,6,0.7437687829999999,10648,285,4,2
28736,2014/03/31,2012/03/05,341,9,0.6225375360000001,12721,341,8,1
28737,2014/03/31,2009/03/10,129,5,0.70818816,11182,129,2,3
28738,2014/03/31,2010/09/24,1,7,0.788015723,10049,1,3,4
28739,2014/03/31,2010/09/18,43,7,0.6882877009999999,11505,43,2,5
28740,2014/03/31,2006/05/19,103,11,0.847057125,9348,103,1,10
28741,2014/03/31,2011/02/02,100,11,0.508617035,15568,100,5,6
28742,2014/03/31,2011/06/21,14,10,0.602156982,13148,14,0,10
28743,2014/03/31,2013/01/06,71,4,0.649147261,12196,71,1,3
28744,2014/03/31,2011/07/26,48,9,0.51992776,15227,48,4,5
28745,2014/03/31,2010/02/24,76,10,0.57614948,13741,76,5,5
28746,2014/03/31,2013/03/14,47,6,0.686969802,11524,47,0,6
28747,2014/03/31,2007/06/19,207,10,0.859261913,9213,207,8,2
28748,2014/03/31,2013/03/07,49,11,0.6971563190000001,11355,49,2,9
28749,2014/03/31,2012/02/18,67,6,0.479962408,16493,67,4,2
28750,2014/03/31,2009/07/20,115,6,0.803895603,9847,115,2,4
28751,2014/03/31,2012/11/19,142,5,0.764728046,10351,142,3,2
28752,2014/03/31,2006/02/04,7,7,0.493712343,16033,7,3,4
28753,2014/03/31,2006/01/11,3,15,0.6496634929999999,12184,3,4,11
28754,2014/03/31,2007/10/09,260,8,0.7562239629999999,10466,260,6,2
28755,2014/03/31,2006/08/26,195,5,1.429913279,5535,195,3,2
28756,2014/03/31,2012/11/17,76,7,0.671151628,11792,76,2,5
28757,2014/03/31,2006/12/21,212,8,0.479762973,16496,212,5,3
28758,2014/03/31,2010/09/10,386,8,0.911861966,8679,386,8,0
28759,2014/03/31,2011/05/05,18,11,0.7007774729999999,11293,18,4,7
28760,2014/03/31,2006/10/01,44,7,0.483697207,16361,44,6,1
28761,2014/03/31,2011/10/28,440,7,0.708034356,11177,440,7,0
28762,2014/03/31,2010/08/21,661,3,0.816666667,9690,661,3,0
28763,2014/03/31,2011/12/22,475,7,0.8642857140000001,9156,475,7,0
28764,2014/03/31,2008/08/12,127,9,0.6816979670000001,11608,127,3,6
28765,2014/03/31,2008/02/10,3,5,0.769818076,10279,3,2,3
28766,2014/03/31,2005/12/28,78,7,0.746856064,10595,78,4,3
28767,2014/03/31,2008/05/16,127,4,1.4691032309999998,5386,127,2,2
28768,2014/03/31,2010/04/24,347,9,0.745412153,10615,347,8,1
28769,2014/03/31,2010/07/29,166,12,0.80481538,9831,166,10,2
28770,2014/03/31,2007/01/12,156,8,0.540540411,14637,156,7,1
28771,2014/03/31,2012/01/06,8,10,0.623667823,12686,8,8,2
28772,2014/03/31,2011/06/06,541,6,0.6416666670000001,12330,541,6,0
28773,2014/03/31,2013/01/03,264,4,0.583830714,13551,264,2,2
28774,2014/03/31,2007/09/18,74,6,0.921708027,8583,74,2,4
28775,2014/03/31,2013/01/14,25,12,0.528978937,14955,25,5,7
28776,2014/03/31,2007/11/27,4,6,0.857427642,9225,4,3,3
28777,2014/03/31,2011/10/13,195,7,0.708043147,11171,195,2,5
28778,2014/03/31,2010/09/20,222,8,0.667321971,11852,222,2,6
28779,2014/03/31,2007/05/01,70,11,0.6417111560000001,12325,70,7,4
28780,2014/03/31,2012/09/14,44,8,0.616477237,12828,44,3,5
28781,2014/03/31,2007/10/10,4,18,0.580749119,13616,4,10,8
28782,2014/03/31,2013/01/16,180,6,0.736523845,10736,180,0,6
28783,2014/03/31,2009/06/19,510,9,0.823742056,9599,510,9,0
28784,2014/03/31,2005/03/11,10,10,0.665624211,11879,10,3,7
28785,2014/03/31,2012/03/03,92,13,0.642100049,12314,92,2,11
28786,2014/03/31,2011/08/08,4,13,0.6178580920000001,12797,4,8,5
28787,2014/03/31,2004/12/10,23,12,0.559648874,14126,23,5,7
28788,2014/03/31,2012/09/21,216,5,0.757245905,10439,216,4,1
28789,2014/03/31,2004/12/21,382,10,0.608943841,12981,382,10,0
28790,2014/03/31,2011/11/01,380,8,0.650213869,12157,380,8,0
28791,2014/03/31,2010/07/12,204,11,0.719593044,10984,204,6,5
28792,2014/03/31,2009/09/22,31,14,0.838435345,9427,31,11,3
28793,2014/03/31,2012/08/04,339,8,0.912393212,8662,339,7,1
28794,2014/03/31,2011/03/20,552,7,0.7663143609999999,10313,552,7,0
28795,2014/03/31,2012/01/16,35,9,0.8043623409999999,9825,35,7,2
28796,2014/03/31,2006/07/18,67,9,0.629505337,12554,67,5,4
28797,2014/03/31,2012/12/19,18,5,0.8309884329999999,9510,18,2,3
28798,2014/03/31,2007/03/04,398,4,0.821817804,9616,398,4,0
28799,2014/03/31,2010/07/03,247,9,0.714843962,11055,247,2,7
28800,2014/03/31,2011/03/27,147,10,0.994,7950,147,8,2
28801,2014/03/31,2012/12/27,86,8,0.62875,12568,86,3,5
28802,2014/03/31,2009/10/11,103,5,0.869941649,9083,103,2,3
28803,2014/03/31,2010/05/28,202,10,0.982023366,8046,202,5,5
28804,2014/03/31,2011/09/01,21,4,1.266412887,6239,21,0,4
28805,2014/03/31,2009/10/15,93,8,0.808541752,9772,93,2,6
28806,2014/03/31,2009/03/16,383,8,0.718664726,10994,383,8,0
28807,2014/03/31,2011/12/16,1,11,0.6081818179999999,12991,1,6,5
28808,2014/03/31,2012/08/28,62,4,0.821636855,9616,62,2,2
28809,2014/03/31,2012/02/21,17,10,0.561825487,14062,17,6,4
28810,2014/03/31,2013/02/04,320,5,1.167122175,6769,320,3,2
28811,2014/03/31,2011/05/20,126,5,0.691244203,11429,126,1,4
28812,2014/03/31,2006/06/21,28,8,0.606885611,13017,28,1,7
28813,2014/03/31,2009/10/24,18,14,0.587100706,13455,18,7,7
28814,2014/03/31,2012/04/06,8,22,0.749545455,10538,8,11,11
28815,2014/03/31,2007/01/12,103,10,0.784450293,10069,103,6,4
28816,2014/03/31,2005/10/25,41,11,0.581029282,13592,41,7,4
28817,2014/03/31,2010/03/01,26,14,0.455758398,17326,26,3,11
28818,2014/03/31,2012/11/20,68,6,0.707180475,11165,68,3,3
28819,2014/03/31,2012/11/18,6,6,0.909216951,8684,6,1,5
28820,2014/03/31,2005/05/13,147,8,0.607253288,13001,147,5,3
28821,2014/03/31,2011/11/22,426,4,0.85,9288,426,4,0
28822,2014/03/31,2012/09/14,8,10,0.56607171,13945,8,0,10
28823,2014/03/31,2011/06/03,165,10,0.633419194,12462,165,4,6
28824,2014/03/31,2010/07/05,16,9,0.6560505320000001,12032,16,3,6
28825,2014/03/31,2004/12/29,500,9,0.514811192,15333,500,9,0
28826,2014/03/31,2007/06/01,101,8,0.536330525,14716,101,2,6
28827,2014/03/31,2011/11/23,187,7,0.837233185,9426,187,4,3
28828,2014/03/31,2008/07/28,263,6,0.92,8578,263,0,6
28829,2014/03/31,2012/05/20,192,5,0.717684613,10996,192,1,4
28830,2014/03/31,2012/05/11,371,7,0.72174609,10933,371,7,0
28831,2014/03/31,2012/03/22,2,17,0.5533373070000001,14260,2,10,7
28832,2014/03/31,2012/03/27,284,6,0.847192097,9313,284,5,1
28833,2014/03/31,2012/09/22,2,7,0.6357853170000001,12409,2,3,4
28834,2014/03/31,2011/09/25,224,6,0.809397763,9747,224,4,2
28835,2014/03/31,2006/06/07,124,9,0.972399852,8113,124,6,3
28836,2014/03/31,2010/11/06,52,12,0.665110024,11861,52,9,3
28837,2014/03/31,2012/10/18,131,11,0.6698675270000001,11776,131,1,10
28838,2014/03/31,2011/08/23,142,7,0.678956791,11618,142,5,2
28839,2014/03/31,2012/06/23,280,9,0.84716357,9311,280,6,3
28840,2014/03/31,2008/03/19,79,5,0.932706634,8457,79,3,2
28841,2014/03/31,2010/01/09,32,11,0.72770274,10839,32,6,5
28842,2014/03/31,2012/09/28,331,9,0.8,9859,331,7,2
28843,2014/03/31,2010/05/15,101,14,0.583295614,13521,101,3,11
28844,2014/03/31,2008/03/13,262,6,1.251664815,6301,262,4,2
28845,2014/03/31,2011/03/21,9,12,0.613581265,12853,9,2,10
28846,2014/03/31,2010/03/09,220,3,0.861682692,9152,220,1,2
28847,2014/03/31,2008/05/22,552,6,0.616567631,12790,552,6,0
28848,2014/03/31,2011/11/21,12,7,0.674511162,11691,12,3,4
28849,2014/03/31,2011/03/19,38,5,0.6659999999999999,11840,38,3,2
28850,2014/03/31,2013/01/16,8,14,0.635,12418,8,4,10
28851,2014/03/31,2005/05/27,254,7,0.79312412,9942,254,4,3
28852,2014/03/31,2012/06/06,353,10,0.745852251,10572,353,9,1
28853,2014/03/31,2011/09/27,584,3,0.958890781,8222,584,3,0
28854,2014/03/31,2012/12/28,58,7,0.678247591,11624,58,1,6
28855,2014/03/31,2007/12/12,82,6,0.648053432,12165,82,1,5
28856,2014/03/31,2011/07/11,307,4,0.765443247,10299,307,2,2
28857,2014/03/31,2009/10/19,43,9,0.817150409,9647,43,4,5
28858,2014/03/31,2007/05/13,115,6,0.662318098,11902,115,5,1
28859,2014/03/31,2007/06/29,67,9,0.577285045,13654,67,0,9
28860,2014/03/31,2011/07/29,347,8,0.72047532,10940,347,6,2
28861,2014/03/31,2011/06/23,11,8,0.846932087,9306,11,2,6
28862,2014/03/31,2007/09/05,628,5,0.590027701,13357,628,5,0
28863,2014/03/31,2010/11/29,3,10,0.8320291390000001,9472,3,5,5
28864,2014/03/31,2011/06/24,295,8,0.866129245,9099,295,6,2
28865,2014/03/31,2010/02/18,77,12,0.493846973,15958,77,8,4
28866,2014/03/31,2007/12/27,207,10,0.7750781940000001,10167,207,6,4
28867,2014/03/31,2008/01/29,111,9,0.41481076,18997,111,7,2
28868,2014/03/31,2007/02/07,242,10,0.630693933,12494,242,2,8
28869,2014/03/31,2012/12/06,96,10,0.686279394,11482,96,2,8
28870,2014/03/31,2010/07/19,207,8,1.4275,5520,207,5,3
28871,2014/03/31,2006/03/07,39,8,0.8864652940000001,8889,39,2,6
28872,2014/03/31,2011/06/23,4,13,0.79890804,9863,4,5,8
28873,2014/03/31,2012/06/11,67,9,0.567731825,13879,67,2,7
28874,2014/03/31,2011/04/28,39,4,0.8790996320000001,8963,39,1,3
28875,2014/03/31,2011/03/05,94,8,0.904935677,8706,94,5,3
28876,2014/03/31,2012/10/17,325,4,1.0,7878,325,2,2
28877,2014/03/31,2011/05/13,21,16,0.5875305789999999,13408,21,13,3
28878,2014/03/31,2009/05/27,50,13,0.61570591,12792,50,9,4
28879,2014/03/31,2011/03/25,467,8,0.7121247740000001,11060,467,8,0
28880,2014/03/31,2012/01/15,62,11,0.801877418,9822,62,3,8
28881,2014/03/31,2010/09/08,337,8,0.465885833,16905,337,3,5
28882,2014/03/31,2011/07/09,49,10,0.6994022559999999,11259,49,6,4
28883,2014/03/31,2009/06/28,22,7,0.538531665,14622,22,3,4
28884,2014/03/31,2013/01/28,112,8,0.57304563,13741,112,5,3
28885,2014/03/31,2012/08/26,323,15,0.737625293,10675,323,13,2
28886,2014/03/31,2010/01/26,5,10,0.718030275,10966,5,5,5
28887,2014/03/31,2011/10/23,177,7,0.667168277,11802,177,3,4
28888,2014/03/31,2005/01/01,271,8,0.671094443,11732,271,7,1
28889,2014/03/31,2007/11/01,132,6,0.782694105,10059,132,2,4
28890,2014/03/31,2012/12/01,63,12,0.677541308,11620,63,5,7
28891,2014/03/31,2010/12/21,13,13,0.58157051,13537,13,7,6
28892,2014/03/31,2010/04/27,144,3,0.923333333,8526,144,0,3
28893,2014/03/31,2011/05/24,33,6,0.736060776,10695,33,0,6
28894,2014/03/31,2012/11/21,106,10,0.68416826,11506,106,4,6
28895,2014/03/31,2008/04/13,262,7,0.714626839,11014,262,3,4
28896,2014/03/31,2013/01/01,34,20,0.750780311,10483,34,6,14
28897,2014/03/31,2012/10/28,64,11,0.6365882070000001,12363,64,3,8
28898,2014/03/31,2010/05/11,227,7,0.667006526,11799,227,4,3
28899,2014/03/31,2010/09/25,286,10,0.811665635,9696,286,6,4
28900,2014/03/31,2010/11/14,107,11,0.716096451,10990,107,7,4
28901,2014/03/31,2007/09/25,148,2,0.7740684640000001,10166,148,1,1
28902,2014/03/31,2012/01/21,50,11,0.480528212,16376,50,5,6
28903,2014/03/31,2012/07/18,217,11,0.604084139,13026,217,5,6
28904,2014/03/31,2012/06/07,313,6,0.666666667,11802,313,3,3
28905,2014/03/31,2008/10/14,113,10,0.570559907,13788,113,6,4
28906,2014/03/31,2013/03/07,24,6,0.660094838,11915,24,0,6
28907,2014/03/31,2011/11/14,192,6,0.788275033,9977,192,1,5
28908,2014/03/31,2010/12/08,191,7,0.572062996,13747,191,6,1
28909,2014/03/31,2012/02/21,474,5,0.648939594,12118,474,5,0
28910,2014/03/31,2010/08/04,572,20,0.92697159,8483,572,20,0
28911,2014/03/31,2009/09/01,14,17,0.6593467510000001,11925,14,8,9
28912,2014/03/31,2011/03/15,214,11,0.757110255,10385,214,9,2
28913,2014/03/31,2012/12/12,290,6,0.706038973,11136,290,5,1
28914,2014/03/31,2008/03/11,126,10,0.602112115,13058,126,4,6
28915,2014/03/31,2007/11/01,193,10,0.561264991,14008,193,8,2
28916,2014/03/31,2011/09/20,94,6,0.6678508320000001,11772,94,1,5
28917,2014/03/31,2009/08/11,26,7,0.696160113,11292,26,0,7
28918,2014/03/31,2013/03/01,75,5,0.743219249,10577,75,1,4
28919,2014/03/31,2010/12/06,224,8,1.005147059,7820,224,6,2
28920,2014/03/31,2008/06/18,359,6,0.7526958440000001,10442,359,5,1
28921,2014/03/31,2012/08/31,76,7,0.513394735,15309,76,3,4
28922,2014/03/31,2005/12/13,372,5,0.58,13550,372,5,0
28923,2014/03/31,2012/01/14,116,5,0.8637931409999999,9098,116,3,2
28924,2014/03/31,2012/02/21,145,6,0.610912624,12864,145,5,1
28925,2014/03/31,2012/05/23,4,13,0.732192304,10733,4,6,7
28926,2014/03/31,2009/01/29,153,10,0.7515168320000001,10456,153,3,7
28927,2014/03/31,2007/10/17,159,9,0.476982518,16474,159,5,4
28928,2014/03/31,2011/07/22,72,18,0.7124562520000001,11029,72,9,9
28929,2014/03/31,2010/10/24,82,7,0.820973775,9571,82,1,6
28930,2014/03/31,2011/08/14,64,10,0.552619215,14218,64,2,8
28931,2014/03/31,2009/10/22,72,12,0.64088588,12259,72,1,11
28932,2014/03/31,2010/11/20,332,7,0.805361353,9755,332,5,2
28933,2014/03/31,2010/12/24,210,8,0.6951212170000001,11302,210,5,3
28934,2014/03/31,2008/03/05,136,11,0.761471358,10317,136,6,5
28935,2014/03/31,2009/12/10,28,8,0.583310811,13468,28,3,5
28936,2014/03/31,2009/06/14,35,12,0.697326232,11265,35,8,4
28937,2014/03/31,2005/03/30,110,13,0.783933526,10019,110,3,10
28938,2014/03/31,2005/12/02,77,10,0.595439381,13189,77,5,5
28939,2014/03/31,2007/07/25,12,11,0.7490280429999999,10484,12,0,11
28940,2014/03/31,2006/01/31,26,10,0.760268177,10329,26,7,3
28941,2014/03/31,2008/03/03,57,8,0.502493761,15627,57,1,7
28942,2014/03/31,2010/03/19,256,8,0.63919645,12283,256,7,1
28943,2014/03/31,2011/03/06,14,6,1.023476731,7671,14,5,1
28944,2014/03/31,2012/06/07,135,6,0.676637649,11602,135,2,4
28945,2014/03/31,2011/11/30,2,14,0.587073517,13371,2,7,7
28946,2014/03/31,2008/11/05,37,9,0.5704404710000001,13758,37,4,5
28947,2014/03/31,2009/11/21,574,4,1.5,5232,574,4,0
28948,2014/03/31,2012/11/17,32,12,0.519990061,15092,32,4,8
28949,2014/03/31,2005/10/08,16,11,0.545470216,14387,16,3,8
28950,2014/03/31,2012/10/20,16,9,0.55898782,14039,16,1,8
28951,2014/03/31,2007/01/10,68,3,0.456599756,17187,68,0,3
28952,2014/03/31,2008/12/04,110,3,1.246666667,6294,110,0,3
28953,2014/03/31,2010/09/19,432,7,0.732149855,10717,432,7,0
28954,2014/03/31,2011/02/01,256,6,0.5886554620000001,13328,256,5,1
28955,2014/03/31,2010/12/16,26,7,0.6415922470000001,12228,26,4,3
28956,2014/03/31,2008/10/24,121,5,0.7343343940000001,10682,121,4,1
28957,2014/03/31,2011/03/14,13,6,0.708476199,11071,13,1,5
28958,2014/03/31,2010/11/09,185,10,0.607536793,12910,185,7,3
28959,2014/03/31,2009/01/13,589,4,1.13997093,6880,589,4,0
28960,2014/03/31,2011/06/08,156,4,0.86610381,9055,156,2,2
28961,2014/03/31,2009/12/28,156,9,0.7109563959999999,11031,156,3,6
28962,2014/03/31,2009/08/20,104,7,0.7023571559999999,11166,104,2,5
28963,2014/03/31,2013/01/01,185,6,0.702717742,11160,185,3,3
28964,2014/03/31,2008/08/03,13,9,0.630822138,12431,13,4,5
28965,2014/03/31,2007/10/05,495,9,0.6,13069,495,9,0
28966,2014/03/31,2013/01/17,8,9,0.660988029,11862,8,2,7
28967,2014/03/31,2007/02/05,318,8,0.787326772,9958,318,7,1
28968,2014/03/31,2012/07/28,70,8,0.828735729,9460,70,5,3
28969,2014/03/31,2010/11/27,32,12,0.7524407329999999,10419,32,4,8
28970,2014/03/31,2012/05/10,120,13,0.7652083940000001,10245,120,8,5
28971,2014/03/31,2009/07/14,89,17,0.726025748,10797,89,7,10
28972,2014/03/31,2010/09/18,170,6,0.625126814,12538,170,4,2
28973,2014/03/31,2008/01/25,128,12,0.605968764,12934,128,5,7
28974,2014/03/31,2007/08/06,26,9,0.748910655,10465,26,3,6
28975,2014/03/31,2010/10/15,8,11,0.820569634,9550,8,5,6
28976,2014/03/31,2009/09/10,311,7,0.910245092,8609,311,5,2
28977,2014/03/31,2012/10/01,3,5,0.7659999999999999,10230,3,2,3
28978,2014/03/31,2009/01/05,1,11,0.7232284259999999,10835,1,5,6
28979,2014/03/31,2007/12/01,219,6,1.064980973,7358,219,4,2
28980,2014/03/31,2012/07/26,141,7,0.644331058,12161,141,6,1
28981,2014/03/31,2006/03/14,26,14,0.58994654,13281,26,8,6
28982,2014/03/31,2011/06/16,280,13,0.478156963,16386,280,12,1
28983,2014/03/31,2007/04/22,147,7,0.874119157,8963,147,2,5
28984,2014/03/31,2012/04/23,664,6,0.685202029,11434,664,6,0
28985,2014/03/31,2012/07/05,71,10,0.734647412,10664,71,4,6
28986,2014/03/31,2007/12/18,216,6,0.738724187,10605,216,5,1
28987,2014/03/31,2010/11/18,159,7,0.6946071999999999,11278,159,3,4
28988,2014/03/31,2009/11/24,204,9,0.853895792,9174,204,4,5
28989,2014/03/31,2007/03/05,110,9,0.623958101,12554,110,3,6
28990,2014/03/31,2008/08/04,5,6,0.642260763,12195,5,4,2
28991,2014/03/31,2008/05/20,271,11,0.601512941,13021,271,7,4
28992,2014/03/31,2008/11/19,70,8,0.595508745,13150,70,7,1
28993,2014/03/31,2013/02/06,46,8,0.506436425,15462,46,2,6
28994,2014/03/31,2007/03/16,11,5,0.754,10385,11,1,4
28995,2014/03/31,2010/06/23,68,8,0.754487377,10378,68,2,6
28996,2014/03/31,2012/12/05,178,10,0.7647094440000001,10239,178,3,7
28997,2014/03/31,2008/10/25,1,7,0.673705903,11622,1,2,5
28998,2014/03/31,2007/11/22,500,7,0.7495595979999999,10445,500,7,0
28999,2014/03/31,2011/07/19,68,5,0.690572462,11337,68,4,1
29000,2014/03/31,2011/11/21,26,4,0.6300458720000001,12426,26,0,4
29001,2014/03/31,2011/09/14,165,10,0.659382581,11872,165,3,7
29002,2014/03/31,2013/02/16,207,5,0.586001647,13358,207,0,5
29003,2014/03/31,2012/11/06,256,6,0.7439099029999999,10522,256,2,4
29004,2014/03/31,2007/02/28,34,12,0.7164457670000001,10925,34,2,10
29005,2014/03/31,2013/01/21,305,6,0.5821569360000001,13445,305,2,4
29006,2014/03/31,2010/12/20,126,8,0.366253159,21370,126,4,4
29007,2014/03/31,2008/01/18,109,6,0.7427673909999999,10537,109,1,5
29008,2014/03/31,2010/05/15,126,11,0.78108483,10020,126,5,6
29009,2014/03/31,2012/01/20,121,10,0.7808161229999999,10023,121,5,5
29010,2014/03/31,2012/03/21,594,10,0.7674904379999999,10197,594,10,0
29011,2014/03/31,2012/12/15,188,9,0.6650305910000001,11768,188,3,6
29012,2014/03/31,2008/10/25,247,9,0.770400709,10157,247,7,2
29013,2014/03/31,2012/07/06,200,10,0.671060034,11660,200,4,6
29014,2014/03/31,2012/11/20,110,9,0.718060756,10896,110,3,6
29015,2014/03/31,2012/07/24,79,12,0.5529997170000001,14148,79,3,9
29016,2014/03/31,2009/03/23,166,7,0.602697789,12981,166,4,3
29017,2014/03/31,2007/04/07,117,8,0.55413798,14118,117,4,4
29018,2014/03/31,2010/12/07,106,9,0.624631108,12524,106,5,4
29019,2014/03/31,2008/08/16,92,7,0.5884075520000001,13294,92,2,5
29020,2014/03/31,2013/01/13,6,12,0.530392596,14748,6,0,12
29021,2014/03/31,2005/04/29,47,13,0.516201412,15153,47,7,6
29022,2014/03/31,2011/03/23,91,9,0.6917076409999999,11308,91,3,6
29023,2014/03/31,2007/04/26,13,10,0.6317891760000001,12380,13,3,7
29024,2014/03/31,2010/09/08,133,14,0.672902865,11623,133,13,1
29025,2014/03/31,2009/12/08,20,8,0.608451844,12854,20,1,7
29026,2014/03/31,2012/07/07,32,9,0.7256448320000001,10778,32,5,4
29027,2014/03/31,2010/05/16,130,9,0.7500632970000001,10427,130,5,4
29028,2014/03/31,2012/06/15,162,7,0.8472137359999999,9231,162,5,2
29029,2014/03/31,2008/04/05,69,12,0.679698418,11506,69,10,2
29030,2014/03/31,2005/02/19,188,8,0.565185025,13836,188,5,3
29031,2014/03/31,2008/09/07,37,8,0.579804997,13487,37,6,2
29032,2014/03/31,2006/10/04,4,11,0.804922792,9714,4,4,7
29033,2014/03/31,2011/08/05,272,8,1.02163596,7653,272,6,2
29034,2014/03/31,2006/09/18,21,12,0.922312139,8477,21,1,11
29035,2014/03/31,2009/09/01,1,7,0.624807001,12513,1,0,7
29036,2014/03/31,2009/04/01,194,19,0.5421638120000001,14419,194,11,8
29037,2014/03/31,2012/12/29,186,5,0.635382427,12303,186,2,3
29038,2014/03/31,2013/01/04,121,7,0.7424164129999999,10528,121,1,6
29039,2014/03/31,2012/04/30,342,8,0.554140376,14105,342,7,1
29040,2014/03/31,2006/01/07,50,4,0.8387948059999999,9318,50,2,2
29041,2014/03/31,2011/06/26,452,7,0.7948738809999999,9832,452,7,0
29042,2014/03/31,2006/12/21,371,11,0.806511868,9690,371,11,0
29043,2014/03/31,2010/01/11,122,9,0.8243533759999999,9480,122,7,2
29044,2014/03/31,2009/03/06,83,11,0.728292637,10730,83,0,11
29045,2014/03/31,2009/08/12,358,6,0.750086389,10418,358,5,1
29046,2014/03/31,2009/04/04,162,8,0.730701328,10694,162,5,3
29047,2014/03/31,2008/04/29,597,7,0.6641648960000001,11765,597,7,0
29048,2014/03/31,2012/02/07,108,9,0.84434947,9254,108,8,1
29049,2014/03/31,2012/11/13,21,9,0.674103184,11591,21,1,8
29050,2014/03/31,2006/03/24,29,8,0.577431823,13531,29,5,3
29051,2014/03/31,2011/10/27,397,7,0.8677476679999999,9004,397,7,0
29052,2014/03/31,2012/03/09,18,10,0.674943849,11576,18,5,5
29053,2014/03/31,2006/10/20,366,5,0.908559135,8599,366,4,1
29054,2014/03/31,2011/05/01,49,8,0.731173608,10685,49,0,8
29055,2014/03/31,2009/03/29,20,8,0.6086031470000001,12836,20,5,3
29056,2014/03/31,2012/11/15,168,7,0.694934614,11241,168,3,4
29057,2014/03/31,2012/08/04,152,9,0.616845389,12664,152,4,5
29058,2014/03/31,2010/06/05,138,6,0.657204274,11886,138,0,6
29059,2014/03/31,2008/03/22,2,6,0.652165818,11977,2,3,3
29060,2014/03/31,2009/01/26,8,9,0.540808696,14443,8,2,7
29061,2014/03/31,2005/01/01,2,3,0.71,11001,2,0,3
29062,2014/03/31,2007/08/05,264,5,0.785191515,9947,264,4,1
29063,2014/03/31,2011/01/13,6,13,0.42932113,18192,6,8,5
29064,2014/03/31,2012/08/17,526,5,0.8328214970000001,9378,526,5,0
29065,2014/03/31,2007/12/19,102,15,0.756635342,10322,102,10,5
29066,2014/03/31,2012/07/27,37,4,0.535,14596,37,1,3
29067,2014/03/31,2011/02/01,90,8,0.688357722,11344,90,2,6
29068,2014/03/31,2006/04/28,590,6,0.6993506490000001,11165,590,6,0
29069,2014/03/31,2008/12/20,410,7,0.5703755110000001,13688,410,7,0
29070,2014/03/31,2009/03/19,544,10,0.663332767,11768,544,10,0
29071,2014/03/31,2010/01/09,449,13,0.607407984,12851,449,13,0
29072,2014/03/31,2009/01/30,204,12,0.919255682,8491,204,11,1
29073,2014/03/31,2011/11/21,49,10,0.571537786,13656,49,0,10
29074,2014/03/31,2011/09/22,342,11,0.533167099,14638,342,9,2
29075,2014/03/31,2013/03/06,44,5,0.7962881340000001,9801,44,1,4
29076,2014/03/31,2008/06/24,61,7,0.652393412,11962,61,2,5
29077,2014/03/31,2008/04/04,10,10,0.6065241720000001,12866,10,9,1
29078,2014/03/31,2012/11/14,95,6,0.5793674360000001,13469,95,1,5
29079,2014/03/31,2009/01/22,34,2,0.48,16254,34,0,2
29080,2014/03/31,2006/12/01,45,2,0.48,16254,45,0,2
29081,2014/03/31,2007/12/20,105,12,0.65901926,11838,105,9,3
29082,2014/03/31,2010/03/13,194,5,1.3555708080000002,5755,194,1,4
29083,2014/03/31,2007/08/22,468,9,0.642957224,12133,468,9,0
29084,2014/03/31,2010/12/28,57,9,0.6431827179999999,12128,57,5,4
29085,2014/03/31,2008/09/25,34,12,0.567652281,13741,34,7,5
29086,2014/03/31,2011/05/29,52,8,0.70137128,11121,52,6,2
29087,2014/03/31,2007/04/04,241,14,0.625987961,12460,241,12,2
29088,2014/03/31,2011/01/15,49,6,0.838230868,9304,49,4,2
29089,2014/03/31,2012/03/30,312,8,0.671287768,11617,312,7,1
29090,2014/03/31,2008/07/10,270,10,0.6105739570000001,12771,270,9,1
29091,2014/03/31,2009/10/25,76,10,0.580077369,13442,76,3,7
29092,2014/03/31,2008/11/27,625,8,0.7401376359999999,10535,625,8,0
29093,2014/03/31,2007/06/25,124,14,0.575447232,13550,124,10,4
29094,2014/03/31,2008/12/31,337,6,1.056960824,7377,337,5,1
29095,2014/03/31,2012/03/20,400,10,0.537909624,14495,400,10,0
29096,2014/03/31,2008/03/04,253,9,0.8327341659999999,9363,253,5,4
29097,2014/03/31,2009/11/03,26,4,0.7375,10572,26,2,2
29098,2014/03/31,2013/01/26,259,4,0.894935721,8712,259,1,3
29099,2014/03/31,2011/07/20,148,9,0.568477579,13715,148,5,4
29100,2014/03/31,2012/03/12,136,7,0.759016745,10272,136,6,1
29101,2014/03/31,2013/01/01,187,8,0.485795377,16049,187,1,7
29102,2014/03/31,2013/02/13,138,9,0.7699417279999999,10125,138,2,7
29103,2014/03/31,2011/05/15,33,8,0.641913036,12143,33,6,2
29104,2014/03/31,2011/03/24,165,6,0.750796648,10381,165,0,6
29105,2014/03/31,2006/05/07,3,5,0.755522055,10315,3,1,4
29106,2014/03/31,2012/07/01,69,13,0.46625703,16714,69,4,9
29107,2014/03/31,2012/01/21,123,8,0.8705272559999999,8952,123,5,3
29108,2014/03/31,2013/03/12,217,8,0.7810774779999999,9977,217,3,5
29109,2014/03/31,2012/05/15,245,10,0.779735842,9994,245,5,5
29110,2014/03/31,2009/01/25,74,6,0.7592176540000001,10264,74,5,1
29111,2014/03/31,2013/03/02,72,7,0.7558996990000001,10309,72,1,6
29112,2014/03/31,2007/07/14,225,8,0.7834204709999999,9946,225,5,3
29113,2014/03/31,2012/04/27,548,11,0.740163389,10527,548,11,0
29114,2014/03/31,2008/09/20,57,7,0.6957201540000001,11199,57,0,7
29115,2014/03/31,2012/03/14,15,18,0.6974717990000001,11170,15,8,10
29116,2014/03/31,2012/01/27,214,8,0.952066479,8183,214,5,3
29117,2014/03/31,2011/07/27,139,8,0.637393225,12222,139,0,8
29118,2014/03/31,2006/02/18,341,5,1.036606786,7515,341,3,2
29119,2014/03/31,2012/06/06,442,5,0.69,11290,442,5,0
29120,2014/03/31,2010/12/29,12,8,0.88079602,8844,12,5,3
29121,2014/03/31,2011/12/10,403,9,0.5550986960000001,14033,403,9,0
29122,2014/03/31,2012/11/24,13,14,0.67640066,11516,13,8,6
29123,2014/03/31,2011/09/19,157,17,0.536502962,14518,157,3,14
29124,2014/03/31,2008/10/27,6,12,0.749932602,10386,6,5,7
29125,2014/03/31,2010/02/15,133,11,0.759953166,10249,133,7,4
29126,2014/03/31,2008/07/03,589,16,0.60199799,12938,589,16,0
29127,2014/03/31,2013/03/05,5,8,0.6640868010000001,11728,5,2,6
29128,2014/03/31,2012/04/01,186,11,0.463692546,16796,186,8,3
29129,2014/03/31,2010/03/23,12,15,0.588281462,13238,12,0,15
29130,2014/03/31,2011/03/31,106,7,0.7464353490000001,10433,106,3,4
29131,2014/03/31,2012/07/22,18,6,0.864691317,9006,18,5,1
29132,2014/03/31,2011/01/07,19,10,0.57021381,13657,19,6,4
29133,2014/03/31,2011/09/29,390,4,0.810165435,9611,390,4,0
29134,2014/03/31,2013/01/14,421,6,0.60577342,12852,421,6,0
29135,2014/03/31,2011/09/17,43,11,0.495602954,15706,43,3,8
29136,2014/03/31,2010/09/04,79,10,0.641051808,12141,79,3,7
29137,2014/03/31,2006/12/01,163,9,0.631723354,12319,163,7,2
29138,2014/03/31,2011/08/14,220,9,0.664123571,11718,220,5,4
29139,2014/03/31,2009/01/19,70,6,1.000891318,7775,70,1,5
29140,2014/03/31,2011/04/18,123,10,0.637769035,12201,123,9,1
29141,2014/03/31,2007/02/06,137,5,0.755785333,10295,137,3,2
29142,2014/03/31,2011/07/26,236,7,0.533041244,14596,236,6,1
29143,2014/03/31,2011/05/10,99,10,0.8100083290000001,9605,99,7,3
29144,2014/03/31,2007/08/22,218,5,0.90974275,8552,218,2,3
29145,2014/03/31,2012/03/24,70,15,0.491093296,15842,70,4,11
29146,2014/03/31,2007/12/03,48,9,0.72569403,10720,48,7,2
29147,2014/03/31,2010/05/10,208,6,0.643933775,12080,208,3,3
29148,2014/03/31,2009/03/09,65,7,0.759599609,10240,65,3,4
29149,2014/03/31,2007/12/02,40,8,0.752084703,10342,40,1,7
29150,2014/03/31,2011/02/24,111,7,0.683610794,11377,111,3,4
29151,2014/03/31,2012/11/25,90,4,1.017802644,7641,90,2,2
29152,2014/03/31,2012/11/22,224,4,0.6509676879999999,11946,224,2,2
29153,2014/03/31,2011/12/21,34,13,0.536648723,14490,34,5,8
29154,2014/03/31,2012/08/06,5,7,0.687394802,11312,5,1,6
29155,2014/03/31,2008/08/11,2,8,0.54833921,14180,2,6,2
29156,2014/03/31,2009/11/21,319,8,0.55809705,13931,319,7,1
29157,2014/03/31,2013/03/20,150,8,0.689924572,11269,150,0,8
29158,2014/03/31,2008/08/29,43,11,0.659660614,11786,43,1,10
29159,2014/03/31,2008/06/27,281,8,0.72257273,10759,281,6,2
29160,2014/03/31,2012/11/23,63,5,0.847159983,9176,63,3,2
29161,2014/03/31,2011/05/18,70,6,0.844817955,9201,70,2,4
29162,2014/03/31,2011/06/06,134,5,0.902551092,8612,134,3,2
29163,2014/03/31,2011/09/09,238,6,0.71012974,10945,238,2,4
29164,2014/03/31,2011/03/08,53,11,0.6981988859999999,11132,53,8,3
29165,2014/03/31,2010/01/17,18,17,0.744893617,10434,18,6,11
29166,2014/03/31,2009/08/17,116,13,0.7317700779999999,10621,116,8,5
29167,2014/03/31,2009/11/26,420,4,1.0,7772,420,4,0
29168,2014/03/31,2012/03/07,105,10,0.665555365,11677,105,8,2
29169,2014/03/31,2008/09/02,2,7,0.6510413,11937,2,1,6
29170,2014/03/31,2012/08/02,32,10,0.501642783,15492,32,7,3
29171,2014/03/31,2012/10/29,15,9,0.589325851,13187,15,1,8
29172,2014/03/31,2007/03/06,68,13,0.6790693809999999,11444,68,8,5
29173,2014/03/31,2006/08/01,18,13,0.8314444679999999,9346,18,0,13
29174,2014/03/31,2013/03/21,73,4,0.735,10572,73,2,2
29175,2014/03/31,2008/03/19,48,12,0.651820317,11921,48,3,9
29176,2014/03/31,2012/02/11,528,2,0.8720202020000001,8910,528,2,0
29177,2014/03/31,2010/09/13,110,6,0.689472003,11269,110,4,2
29178,2014/03/31,2009/12/18,15,6,0.909892259,8539,15,3,3
29179,2014/03/31,2009/12/23,104,4,0.950844553,8170,104,3,1
29180,2014/03/31,2011/10/10,12,9,0.7245150159999999,10722,12,3,6
29181,2014/03/31,2006/05/15,137,12,0.670461844,11584,137,5,7
29182,2014/03/31,2011/05/26,95,14,0.694285714,11186,95,12,2
29183,2014/03/31,2006/03/23,8,5,0.967326856,8028,8,2,3
29184,2014/03/31,2012/07/19,11,7,0.605194451,12831,11,3,4
29185,2014/03/31,2011/01/13,17,10,0.627426471,12376,17,2,8
29186,2014/03/31,2013/01/22,74,7,0.880386665,8819,74,2,5
29187,2014/03/31,2012/01/01,177,11,0.667151328,11637,177,4,7
29188,2014/03/31,2009/10/29,365,5,0.7584017190000001,10236,365,4,1
29189,2014/03/31,2010/09/29,611,4,0.925,8392,611,4,0
29190,2014/03/31,2012/05/23,12,8,0.542494933,14309,12,3,5
29191,2014/03/31,2008/09/13,11,16,0.444070366,17480,11,9,7
29192,2014/03/31,2012/01/09,180,13,0.769691621,10085,180,6,7
29193,2014/03/31,2011/09/15,29,7,0.760412422,10208,29,2,5
29194,2014/03/31,2012/11/21,1,15,0.714813962,10858,1,8,7
29195,2014/03/31,2007/04/09,234,11,0.569709315,13623,234,5,6
29196,2014/03/31,2012/07/08,196,8,0.686823009,11300,196,7,1
29197,2014/03/31,2012/04/15,6,9,0.690733357,11236,6,5,4
29198,2014/03/31,2012/12/14,95,9,0.7154240409999999,10848,95,1,8
29199,2014/03/31,2011/12/14,340,11,0.8333297540000001,9313,340,10,1
29200,2014/03/31,2006/03/30,222,6,0.709907611,10932,222,4,2
29201,2014/03/31,2005/06/02,172,8,0.494373169,15698,172,6,2
29202,2014/03/31,2012/09/24,145,10,0.787802254,9851,145,3,7
29203,2014/03/31,2010/11/17,4,10,0.6442138470000001,12046,4,2,8
29204,2014/03/31,2012/12/14,14,16,0.580358986,13371,14,5,11
29205,2014/03/31,2012/09/25,125,7,0.52290903,14840,125,1,6
29206,2014/03/31,2010/12/29,63,5,0.737661375,10519,63,2,3
29207,2014/03/31,2009/08/18,27,8,0.7442403609999999,10426,27,5,3
29208,2014/03/31,2011/07/16,76,20,0.636185322,12195,76,13,7
29209,2014/03/31,2009/11/25,140,12,0.6048,12825,140,3,9
29210,2014/03/31,2009/09/20,33,9,0.650078786,11931,33,3,6
29211,2014/03/31,2011/12/15,103,8,0.7846292359999999,9885,103,6,2
29212,2014/03/31,2007/08/23,336,6,0.63597671,12194,336,4,2
29213,2014/03/31,2006/01/31,23,10,1.119033189,6930,23,7,3
29214,2014/03/31,2011/10/18,9,9,0.721074949,10754,9,0,9
29215,2014/03/31,2012/04/05,37,9,0.7986672159999999,9709,37,6,3
29216,2014/03/31,2005/05/15,49,6,0.739411653,10487,49,0,6
29217,2014/03/31,2011/09/24,26,13,0.8280072620000001,9364,26,9,4
29218,2014/03/31,2012/09/03,63,10,0.8021311809999999,9666,63,4,6
29219,2014/03/31,2009/07/18,44,14,0.560321625,13836,44,9,5
29220,2014/03/31,2011/09/21,14,11,0.538434505,14398,14,6,5
29221,2014/03/31,2010/11/11,224,7,0.8281508390000001,9361,224,6,1
29222,2014/03/31,2009/12/16,133,11,0.8174681009999999,9483,133,7,4
29223,2014/03/31,2011/09/06,638,3,0.8,9690,638,3,0
29224,2014/03/31,2011/07/13,225,8,0.975975825,7942,225,7,1
29225,2014/03/31,2010/11/19,132,4,0.724250607,10702,132,2,2
29226,2014/03/31,2012/01/10,30,7,0.562857143,13769,30,4,3
29227,2014/03/31,2007/06/17,14,8,0.7105244340000001,10907,14,2,6
29228,2014/03/31,2008/11/25,319,8,0.61155303,12672,319,7,1
29229,2014/03/31,2006/12/15,99,9,0.7976644359999999,9715,99,2,7
29230,2014/03/31,2007/04/28,149,7,0.79503437,9747,149,3,4
29231,2014/03/31,2007/11/19,139,10,0.6770138040000001,11446,139,6,4
29232,2014/03/31,2008/12/18,27,13,0.855468095,9058,27,10,3
29233,2014/03/31,2013/03/23,141,3,0.673333333,11508,141,1,2
29234,2014/03/31,2011/12/22,82,7,0.866517558,8942,82,6,1
29235,2014/03/31,2011/04/30,437,19,0.451182088,17173,437,19,0
29236,2014/03/31,2010/03/01,96,7,0.49314684,15711,96,6,1
29237,2014/03/31,2006/01/21,372,5,1.176910223,6583,372,5,0
29238,2014/03/31,2009/12/25,36,7,0.532857143,14539,36,2,5
29239,2014/03/31,2010/05/18,542,4,0.988541534,7837,542,4,0
29240,2014/03/31,2012/12/05,245,6,0.6977751759999999,11102,245,3,3
29241,2014/03/31,2013/01/11,4,8,0.382547286,20249,4,2,6
29242,2014/03/31,2012/08/24,31,9,0.651920552,11882,31,2,7
29243,2014/03/31,2010/06/12,236,5,0.739879645,10469,236,3,2
29244,2014/03/31,2005/09/19,436,4,1.02685934,7543,436,4,0
29245,2014/03/31,2006/02/27,22,10,0.647644452,11959,22,3,7
29246,2014/03/31,2012/06/21,380,9,0.6935037609999999,11168,380,9,0
29247,2014/03/31,2012/10/02,104,10,0.914623288,8468,104,0,10
29248,2014/03/31,2013/03/08,49,12,0.7299038729999999,10611,49,3,9
29249,2014/03/31,2011/12/04,33,7,0.777742519,9958,33,4,3
29250,2014/03/31,2009/10/01,76,13,0.895552729,8648,76,7,6
29251,2014/03/31,2012/01/22,71,16,0.476875,16240,71,10,6
29252,2014/03/31,2012/05/26,222,7,0.88786607,8721,222,5,2
29253,2014/03/31,2009/04/01,163,9,0.624718412,12394,163,5,4
29254,2014/03/31,2009/05/27,70,13,0.50008138,15483,70,10,3
29255,2014/03/31,2011/02/01,215,5,0.788455193,9820,215,2,3
29256,2014/03/31,2007/07/03,81,10,0.585166654,13231,81,4,6
29257,2014/03/31,2011/08/18,540,11,1.0,7742,540,11,0
29258,2014/03/31,2007/08/20,550,5,0.752966349,10282,550,5,0
29259,2014/03/31,2012/05/01,542,4,0.94995705,8149,542,4,0
29260,2014/03/31,2012/07/20,137,14,0.603480159,12827,137,10,4
29261,2014/03/31,2008/06/19,71,6,0.6822855879999999,11345,71,1,5
29262,2014/03/31,2011/07/09,50,10,0.580431946,13335,50,6,4
29263,2014/03/31,2008/12/29,12,9,0.680796904,11369,12,3,6
29264,2014/03/31,2006/04/10,3,11,0.549116708,14095,3,2,9
29265,2014/03/31,2008/09/13,179,9,0.738018499,10487,179,7,2
29266,2014/03/31,2011/08/19,250,7,0.795011813,9735,250,6,1
29267,2014/03/31,2008/12/14,77,9,0.676400105,11442,77,6,3
29268,2014/03/31,2009/07/04,77,11,0.8613567059999999,8985,77,2,9
29269,2014/03/31,2012/04/16,79,8,0.543491116,14239,79,6,2
29270,2014/03/31,2012/09/14,561,3,0.952770254,8122,561,3,0
29271,2014/03/31,2008/01/10,66,10,0.7110282090000001,10883,66,6,4
29272,2014/03/31,2012/04/11,103,9,0.8444963440000001,9163,103,5,4
29273,2014/03/31,2012/07/07,132,10,1.03712505,7461,132,9,1
29274,2014/03/31,2007/10/26,78,9,0.8225640479999999,9407,78,2,7
29275,2014/03/31,2007/07/10,627,7,0.823499361,9396,627,7,0
29276,2014/03/31,2011/11/21,98,3,0.703333333,11001,98,1,2
29277,2014/03/31,2009/09/13,46,5,0.778,9945,46,2,3
29278,2014/03/31,2005/07/27,22,10,0.672077832,11512,22,6,4
29279,2014/03/31,2011/11/20,60,19,0.611706989,12648,60,6,13
29280,2014/03/31,2011/01/14,275,11,0.5425675010000001,14259,275,9,2
29281,2014/03/31,2013/01/23,205,5,0.676088096,11442,205,1,4
29282,2014/03/31,2010/12/22,12,8,0.663451411,11659,12,7,1
29283,2014/03/31,2012/05/26,141,9,0.7192690409999999,10753,141,4,5
29284,2014/03/31,2011/04/14,137,9,0.668547718,11568,137,4,5
29285,2014/03/31,2009/07/16,110,7,0.842874114,9175,110,2,5
29286,2014/03/31,2005/08/02,293,12,0.538128045,14370,293,11,1
29287,2014/03/31,2010/11/01,110,13,0.787191286,9823,110,7,6
29288,2014/03/31,2007/05/13,163,4,1.30309572,5934,163,2,2
29289,2014/03/31,2008/01/29,26,10,0.466377563,16580,26,6,4
29290,2014/03/31,2012/06/07,142,14,0.522807978,14790,142,8,6
29291,2014/03/31,2012/04/28,163,8,0.594399508,13006,163,4,4
29292,2014/03/31,2009/08/04,32,9,0.7049940720000001,10965,32,5,4
29293,2014/03/31,2012/08/06,384,5,0.834074234,9268,384,5,0
29294,2014/03/31,2009/08/16,33,15,0.7912621559999999,9769,33,11,4
29295,2014/03/31,2012/01/20,55,8,0.668244143,11567,55,4,4
29296,2014/03/31,2008/03/01,64,12,0.740285413,10441,64,4,8
29297,2014/03/31,2011/08/25,83,10,0.491293624,15731,83,5,5
29298,2014/03/31,2012/09/21,217,3,0.622492147,12415,217,1,2
29299,2014/03/31,2008/06/14,32,20,0.843554197,9161,32,15,5
29300,2014/03/31,2010/12/22,9,10,0.69893542,11056,9,0,10
29301,2014/03/31,2009/04/04,116,7,0.719126024,10744,116,4,3
29302,2014/03/31,2012/08/08,433,7,0.842805716,9167,433,7,0
29303,2014/03/31,2008/06/10,133,6,1.115285116,6927,133,4,2
29304,2014/03/31,2011/01/13,6,20,0.993071089,7779,6,3,17
29305,2014/03/31,2010/06/12,79,8,0.69488711,11117,79,5,3
29306,2014/03/31,2011/03/30,20,10,0.448245329,17234,20,5,5
29307,2014/03/31,2012/12/07,17,7,0.875844671,8820,17,1,6
29308,2014/03/31,2008/10/24,482,5,0.921338263,8384,482,5,0
29309,2014/03/31,2012/07/16,99,9,0.555982149,13893,99,5,4
29310,2014/03/31,2013/02/18,2,12,0.739342395,10447,2,0,12
29311,2014/03/31,2009/07/03,386,9,0.7567061820000001,10207,386,9,0
29312,2014/03/31,2012/10/10,391,3,0.906892907,8516,391,3,0
29313,2014/03/31,2009/07/03,440,8,0.6364801379999999,12134,440,8,0
29314,2014/03/31,2012/07/25,117,6,0.789750435,9777,117,2,4
29315,2014/03/31,2006/07/02,57,10,0.908880518,8495,57,3,7
29316,2014/03/31,2006/11/08,258,8,0.526648704,14660,258,1,7
29317,2014/03/31,2009/09/29,9,14,0.74348228,10384,9,4,10
29318,2014/03/31,2011/03/02,13,8,0.5996186410000001,12875,13,6,2
29319,2014/03/31,2010/01/08,346,7,0.561841339,13740,346,6,1
29320,2014/03/31,2007/08/01,540,6,0.761301775,10140,540,6,0
29321,2014/03/31,2012/11/22,32,11,0.778142137,9920,32,4,7
29322,2014/03/31,2011/12/09,10,7,0.8146860159999999,9475,10,3,4
29323,2014/03/31,2007/12/04,14,12,0.414166667,18636,14,4,8
29324,2014/03/31,2012/01/25,13,10,0.972205567,7939,13,2,8
29325,2014/03/31,2012/12/29,177,8,0.93178317,8283,177,1,7
29326,2014/03/31,2005/05/03,48,10,0.72843983,10595,48,6,4
29327,2014/03/31,2013/03/04,29,8,0.7415825890000001,10407,29,1,7
29328,2014/03/31,2011/12/21,20,11,0.7245798520000001,10651,20,4,7
29329,2014/03/31,2012/04/09,361,6,0.983333333,7848,361,4,2
29330,2014/03/31,2010/07/29,382,5,0.877048528,8799,382,5,0
29331,2014/03/31,2009/11/02,12,8,0.6214794229999999,12417,12,0,8
29332,2014/03/31,2007/08/29,191,9,0.84400525,9143,191,7,2
29333,2014/03/31,2013/02/02,151,9,0.496639846,15535,151,5,4
29334,2014/03/31,2008/04/29,8,7,0.686164725,11243,8,5,2
29335,2014/03/31,2012/04/23,31,7,0.751885965,10260,31,2,5
29336,2014/03/31,2010/10/25,426,5,1.0,7714,426,5,0
29337,2014/03/31,2012/08/24,4,11,0.766036743,10070,4,9,2
29338,2014/03/31,2006/03/01,335,6,0.658801674,11708,335,5,1
29339,2014/03/31,2007/06/05,20,8,0.638700729,12076,20,4,4
29340,2014/03/31,2010/09/08,228,6,0.960199203,8032,228,4,2
29341,2014/03/31,2006/08/04,155,9,0.596245747,12932,155,6,3
29342,2014/03/31,2007/07/28,145,5,0.784,9835,145,2,3
29343,2014/03/31,2011/10/19,256,15,0.681903246,11307,256,14,1
29344,2014/03/31,2011/05/28,337,9,0.670047805,11505,337,8,1
29345,2014/03/31,2012/07/29,67,7,0.76550149,10070,67,4,3
29346,2014/03/31,2006/03/16,67,7,1.003581565,7681,67,0,7
29347,2014/03/31,2010/07/25,185,4,0.704228029,10946,185,2,2
29348,2014/03/31,2008/05/25,35,15,0.8433457329999999,9140,35,9,6
29349,2014/03/31,2012/09/07,119,8,0.709502025,10864,119,4,4
29350,2014/03/31,2007/06/24,1,8,0.835264413,9228,1,6,2
29351,2014/03/31,2010/08/14,89,11,0.77,10010,89,4,7
29352,2014/03/31,2010/05/18,86,9,0.733866882,10502,86,5,4
29353,2014/03/31,2012/07/28,321,9,0.477768134,16130,321,7,2
29354,2014/03/31,2008/07/14,37,5,1.241145112,6209,37,3,2
29355,2014/03/31,2012/11/23,60,6,0.7105495620000001,10845,60,1,5
29356,2014/03/31,2013/03/17,83,8,0.489321819,15748,83,1,7
29357,2014/03/31,2009/08/14,116,8,0.752781632,10235,116,0,8
29358,2014/03/31,2012/03/30,207,5,0.5952093629999999,12944,207,3,2
29359,2014/03/31,2009/08/30,71,14,0.8110032640000001,9499,71,9,5
29360,2014/03/31,2005/08/05,39,11,0.6123257289999999,12581,39,4,7
29361,2014/03/31,2008/06/25,110,7,0.721096134,10683,110,0,7
29362,2014/03/31,2011/08/19,20,19,0.698947368,11020,20,15,4
29363,2014/03/31,2012/06/10,182,6,0.652448115,11805,182,4,2
29364,2014/03/31,2012/03/23,65,12,0.7981398959999999,9650,65,10,2
29365,2014/03/31,2008/03/14,116,6,0.451666667,17052,116,0,6
29366,2014/03/31,2013/02/16,40,8,0.6193871639999999,12434,40,1,7
29367,2014/03/31,2007/05/02,95,7,0.7004156429999999,10995,95,3,4
29368,2014/03/31,2004/11/25,223,6,0.6823303209999999,11286,223,3,3
29369,2014/03/31,2012/11/12,21,8,0.572074883,13461,21,2,6
29370,2014/03/31,2013/02/23,239,7,0.869811342,8852,239,2,5
29371,2014/03/31,2008/03/16,138,8,0.774472387,9941,138,3,5
29372,2014/03/31,2011/05/26,267,10,0.770961346,9986,267,4,6
29373,2014/03/31,2010/02/05,34,6,0.692074793,11124,34,1,5
29374,2014/03/31,2012/07/20,168,17,0.843914712,9122,168,10,7
29375,2014/03/31,2012/10/21,32,6,0.774820332,9935,32,2,4
29376,2014/03/31,2012/06/12,186,8,0.8172523620000001,9419,186,5,3
29377,2014/03/31,2008/05/31,69,8,0.652721954,11793,69,6,2
29378,2014/03/31,2006/06/09,78,4,0.784482267,9812,78,0,4
29379,2014/03/31,2013/02/04,151,9,0.651630545,11812,151,1,8
29380,2014/03/31,2011/12/02,138,8,0.5642910560000001,13640,138,4,4
29381,2014/03/31,2013/03/28,76,17,0.5932023120000001,12975,76,0,17
29382,2014/03/31,2010/02/02,49,9,0.644429744,11942,49,0,9
29383,2014/03/31,2010/08/06,72,6,0.8457577759999999,9099,72,0,6
29384,2014/03/31,2008/06/25,132,9,0.8714915059999999,8830,132,3,6
29385,2014/03/31,2011/12/15,58,4,1.270680317,6056,58,0,4
29386,2014/03/31,2012/12/05,28,8,0.623871726,12333,28,1,7
29387,2014/03/31,2010/03/01,217,8,0.83203201,9247,217,6,2
29388,2014/03/31,2011/07/21,94,6,0.555810577,13842,94,2,4
29389,2014/03/31,2012/11/28,28,10,0.7728943140000001,9954,28,2,8
29390,2014/03/31,2011/01/13,466,8,0.8,9616,466,8,0
29391,2014/03/31,2012/03/16,21,16,0.648145277,11867,21,10,6
29392,2014/03/31,2007/10/01,223,8,0.60263496,12763,223,5,3
29393,2014/03/31,2007/10/01,130,7,0.804436774,9561,130,5,2
29394,2014/03/31,2005/09/18,339,6,0.75833169,10142,339,5,1
29395,2014/03/31,2012/03/11,31,10,0.552479885,13920,31,3,7
29396,2014/03/31,2011/08/24,118,6,0.708175707,10859,118,0,6
29397,2014/03/31,2012/01/26,81,14,0.733817158,10479,81,8,6
29398,2014/03/31,2009/04/16,61,4,0.945808118,8130,61,0,4
29399,2014/03/31,2010/09/01,345,7,0.5465103060000001,14070,345,5,2
29400,2014/03/31,2007/12/02,99,8,0.875685002,8781,99,3,5
29401,2014/03/31,2012/09/07,16,11,0.808724232,9508,16,1,10
29402,2014/03/31,2006/06/24,190,8,0.925754876,8306,190,4,4
29403,2014/03/31,2013/01/02,17,10,0.615376181,12494,17,1,9
29404,2014/03/31,2013/03/09,151,5,0.78804838,9756,151,1,4
29405,2014/03/31,2010/02/22,93,11,0.82153131,9358,93,6,5
29406,2014/03/31,2008/10/14,20,11,0.7071916109999999,10871,20,3,8
29407,2014/03/31,2008/12/10,79,8,0.8458378259999999,9089,79,0,8
29408,2014/03/31,2012/08/22,163,5,0.742027223,10359,163,2,3
29409,2014/03/31,2010/08/04,74,6,0.620361582,12390,74,1,5
29410,2014/03/31,2009/12/01,428,10,0.915515188,8395,428,10,0
29411,2014/03/31,2009/12/10,439,5,0.836766467,9185,439,5,0
29412,2014/03/31,2012/07/05,102,6,0.746875607,10290,102,1,5
29413,2014/03/31,2012/10/24,25,8,0.741669562,10362,25,4,4
29414,2014/03/31,2010/02/26,400,5,0.74,10385,400,5,0
29415,2014/03/31,2012/08/26,558,4,0.530031729,14498,558,4,0
29416,2014/03/31,2007/12/23,22,10,0.619168346,12409,22,0,10
29417,2014/03/31,2012/07/19,370,5,0.927689893,8281,370,5,0
29418,2014/03/31,2010/12/06,58,9,0.563950518,13621,58,0,9
29419,2014/03/31,2010/05/21,177,8,0.685181088,11210,177,7,1
29420,2014/03/31,2009/02/28,10,4,0.7551612590000001,10170,10,0,4
29421,2014/03/31,2011/05/29,52,8,0.690580883,11121,52,6,2
29422,2014/03/31,2007/11/27,109,9,0.704309428,10904,109,6,3
29423,2014/03/31,2012/11/20,210,8,0.693932412,11067,210,3,5
29424,2014/03/31,2011/09/19,562,7,0.7274820009999999,10556,562,7,0
29425,2014/03/31,2013/02/06,154,11,0.578389696,13277,154,4,7
29426,2014/03/31,2006/12/30,1,6,0.562489013,13652,1,0,6
29427,2014/03/31,2009/07/16,123,7,0.803317293,9559,123,4,3
29428,2014/03/31,2012/01/25,205,15,0.794392717,9666,205,11,4
29429,2014/03/31,2012/03/08,12,10,0.718631727,10685,12,6,4
29430,2014/03/31,2010/04/23,208,7,0.88327735,8693,208,3,4
29431,2014/03/31,2012/05/31,298,10,0.541477433,14180,298,5,5
29432,2014/03/31,2006/11/04,9,10,0.788270021,9740,9,0,10
29433,2014/03/31,2010/11/25,102,17,0.618095008,12420,102,11,6
29434,2014/03/31,2009/07/23,20,7,0.989774368,7756,20,6,1
29435,2014/03/31,2010/07/04,96,10,0.534322406,14367,96,5,5
29436,2014/03/31,2009/02/15,294,6,0.7131308059999999,10764,294,5,1
29437,2014/03/31,2008/04/17,583,8,0.788009445,9741,583,8,0
29438,2014/03/31,2012/05/31,147,9,0.7016014629999999,10940,147,7,2
29439,2014/03/31,2011/07/23,16,9,0.6797847840000001,11291,16,1,8
29440,2014/03/31,2012/08/17,2,14,0.632017457,12144,2,6,8
29441,2014/03/31,2009/02/10,145,10,0.797481297,9624,145,5,5
29442,2014/03/31,2005/03/26,156,4,0.693152999,11072,156,0,4
29443,2014/03/31,2010/09/24,76,5,0.722309647,10625,76,3,2
29444,2014/03/31,2012/02/20,36,11,0.5836578689999999,13147,36,3,8
29445,2014/03/31,2011/10/19,10,6,0.638453154,12018,10,2,4
29446,2014/03/31,2011/08/14,93,11,0.717024577,10701,93,9,2
29447,2014/03/31,2011/05/04,49,12,0.6107482879999999,12562,49,5,7
29448,2014/03/31,2007/10/24,163,11,0.645808081,11880,163,7,4
29449,2014/03/31,2013/02/09,402,2,1.0,7672,402,2,0
29450,2014/03/31,2006/03/20,657,2,1.0,7672,657,2,0
29451,2014/03/31,2007/02/22,34,9,0.7241079859999999,10594,34,5,4
29452,2014/03/31,2011/12/19,94,10,0.543898894,14104,94,0,10
29453,2014/03/31,2010/06/15,305,7,0.8023734309999999,9560,305,4,3
29454,2014/03/31,2008/06/15,245,8,0.714892348,10729,245,5,3
29455,2014/03/31,2006/04/14,172,3,0.897523698,8545,172,1,2
29456,2014/03/31,2007/12/10,174,13,0.551490004,13906,174,8,5
29457,2014/03/31,2008/07/11,152,8,0.6700699000000001,11445,152,6,2
29458,2014/03/31,2010/02/23,28,5,1.267751694,6049,28,4,1
29459,2014/03/31,2005/06/09,1,12,0.8933857629999999,8583,1,5,7
29460,2014/03/31,2007/03/27,84,11,0.76913231,9969,84,9,2
29461,2014/03/31,2008/09/05,542,4,1.0,7667,542,4,0
29462,2014/03/31,2013/02/07,91,8,0.732982792,10460,91,1,7
29463,2014/03/31,2010/10/19,644,4,1.399342946,5479,644,4,0
29464,2014/03/31,2010/12/28,69,8,0.592903101,12931,69,3,5
29465,2014/03/31,2007/09/07,6,4,0.796685025,9623,6,0,4
29466,2014/03/31,2012/06/12,163,9,0.608131049,12606,163,7,2
29467,2014/03/31,2008/10/15,220,6,0.575147059,13328,220,1,5
29468,2014/03/31,2009/11/06,30,11,0.641597891,11947,30,0,11
29469,2014/03/31,2010/04/25,15,8,0.593542667,12914,15,4,4
29470,2014/03/31,2012/12/12,271,5,1.283689499,5971,271,3,2
29471,2014/03/31,2012/05/26,125,8,0.7489573970000001,10234,125,4,4
29472,2014/03/31,2011/10/07,44,11,0.483643362,15848,44,6,5
29473,2014/03/31,2005/10/13,284,5,0.526513705,14557,284,3,2
29474,2014/03/31,2011/05/19,119,7,0.74547179,10280,119,0,7
29475,2014/03/31,2007/03/18,186,8,0.734017241,10440,186,6,2
29476,2014/03/31,2006/08/26,647,3,0.7,10947,647,3,0
29477,2014/03/31,2012/06/18,15,8,0.6300049329999999,12163,15,1,7
29478,2014/03/31,2010/03/28,10,8,0.62470406,12266,10,2,6
29479,2014/03/31,2012/08/21,473,4,0.825,9288,473,4,0
29480,2014/03/31,2010/09/16,484,4,0.825,9288,484,4,0
29481,2014/03/31,2012/10/23,459,4,0.825,9288,459,4,0
29482,2014/03/31,2006/08/17,349,5,0.8222901909999999,9318,349,4,1
29483,2014/03/31,2012/08/21,542,5,0.736174097,10408,542,5,0
29484,2014/03/31,2007/02/07,81,8,0.788320815,9719,81,7,1
29485,2014/03/31,2011/01/13,18,8,0.653392461,11726,18,4,4
29486,2014/03/31,2012/07/30,307,4,0.946411365,8095,307,2,2
29487,2014/03/31,2012/05/19,221,5,0.706004055,10851,221,3,2
29488,2014/03/31,2012/07/23,9,8,0.893871645,8570,9,1,7
29489,2014/03/31,2011/06/07,273,9,0.6310082370000001,12140,273,8,1
29490,2014/03/31,2012/09/03,7,8,0.644403971,11887,7,0,8
29491,2014/03/31,2012/09/26,82,11,0.550753577,13907,82,6,5
29492,2014/03/31,2010/12/06,589,3,1.5,5106,589,3,0
29493,2014/03/31,2006/11/07,595,8,0.803135487,9536,595,8,0
29494,2014/03/31,2010/08/20,164,11,0.74758688,10244,164,7,4
29495,2014/03/31,2013/02/28,351,8,0.7402319959999999,10345,351,6,2
29496,2014/03/31,2008/11/28,184,12,0.7187909509999999,10653,184,7,5
29497,2014/03/31,2009/08/01,51,7,0.6842278820000001,11190,51,3,4
29498,2014/03/31,2011/07/31,269,10,0.665927279,11496,269,7,3
29499,2014/03/31,2013/01/26,74,7,0.932923827,8205,74,4,3
29500,2014/03/31,2012/09/05,435,4,0.889747762,8603,435,4,0
29501,2014/03/31,2012/07/22,12,16,0.790089802,9688,12,5,11
29502,2014/03/31,2012/09/26,41,5,0.7120000000000001,10750,41,0,5
29503,2014/03/31,2008/08/24,124,10,0.731110899,10469,124,5,5
29504,2014/03/31,2007/07/02,540,4,0.5884890429999999,13005,540,4,0
29505,2014/03/31,2010/03/05,6,9,0.841633124,9093,6,2,7
29506,2014/03/31,2010/04/05,33,5,0.572784223,13361,33,0,5
29507,2014/03/31,2012/01/03,38,9,0.672418944,11381,38,2,7
29508,2014/03/31,2012/05/01,349,7,0.788601463,9703,349,6,1
29509,2014/03/31,2010/04/14,5,7,0.835714286,9156,5,5,2
29510,2014/03/31,2007/10/07,49,7,0.748071959,10228,49,3,4
29511,2014/03/31,2011/05/24,104,9,0.727629827,10514,104,6,3
29512,2014/03/31,2010/11/15,446,6,0.629978587,12142,446,6,0
29513,2014/03/31,2011/07/21,163,7,0.914137684,8367,163,1,6
29514,2014/03/31,2008/01/22,302,5,0.991357097,7715,302,4,1
29515,2014/03/31,2012/06/09,516,11,0.7551209879999999,10125,516,11,0
29516,2014/03/31,2012/11/01,97,5,1.31932528,5795,97,1,4
29517,2014/03/31,2012/09/30,67,12,0.679101972,11258,67,8,4
29518,2014/03/31,2010/05/20,313,6,0.585283308,13060,313,4,2
29519,2014/03/31,2011/09/20,1,10,0.6583298879999999,11610,1,4,6
29520,2014/03/31,2011/05/06,560,6,0.487839908,15666,560,6,0
29521,2014/03/31,2005/04/10,107,7,0.702931383,10872,107,1,6
29522,2014/03/31,2010/06/22,220,2,1.41,5420,220,0,2
29523,2014/03/31,2011/04/24,3,10,0.7680552759999999,9950,3,1,9
29524,2014/03/31,2006/06/13,12,8,0.678637776,11261,12,2,6
29525,2014/03/31,2012/01/01,72,9,0.570559206,13394,72,4,5
29526,2014/03/31,2012/01/27,89,6,0.8257974929999999,9254,89,3,3
29527,2014/03/31,2009/12/10,7,8,0.8527920990000001,8961,7,4,4
29528,2014/03/31,2011/03/29,43,8,0.836347817,9137,43,0,8
29529,2014/03/31,2011/02/05,14,9,0.618255663,12360,14,2,7
29530,2014/03/31,2009/08/14,111,4,0.798119908,9574,111,2,2
29531,2014/03/31,2008/11/22,169,4,0.653984081,11684,169,2,2
29532,2014/03/31,2006/12/27,1,8,0.640546705,11926,1,2,6
29533,2014/03/31,2010/06/17,153,9,0.734029406,10406,153,5,4
29534,2014/03/31,2011/11/11,134,8,0.627356879,12175,134,2,6
29535,2014/03/31,2007/05/17,76,9,0.554588295,13772,76,7,2
29536,2014/03/31,2010/11/19,29,11,0.817719486,9340,29,2,9
29537,2014/03/31,2011/06/22,178,5,0.803154906,9509,178,0,5
29538,2014/03/31,2012/12/31,20,14,0.615,12418,20,3,11
29539,2014/03/31,2011/07/08,131,9,0.8591146359999999,8889,131,6,3
29540,2014/03/31,2011/11/15,15,16,0.643730085,11863,15,0,16
29541,2014/03/31,2012/11/06,254,7,0.413006059,18486,254,2,5
29542,2014/03/31,2011/07/08,174,11,0.679731125,11232,174,7,4
29543,2014/03/31,2013/01/17,440,2,0.85,8981,440,2,0
29544,2014/03/31,2010/04/05,560,3,1.262245742,6047,560,3,0
29545,2014/03/31,2011/12/09,1,5,0.6679999999999999,11425,1,0,5
29546,2014/03/31,2009/09/20,114,6,0.686733555,11113,114,2,4
29547,2014/03/31,2007/09/01,127,8,0.55380942,13779,127,2,6
29548,2014/03/31,2008/10/06,416,4,0.592725649,12874,416,4,0
29549,2014/03/31,2011/02/03,48,18,0.647916101,11776,48,8,10
29550,2014/03/31,2010/11/28,32,10,0.789667771,9662,32,1,9
29551,2014/03/31,2011/08/14,395,9,0.5580645160000001,13671,395,9,0
29552,2014/03/31,2006/06/15,111,9,0.706023505,10806,111,5,4
29553,2014/03/31,2008/06/17,199,5,0.595311744,12815,199,3,2
29554,2014/03/31,2011/06/07,243,7,0.605180895,12604,243,5,2
29555,2014/03/31,2012/11/06,16,5,0.773812519,9857,16,1,4
29556,2014/03/31,2012/06/08,77,6,0.636007338,11992,77,2,4
29557,2014/03/31,2012/10/18,196,8,0.569220091,13399,196,4,4
29558,2014/03/31,2008/05/09,210,6,0.723201214,10546,210,2,4
29559,2014/03/31,2007/11/17,153,7,0.8231570429999999,9265,153,6,1
29560,2014/03/31,2012/05/30,130,3,0.794416667,9600,130,2,1
29561,2014/03/31,2007/07/22,14,9,0.675960993,11280,14,5,4
29562,2014/03/31,2006/10/12,37,5,0.6835159120000001,11155,37,1,4
29563,2014/03/31,2009/10/11,51,12,0.724919654,10517,51,3,9
29564,2014/03/31,2009/11/02,69,6,0.7045023570000001,10821,69,1,5
29565,2014/03/31,2005/06/22,17,7,0.728811663,10460,17,1,6
29566,2014/03/31,2013/01/24,12,11,0.795089695,9588,12,1,10
29567,2014/03/31,2011/10/25,246,11,0.516823729,14750,246,9,2
29568,2014/03/31,2013/03/28,101,5,0.664696547,11468,101,0,5
29569,2014/03/31,2010/08/09,201,9,0.699839332,10892,201,4,5
29570,2014/03/31,2005/12/23,48,10,0.72998372,10442,48,5,5
29571,2014/03/31,2011/02/12,268,13,0.779121946,9783,268,12,1
29572,2014/03/31,2007/09/13,83,8,0.61376067,12418,83,2,6
29573,2014/03/31,2011/09/06,64,7,0.869955485,8761,64,3,4
29574,2014/03/31,2011/03/10,12,18,0.73,10440,12,12,6
29575,2014/03/31,2006/09/21,321,6,0.71641286,10638,321,3,3
29576,2014/03/31,2011/07/13,125,12,0.7200330690000001,10584,125,5,7
29577,2014/03/31,2009/08/24,142,6,0.7813585559999999,9753,142,0,6
29578,2014/03/31,2012/07/20,16,8,0.671994709,11340,16,2,6
29579,2014/03/31,2010/01/02,129,6,0.7382462940000001,10321,129,4,2
29580,2014/03/31,2013/01/24,20,6,1.158798479,6575,20,0,6
29581,2014/03/31,2010/11/29,132,9,0.831770742,9160,132,6,3
29582,2014/03/31,2011/04/19,37,11,0.576760542,13209,37,6,5
29583,2014/03/31,2008/01/21,122,4,0.553515222,13763,122,0,4
29584,2014/03/31,2011/11/10,140,6,0.713890919,10671,140,2,4
29585,2014/03/31,2012/09/21,42,11,0.6418181820000001,11869,42,3,8
29586,2014/03/31,2011/11/26,261,12,0.692663696,10996,261,11,1
29587,2014/03/31,2007/06/12,38,8,0.744426742,10231,38,0,8
29588,2014/03/31,2008/09/03,73,4,0.8325,9148,73,1,3
29589,2014/03/31,2013/02/26,33,8,0.5405124570000001,14089,33,0,8
29590,2014/03/31,2008/09/03,468,4,0.7125,10688,468,4,0
29591,2014/03/31,2012/01/06,63,8,0.708840175,10743,63,4,4
29592,2014/03/31,2012/03/26,49,8,0.631668187,12055,49,3,5
29593,2014/03/31,2012/08/17,226,6,0.651204994,11693,226,4,2
29594,2014/03/31,2011/12/15,4,11,0.7102667909999999,10720,4,7,4
29595,2014/03/31,2012/08/21,30,17,0.7507325970000001,10142,30,6,11
29596,2014/03/31,2013/03/03,118,6,0.7223503179999999,10539,118,4,2
29597,2014/03/31,2011/01/04,238,9,0.7343098290000001,10367,238,7,2
29598,2014/03/31,2006/10/05,170,4,1.455,5232,170,2,2
29599,2014/03/31,2007/03/14,189,4,1.455,5232,189,2,2
29600,2014/03/31,2010/10/24,298,8,0.7653710029999999,9946,298,4,4
29601,2014/03/31,2009/11/25,66,9,0.852908683,8925,66,3,6
29602,2014/03/31,2007/04/16,96,7,0.826480999,9210,96,4,3
29603,2014/03/31,2012/07/11,11,8,0.803184552,9477,11,7,1
29604,2014/03/31,2011/06/29,50,14,0.568774473,13382,50,11,3
29605,2014/03/31,2010/08/02,270,5,0.627651328,12126,270,4,1
29606,2014/03/31,2007/03/28,180,10,0.769283332,9893,180,5,5
29607,2014/03/31,2009/08/27,297,8,0.720282037,10566,297,4,4
29608,2014/03/31,2009/12/13,11,17,0.7838160470000001,9709,11,0,17
29609,2014/03/31,2011/11/09,381,8,0.6125,12424,381,8,0
29610,2014/03/31,2013/03/07,75,9,0.899056002,8464,75,1,8
29611,2014/03/31,2008/06/16,214,9,0.7859347240000001,9682,214,5,4
29612,2014/03/31,2011/09/20,120,12,0.891105516,8539,120,3,9
29613,2014/03/31,2012/10/01,60,9,0.8076658529999999,9421,60,3,6
29614,2014/03/31,2012/01/16,127,12,0.776515615,9798,127,6,6
29615,2014/03/31,2009/12/16,126,7,0.7310598640000001,10407,126,4,3
29616,2014/03/31,2012/02/22,487,4,0.6232836310000001,12206,487,4,0
29617,2014/03/31,2008/05/21,181,7,0.560960106,13561,181,2,5
29618,2014/03/31,2010/06/28,608,6,0.455469732,16701,608,6,0
29619,2014/03/31,2006/04/16,374,7,0.558063096,13630,374,7,0
29620,2014/03/31,2011/09/08,273,6,0.811438173,9373,273,2,4
29621,2014/03/31,2012/08/16,122,6,0.7123321159999999,10677,122,1,5
29622,2014/03/31,2009/03/05,391,11,0.494991865,15365,391,11,0
29623,2014/03/31,2008/07/04,83,6,0.623657237,12195,83,5,1
29624,2014/03/31,2012/01/24,153,10,0.545894344,13932,153,4,6
29625,2014/03/31,2010/08/15,104,9,0.62758541,12118,104,2,7
29626,2014/03/31,2010/07/18,373,4,0.913782745,8322,373,4,0
29627,2014/03/31,2005/02/12,174,11,0.729714999,10421,174,6,5
29628,2014/03/31,2012/04/25,71,12,0.7183393159999999,10586,71,5,7
29629,2014/03/31,2005/08/30,242,12,0.721788325,10535,242,8,4
29630,2014/03/31,2011/08/28,66,9,0.78680774,9664,66,1,8
29631,2014/03/31,2005/08/26,444,7,0.528571429,14385,444,7,0
29632,2014/03/31,2010/02/04,191,5,0.798849548,9518,191,1,4
29633,2014/03/31,2013/03/15,27,8,0.505682362,15036,27,2,6
29634,2014/03/31,2006/10/13,1,8,0.715126975,10632,1,6,2
29635,2014/03/31,2009/11/03,246,8,0.90567838,8395,246,6,2
29636,2014/03/31,2012/12/06,9,16,0.420340557,18088,9,2,14
29637,2014/03/31,2011/01/24,97,13,0.7862409509999999,9670,97,7,6
29638,2014/03/31,2012/09/14,53,6,0.668974043,11365,53,4,2
29639,2014/03/31,2012/12/18,465,4,1.05,7240,465,4,0
29640,2014/03/31,2009/12/15,2,6,0.7164825640000001,10610,2,4,2
29641,2014/03/31,2012/12/18,32,12,0.687880735,11051,32,1,11
29642,2014/03/31,2011/01/24,33,10,0.695313758,10932,33,2,8
29643,2014/03/31,2005/02/04,30,15,0.5434784779999999,13986,30,12,3
29644,2014/03/31,2011/01/14,10,8,0.650020529,11691,10,7,1
29645,2014/03/31,2012/04/17,186,6,0.817953714,9290,186,0,6
29646,2014/03/31,2013/01/15,104,8,0.6671369620000001,11390,104,2,6
29647,2014/03/31,2010/03/01,377,10,0.983203934,7728,377,10,0
29648,2014/03/31,2008/10/25,46,14,0.594444531,12782,46,2,12
29649,2014/03/31,2011/10/16,514,7,0.7617142859999999,9975,514,7,0
29650,2014/03/31,2008/02/17,24,6,0.6456279739999999,11768,24,3,3
29651,2014/03/31,2012/07/07,86,9,0.762044132,9970,86,4,5
29652,2014/03/31,2011/07/29,24,12,0.664381286,11435,24,7,5
29653,2014/03/31,2011/06/21,2,14,0.625573123,12144,2,9,5
29654,2014/03/31,2011/02/25,146,10,0.7842107979999999,9687,146,7,3
29655,2014/03/31,2007/07/07,2,15,0.773962303,9815,2,10,5
29656,2014/03/31,2006/08/23,8,13,0.506380241,15001,8,7,6
29657,2014/03/31,2006/04/15,169,6,0.661615713,11481,169,5,1
29658,2014/03/31,2006/05/19,445,7,0.62758407,12103,445,7,0
29659,2014/03/31,2013/01/29,102,8,0.736097112,10318,102,0,8
29660,2014/03/31,2011/07/02,29,10,0.904330793,8398,29,8,2
29661,2014/03/31,2010/05/23,121,7,0.640614087,11855,121,0,7
29662,2014/03/31,2007/12/01,74,16,0.713318617,10646,74,8,8
29663,2014/03/31,2007/10/22,256,5,1.041816436,7289,256,3,2
29664,2014/03/31,2010/12/21,7,9,0.705655204,10760,7,4,5
29665,2014/03/31,2011/07/19,13,9,0.7621260790000001,9962,13,6,3
29666,2014/03/31,2013/02/02,58,9,0.788680657,9626,58,2,7
29667,2014/03/31,2009/01/30,39,6,0.773661843,9812,39,4,2
29668,2014/03/31,2011/08/30,160,3,0.783333333,9690,160,2,1
29669,2014/03/31,2009/08/01,6,10,0.534144848,14208,6,5,5
29670,2014/03/31,2013/03/26,164,5,0.495243409,15324,164,1,4
29671,2014/03/31,2009/09/15,372,9,0.7419812240000001,10226,372,9,0
29672,2014/03/31,2012/11/09,32,3,0.5532640560000001,13713,32,2,1
29673,2014/03/31,2012/09/22,242,11,0.627963745,12081,242,8,3
29674,2014/03/31,2013/01/01,14,14,0.8599727890000001,8820,14,0,14
29675,2014/03/31,2007/07/23,52,7,1.130824512,6707,52,0,7
29676,2014/03/31,2005/09/09,84,13,0.70382181,10775,84,5,8
29677,2014/03/31,2011/11/03,10,9,0.381888408,19858,10,5,4
29678,2014/03/31,2013/02/12,53,7,0.86407247,8776,53,4,3
29679,2014/03/31,2009/07/03,8,9,0.6439240829999999,11776,8,3,6
29680,2014/03/31,2008/07/02,212,10,0.590425913,12843,212,7,3
29681,2014/03/31,2011/09/20,95,12,0.612454567,12381,95,3,9
29682,2014/03/31,2012/09/09,133,4,0.607197309,12488,133,1,3
29683,2014/03/31,2012/09/20,101,6,0.7506831009999999,10101,101,4,2
29684,2014/03/31,2012/11/06,29,9,0.591006235,12830,29,1,8
29685,2014/03/31,2011/04/26,265,10,0.598668667,12664,265,6,4
29686,2014/03/31,2007/12/09,48,6,0.696065002,10892,48,2,4
29687,2014/03/31,2011/10/17,639,3,1.216666667,6231,639,3,0
29688,2014/03/31,2009/12/20,346,6,0.6347709570000001,11941,346,4,2
29689,2014/03/31,2007/06/17,136,12,0.381751196,19855,136,5,7
29690,2014/03/31,2005/10/26,106,9,0.736592809,10290,106,3,6
29691,2014/03/31,2012/03/30,158,8,0.713178696,10627,158,6,2
29692,2014/03/31,2007/11/26,33,5,0.984144916,7701,33,1,4
29693,2014/03/31,2008/02/10,169,5,0.608,12465,169,4,1
29694,2014/03/31,2012/06/14,109,9,0.549523568,13790,109,4,5
29695,2014/03/31,2013/01/18,64,9,0.7970853059999999,9507,64,1,8
29696,2014/03/31,2013/03/20,114,6,0.533333333,14208,114,0,6
29697,2014/03/31,2006/06/22,20,23,0.850565784,8908,20,6,17
29698,2014/03/31,2010/05/20,47,6,0.7388648329999999,10254,47,3,3
29699,2014/03/31,2012/06/18,219,4,0.981549624,7718,219,3,1
29700,2014/03/31,2010/02/22,203,13,0.705987884,10730,203,7,6
29701,2014/03/31,2012/03/12,338,9,0.920159135,8232,338,8,1
29702,2014/03/31,2012/11/16,234,5,0.568492945,13324,234,4,1
29703,2014/03/31,2010/06/22,440,8,0.572524565,13230,440,8,0
29704,2014/03/31,2011/01/15,189,13,0.7384615379999999,10257,189,9,4
29705,2014/03/31,2011/08/12,327,6,0.853612082,8873,327,5,1
29706,2014/03/31,2011/07/31,14,13,0.799460629,9474,14,4,9
29707,2014/03/31,2011/09/29,48,12,0.779813633,9712,48,0,12
29708,2014/03/31,2010/10/04,675,4,0.9625,7868,675,4,0
29709,2014/03/31,2008/04/01,29,13,0.509831684,14853,29,8,5
29710,2014/03/31,2005/01/31,124,8,0.475676864,15919,124,3,5
29711,2014/03/31,2008/10/10,170,4,0.6351862420000001,11920,170,2,2
29712,2014/03/31,2012/05/13,141,6,0.660560984,11462,141,4,2
29713,2014/03/31,2010/12/02,438,6,0.775337976,9764,438,6,0
29714,2014/03/31,2008/03/17,1,7,0.815507918,9283,1,0,7
29715,2014/03/31,2009/09/09,93,11,0.474522944,15952,93,7,4
29716,2014/03/31,2011/04/03,40,8,0.8062072640000001,9389,40,1,7
29717,2014/03/31,2012/07/27,157,9,0.729604705,10372,157,5,4
29718,2014/03/31,2013/02/13,25,8,0.7547476559999999,10026,25,2,6
29719,2014/03/31,2011/04/30,138,9,0.784303483,9648,138,4,5
29720,2014/03/31,2011/08/16,100,5,0.806926522,9377,100,2,3
29721,2014/03/31,2008/06/03,28,8,0.484715567,15610,28,0,8
29722,2014/03/31,2011/03/19,30,9,0.662573781,11419,30,4,5
29723,2014/03/31,2008/01/31,598,4,0.7258226999999999,10423,598,4,0
29724,2014/03/31,2010/07/16,8,12,0.916089852,8258,8,4,8
29725,2014/03/31,2007/11/13,35,8,0.672718783,11244,35,4,4
29726,2014/03/31,2010/02/21,129,10,0.528446168,14313,129,0,10
29727,2014/03/31,2007/04/06,153,8,0.483997824,15626,153,3,5
29728,2014/03/31,2011/11/20,25,10,0.572329348,13214,25,0,10
29729,2014/03/31,2004/12/03,105,8,0.949923376,7961,105,4,4
29730,2014/03/31,2008/09/15,85,7,0.779130435,9706,85,5,2
29731,2014/03/31,2011/07/31,5,6,0.751186053,10067,5,2,4
29732,2014/03/31,2010/03/08,35,7,0.785922885,9622,35,2,5
29733,2014/03/31,2007/04/24,316,8,0.721376777,10481,316,6,2
29734,2014/03/31,2007/07/13,9,9,0.69483871,10881,9,4,5
29735,2014/03/31,2005/09/11,8,11,0.615923422,12275,8,0,11
29736,2014/03/31,2009/08/10,260,6,1.081533619,6990,260,3,3
29737,2014/03/31,2012/05/18,199,10,0.801118058,9436,199,8,2
29738,2014/03/31,2010/03/30,184,6,0.813166954,9296,184,3,3
29739,2014/03/31,2006/04/14,70,6,0.7815053759999999,9672,70,3,3
29740,2014/03/31,2012/04/06,66,9,0.5828531770000001,12968,66,0,9
29741,2014/03/31,2012/10/30,111,10,0.815098674,9273,111,3,7
29742,2014/03/31,2012/04/14,315,9,0.67152821,11255,315,7,2
29743,2014/03/31,2006/11/10,554,4,0.7358339009999999,10271,554,4,0
29744,2014/03/31,2010/11/30,138,7,0.764918016,9880,138,0,7
29745,2014/03/31,2009/01/07,12,9,0.7548272070000001,10012,12,3,6
29746,2014/03/31,2012/05/20,205,8,0.691103795,10935,205,5,3
29747,2014/03/31,2011/02/09,83,9,0.551539191,13702,83,6,3
29748,2014/03/31,2010/10/16,153,7,0.4531174670000001,16677,153,3,4
29749,2014/03/31,2008/09/22,13,6,0.8284036840000001,9121,13,2,4
29750,2014/03/31,2007/02/05,142,10,0.74149264,10190,142,8,2
29751,2014/03/31,2012/03/15,2,11,0.671755135,11247,2,2,9
29752,2014/03/31,2008/07/17,330,11,0.937631873,8057,330,10,1
29753,2014/03/31,2009/07/16,87,9,0.61844781,12215,87,4,5
29754,2014/03/31,2007/11/30,139,8,0.7543005490000001,10015,139,3,5
29755,2014/03/31,2010/10/30,323,15,0.681796029,11080,323,11,4
29756,2014/03/31,2012/06/18,240,10,0.969486653,7792,240,5,5
29757,2014/03/31,2012/02/06,155,7,0.760500352,9933,155,2,5
29758,2014/03/31,2010/11/29,18,11,0.529453985,14267,18,3,8
29759,2014/03/31,2013/03/06,56,3,0.809322833,9333,56,1,2
29760,2014/03/31,2012/04/30,49,5,0.73738065,10243,49,4,1
29761,2014/03/31,2007/10/10,128,9,0.625184173,12081,128,7,2
29762,2014/03/31,2008/10/26,500,5,0.818177879,9231,500,5,0
29763,2014/03/31,2012/12/06,106,5,0.519346675,14541,106,2,3
29764,2014/03/31,2007/10/29,63,7,0.92326281,8177,63,2,5
29765,2014/03/31,2008/10/24,419,10,0.787528688,9586,419,10,0
29766,2014/03/31,2012/04/17,520,7,0.84259962,8959,520,7,0
29767,2014/03/31,2005/05/23,112,8,0.8984348959999999,8402,112,5,3
29768,2014/03/31,2012/06/19,64,10,0.524480962,14392,64,6,4
29769,2014/03/31,2009/12/25,216,9,0.82545713,9144,216,7,2
29770,2014/03/31,2009/11/21,147,11,0.5054821860000001,14932,147,3,8
29771,2014/03/31,2008/04/28,303,5,0.942154538,8011,303,4,1
29772,2014/03/31,2012/08/22,41,13,0.562031576,13428,41,5,8
29773,2014/03/31,2011/02/08,618,4,0.863978248,8735,618,4,0
29774,2014/03/31,2006/01/05,582,6,0.629796378,11983,582,6,0
29775,2014/03/31,2008/10/26,520,4,0.8125,9288,520,4,0
29776,2014/03/31,2011/11/21,636,4,0.8125,9288,636,4,0
29777,2014/03/31,2010/08/17,17,8,0.854685695,8829,17,7,1
29778,2014/03/31,2007/09/04,192,15,0.5968029739999999,12643,192,9,6
29779,2014/03/31,2008/08/21,32,7,0.691473607,10912,32,5,2
29780,2014/03/31,2007/04/16,3,14,0.448216704,16834,3,2,12
29781,2014/03/31,2006/06/19,102,7,0.929881686,8114,102,1,6
29782,2014/03/31,2010/12/20,181,7,0.572761919,13172,181,6,1
29783,2014/03/31,2011/12/27,109,7,0.5320819520000001,14179,109,5,2
29784,2014/03/31,2006/04/20,260,6,0.62122375,12143,260,5,1
29785,2014/03/31,2012/05/01,179,3,1.021185867,7387,179,1,2
29786,2014/03/31,2008/06/07,100,7,0.8020616690000001,9405,100,6,1
29787,2014/03/31,2012/08/03,203,6,0.7808032290000001,9661,203,3,3
29788,2014/03/31,2009/03/19,104,5,0.727840602,10364,104,3,2
29789,2014/03/31,2005/08/03,30,8,0.5424428139999999,13902,30,4,4
29790,2014/03/31,2010/04/28,248,5,0.610412855,12353,248,1,4
29791,2014/03/31,2012/08/07,8,10,0.5970768989999999,12627,8,3,7
29792,2014/03/31,2012/03/27,109,8,0.582317318,12946,109,3,5
29793,2014/03/31,2006/01/18,1,6,0.7198013940000001,10473,1,0,6
29794,2014/03/31,2011/07/16,142,13,0.695326077,10841,142,7,6
29795,2014/03/31,2011/08/14,20,4,0.630562155,11954,20,1,3
29796,2014/03/31,2010/01/14,89,8,0.807036403,9340,89,6,2
29797,2014/03/31,2007/07/26,200,12,0.79075535,9532,200,7,5
29798,2014/03/31,2008/09/04,6,8,0.786665275,9581,6,2,6
29799,2014/03/31,2013/03/06,49,9,0.8787023429999999,8577,49,1,8
29800,2014/03/31,2010/07/26,75,8,0.7760090609999999,9712,75,5,3
29801,2014/03/31,2013/01/08,110,8,0.6959192909999999,10829,110,1,7
29802,2014/03/31,2012/06/12,400,3,0.853647485,8828,400,3,0
29803,2014/03/31,2011/06/25,272,3,1.465571762,5142,272,1,2
29804,2014/03/31,2009/08/23,343,7,0.629832846,11965,343,6,1
29805,2014/03/31,2005/04/21,42,7,0.781206718,9646,42,4,3
29806,2014/03/31,2009/09/20,5,8,0.678631124,11104,5,5,3
29807,2014/03/31,2010/01/19,143,9,0.681691695,11054,143,1,8
29808,2014/03/31,2006/02/18,177,11,0.5691389729999999,13240,177,6,5
29809,2014/03/31,2012/11/30,142,6,0.80522975,9358,142,4,2
29810,2014/03/31,2007/04/12,419,5,1.0,7535,419,5,0
29811,2014/03/31,2010/04/18,349,4,0.590652191,12757,349,3,1
29812,2014/03/31,2007/06/09,59,9,0.828888889,9090,59,6,3
29813,2014/03/31,2005/08/26,31,9,0.7324927090000001,10286,31,5,4
29814,2014/03/31,2005/01/27,214,13,0.593442817,12696,214,7,6
29815,2014/03/31,2011/07/12,229,6,0.817237227,9219,229,3,3
29816,2014/03/31,2011/03/29,15,17,0.424874514,17731,15,6,11
29817,2014/03/31,2006/01/12,7,8,0.497248845,15150,7,0,8
29818,2014/03/31,2009/12/29,131,8,0.845566281,8909,131,5,3
29819,2014/03/31,2012/09/27,55,4,0.652034969,11553,55,2,2
29820,2014/03/31,2011/07/25,471,8,0.896441747,8403,471,8,0
29821,2014/03/31,2006/01/03,16,11,0.416957821,18066,16,7,4
29822,2014/03/31,2012/08/08,372,3,0.738470588,10200,372,3,0
29823,2014/03/31,2008/01/28,69,11,0.805604278,9350,69,0,11
29824,2014/03/31,2010/07/26,171,6,0.699826257,10763,171,1,5
29825,2014/03/31,2010/08/06,224,10,0.747902889,10071,224,6,4
29826,2014/03/31,2012/08/14,149,5,0.8148966790000001,9243,149,4,1
29827,2014/03/31,2010/10/21,101,16,0.571259006,13185,101,12,4
29828,2014/03/31,2012/09/29,330,6,0.6812138209999999,11056,330,4,2
29829,2014/03/31,2009/12/13,386,4,0.6625,11368,386,4,0
29830,2014/03/31,2011/03/17,209,4,0.6625,11368,209,3,1
29831,2014/03/31,2009/03/07,399,3,0.8833333329999999,8526,399,3,0
29832,2014/03/31,2013/03/23,201,6,0.5629680020000001,13376,201,0,6
29833,2014/03/31,2006/05/02,244,9,0.569591528,13220,244,6,3
29834,2014/03/31,2011/08/16,11,13,0.550066477,13689,11,8,5
29835,2014/03/31,2012/09/10,9,8,0.64395142,11692,9,3,5
29836,2014/03/31,2012/07/19,267,7,0.837294262,8992,267,6,1
29837,2014/03/31,2012/12/21,21,10,0.591644794,12725,21,5,5
29838,2014/03/31,2010/11/27,50,11,0.5653946679999999,13315,50,4,7
29839,2014/03/31,2010/05/20,10,7,0.637689115,11805,10,2,5
29840,2014/03/31,2008/03/17,503,7,0.914530434,8231,503,7,0
29841,2014/03/31,2006/06/27,296,6,0.917411335,8205,296,3,3
29842,2014/03/31,2011/08/26,108,10,0.5319448760000001,14150,108,4,6
29843,2014/03/31,2012/10/19,177,6,0.829056063,9079,177,3,3
29844,2014/03/31,2007/12/18,413,8,0.783317723,9609,413,8,0
29845,2014/03/31,2007/11/27,168,6,0.6104411999999999,12330,168,4,2
29846,2014/03/31,2008/06/24,140,6,0.710631668,10591,140,3,3
29847,2014/03/31,2007/05/13,338,5,0.6942394609999999,10841,338,2,3
29848,2014/03/31,2006/02/20,28,5,0.93501553,8049,28,1,4
29849,2014/03/31,2013/03/17,145,6,0.581807499,12935,145,2,4
29850,2014/03/31,2005/11/11,176,8,0.688155464,10935,176,4,4
29851,2014/03/31,2011/01/21,33,11,0.798181818,9427,33,9,2
29852,2014/03/31,2012/06/30,200,9,0.6371581000000001,11809,200,5,4
29853,2014/03/31,2011/10/16,89,7,0.677299487,11109,89,4,3
29854,2014/03/31,2011/05/31,695,3,0.7333333329999999,10260,695,3,0
29855,2014/03/31,2012/07/11,155,10,0.482097911,15606,155,7,3
29856,2014/03/31,2012/10/03,176,4,0.81,9288,176,1,3
29857,2014/03/31,2008/07/02,419,10,0.745092602,10097,419,10,0
29858,2014/03/31,2012/01/09,227,11,0.7140394840000001,10536,227,10,1
29859,2014/03/31,2011/08/15,18,11,0.621715702,12100,18,6,5
29860,2014/03/31,2010/04/17,527,8,0.583958236,12882,527,8,0
29861,2014/03/31,2012/06/13,33,14,0.44398005,16942,33,8,6
29862,2014/03/31,2010/02/15,341,8,0.583707124,12886,341,6,2
29863,2014/03/31,2007/06/11,80,5,0.67068575,11214,80,0,5
29864,2014/03/31,2012/10/09,105,7,0.62208933,12090,105,3,4
29865,2014/03/31,2011/01/03,423,4,0.880679157,8540,423,4,0
29866,2014/03/31,2013/02/06,102,12,0.885447375,8494,102,3,9
29867,2014/03/31,2012/02/19,137,11,0.756918277,9936,137,1,10
29868,2014/03/31,2011/08/22,125,9,0.554338468,13567,125,6,3
29869,2014/03/31,2007/11/06,153,9,0.493876264,15226,153,6,3
29870,2014/03/31,2009/04/16,58,9,0.6827092790000001,11014,58,0,9
29871,2014/03/31,2009/03/01,161,4,0.912742503,8237,161,1,3
29872,2014/03/31,2010/11/17,67,7,0.683014445,11007,67,0,7
29873,2014/03/31,2012/07/19,490,4,0.7690198490000001,9774,490,4,0
29874,2014/03/31,2010/01/13,8,9,0.464376892,16185,8,4,5
29875,2014/03/31,2011/07/10,13,8,0.6943098670000001,10824,13,1,7
29876,2014/03/31,2010/09/15,126,10,0.842839838,8916,126,5,5
29877,2014/03/31,2011/10/29,23,11,0.627358491,11978,23,4,7
29878,2014/03/31,2012/11/30,11,11,0.562990934,13347,11,3,8
29879,2014/03/31,2012/04/24,204,6,0.8777187240000001,8561,204,5,1
29880,2014/03/31,2012/03/03,4,4,0.955,7868,4,3,1
29881,2014/03/31,2010/06/16,222,8,0.651115251,11540,222,3,5
29882,2014/03/31,2012/09/28,191,5,0.7425061759999999,10119,191,2,3
29883,2014/03/31,2012/03/27,73,9,0.707540258,10619,73,4,5
29884,2014/03/31,2007/09/26,565,3,0.98921659,7595,565,3,0
29885,2014/03/31,2006/08/03,286,10,0.555249815,13530,286,5,5
29886,2014/03/31,2010/09/01,429,13,0.624627921,12027,429,13,0
29887,2014/03/31,2010/09/23,385,2,0.554830133,13540,385,2,0
29888,2014/03/31,2005/03/24,103,8,0.676259453,11108,103,4,4
29889,2014/03/31,2011/10/16,256,12,0.49360297,15218,256,8,4
29890,2014/03/31,2012/09/21,168,6,0.783125847,9591,168,3,3
29891,2014/03/31,2007/08/18,71,7,0.667279431,11255,71,1,6
29892,2014/03/31,2007/06/16,163,11,0.722571923,10393,163,3,8
29893,2014/03/31,2008/03/17,35,4,0.6897832279999999,10887,35,0,4
29894,2014/03/31,2010/02/22,98,8,0.7492297720000001,10023,98,5,3
29895,2014/03/31,2011/02/02,373,6,0.629446773,11930,373,6,0
29896,2014/03/31,2008/07/29,99,11,0.534195774,14057,99,9,2
29897,2014/03/31,2012/04/21,417,15,0.863301908,8698,417,15,0
29898,2014/03/31,2008/09/02,346,6,1.237784372,6066,346,4,2
29899,2014/03/31,2011/04/18,487,5,0.71118795,10556,487,5,0
29900,2014/03/31,2013/03/09,183,9,0.478537005,15687,183,2,7
29901,2014/03/31,2010/01/14,170,11,0.682052703,11005,170,5,6
29902,2014/03/31,2011/10/20,11,8,0.8498629670000001,8830,11,0,8
29903,2014/03/31,2011/08/16,161,6,0.59083622,12700,161,4,2
29904,2014/03/31,2012/08/23,109,8,0.653383838,11484,109,2,6
29905,2014/03/31,2013/02/12,72,9,0.791024776,9485,72,2,7
29906,2014/03/31,2011/08/22,18,6,0.617009868,12160,18,2,4
29907,2014/03/31,2008/02/25,116,5,0.809519853,9268,116,0,5
29908,2014/03/31,2006/05/23,35,9,0.6578334060000001,11405,35,4,5
29909,2014/03/31,2006/01/27,186,11,0.710722812,10556,186,4,7
29910,2014/03/31,2011/03/17,104,6,0.674157455,11127,104,2,4
29911,2014/03/31,2011/12/03,220,5,0.77402848,9691,220,4,1
29912,2014/03/31,2011/12/08,89,6,0.521628651,14380,89,2,4
29913,2014/03/31,2012/04/26,107,8,0.530502864,14139,107,3,5
29914,2014/03/31,2005/09/09,7,8,0.89193721,8409,7,1,7
29915,2014/03/31,2008/06/26,346,6,0.878026223,8542,346,5,1
29916,2014/03/31,2011/03/11,247,7,0.751736995,9977,247,0,7
29917,2014/03/31,2012/04/24,193,11,0.8242707990000001,9099,193,7,4
29918,2014/03/31,2012/03/03,524,5,1.5,5000,524,5,0
29919,2014/03/31,2011/01/04,6,14,0.659846032,11366,6,9,5
29920,2014/03/31,2007/06/19,16,6,0.650220218,11534,16,3,3
29921,2014/03/31,2012/05/14,114,8,0.672154701,11157,114,2,6
29922,2014/03/31,2010/11/11,156,11,0.642381564,11673,156,8,3
29923,2014/03/31,2012/08/11,224,5,0.736149617,10186,224,3,2
29924,2014/03/31,2012/03/08,330,6,0.867783565,8640,330,4,2
29925,2014/03/31,2006/11/30,7,16,0.755957447,9917,7,7,9
29926,2014/03/31,2012/09/11,115,8,0.548670034,13662,115,3,5
29927,2014/03/31,2008/12/25,190,8,0.681605893,10997,190,4,4
29928,2014/03/31,2010/06/25,177,8,0.966043305,7759,177,3,5
29929,2014/03/31,2012/10/14,315,7,0.5279495670000001,14197,315,2,5
29930,2014/03/31,2008/11/21,195,6,0.865196814,8663,195,2,4
29931,2014/03/31,2011/02/15,169,4,1.026571703,7301,169,1,3
29932,2014/03/31,2008/02/27,353,7,0.7646005509999999,9801,353,6,1
29933,2014/03/31,2012/11/18,136,3,0.773333333,9690,136,2,1
29934,2014/03/31,2006/06/22,245,8,0.7695111929999999,9738,245,6,2
29935,2014/03/31,2007/05/19,431,6,0.752939403,9951,431,6,0
29936,2014/03/31,2012/05/14,33,10,0.493251465,15187,33,1,9
29937,2014/03/31,2006/01/21,263,7,0.795974923,9411,263,5,2
29938,2014/03/31,2009/01/17,57,5,0.6226799670000001,12030,57,1,4
29939,2014/03/31,2008/02/19,153,12,0.610833401,12263,153,9,3
29940,2014/03/31,2011/10/01,477,11,0.6192864229999999,12094,477,11,0
29941,2014/03/31,2006/03/17,100,8,0.618463952,12109,100,1,7
29942,2014/03/31,2011/10/19,3,12,0.524103856,14289,3,10,2
29943,2014/03/31,2012/09/01,91,8,0.879497358,8515,91,3,5
29944,2014/03/31,2008/04/11,373,6,0.739274432,10130,373,6,0
29945,2014/03/31,2013/02/05,11,9,0.641907252,11666,11,1,8
29946,2014/03/31,2012/04/27,155,8,0.7299385909999999,10259,155,4,4
29947,2014/03/31,2011/07/01,88,8,0.704854104,10624,88,6,2
29948,2014/03/31,2011/04/30,105,8,0.875422025,8554,105,4,4
29949,2014/03/31,2007/05/17,185,7,0.501806179,14921,185,6,1
29950,2014/03/31,2010/08/27,138,10,0.6863195529999999,10909,138,4,6
29951,2014/03/31,2005/11/05,174,3,0.793781807,9432,174,2,1
29952,2014/03/31,2006/12/06,40,6,0.657201545,11392,40,4,2
29953,2014/03/31,2012/06/29,108,8,0.7479048859999999,10009,108,5,3
29954,2014/03/31,2013/02/02,13,13,0.660411116,11335,13,0,13
29955,2014/03/31,2009/01/12,11,9,0.736778543,10160,11,3,6
29956,2014/03/31,2013/02/07,36,9,0.415124224,18032,36,1,8
29957,2014/03/31,2009/01/03,334,9,0.702246927,10659,334,8,1
29958,2014/03/31,2012/05/27,468,10,0.806247307,9284,468,10,0
29959,2014/03/31,2008/09/30,133,7,0.756491813,9894,133,2,5
29960,2014/03/31,2010/04/09,26,8,0.6957177390000001,10756,26,0,8
29961,2014/03/31,2009/04/04,141,7,0.6648218570000001,11255,141,5,2
29962,2014/03/31,2012/04/27,520,8,0.991788176,7544,520,8,0
29963,2014/03/31,2009/06/20,578,6,1.0,7482,578,6,0
29964,2014/03/31,2009/12/01,398,6,0.674661858,11090,398,6,0
29965,2014/03/31,2009/10/08,76,10,0.738282021,10134,76,3,7
29966,2014/03/31,2010/11/26,1,9,0.604422362,12378,1,2,7
29967,2014/03/31,2009/10/27,31,8,0.56649629,13206,31,3,5
29968,2014/03/31,2011/07/19,116,8,0.798551452,9368,116,3,5
29969,2014/03/31,2011/08/17,117,11,0.592770206,12620,117,8,3
29970,2014/03/31,2008/09/28,393,3,0.683333333,10947,393,3,0
29971,2014/03/31,2010/10/14,18,13,0.7234226309999999,10340,18,8,5
29972,2014/03/31,2012/03/22,43,9,0.726998445,10288,43,3,6
29973,2014/03/31,2011/06/24,136,12,0.573656236,13038,136,8,4
29974,2014/03/31,2011/10/25,155,20,0.534924903,13982,155,10,10
29975,2014/03/31,2006/04/21,121,7,0.70997247,10534,121,3,4
29976,2014/03/31,2006/01/16,16,16,0.566225015,13208,16,5,11
29977,2014/03/31,2006/07/17,37,6,0.563864887,13263,37,4,2
29978,2014/03/31,2009/12/14,102,10,0.928300645,8056,102,6,4
29979,2014/03/31,2008/07/07,2,10,0.642695316,11635,2,2,8
29980,2014/03/31,2012/06/03,114,20,0.6445,11600,114,10,10
29981,2014/03/31,2012/12/21,9,11,0.800506478,9339,9,3,8
29982,2014/03/31,2012/05/17,20,11,0.524581053,14250,20,9,2
29983,2014/03/31,2004/12/04,120,8,0.789173353,9472,120,7,1
29984,2014/03/31,2012/10/16,149,5,0.6703874439999999,11150,149,2,3
29985,2014/03/31,2007/07/08,677,4,0.95,7868,677,4,0
29986,2014/03/31,2012/02/27,94,9,0.861394491,8677,94,2,7
29987,2014/03/31,2010/12/29,213,5,0.8604766290000001,8686,213,4,1
29988,2014/03/31,2011/03/25,37,11,0.605089054,12352,37,3,8
29989,2014/03/31,2007/03/06,371,10,0.611107931,12230,371,10,0
29990,2014/03/31,2010/05/08,640,3,0.8,9342,640,3,0
29991,2014/03/31,2011/02/21,136,12,0.618336091,12086,136,6,6
29992,2014/03/31,2011/08/29,158,8,0.722610966,10341,158,5,3
29993,2014/03/31,2009/06/25,40,7,0.667226538,11199,40,1,6
29994,2014/03/31,2009/04/20,299,9,0.568589695,13139,299,6,3
29995,2014/03/31,2012/08/07,20,10,0.4327743020000001,17262,20,6,4
29996,2014/03/31,2011/05/13,55,13,0.7004594470000001,10665,55,8,5
29997,2014/03/31,2008/11/07,269,9,0.593606961,12584,269,7,2
29998,2014/03/31,2012/01/03,223,11,0.738377817,10116,223,3,8
29999,2014/03/31,2008/11/15,293,13,0.40320054,18525,293,3,10
30000,2014/03/31,2012/03/03,336,16,0.6656327989999999,11220,336,13,3
30001,2014/03/31,2009/08/09,4,7,0.5453680439999999,13694,4,2,5
30002,2014/03/31,2008/09/29,229,5,0.785371753,9509,229,0,5
30003,2014/03/31,2009/06/14,169,9,0.568322424,13138,169,4,5
30004,2014/03/31,2010/12/31,63,9,0.560638985,13318,63,8,1
30005,2014/03/31,2012/06/08,3,9,0.5529516329999999,13501,3,5,4
30006,2014/03/31,2009/08/31,56,9,0.713103745,10468,56,0,9
30007,2014/03/31,2005/04/22,115,7,0.605802289,12321,115,2,5
30008,2014/03/31,2008/05/03,121,6,0.8127166809999999,9184,121,0,6
30009,2014/03/31,2010/04/18,100,7,0.4996144320000001,14939,100,4,3
30010,2014/03/31,2012/08/20,2,6,0.664793801,11227,2,4,2
30011,2014/03/31,2012/03/01,120,7,0.6737934459999999,11077,120,1,6
30012,2014/03/31,2009/12/04,340,5,0.832247993,8968,340,4,1
30013,2014/03/31,2005/01/19,254,9,0.554524853,13459,254,2,7
30014,2014/03/31,2011/05/03,130,13,0.5128724570000001,14552,130,9,4
30015,2014/03/31,2010/11/25,25,11,0.575136031,12975,25,2,9
30016,2014/03/31,2006/06/14,162,7,0.676379623,11032,162,3,4
30017,2014/03/31,2008/04/08,380,6,0.617136713,12091,380,6,0
30018,2014/03/31,2006/02/13,8,13,0.704369867,10593,8,9,4
30019,2014/03/31,2006/12/08,195,9,0.787561748,9474,195,8,1
30020,2014/03/31,2011/11/15,262,8,0.7642737140000001,9762,262,4,4
30021,2014/03/31,2008/10/10,108,8,0.575668981,12960,108,2,6
30022,2014/03/31,2010/10/19,246,8,0.596890951,12499,246,6,2
30023,2014/03/31,2009/05/20,138,5,0.726,10275,138,4,1
30024,2014/03/31,2009/02/09,44,10,0.6136344189999999,12156,44,5,5
30025,2014/03/31,2012/05/13,173,9,0.48417954,15406,173,8,1
30026,2014/03/31,2009/11/12,9,11,0.5790909089999999,12881,9,4,7
30027,2014/03/31,2010/07/13,247,9,0.595300878,12530,247,4,5
30028,2014/03/31,2011/04/06,14,6,0.638117889,11689,14,4,2
30029,2014/03/31,2013/01/26,421,4,0.8155368470000001,9146,421,4,0
30030,2014/03/31,2007/09/11,152,10,0.756777597,9856,152,5,5
30031,2014/03/31,2012/03/17,357,8,0.711611487,10481,357,6,2
30032,2014/03/31,2006/06/30,149,14,0.82571302,9032,149,7,7
30033,2014/03/31,2007/04/12,44,7,0.475441795,15686,44,3,4
30034,2014/03/31,2011/12/16,2,7,0.6877709120000001,10843,2,5,2
30035,2014/03/31,2011/11/21,124,13,0.6351861320000001,11739,124,12,1
30036,2014/03/31,2011/06/16,209,9,0.803895418,9275,209,6,3
30037,2014/03/31,2006/03/25,186,7,0.705534633,10568,186,4,3
30038,2014/03/31,2010/06/29,31,12,0.622597912,11975,31,0,12
30039,2014/03/31,2005/07/03,20,6,0.6316666670000001,11802,20,5,1
30040,2014/03/31,2009/08/31,37,10,0.7023572640000001,10614,37,3,7
30041,2014/03/31,2007/12/19,4,5,1.270576104,5867,4,0,5
30042,2014/03/31,2012/04/14,488,6,0.818771968,9104,488,6,0
30043,2014/03/31,2007/11/01,475,7,0.80714131,9235,475,7,0
30044,2014/03/31,2009/03/31,8,8,0.541140637,13773,8,0,8
30045,2014/03/31,2010/10/19,86,5,0.690201889,10798,86,2,3
30046,2014/03/31,2012/07/21,25,8,0.512179232,14551,25,1,7
30047,2014/03/31,2007/02/23,12,5,0.802307278,9288,12,3,2
30048,2014/03/31,2013/03/06,61,10,0.631337909,11802,61,1,9
30049,2014/03/31,2011/01/16,60,5,0.753537621,9888,60,3,2
30050,2014/03/31,2007/06/15,138,10,0.805111303,9254,138,8,2
30051,2014/03/31,2012/08/17,251,5,0.787226038,9463,251,2,3
30052,2014/03/31,2010/01/29,506,9,0.805019994,9253,506,9,0
30053,2014/03/31,2009/08/04,214,9,0.890751106,8361,214,7,2
30054,2014/03/31,2008/12/11,181,5,0.8185854029999999,9098,181,2,3
30055,2014/03/31,2008/04/17,136,11,0.742475573,10030,136,6,5
30056,2014/03/31,2010/06/01,443,4,0.7308568059999999,10189,443,4,0
30057,2014/03/31,2007/05/01,55,9,0.403881326,18437,55,6,3
30058,2014/03/31,2011/12/22,106,11,0.7974927709999999,9337,106,3,8
30059,2014/03/31,2012/01/06,182,10,0.489668508,15204,182,7,3
30060,2014/03/31,2005/08/09,33,10,0.577037209,12900,33,7,3
30061,2014/03/31,2010/11/25,319,7,0.865416812,8601,319,6,1
30062,2014/03/31,2012/08/23,40,12,0.47429236,15693,40,1,11
30063,2014/03/31,2004/11/10,134,8,0.7759090909999999,9592,134,6,2
30064,2014/03/31,2011/01/04,8,10,0.930876798,7995,8,8,2
30065,2014/03/31,2012/01/02,128,8,0.80569449,9237,128,5,3
30066,2014/03/31,2008/08/02,334,8,0.837840576,8882,334,7,1
30067,2014/03/31,2008/04/14,148,4,0.763611083,9745,148,3,1
30068,2014/03/31,2011/05/19,23,12,0.605923785,12281,23,6,6
30069,2014/03/31,2007/05/11,238,6,0.729800902,10196,238,4,2
30070,2014/03/31,2012/04/30,260,10,0.931403179,7989,260,8,2
30071,2014/03/31,2008/03/26,328,10,0.865085455,8601,328,8,2
30072,2014/03/31,2007/12/12,1,7,0.764778988,9728,1,0,7
30073,2014/03/31,2007/04/07,21,8,0.7586081370000001,9807,21,4,4
30074,2014/03/31,2009/06/01,99,7,0.73958644,10059,99,0,7
30075,2014/03/31,2010/05/19,35,10,0.765238144,9721,35,4,6
30076,2014/03/31,2011/02/05,369,8,0.874089307,8510,369,8,0
30077,2014/03/31,2012/09/08,13,12,0.7473616,9953,13,1,11
30078,2014/03/31,2012/07/24,475,4,0.597821894,12442,475,4,0
30079,2014/03/31,2005/05/13,62,8,0.6939167759999999,10718,62,6,2
30080,2014/03/31,2012/04/18,113,10,0.413412451,17990,113,6,4
30081,2014/03/31,2013/03/08,235,7,0.8606735329999999,8641,235,2,5
30082,2014/03/31,2012/09/01,5,6,0.625385133,11892,5,3,3
30083,2014/03/31,2009/11/27,326,5,0.591784038,12567,326,4,1
30084,2014/03/31,2006/01/26,65,12,0.853651705,8711,65,10,2
30085,2014/03/31,2005/08/27,186,8,0.662037037,11232,186,4,4
30086,2014/03/31,2011/05/30,290,9,0.7068441059999999,10520,290,5,4
30087,2014/03/31,2012/06/21,137,10,0.70469674,10552,137,9,1
30088,2014/03/31,2010/05/30,87,7,0.7975919770000001,9323,87,3,4
30089,2014/03/31,2006/09/16,615,2,1.5,4957,615,2,0
30090,2014/03/31,2013/01/15,34,7,0.596110799,12473,34,0,7
30091,2014/03/31,2011/11/08,292,5,0.6614946620000001,11240,292,3,2
30092,2014/03/31,2008/01/16,163,5,0.8430729109999999,8819,163,0,5
30093,2014/03/31,2007/11/24,44,7,0.740083632,10044,44,2,5
30094,2014/03/31,2009/08/07,430,10,0.578578656,12847,430,10,0
30095,2014/03/31,2013/03/22,140,8,0.838531137,8864,140,1,7
30096,2014/03/31,2009/10/06,118,7,0.904434709,8217,118,3,4
30097,2014/03/31,2008/03/17,91,4,0.7073577,10506,91,0,4
30098,2014/03/31,2007/06/19,137,8,0.892327089,8328,137,3,5
30099,2014/03/31,2011/04/23,43,7,0.6915988829999999,10745,43,2,5
30100,2014/03/31,2009/07/14,11,14,0.6807007420000001,10917,11,2,12
30101,2014/03/31,2011/05/30,304,10,0.676287768,10988,304,9,1
30102,2014/03/31,2012/02/13,52,7,0.891866299,8332,52,4,3
30103,2014/03/31,2006/05/12,185,12,0.621737784,11952,185,7,5
30104,2014/03/31,2008/04/01,276,10,0.570867327,13017,276,5,5
30105,2014/03/31,2006/04/15,194,4,0.610345791,12175,194,1,3
30106,2014/03/31,2012/06/20,603,5,0.38679923,19211,603,5,0
30107,2014/03/31,2011/02/24,174,3,0.6779281090000001,10961,174,0,3
30108,2014/03/31,2007/12/01,19,13,0.645646885,11509,19,8,5
30109,2014/03/31,2011/07/10,51,7,0.584245951,12718,51,3,4
30110,2014/03/31,2012/08/20,531,4,0.8,9288,531,4,0
30111,2014/03/31,2013/01/20,38,10,0.773106857,9611,38,2,8
30112,2014/03/31,2012/12/22,126,10,1.4491808069999998,5127,126,5,5
30113,2014/03/31,2012/03/08,538,5,0.7211803529999999,10302,538,5,0
30114,2014/03/31,2005/05/04,36,15,0.515126552,14421,36,9,6
30115,2014/03/31,2009/10/06,224,8,0.863520112,8602,224,7,1
30116,2014/03/31,2011/01/12,19,13,0.608846721,12200,19,11,2
30117,2014/03/31,2012/07/30,337,5,0.7554775709999999,9831,337,4,1
30118,2014/03/31,2010/11/17,18,6,0.6665233779999999,11143,18,0,6
30119,2014/03/31,2012/04/24,175,5,0.886482454,8378,175,4,1
30120,2014/03/31,2012/04/15,85,8,0.673113387,11033,85,2,6
30121,2014/03/31,2012/02/15,118,12,0.983873874,7548,118,5,7
30122,2014/03/31,2011/09/24,372,5,0.691502933,10739,372,5,0
30123,2014/03/31,2007/12/26,10,8,0.717865429,10344,10,1,7
30124,2014/03/31,2012/12/01,477,3,0.6798086609999999,10923,477,3,0
30125,2014/03/31,2009/08/12,299,13,0.486982815,15246,299,9,4
30126,2014/03/31,2011/08/17,545,8,0.6356121579999999,11680,545,8,0
30127,2014/03/31,2009/10/07,342,3,0.7,10605,342,1,2
30128,2014/03/31,2009/07/12,27,3,0.7,10605,27,1,2
30129,2014/03/31,2005/12/10,12,10,0.574831191,12914,12,0,10
30130,2014/03/31,2012/05/20,494,4,0.973164657,7628,494,4,0
30131,2014/03/31,2012/11/15,137,7,0.7324380859999999,10135,137,2,5
30132,2014/03/31,2013/01/01,37,6,0.6991184779999999,10618,37,2,4
30133,2014/03/31,2013/01/01,211,6,0.840646659,8830,211,3,3
30134,2014/03/31,2009/08/10,50,8,0.780785902,9505,50,6,2
30135,2014/03/31,2012/04/02,724,2,0.5543138870000001,13387,724,2,0
30136,2014/03/31,2011/10/17,361,5,0.815898846,9095,361,4,1
30137,2014/03/31,2011/09/05,45,4,1.163037618,6380,45,3,1
30138,2014/03/31,2012/11/09,191,4,0.504460158,14708,191,2,2
30139,2014/03/31,2007/05/16,227,9,0.79507234,9331,227,6,3
30140,2014/03/31,2012/04/05,189,7,0.528883502,14026,189,5,2
30141,2014/03/31,2012/03/15,317,8,0.693520942,10696,317,6,2
30142,2014/03/31,2011/06/27,138,5,0.799767116,9275,138,4,1
30143,2014/03/31,2012/09/19,210,8,0.720697629,10292,210,3,5
30144,2014/03/31,2010/10/21,48,12,0.6140986999999999,12077,48,1,11
30145,2014/03/31,2007/07/17,9,10,0.7563885770000001,9805,9,2,8
30146,2014/03/31,2011/10/16,135,9,0.6108434229999999,12141,135,5,4
30147,2014/03/31,2011/09/11,3,5,0.773002918,9594,3,1,4
30148,2014/03/31,2010/07/07,146,9,0.629102477,11788,146,5,4
30149,2014/03/31,2011/09/19,313,6,0.677824497,10940,313,5,1
30150,2014/03/31,2011/06/04,9,13,0.62447907,11873,9,2,11
30151,2014/03/31,2010/06/10,136,8,0.915753458,8096,136,5,3
30152,2014/03/31,2008/03/01,381,6,1.007706946,7357,381,6,0
30153,2014/03/31,2012/06/01,196,11,0.670948502,11049,196,7,4
30154,2014/03/31,2009/02/15,27,9,0.557841072,13289,27,5,4
30155,2014/03/31,2011/10/29,137,8,0.630069698,11765,137,3,5
30156,2014/03/31,2009/12/26,11,11,0.582737421,12720,11,5,6
30157,2014/03/31,2010/11/17,331,8,0.705669269,10504,331,5,3
30158,2014/03/31,2012/10/13,506,6,0.829330797,8936,506,6,0
30159,2014/03/31,2006/11/06,171,9,0.608034132,12188,171,3,6
30160,2014/03/31,2005/05/14,310,7,0.836316443,8861,310,5,2
30161,2014/03/31,2005/10/08,316,9,0.488919311,15157,316,7,2
30162,2014/03/31,2012/06/22,9,4,0.775156904,9560,9,0,4
30163,2014/03/31,2009/03/27,101,9,0.765860465,9675,101,4,5
30164,2014/03/31,2012/05/31,75,13,0.757003474,9788,75,10,3
30165,2014/03/31,2008/08/08,139,5,0.948696543,7810,139,4,1
30166,2014/03/31,2011/03/23,14,4,0.870833333,8508,14,1,3
30167,2014/03/31,2010/12/16,248,8,0.848880614,8728,248,4,4
30168,2014/03/31,2009/02/15,101,7,0.5491727820000001,13491,101,0,7
30169,2014/03/31,2012/12/24,96,14,0.47480646,15604,96,3,11
30170,2014/03/31,2012/01/29,44,7,0.904152325,8193,44,1,6
30171,2014/03/31,2010/12/02,23,9,0.410774691,18033,23,4,5
30172,2014/03/31,2005/09/09,483,8,0.701700455,10556,483,8,0
30173,2014/03/31,2012/06/27,89,6,0.599654307,12352,89,4,2
30174,2014/03/31,2008/08/14,109,5,0.640169404,11570,109,1,4
30175,2014/03/31,2011/01/05,342,8,0.8468671390000001,8746,342,6,2
30176,2014/03/31,2006/09/29,16,9,0.657542614,11264,16,5,4
30177,2014/03/31,2008/03/10,64,12,0.699454151,10589,64,3,9
30178,2014/03/31,2012/10/27,29,10,0.618047234,11983,29,1,9
30179,2014/03/31,2010/11/10,160,6,0.714308449,10368,160,2,4
30180,2014/03/31,2009/03/06,138,17,0.346617991,21366,138,5,12
30181,2014/03/31,2011/10/12,11,26,0.797097191,9291,11,15,11
30182,2014/03/31,2013/03/23,72,10,0.574,12900,72,0,10
30183,2014/03/31,2008/08/13,1,7,0.476940419,15525,1,3,4
30184,2014/03/31,2010/11/08,5,8,0.674818157,10971,5,2,6
30185,2014/03/31,2010/08/27,114,7,0.716161362,10337,114,2,5
30186,2014/03/31,2005/04/28,4,8,1.293720727,5722,4,6,2
30187,2014/03/31,2008/04/29,67,4,0.8709718790000001,8499,67,1,3
30188,2014/03/31,2012/09/26,77,11,0.8134461540000001,9100,77,6,5
30189,2014/03/31,2012/08/11,388,8,0.786814413,9408,388,8,0
30190,2014/03/31,2012/09/06,11,7,0.759725957,9743,11,5,2
30191,2014/03/31,2008/10/10,170,6,0.635436985,11648,170,0,6
30192,2014/03/31,2006/07/25,63,8,0.8566597220000001,8640,63,0,8
30193,2014/03/31,2011/01/13,11,9,0.536018686,13807,11,4,5
30194,2014/03/31,2010/03/29,319,8,0.564243233,13115,319,5,3
30195,2014/03/31,2009/08/10,100,11,0.6476089620000001,11426,100,2,9
30196,2014/03/31,2012/10/19,78,9,0.704114008,10508,78,1,8
30197,2014/03/31,2012/10/02,40,11,0.5455360570000001,13562,40,10,1
30198,2014/03/31,2012/09/27,196,11,0.578475915,12788,196,5,6
30199,2014/03/31,2013/02/14,6,10,0.7705729170000001,9600,6,0,10
30200,2014/03/31,2008/05/03,37,5,0.690230475,10717,37,2,3
30201,2014/03/31,2011/05/23,221,10,0.709927056,10419,221,5,5
30202,2014/03/31,2009/09/17,96,4,0.89113012,8300,96,3,1
30203,2014/03/31,2009/01/27,18,7,0.448065552,16506,18,3,4
30204,2014/03/31,2011/07/13,173,7,0.8280718840000001,8931,173,4,3
30205,2014/03/31,2012/03/06,251,6,0.555988272,13301,251,4,2
30206,2014/03/31,2009/06/22,3,7,0.769714791,9607,3,2,5
30207,2014/03/31,2007/11/14,570,6,0.696215046,10621,570,6,0
30208,2014/03/31,2012/03/15,170,10,0.648295634,11406,170,7,3
30209,2014/03/31,2009/05/05,10,8,0.577302467,12808,10,2,6
30210,2014/03/31,2011/12/15,152,5,0.76860395,9620,152,0,5
30211,2014/03/31,2012/01/17,254,5,0.807280271,9159,254,4,1
30212,2014/03/31,2011/03/15,137,9,0.8440194059999999,8760,137,2,7
30213,2014/03/31,2009/11/19,81,11,0.8674715479999999,8523,81,5,6
30214,2014/03/31,2009/06/20,14,12,0.499672885,14796,14,6,6
30215,2014/03/31,2011/02/08,34,15,0.35828462,20631,34,7,8
30216,2014/03/31,2009/01/20,128,9,0.632028217,11695,128,5,4
30217,2014/03/31,2010/09/25,49,4,0.836285359,8838,49,1,3
30218,2014/03/31,2012/09/29,28,10,0.58858474,12556,28,0,10
30219,2014/03/31,2006/04/05,307,13,0.456739802,16180,307,11,2
30220,2014/03/31,2012/04/19,232,5,0.582650792,12683,232,3,2
30221,2014/03/31,2013/01/16,39,7,0.646007518,11439,39,3,4
30222,2014/03/31,2012/01/08,3,5,0.613797658,12039,3,2,3
30223,2014/03/31,2006/04/06,329,6,0.825435657,8952,329,5,1
30224,2014/03/31,2012/05/16,673,3,0.8666666670000001,8526,673,3,0
30225,2014/03/31,2012/01/01,3,7,0.688390162,10734,3,0,7
30226,2014/03/31,2008/10/18,137,8,0.790443993,9347,137,3,5
30227,2014/03/31,2012/07/09,384,6,0.7680476140000001,9619,384,6,0
30228,2014/03/31,2012/06/15,252,4,0.845649038,8736,252,3,1
30229,2014/03/31,2011/03/01,320,6,0.956050214,7727,320,4,2
30230,2014/03/31,2012/09/11,247,4,0.8057537090000001,9168,247,2,2
30231,2014/03/31,2006/10/08,76,12,0.6792312640000001,10875,76,5,7
30232,2014/03/31,2007/11/27,18,8,0.811357645,9104,18,6,2
30233,2014/03/31,2011/01/24,118,8,0.422420794,17486,118,3,5
30234,2014/03/31,2007/11/07,73,7,0.8266368209999999,8935,73,6,1
30235,2014/03/31,2012/07/23,12,8,0.655677379,11264,12,4,4
30236,2014/03/31,2009/07/08,43,9,0.656197796,11254,43,1,8
30237,2014/03/31,2011/09/11,115,10,0.502941497,14683,115,7,3
30238,2014/03/31,2005/10/19,83,7,0.6408287770000001,11523,83,1,6
30239,2014/03/31,2010/03/05,436,10,0.819561598,9010,436,10,0
30240,2014/03/31,2012/03/23,128,7,0.907571288,8136,128,4,3
30241,2014/03/31,2011/05/02,211,11,0.769959333,9590,211,1,10
30242,2014/03/31,2011/10/09,40,8,0.8455737520000001,8732,40,5,3
30243,2014/03/31,2008/06/18,12,7,0.617393595,11959,12,0,7
30244,2014/03/31,2007/05/05,11,12,0.751311692,9827,11,3,9
30245,2014/03/31,2005/09/02,26,9,0.599308385,12319,26,1,8
30246,2014/03/31,2012/04/24,16,9,0.902174019,8183,16,6,3
30247,2014/03/31,2011/10/12,79,6,0.941681337,7839,79,3,3
30248,2014/03/31,2010/10/14,293,10,0.7048209679999999,10473,293,8,2
30249,2014/03/31,2006/05/19,42,6,0.485635897,15199,42,3,3
30250,2014/03/31,2007/08/19,20,6,0.593142077,12444,20,2,4
30251,2014/03/31,2012/02/05,465,5,0.74293336,9934,465,5,0
30252,2014/03/31,2012/08/09,209,6,0.887468735,8316,209,5,1
30253,2014/03/31,2011/12/21,4,11,0.682497225,10812,4,7,4
30254,2014/03/31,2008/01/22,90,16,0.714469404,10328,90,8,8
30255,2014/03/31,2012/06/03,319,3,1.056406586,6985,319,2,1
30256,2014/03/31,2006/12/04,8,14,0.531397091,13886,8,6,8
30257,2014/03/31,2012/05/21,172,13,0.7339039190000001,10054,172,9,4
30258,2014/03/31,2012/02/24,85,9,0.918410505,8034,85,5,4
30259,2014/03/31,2007/09/08,113,11,0.707813699,10424,113,3,8
30260,2014/03/31,2011/07/02,44,8,0.665420274,11088,44,3,5
30261,2014/03/31,2011/11/29,94,10,0.686895075,10741,94,6,4
30262,2014/03/31,2006/04/09,479,11,0.8166758909999999,9034,479,11,0
30263,2014/03/31,2005/02/07,275,3,1.372861928,5374,275,2,1
30264,2014/03/31,2005/09/20,7,6,0.716064253,10303,7,1,5
30265,2014/03/31,2010/01/10,130,6,0.567637147,12997,130,2,4
30266,2014/03/31,2009/10/05,543,5,0.584351236,12624,543,5,0
30267,2014/03/31,2012/10/31,45,5,0.7340000000000001,10050,45,4,1
30268,2014/03/31,2007/08/18,162,10,0.566856989,13013,162,9,1
30269,2014/03/31,2010/11/17,376,4,0.9375,7868,376,4,0
30270,2014/03/31,2008/08/29,511,4,0.9375,7868,511,4,0
30271,2014/03/31,2011/08/01,65,6,0.784830265,9397,65,2,4
30272,2014/03/31,2011/08/01,659,6,1.0,7375,659,6,0
30273,2014/03/31,2009/06/01,8,7,0.6542512420000001,11272,8,0,7
30274,2014/03/31,2012/11/05,12,9,0.6561067620000001,11240,12,3,6
30275,2014/03/31,2011/09/08,23,8,0.6689957360000001,11023,23,0,8
30276,2014/03/31,2013/03/01,43,5,0.7182554059999999,10266,43,1,4
30277,2014/03/31,2013/03/23,10,9,0.613080569,12027,10,0,9
30278,2014/03/31,2013/01/16,4,9,0.811111111,9090,4,0,9
30279,2014/03/31,2008/03/05,49,9,0.651319788,11320,49,4,5
30280,2014/03/31,2012/10/28,91,8,0.6852146840000001,10760,91,2,6
30281,2014/03/31,2012/07/30,595,4,0.775,9512,595,4,0
30282,2014/03/31,2010/03/18,338,8,0.8190777779999999,9000,338,7,1
30283,2014/03/31,2012/08/17,215,7,0.848519457,8686,215,3,4
30284,2014/03/31,2008/11/04,28,9,0.610848806,12064,28,0,9
30285,2014/03/31,2010/10/01,336,7,0.648697183,11360,336,6,1
30286,2014/03/31,2007/05/12,211,5,0.868303087,8486,211,3,2
30287,2014/03/31,2012/09/14,117,7,0.711451333,10356,117,4,3
30288,2014/03/31,2010/05/18,49,7,0.668240203,11024,49,3,4
30289,2014/03/31,2010/11/03,95,13,0.555539216,13260,95,7,6
30290,2014/03/31,2011/04/19,95,6,0.706444807,10427,95,4,2
30291,2014/03/31,2012/04/17,339,6,0.65804074,11193,339,2,4
30292,2014/03/31,2011/05/09,7,4,0.6829970329999999,10784,7,0,4
30293,2014/03/31,2009/09/11,574,5,0.687794173,10708,574,5,0
30294,2014/03/31,2011/06/30,216,4,0.970713062,7587,216,2,2
30295,2014/03/31,2007/08/09,38,7,0.5548252220000001,13274,38,5,2
30296,2014/03/31,2011/02/04,22,9,0.622322968,11834,22,0,9
30297,2014/03/31,2007/12/12,11,9,0.527266414,13967,11,2,7
30298,2014/03/31,2009/10/01,419,7,0.5810399239999999,12674,419,7,0
30299,2014/03/31,2012/04/24,420,8,0.8140796020000001,9045,420,8,0
30300,2014/03/31,2009/02/14,313,5,0.5509839870000001,13364,313,3,2
30301,2014/03/31,2011/09/04,189,16,0.7502037909999999,9814,189,11,5
30302,2014/03/31,2009/04/07,312,5,0.69,10670,312,3,2
30303,2014/03/31,2011/10/12,471,4,1.137919307,6469,471,4,0
30304,2014/03/31,2011/10/17,223,7,0.837882755,8785,223,6,1
30305,2014/03/31,2011/09/30,275,3,0.8633333329999999,8526,275,0,3
30306,2014/03/31,2011/06/22,156,10,0.6799685879999999,10824,156,4,6
30307,2014/03/31,2012/01/09,144,8,0.880229638,8361,144,7,1
30308,2014/03/31,2004/12/10,18,10,0.592296982,12425,18,2,8
30309,2014/03/31,2011/01/13,199,5,0.760066102,9682,199,4,1
30310,2014/03/31,2009/10/14,24,15,0.814085629,9039,24,10,5
30311,2014/03/31,2007/06/30,304,5,0.499237346,14738,304,3,2
30312,2014/03/31,2008/02/20,504,5,0.75712154,9717,504,5,0
30313,2014/03/31,2012/09/08,563,4,0.8482531999999999,8673,563,4,0
30314,2014/03/31,2013/03/26,179,9,0.605279743,12154,179,2,7
30315,2014/03/31,2010/06/22,265,9,0.6880561270000001,10690,265,4,5
30316,2014/03/31,2013/03/25,13,8,0.693295315,10609,13,0,8
30317,2014/03/31,2012/04/03,431,6,0.717220868,10255,431,6,0
30318,2014/03/31,2012/11/03,11,11,0.5928647429999999,12406,11,2,9
30319,2014/03/31,2008/11/26,4,6,0.836534349,8792,4,2,4
30320,2014/03/31,2008/05/12,39,9,0.520494692,14130,39,3,6
30321,2014/03/31,2012/10/25,144,17,0.49508146,14854,144,9,8
30322,2014/03/31,2008/05/18,225,9,0.745075988,9870,225,6,3
30323,2014/03/31,2010/06/30,500,14,0.907142857,8106,500,14,0
30324,2014/03/31,2012/04/06,286,5,0.731684745,10049,286,4,1
30325,2014/03/31,2006/09/24,135,9,0.823831671,8923,135,4,5
30326,2014/03/31,2007/07/16,123,10,0.66141096,11113,123,6,4
30327,2014/03/31,2007/07/01,169,14,0.451457527,16281,169,8,6
30328,2014/03/31,2010/07/17,191,10,0.933782239,7871,191,9,1
30329,2014/03/31,2005/08/11,38,8,0.507024286,14494,38,3,5
30330,2014/03/31,2010/11/18,301,8,0.5667468760000001,12966,301,6,2
30331,2014/03/31,2006/07/17,96,10,0.649666696,11311,96,5,5
30332,2014/03/31,2007/04/02,189,4,0.69468942,10577,189,1,3
30333,2014/03/31,2010/02/12,13,7,0.7569554909999999,9706,13,2,5
30334,2014/03/31,2011/11/09,563,5,0.550007487,13357,563,5,0
30335,2014/03/31,2007/10/20,3,15,0.850521014,8637,3,6,9
30336,2014/03/31,2010/06/11,2,10,0.878686603,8360,2,7,3
30337,2014/03/31,2008/02/03,30,9,0.7718419670000001,9517,30,5,4
30338,2014/03/31,2012/07/02,379,6,0.5650384620000001,13000,379,6,0
30339,2014/03/31,2012/11/20,2,7,0.5713643429999999,12856,2,4,3
30340,2014/03/31,2007/07/17,28,9,0.800669283,9174,28,5,4
30341,2014/03/31,2008/11/01,54,16,0.509403565,14419,54,9,7
30342,2014/03/31,2010/09/25,165,9,0.762218763,9636,165,7,2
30343,2014/03/31,2012/10/30,104,9,0.707531792,10380,104,3,6
30344,2014/03/31,2012/12/11,36,11,0.73051328,10053,36,7,4
30345,2014/03/31,2012/02/13,244,10,0.851237974,8627,244,7,3
30346,2014/03/31,2006/05/10,131,8,0.448017815,16391,131,7,1
30347,2014/03/31,2010/10/17,7,9,0.837795779,8765,7,4,5
30348,2014/03/31,2010/10/16,195,14,0.7366268690000001,9967,195,9,5
30349,2014/03/31,2012/02/25,681,2,0.719467856,10204,681,2,0
30350,2014/03/31,2009/01/01,295,8,0.769836409,9536,295,6,2
30351,2014/03/31,2011/06/22,361,7,0.652944054,11243,361,6,1
30352,2014/03/31,2005/04/06,26,9,0.681085545,10778,26,2,7
30353,2014/03/31,2011/12/13,77,5,0.744651517,9857,77,4,1
30354,2014/03/31,2012/12/20,152,8,0.588795828,12465,152,4,4
30355,2014/03/31,2007/07/21,323,7,0.5380681820000001,13640,323,6,1
30356,2014/03/31,2004/12/13,218,5,0.733908,10000,218,4,1
30357,2014/03/31,2006/06/08,488,7,0.973997876,7534,488,7,0
30358,2014/03/31,2006/04/20,341,6,0.7241488209999999,10133,341,4,2
30359,2014/03/31,2009/09/11,139,7,0.753830902,9734,139,4,3
30360,2014/03/31,2006/02/27,15,8,0.488697216,15014,15,4,4
30361,2014/03/31,2012/07/05,97,13,0.711102927,10318,97,9,4
30362,2014/03/31,2011/07/28,709,2,0.55,13340,709,2,0
30363,2014/03/31,2009/08/26,113,8,0.529626074,13853,113,7,1
30364,2014/03/31,2012/08/27,44,11,0.5243624929999999,13992,44,7,4
30365,2014/03/31,2012/12/11,195,7,0.848926174,8642,195,3,4
30366,2014/03/31,2011/06/28,224,7,0.947530354,7742,224,2,5
30367,2014/03/31,2011/11/15,138,6,0.65749395,11157,138,2,4
30368,2014/03/31,2012/09/04,85,6,0.7099506390000001,10332,85,1,5
30369,2014/03/31,2013/03/06,9,12,0.827711578,8862,9,2,10
30370,2014/03/31,2009/10/29,35,8,0.588318094,12468,35,2,6
30371,2014/03/31,2007/11/22,197,8,0.6772154,10831,197,4,4
30372,2014/03/31,2012/10/12,282,6,0.702976133,10433,282,4,2
30373,2014/03/31,2007/09/10,73,12,0.72064066,10177,73,0,12
30374,2014/03/31,2009/11/06,181,7,0.645363428,11364,181,5,2
30375,2014/03/31,2013/01/31,56,6,0.845836217,8670,56,2,4
30376,2014/03/31,2008/09/26,233,10,0.614286672,11937,233,4,6
30377,2014/03/31,2011/09/07,33,8,0.7279142259999999,10073,33,1,7
30378,2014/03/31,2010/10/04,269,3,0.6266666670000001,11700,269,2,1
30379,2014/03/31,2009/08/12,377,7,0.933392743,7855,377,7,0
30380,2014/03/31,2008/02/09,44,3,0.634841112,11549,44,0,3
30381,2014/03/31,2007/10/26,3,9,0.598743977,12245,3,5,4
30382,2014/03/31,2009/04/02,630,8,0.598823818,12243,630,8,0
30383,2014/03/31,2010/12/23,403,6,0.7156741190000001,10243,403,6,0
30384,2014/03/31,2013/02/14,7,6,0.901666667,8130,7,2,4
30385,2014/03/31,2007/08/27,171,7,0.909699677,8058,171,5,2
30386,2014/03/31,2009/07/17,14,10,0.646244049,11342,14,7,3
30387,2014/03/31,2008/01/14,583,5,0.8365042229999999,8762,583,5,0
30388,2014/03/31,2010/06/17,496,9,0.905168581,8097,496,9,0
30389,2014/03/31,2008/09/05,72,8,0.918543677,7979,72,2,6
30390,2014/03/31,2008/07/10,49,5,0.7773642340000001,9428,49,0,5
30391,2014/03/31,2011/06/29,208,7,0.7514528859999999,9753,208,5,2
30392,2014/03/31,2009/02/06,44,13,0.5833102520000001,12564,44,12,1
30393,2014/03/31,2006/07/08,122,9,0.655437796,11181,122,8,1
30394,2014/03/31,2012/11/12,103,6,0.5844035089999999,12540,103,1,5
30395,2014/03/31,2013/01/01,250,6,0.566842512,12928,250,0,6
30396,2014/03/31,2012/04/22,46,9,0.647938628,11308,46,2,7
30397,2014/03/31,2005/05/21,17,14,0.904541975,8100,17,9,5
30398,2014/03/31,2012/01/07,275,6,0.644733369,11364,275,5,1
30399,2014/03/31,2013/03/28,233,7,0.7988943409999999,9171,233,0,7
30400,2014/03/31,2012/10/11,19,10,0.74362566,9852,19,3,7
30401,2014/03/31,2006/10/12,46,5,0.8399506990000001,8722,46,0,5
30402,2014/03/31,2011/09/26,80,10,0.5438775060000001,13470,80,4,6
30403,2014/03/31,2012/09/20,5,11,0.6234817020000001,11750,5,1,10
30404,2014/03/31,2011/06/22,305,6,0.939305039,7799,305,3,3
30405,2014/03/31,2011/06/06,122,7,0.8710595790000001,8409,122,0,7
30406,2014/03/31,2012/12/20,125,11,0.796101087,9200,125,4,7
30407,2014/03/31,2007/12/10,50,8,0.7222633140000001,10140,50,0,8
30408,2014/03/31,2012/04/01,638,7,0.7021526509999999,10429,638,7,0
30409,2014/03/31,2013/01/23,188,10,0.855353347,8561,188,4,6
30410,2014/03/31,2009/04/17,466,2,1.0,7322,466,2,0
30411,2014/03/31,2008/01/01,70,14,0.466582335,15692,70,2,12
30412,2014/03/31,2013/01/24,59,5,0.676227025,10827,59,0,5
30413,2014/03/31,2012/04/01,297,9,0.8146884040000001,8986,297,8,1
30414,2014/03/31,2011/02/13,47,3,0.913344148,8014,47,1,2
30415,2014/03/31,2005/08/24,1,5,0.735665896,9949,1,0,5
30416,2014/03/31,2012/10/25,396,2,0.815316921,8977,396,2,0
30417,2014/03/31,2007/10/08,325,5,0.7955326090000001,9200,325,3,2
30418,2014/03/31,2007/04/28,382,14,0.8775299759999999,8340,382,14,0
30419,2014/03/31,2008/07/16,98,12,0.4260691620000001,17177,98,6,6
30420,2014/03/31,2009/01/05,210,9,0.619983904,11804,210,4,5
30421,2014/03/31,2012/09/11,31,9,0.8168367009999999,8959,31,5,4
30422,2014/03/31,2010/06/01,45,12,0.623114782,11744,45,6,6
30423,2014/03/31,2011/02/22,158,8,0.66844889,10947,158,3,5
30424,2014/03/31,2010/09/11,137,13,0.816723965,8959,137,10,3
30425,2014/03/31,2012/10/30,11,6,1.025736717,7133,11,0,6
30426,2014/03/31,2007/01/14,30,6,0.589607543,12409,30,0,6
30427,2014/03/31,2006/10/18,164,6,1.411612965,5183,164,4,2
30428,2014/03/31,2012/10/08,325,5,0.612400603,11947,325,0,5
30429,2014/03/31,2012/06/03,155,6,0.590625656,12387,155,2,4
30430,2014/03/31,2012/04/05,200,8,0.827953825,8836,200,3,5
30431,2014/03/31,2012/12/13,23,9,0.591006625,12378,23,1,8
30432,2014/03/31,2005/05/04,32,14,0.627165638,11664,32,7,7
30433,2014/03/31,2011/03/08,48,8,0.802247203,9118,48,2,6
30434,2014/03/31,2011/11/12,1,14,0.8172960890000001,8950,1,7,7
30435,2014/03/31,2010/12/23,150,7,0.649449525,11263,150,6,1
30436,2014/03/31,2012/09/27,279,24,0.773710599,9454,279,14,10
30437,2014/03/31,2011/08/26,249,6,0.867795705,8429,249,5,1
30438,2014/03/31,2012/09/19,328,2,0.45,16254,328,0,2
30439,2014/03/31,2012/12/05,240,4,0.7875,9288,240,2,2
30440,2014/03/31,2012/03/13,698,2,0.45,16254,698,2,0
30441,2014/03/31,2011/03/02,6,17,0.60856703,12017,6,6,11
30442,2014/03/31,2008/06/19,331,5,0.466747511,15668,331,2,3
30443,2014/03/31,2008/04/21,118,9,0.866672197,8438,118,3,6
30444,2014/03/31,2007/03/20,364,10,0.7704899890000001,9490,364,9,1
30445,2014/03/31,2011/03/24,4,12,0.744821228,9817,4,6,6
30446,2014/03/31,2007/01/09,99,13,0.547250954,13361,99,9,4
30447,2014/03/31,2009/08/22,161,9,0.5488199970000001,13322,161,5,4
30448,2014/03/31,2007/06/07,61,8,0.698193105,10471,61,2,6
30449,2014/03/31,2012/07/08,6,9,0.531443734,13756,6,4,5
30450,2014/03/31,2012/08/01,76,8,0.8088614740000001,9038,76,0,8
30451,2014/03/31,2013/03/21,96,10,0.873880454,8365,96,3,7
30452,2014/03/31,2005/09/09,217,10,0.90163069,8107,217,6,4
30453,2014/03/31,2012/03/08,490,5,0.8039485259999999,9092,490,5,0
30454,2014/03/31,2013/02/06,44,5,0.7506891240000001,9737,44,4,1
30455,2014/03/31,2011/05/19,31,14,0.46326087,15778,31,6,8
30456,2014/03/31,2005/07/17,35,12,0.725686625,10071,35,3,9
30457,2014/03/31,2012/06/25,45,4,0.6125,11932,45,1,3
30458,2014/03/31,2012/05/15,160,9,0.686875353,10638,160,5,4
30459,2014/03/31,2005/03/04,62,6,0.893542864,8177,62,2,4
30460,2014/03/31,2006/03/01,36,6,0.617046702,11841,36,0,6
30461,2014/03/31,2007/02/06,22,10,0.7063292729999999,10344,22,4,6
30462,2014/03/31,2008/05/19,226,7,0.7623875609999999,9583,226,5,2
30463,2014/03/31,2013/02/14,43,9,0.87,8397,43,2,7
30464,2014/03/31,2008/03/09,75,6,0.8584195059999999,8510,75,2,4
30465,2014/03/31,2012/11/24,25,8,0.8758764990000001,8340,25,6,2
30466,2014/03/31,2005/10/21,375,8,0.741110209,9854,375,8,0
30467,2014/03/31,2005/08/03,32,11,0.525539004,13896,32,2,9
30468,2014/03/31,2012/07/02,66,9,0.6873204709999999,10625,66,7,2
30469,2014/03/31,2011/03/03,74,6,0.853484105,8556,74,1,5
30470,2014/03/31,2008/05/26,57,10,0.670411387,10890,57,3,7
30471,2014/03/31,2011/03/06,75,11,0.548541588,13309,75,2,9
30472,2014/03/31,2012/05/28,253,8,0.7766762420000001,9399,253,4,4
30473,2014/03/31,2010/12/06,114,12,0.861927028,8469,114,6,6
30474,2014/03/31,2009/07/10,88,5,0.751181435,9717,88,3,2
30475,2014/03/31,2011/09/21,11,8,0.492613215,14817,11,3,5
30476,2014/03/31,2010/06/28,7,11,0.5044394529999999,14468,7,8,3
30477,2014/03/31,2005/06/07,265,6,1.07405298,6795,265,4,2
30478,2014/03/31,2012/03/27,16,13,0.492279258,14825,16,4,9
30479,2014/03/31,2011/04/15,265,7,0.97332622,7498,265,2,5
30480,2014/03/31,2009/08/26,175,8,0.523110171,13951,175,5,3
30481,2014/03/31,2012/08/10,127,6,0.733824032,9945,127,4,2
30482,2014/03/31,2012/09/01,250,9,0.7352226479999999,9926,250,8,1
30483,2014/03/31,2012/09/07,248,4,1.23915945,5889,248,2,2
30484,2014/03/31,2013/02/14,142,7,0.6098729629999999,11965,142,2,5
30485,2014/03/31,2012/03/01,7,10,0.666509865,10948,7,5,5
30486,2014/03/31,2007/04/12,34,9,0.708003105,10306,34,4,5
30487,2014/03/31,2012/09/16,75,8,0.549484901,13279,75,4,4
30488,2014/03/31,2007/01/07,7,8,0.907674795,8038,7,5,3
30489,2014/03/31,2012/11/22,16,10,0.771313035,9459,16,2,8
30490,2014/03/31,2011/11/10,94,7,0.75873947,9615,94,3,4
30491,2014/03/31,2011/08/20,26,10,0.6621074610000001,11018,26,2,8
30492,2014/03/31,2013/01/29,37,8,0.81636974,8936,37,1,7
30493,2014/03/31,2010/10/14,65,7,0.585891896,12451,65,3,4
30494,2014/03/31,2012/05/23,70,7,0.668132271,10917,70,2,5
30495,2014/03/31,2012/06/29,170,11,0.538778254,13538,170,6,5
30496,2014/03/31,2012/12/01,10,12,0.581001274,12554,10,1,11
30497,2014/03/31,2007/04/22,222,5,0.537566333,13568,222,4,1
30498,2014/03/31,2008/10/15,29,13,0.467393784,15605,29,2,11
30499,2014/03/31,2010/11/20,46,11,0.7918043640000001,9211,46,5,6
30500,2014/03/31,2011/01/19,64,6,0.76376165,9549,64,1,5
30501,2014/03/31,2010/06/26,13,7,0.7485926909999999,9742,13,2,5
30502,2014/03/31,2011/06/10,30,6,0.843274746,8648,30,3,3
30503,2014/03/31,2013/01/23,103,8,0.584631604,12473,103,3,5
30504,2014/03/31,2012/09/01,32,6,0.59795736,12195,32,1,5
30505,2014/03/31,2012/05/17,31,8,0.8091389259999999,9012,31,4,4
30506,2014/03/31,2012/07/23,116,7,0.803838607,9071,116,5,2
30507,2014/03/31,2012/04/12,485,6,0.772246346,9442,485,6,0
30508,2014/03/31,2012/04/05,259,9,0.812656041,8972,259,5,4
30509,2014/03/31,2005/09/27,401,8,0.611478779,11922,401,8,0
30510,2014/03/31,2012/05/16,137,4,0.6525,11172,137,1,3
30511,2014/03/31,2013/01/05,77,7,0.849402168,8581,77,4,3
30512,2014/03/31,2011/04/05,391,2,0.95,7672,391,2,0
30513,2014/03/31,2011/04/14,46,9,0.53743603,13561,46,7,2
30514,2014/03/31,2012/03/25,95,7,0.623521561,11688,95,1,6
30515,2014/03/31,2009/04/03,68,6,0.635867725,11461,68,2,4
30516,2014/03/31,2006/07/06,22,17,0.523350808,13925,22,3,14
30517,2014/03/31,2010/07/18,25,5,0.681835704,10688,25,1,4
30518,2014/03/31,2012/01/04,273,5,0.752499225,9683,273,4,1
30519,2014/03/31,2006/10/11,135,6,0.54084323,13472,135,4,2
30520,2014/03/31,2010/09/04,79,10,0.724699622,10054,79,4,6
30521,2014/03/31,2009/09/14,95,12,0.572400817,12729,95,7,5
30522,2014/03/31,2009/01/26,1,10,0.575390569,12661,1,2,8
30523,2014/03/31,2005/10/27,170,11,0.652700475,11161,170,7,4
30524,2014/03/31,2008/12/12,11,8,0.6879440929999999,10589,11,2,6
30525,2014/03/31,2011/12/25,238,6,0.9878492,7374,238,3,3
30526,2014/03/31,2011/12/24,437,6,0.607573609,11989,437,6,0
30527,2014/03/31,2011/07/19,62,10,0.524,13900,62,4,6
30528,2014/03/31,2009/05/29,151,11,0.638152107,11413,151,2,9
30529,2014/03/31,2008/09/15,35,9,0.432922958,16822,35,5,4
30530,2014/03/31,2008/06/19,555,4,0.8646995959999999,8422,555,4,0
30531,2014/03/31,2010/04/25,3,5,0.7057185770000001,10319,3,4,1
30532,2014/03/31,2011/05/08,86,11,0.721722498,10090,86,6,5
30533,2014/03/31,2007/04/27,366,5,0.892961373,8155,366,4,1
30534,2014/03/31,2013/01/12,339,6,0.758995205,9594,339,4,2
30535,2014/03/31,2006/06/29,209,10,0.659932028,11034,209,4,6
30536,2014/03/31,2012/04/01,330,6,0.492812183,14775,330,3,3
30537,2014/03/31,2007/10/11,32,5,1.311170538,5553,32,0,5
30538,2014/03/31,2011/06/24,4,7,0.501536819,14517,4,3,4
30539,2014/03/31,2013/02/10,163,9,0.682804352,10662,163,4,5
30540,2014/03/31,2006/11/26,58,7,0.705958685,10311,58,4,3
30541,2014/03/31,2007/04/15,109,5,0.364679359,19960,109,4,1
30542,2014/03/31,2011/07/20,30,8,0.587197483,12396,30,0,8
30543,2014/03/31,2007/02/20,151,11,0.606430595,12002,151,6,5
30544,2014/03/31,2010/08/12,222,10,0.7814408420000001,9314,222,6,4
30545,2014/03/31,2009/02/12,37,8,0.730183606,9967,37,4,4
30546,2014/03/31,2008/09/30,359,8,0.747422204,9737,359,7,1
30547,2014/03/31,2005/01/01,195,6,0.812599375,8956,195,5,1
30548,2014/03/31,2012/03/31,10,11,0.845336896,8608,10,0,11
30549,2014/03/31,2010/10/29,216,12,0.78391295,9282,216,7,5
30550,2014/03/31,2010/07/31,321,5,0.8115324559999999,8966,321,2,3
30551,2014/03/31,2012/09/17,266,5,0.75148523,9682,266,3,2
30552,2014/03/31,2011/01/04,79,12,0.896718846,8113,79,6,6
30553,2014/03/31,2012/12/04,1,13,0.602307692,12077,1,2,11
30554,2014/03/31,2012/05/11,122,10,0.662767198,10975,122,6,4
30555,2014/03/31,2012/03/01,321,8,0.720682651,10093,321,6,2
30556,2014/03/31,2011/01/29,36,12,0.670813428,10843,36,7,5
30557,2014/03/31,2011/12/30,86,7,1.009087125,7208,86,4,3
30558,2014/03/31,2007/12/31,109,4,0.85949415,8461,109,1,3
30559,2014/03/31,2011/11/29,544,6,0.648604174,11212,544,6,0
30560,2014/03/31,2006/10/08,33,6,0.9572604,7596,33,4,2
30561,2014/03/31,2012/05/27,149,4,0.6225,11680,149,2,2
30562,2014/03/31,2013/03/29,47,4,0.703434598,10336,47,1,3
30563,2014/03/31,2009/10/25,12,10,0.5775770579999999,12588,12,0,10
30564,2014/03/31,2010/12/13,17,9,0.7061981540000001,10295,17,3,6
30565,2014/03/31,2012/10/26,60,8,0.711091549,10224,60,6,2
30566,2014/03/31,2008/02/17,57,5,0.917343849,7925,57,4,1
30567,2014/03/31,2009/08/04,396,10,0.7084884509999999,10261,396,10,0
30568,2014/03/31,2007/11/11,244,3,1.058652978,6867,244,0,3
30569,2014/03/31,2007/03/23,16,11,0.820780174,8857,16,5,6
30570,2014/03/31,2011/05/09,233,7,0.8828325029999999,8233,233,0,7
30571,2014/03/31,2011/04/09,358,6,0.803398917,9047,358,5,1
30572,2014/03/31,2011/11/08,21,13,0.578018928,12574,21,9,4
30573,2014/03/31,2012/06/09,312,6,0.516986769,14058,312,4,2
30574,2014/03/31,2012/09/25,260,8,0.5474322079999999,13276,260,3,5
30575,2014/03/31,2008/12/05,158,5,0.654167267,11108,158,1,4
30576,2014/03/31,2011/11/29,151,6,0.8434896679999999,8614,151,2,4
30577,2014/03/31,2012/07/31,15,7,0.701409539,10358,15,2,5
30578,2014/03/31,2008/02/20,295,11,0.5604837220000001,12962,295,9,2
30579,2014/03/31,2006/04/25,149,9,0.422453916,17197,149,4,5
30580,2014/03/31,2009/12/04,168,9,0.585661077,12404,168,6,3
30581,2014/03/31,2011/08/04,143,7,0.5533678679999999,13127,143,4,3
30582,2014/03/31,2007/04/09,189,5,0.6065288910000001,11976,189,0,5
30583,2014/03/31,2010/01/17,6,11,0.786682552,9233,6,7,4
30584,2014/03/31,2006/07/16,4,10,0.552521111,13145,4,4,6
30585,2014/03/31,2007/04/27,127,6,0.682753596,10637,127,3,3
30586,2014/03/31,2008/11/12,397,3,0.803362832,9040,397,3,0
30587,2014/03/31,2012/05/19,281,6,0.7527690229999999,9646,281,2,4
30588,2014/03/31,2009/12/11,458,4,0.8,9076,458,4,0
30589,2014/03/31,2012/01/02,32,13,0.753340942,9638,32,5,8
30590,2014/03/31,2011/01/14,628,4,0.853739417,8504,628,4,0
30591,2014/03/31,2011/08/28,139,10,0.49549686,14652,139,8,2
30592,2014/03/31,2010/05/29,73,4,0.7860166740000001,9236,73,0,4
30593,2014/03/31,2012/10/28,10,5,0.747565647,9711,10,2,3
30594,2014/03/31,2011/03/18,289,9,0.683187465,10626,289,7,2
30595,2014/03/31,2008/09/05,12,9,0.575370165,12616,12,1,8
30596,2014/03/31,2007/12/10,29,6,0.828049281,8766,29,2,4
30597,2014/03/31,2008/11/29,8,9,0.369339949,19650,8,5,4
30598,2014/03/31,2011/08/21,549,6,0.727048688,9982,549,6,0
30599,2014/03/31,2009/06/22,18,11,0.683260522,10621,18,8,3
30600,2014/03/31,2011/09/05,232,8,0.7274506270000001,9975,232,4,4
30601,2014/03/31,2011/12/25,118,5,0.762130028,9521,118,2,3
30602,2014/03/31,2011/12/09,525,10,0.618865672,11725,525,10,0
30603,2014/03/31,2012/06/20,8,11,0.664297354,10923,8,9,2
30604,2014/03/31,2005/12/02,142,6,0.630306637,11512,142,5,1
30605,2014/03/31,2010/12/16,84,10,0.642402833,11295,84,7,3
30606,2014/03/31,2009/12/16,553,3,0.7945356990000001,9132,553,3,0
30607,2014/03/31,2009/02/21,43,7,0.640223242,11333,43,4,3
30608,2014/03/31,2011/07/09,177,7,0.517300535,14025,177,4,3
30609,2014/03/31,2012/08/01,178,6,0.595264194,12188,178,0,6
30610,2014/03/31,2012/04/15,118,14,0.593571429,12222,118,8,6
30611,2014/03/31,2012/12/12,50,9,0.675532172,10739,50,3,6
30612,2014/03/31,2005/09/21,457,6,0.715058162,10144,457,6,0
30613,2014/03/31,2010/01/19,117,7,0.476077054,15236,117,2,5
30614,2014/03/31,2005/12/02,173,3,1.185922171,6116,173,0,3
30615,2014/03/31,2011/04/28,327,4,0.831766055,8720,327,3,1
30616,2014/03/31,2006/06/07,120,5,0.91053484,7965,120,0,5
30617,2014/03/31,2012/12/25,5,8,0.6983514679999999,10385,5,5,3
30618,2014/03/31,2012/12/27,88,5,0.748,9695,88,1,4
30619,2014/03/31,2006/04/10,468,10,0.665924327,10889,468,10,0
30620,2014/03/31,2011/11/19,463,6,0.636852275,11386,463,6,0
30621,2014/03/31,2011/10/05,84,7,0.668133063,10852,84,4,3
30622,2014/03/31,2008/08/29,166,7,0.716278036,10121,166,2,5
30623,2014/03/31,2005/07/07,137,8,0.812258824,8925,137,3,5
30624,2014/03/31,2011/09/28,59,8,0.830241668,8731,59,1,7
30625,2014/03/31,2010/05/20,159,6,0.495863319,14618,159,1,5
30626,2014/03/31,2011/08/22,9,17,0.6800337740000001,10659,9,7,10
30627,2014/03/31,2006/09/12,69,9,0.730515017,9922,69,2,7
30628,2014/03/31,2012/07/11,150,5,0.7903380590000001,9170,150,4,1
30629,2014/03/31,2006/10/22,637,7,0.5587078870000001,12971,637,7,0
30630,2014/03/31,2009/08/25,4,8,0.848191713,8544,4,2,6
30631,2014/03/31,2011/06/14,399,7,0.7274771609999999,9961,399,7,0
30632,2014/03/31,2012/02/21,114,9,0.6089302520000001,11900,114,5,4
30633,2014/03/31,2012/05/22,45,10,0.527,13750,45,3,7
30634,2014/03/31,2012/01/25,104,7,0.755429525,9592,104,4,3
30635,2014/03/31,2011/06/14,93,6,0.754466889,9604,93,0,6
30636,2014/03/31,2013/02/27,33,7,0.696085119,10409,33,0,7
30637,2014/03/31,2011/06/21,387,5,1.062049252,6822,387,5,0
30638,2014/03/31,2012/01/27,50,11,0.7031456859999999,10303,50,3,8
30639,2014/03/31,2009/11/18,17,14,0.7503262559999999,9655,17,6,8
30640,2014/03/31,2007/05/16,5,7,0.87142565,8312,5,3,4
30641,2014/03/31,2009/01/24,61,8,0.780467672,9280,61,4,4
30642,2014/03/31,2007/06/13,191,7,0.542859606,13341,191,2,5
30643,2014/03/31,2011/09/25,175,7,0.829958744,8726,175,6,1
30644,2014/03/31,2012/03/23,97,7,0.6020583589999999,12029,97,5,2
30645,2014/03/31,2007/08/18,72,10,0.711658968,10175,72,4,6
30646,2014/03/31,2011/12/11,6,9,0.527496175,13727,6,4,5
30647,2014/03/31,2009/01/10,264,4,0.6904548490000001,10487,264,3,1
30648,2014/03/31,2010/05/29,445,7,0.8943305340000001,8096,445,7,0
30649,2014/03/31,2009/08/25,163,7,0.665702464,10876,163,2,5
30650,2014/03/31,2012/05/25,525,6,0.895620438,8083,525,6,0
30651,2014/03/31,2012/10/18,205,6,0.777865893,9306,205,5,1
30652,2014/03/31,2008/12/06,24,4,0.92,7868,24,3,1
30653,2014/03/31,2009/01/04,3,10,0.7240692209999999,9997,3,3,7
30654,2014/03/31,2009/02/21,119,19,0.661163683,10948,119,10,9
30655,2014/03/31,2012/06/08,80,10,0.708516887,10215,80,8,2
30656,2014/03/31,2005/01/01,420,6,0.604472563,11973,420,6,0
30657,2014/03/31,2011/01/14,133,4,0.902636568,8018,133,2,2
30658,2014/03/31,2010/03/28,32,8,0.682701632,10601,32,5,3
30659,2014/03/31,2007/09/28,114,11,0.7114204270000001,10173,114,3,8
30660,2014/03/31,2007/05/24,128,6,0.847398126,8540,128,1,5
30661,2014/03/31,2007/05/12,481,6,0.777549157,9307,481,6,0
30662,2014/03/31,2008/01/11,116,9,0.991454994,7299,116,7,2
30663,2014/03/31,2005/08/01,25,5,0.980631522,7379,25,0,5
30664,2014/03/31,2010/11/18,192,9,0.586034343,12346,192,6,3
30665,2014/03/31,2012/12/01,164,8,0.7530224809999999,9608,164,5,3
30666,2014/03/31,2011/07/15,6,8,0.733528338,9863,6,4,4
30667,2014/03/31,2010/11/17,204,12,0.745560709,9702,204,8,4
30668,2014/03/31,2011/07/10,364,7,0.6081385570000001,11894,364,6,1
30669,2014/03/31,2011/09/26,160,7,0.930185185,7776,160,6,1
30670,2014/03/31,2009/07/14,418,5,0.834822253,8664,418,5,0
30671,2014/03/31,2007/06/17,18,12,0.6763446790000001,10694,18,0,12
30672,2014/03/31,2012/03/24,104,10,0.697053778,10376,104,6,4
30673,2014/03/31,2012/06/11,43,10,0.65223104,11089,43,4,6
30674,2014/03/31,2011/09/15,184,4,0.612979914,11799,184,2,2
30675,2014/03/31,2012/06/13,562,5,0.7979311490000001,9063,562,5,0
30676,2014/03/31,2009/11/30,1,8,0.60556272,11942,1,2,6
30677,2014/03/31,2011/06/14,134,2,0.58,12468,134,0,2
30678,2014/03/31,2012/02/27,344,11,0.718002184,10071,344,10,1
30679,2014/03/31,2012/03/09,175,6,0.7137719640000001,10130,175,4,2
30680,2014/03/31,2006/01/01,281,13,0.912970447,7918,281,10,3
30681,2014/03/31,2011/09/08,1,6,0.862173187,8384,1,2,4
30682,2014/03/31,2012/12/11,10,4,0.625350809,11559,10,0,4
30683,2014/03/31,2008/07/24,3,8,0.564290733,12809,3,4,4
30684,2014/03/31,2005/04/07,34,4,0.87,8308,34,0,4
30685,2014/03/31,2009/11/08,94,8,0.679483877,10637,94,2,6
30686,2014/03/31,2013/01/29,224,7,0.968448137,7462,224,3,4
30687,2014/03/31,2013/03/25,7,5,0.923696792,7823,7,0,5
30688,2014/03/31,2012/11/01,240,5,0.635267739,11373,240,2,3
30689,2014/03/31,2013/03/04,136,7,0.7416794990000001,9741,136,2,5
30690,2014/03/31,2012/01/31,177,5,0.840361754,8597,177,3,2
30691,2014/03/31,2006/03/12,165,8,0.615302785,11741,165,3,5
30692,2014/03/31,2011/10/13,104,10,0.658352319,10973,104,5,5
30693,2014/03/31,2011/05/15,433,7,0.6970809609999999,10363,433,7,0
30694,2014/03/31,2012/03/21,347,7,0.709806426,10177,347,6,1
30695,2014/03/31,2008/03/03,462,9,0.7039421109999999,10261,462,9,0
30696,2014/03/31,2006/10/01,21,8,0.8061294640000001,8960,21,4,4
30697,2014/03/31,2012/02/20,37,12,0.446106479,16191,37,4,8
30698,2014/03/31,2012/08/23,143,9,0.770334898,9376,143,3,6
30699,2014/03/31,2010/07/08,209,9,0.639282174,11298,209,6,3
30700,2014/03/31,2011/08/07,158,10,0.752933695,9592,158,7,3
30701,2014/03/31,2012/07/29,252,6,0.5155922039999999,14007,252,2,4
30702,2014/03/31,2010/07/25,167,7,0.8270988429999999,8731,167,6,1
30703,2014/03/31,2012/06/02,155,5,0.531724468,13581,155,4,1
30704,2014/03/31,2010/06/14,31,9,0.626360482,11529,31,7,2
30705,2014/03/31,2011/06/22,382,3,0.809649024,8918,382,3,0
30706,2014/03/31,2007/03/18,8,13,0.811396943,8898,8,0,13
30707,2014/03/31,2012/03/15,71,8,0.667492604,10816,71,2,6
30708,2014/03/31,2006/12/05,192,5,0.859883278,8396,192,3,2
30709,2014/03/31,2007/02/20,266,13,0.89017016,8110,266,10,3
30710,2014/03/31,2011/09/26,47,4,0.718486115,10047,47,0,4
30711,2014/03/31,2005/04/16,155,9,0.56095042,12868,155,2,7
30712,2014/03/31,2008/04/15,439,9,0.676447985,10670,439,9,0
30713,2014/03/31,2007/08/21,26,11,0.59767205,12075,26,7,4
30714,2014/03/31,2012/05/23,474,5,1.327446652,5436,474,5,0
30715,2014/03/31,2006/12/14,34,16,0.464846669,15522,34,7,9
30716,2014/03/31,2005/05/17,22,8,0.836741273,8623,22,4,4
30717,2014/03/31,2010/11/12,169,10,0.873592445,8259,169,9,1
30718,2014/03/31,2007/08/12,570,2,0.686815802,10505,570,2,0
30719,2014/03/31,2012/03/16,170,4,1.4574565659999998,4950,170,3,1
30720,2014/03/31,2012/05/16,514,6,0.7446635009999999,9688,514,6,0
30721,2014/03/31,2013/02/14,26,7,0.7258703959999999,9938,26,1,6
30722,2014/03/31,2012/09/15,13,6,0.76847129,9387,13,1,5
30723,2014/03/31,2006/07/25,23,9,0.729719777,9885,23,0,9
30724,2014/03/31,2009/10/13,166,4,1.19364554,6043,166,1,3
30725,2014/03/31,2011/10/09,35,12,0.776907583,9284,35,6,6
30726,2014/03/31,2007/07/23,481,6,0.814040632,8860,481,6,0
30727,2014/03/31,2006/12/26,70,6,0.734363544,9820,70,4,2
30728,2014/03/31,2010/12/23,2,12,0.480153139,15019,2,2,10
30729,2014/03/31,2007/12/29,139,4,0.6013827039999999,11991,139,0,4
30730,2014/03/31,2009/11/28,162,7,0.475763014,15157,162,5,2
30731,2014/03/31,2012/08/19,212,5,0.816832805,8828,212,1,4
30732,2014/03/31,2005/04/23,41,9,0.855237813,8431,41,1,8
30733,2014/03/31,2008/07/21,101,7,0.765607348,9418,101,0,7
30734,2014/03/31,2013/03/03,236,8,0.678243815,10631,236,1,7
30735,2014/03/31,2010/04/15,495,6,0.8349235759999999,8636,495,6,0
30736,2014/03/31,2008/02/25,3,7,0.7062056809999999,10210,3,2,5
30737,2014/03/31,2012/12/21,141,7,0.611292073,11795,141,3,4
30738,2014/03/31,2005/11/25,14,8,0.624198771,11551,14,0,8
30739,2014/03/31,2011/04/06,88,8,0.7076278340000001,10189,88,0,8
30740,2014/03/31,2013/02/03,42,8,0.579789287,12434,42,1,7
30741,2014/03/31,2010/05/25,70,12,0.53167859,13559,70,4,8
30742,2014/03/31,2009/09/17,204,8,0.7264637709999999,9923,204,7,1
30743,2014/03/31,2010/04/09,97,7,0.6540274,11022,97,0,7
30744,2014/03/31,2007/12/16,46,6,0.598294323,12048,46,0,6
30745,2014/03/31,2011/01/27,132,5,0.977699403,7372,132,2,3
30746,2014/03/31,2013/01/01,16,8,0.88291437,8163,16,0,8
30747,2014/03/31,2007/06/24,14,8,0.68875,10464,14,1,7
30748,2014/03/31,2012/12/02,91,5,1.071336406,6727,91,1,4
30749,2014/03/31,2011/11/27,186,12,0.706824245,10196,186,9,3
30750,2014/03/31,2012/09/30,27,9,0.852061953,8458,27,2,7
30751,2014/03/31,2010/12/06,8,8,0.611434875,11785,8,4,4
30752,2014/03/31,2009/01/16,98,5,0.777481657,9268,98,2,3
30753,2014/03/31,2011/09/28,487,9,0.654089506,11016,487,9,0
30754,2014/03/31,2005/06/08,265,7,0.587339203,12267,265,6,1
30755,2014/03/31,2012/07/31,8,11,0.694957075,10367,8,1,10
30756,2014/03/31,2012/10/21,223,5,0.7066758209999999,10195,223,2,3
30757,2014/03/31,2012/09/22,105,9,0.5901941510000001,12207,105,1,8
30758,2014/03/31,2012/04/14,200,6,0.873241212,8250,200,3,3
30759,2014/03/31,2010/01/09,4,13,0.825699713,8725,4,8,5
30760,2014/03/31,2012/11/21,68,13,0.724311281,9946,68,2,11
30761,2014/03/31,2013/01/10,114,8,0.726280875,9919,114,4,4
30762,2014/03/31,2012/11/06,34,10,0.635317929,11339,34,4,6
30763,2014/03/31,2007/09/07,66,13,0.846799107,8507,66,7,6
30764,2014/03/31,2012/03/26,75,7,0.732078252,9840,75,6,1
30765,2014/03/31,2012/01/14,256,9,0.948091603,7598,256,6,3
30766,2014/03/31,2012/09/04,172,12,0.802538993,8976,172,8,4
30767,2014/03/31,2010/05/12,58,9,0.70366709,10237,58,2,7
30768,2014/03/31,2012/05/21,209,4,0.677074913,10639,209,3,1
30769,2014/03/31,2011/02/04,127,10,0.47238292,15246,127,5,5
30770,2014/03/31,2009/10/03,128,9,0.829044549,8687,128,4,5
30771,2014/03/31,2008/01/04,59,4,0.707829762,10174,59,0,4
30772,2014/03/31,2012/02/15,258,11,0.550856793,13072,258,10,1
30773,2014/03/31,2006/09/04,10,10,0.571086612,12608,10,0,10
30774,2014/03/31,2012/07/02,372,9,0.967531246,7441,372,9,0
30775,2014/03/31,2011/10/15,123,11,0.550909091,13068,123,9,2
30776,2014/03/31,2012/09/18,8,11,0.795577412,9049,8,7,4
30777,2014/03/31,2011/06/09,2,6,0.5373270139999999,13397,2,3,3
30778,2014/03/31,2008/05/23,62,6,0.725846526,9917,62,4,2
30779,2014/03/31,2010/05/30,99,7,0.677395069,10626,99,1,6
30780,2014/03/31,2008/08/26,167,6,0.934303518,7703,167,5,1
30781,2014/03/31,2013/01/01,16,6,0.547791733,13137,16,0,6
30782,2014/03/31,2013/01/26,28,13,0.7955975679999999,9045,28,2,11
30783,2014/03/31,2010/12/20,16,9,0.992146698,7253,16,7,2
30784,2014/03/31,2010/04/20,167,10,0.641907226,11210,167,5,5
30785,2014/03/31,2009/03/11,467,8,0.86111776,8356,467,8,0
30786,2014/03/31,2011/11/27,303,9,0.5234718079999999,13745,303,6,3
30787,2014/03/31,2010/08/25,28,12,0.456395179,15765,28,2,10
30788,2014/03/31,2007/09/01,218,6,0.8556779259999999,8408,218,3,3
30789,2014/03/31,2009/08/07,79,4,0.6462827879999999,11132,79,0,4
30790,2014/03/31,2012/12/02,5,9,0.631013069,11401,5,3,6
30791,2014/03/31,2011/10/17,98,8,0.626641115,11480,98,3,5
30792,2014/03/31,2006/09/25,32,10,0.452970846,15881,32,1,9
30793,2014/03/31,2012/10/30,39,5,1.230487513,5846,39,1,4
30794,2014/03/31,2009/04/29,307,3,0.8376106190000001,8588,307,1,2
30795,2014/03/31,2010/12/09,50,10,0.525650395,13684,50,5,5
30796,2014/03/31,2011/11/28,533,9,0.836983591,8593,533,9,0
30797,2014/03/31,2013/01/15,95,10,0.550227986,13071,95,3,7
30798,2014/03/31,2010/01/08,130,7,0.788596491,9120,130,2,5
30799,2014/03/31,2008/02/26,64,7,0.481428571,14938,64,1,6
30800,2014/03/31,2011/07/14,14,8,0.7400771840000001,9717,14,4,4
30801,2014/03/31,2010/06/15,625,4,0.901378792,7978,625,4,0
30802,2014/03/31,2005/06/14,85,10,0.618743762,11622,85,5,5
30803,2014/03/31,2010/10/25,302,7,0.391706613,18358,302,5,2
30804,2014/03/31,2007/06/27,401,6,0.867474967,8289,401,6,0
30805,2014/03/31,2012/11/06,100,6,0.645277753,11143,100,1,5
30806,2014/03/31,2009/10/31,95,7,0.8459164709999999,8500,95,1,6
30807,2014/03/31,2012/06/12,104,9,0.688263616,10447,104,6,3
30808,2014/03/31,2010/06/23,10,8,0.594826274,12088,10,3,5
30809,2014/03/31,2009/07/26,397,6,0.669296286,10743,397,6,0
30810,2014/03/31,2012/02/05,562,5,0.89619843,8023,562,5,0
30811,2014/03/31,2012/12/19,69,10,0.707463347,10163,69,5,5
30812,2014/03/31,2011/07/01,36,8,0.614576851,11698,36,2,6
30813,2014/03/31,2013/01/25,164,8,0.616340021,11664,164,0,8
30814,2014/03/31,2012/06/26,5,8,0.7170154609999999,10025,5,0,8
30815,2014/03/31,2012/09/21,91,8,0.77707027,9250,91,3,5
30816,2014/03/31,2010/11/17,4,7,0.580962658,12372,4,0,7
30817,2014/03/31,2007/05/30,95,10,0.523987023,13717,95,1,9
30818,2014/03/31,2008/05/03,26,12,0.845577127,8499,26,7,5
30819,2014/03/31,2008/02/17,83,4,0.865,8308,83,0,4
30820,2014/03/31,2007/08/01,171,8,0.82735091,8686,171,4,4
30821,2014/03/31,2012/09/28,201,8,0.779929455,9214,201,5,3
30822,2014/03/31,2008/07/08,162,8,0.83171412,8640,162,3,5
30823,2014/03/31,2007/05/11,28,10,0.485241407,14809,28,4,6
30824,2014/03/31,2012/04/06,720,3,0.584972322,12284,720,3,0
30825,2014/03/31,2013/02/05,241,8,0.6103831120000001,11772,241,2,6
30826,2014/03/31,2006/06/04,26,13,0.66742382,10764,26,9,4
30827,2014/03/31,2011/11/08,48,11,0.7540275009999999,9527,48,3,8
30828,2014/03/31,2008/11/11,139,7,0.809397183,8875,139,6,1
30829,2014/03/31,2006/12/03,199,8,0.5806499070000001,12371,199,7,1
30830,2014/03/31,2005/04/27,186,7,0.715003982,10046,186,5,2
30831,2014/03/31,2007/04/01,76,9,0.699364167,10270,76,8,1
30832,2014/03/31,2011/09/22,151,3,0.760838983,9440,151,1,2
30833,2014/03/31,2012/11/02,36,10,0.6677361470000001,10756,36,2,8
30834,2014/03/31,2011/06/14,99,12,0.656780979,10935,99,5,7
30835,2014/03/31,2008/09/01,310,5,0.74,9705,310,3,2
30836,2014/03/31,2007/09/18,233,8,0.756653672,9491,233,6,2
30837,2014/03/31,2008/04/26,11,10,0.62661227,11459,11,8,2
30838,2014/03/31,2008/11/22,377,4,1.24181944,5782,377,4,0
30839,2014/03/31,2007/12/31,250,15,0.746913555,9613,250,13,2
30840,2014/03/31,2012/12/23,23,3,0.697825833,10289,23,2,1
30841,2014/03/31,2011/12/27,280,7,0.512101284,14020,280,1,6
30842,2014/03/31,2011/12/01,538,5,0.66250346,10837,538,5,0
30843,2014/03/31,2012/07/27,109,9,0.663439608,10821,109,2,7
30844,2014/03/31,2005/06/22,20,9,0.6210875579999999,11558,20,7,2
30845,2014/03/31,2012/07/21,219,6,0.893711404,8032,219,3,3
30846,2014/03/31,2008/12/03,25,10,0.58331058,12306,25,2,8
30847,2014/03/31,2009/04/18,136,5,0.850773972,8437,136,0,5
30848,2014/03/31,2006/09/21,238,7,0.671262508,10693,238,5,2
30849,2014/03/31,2012/08/26,235,9,0.92952603,7722,235,5,4
30850,2014/03/31,2006/04/28,373,5,0.603476543,11894,373,5,0
30851,2014/03/31,2009/01/09,232,4,0.583023312,12311,232,1,3
30852,2014/03/31,2012/12/22,57,7,0.8191644790000001,8761,57,2,5
30853,2014/03/31,2006/09/18,1,14,0.404917043,17720,1,4,10
30854,2014/03/31,2012/09/14,95,8,0.5853846779999999,12257,95,2,6
30855,2014/03/31,2008/11/09,57,8,0.62756232,11433,57,6,2
30856,2014/03/31,2009/08/20,153,5,0.975085621,7358,153,4,1
30857,2014/03/31,2013/02/26,227,6,0.794877022,9026,227,2,4
30858,2014/03/31,2008/11/25,2,7,0.7038863809999999,10192,2,3,4
30859,2014/03/31,2009/09/21,60,14,0.723609038,9914,60,7,7
30860,2014/03/31,2005/08/20,296,8,0.649398823,11045,296,6,2
30861,2014/03/31,2011/04/14,179,8,0.797842047,8990,179,4,4
30862,2014/03/31,2009/10/25,166,9,0.528253664,13577,166,7,2
30863,2014/03/31,2013/01/11,24,11,0.799555184,8970,24,4,7
30864,2014/03/31,2011/08/08,94,13,0.582984881,12302,94,2,11
30865,2014/03/31,2011/04/18,149,9,0.7186022040000001,9980,149,7,2
30866,2014/03/31,2009/11/25,41,5,0.8479661820000001,8457,41,3,2
30867,2014/03/31,2012/11/05,112,10,0.51837285,13834,112,3,7
30868,2014/03/31,2010/03/31,224,7,0.915617978,7832,224,6,1
30869,2014/03/31,2010/02/26,13,13,0.528514888,13568,13,6,7
30870,2014/03/31,2011/10/16,35,7,0.721779567,9935,35,0,7
30871,2014/03/31,2012/10/02,195,4,0.7107265340000001,10089,195,0,4
30872,2014/03/31,2012/09/03,16,8,0.869128485,8250,16,0,8
30873,2014/03/31,2012/08/03,459,4,0.726967147,9862,459,4,0
30874,2014/03/31,2011/11/27,87,11,0.8537727759999999,8397,87,4,7
30875,2014/03/31,2012/09/11,40,6,0.673518745,10643,40,3,3
30876,2014/03/31,2008/08/01,28,7,0.770090245,9308,28,0,7
30877,2014/03/31,2012/09/11,108,7,0.900787985,7957,108,4,3
30878,2014/03/31,2011/02/18,25,6,0.655327786,10937,25,4,2
30879,2014/03/31,2011/07/31,277,6,0.734124155,9762,277,5,1
30880,2014/03/31,2005/02/03,72,15,0.472349219,15171,72,3,12
30881,2014/03/31,2008/09/13,127,10,0.531174203,13490,127,3,7
30882,2014/03/31,2011/07/21,20,10,0.8624843520000001,8308,20,6,4
30883,2014/03/31,2006/11/23,160,4,0.766856807,9344,160,0,4
30884,2014/03/31,2010/08/03,71,10,0.574128536,12479,71,7,3
30885,2014/03/31,2009/11/09,213,10,0.534091248,13414,213,4,6
30886,2014/03/31,2012/12/24,97,13,0.555699659,12892,97,3,10
30887,2014/03/31,2009/04/17,147,7,0.697910375,10265,147,4,3
30888,2014/03/31,2010/01/11,59,9,0.694926763,10309,59,5,4
30889,2014/03/31,2011/10/02,49,4,0.8089295390000001,8856,49,1,3
30890,2014/03/31,2010/03/31,119,11,0.809741155,8847,119,1,10
30891,2014/03/31,2011/09/30,59,13,0.681965918,10504,59,7,6
30892,2014/03/31,2004/12/21,521,6,1.047878877,6836,521,6,0
30893,2014/03/31,2013/03/29,15,7,0.6364919139999999,11254,15,1,6
30894,2014/03/31,2008/11/12,431,5,0.943303042,7593,431,5,0
30895,2014/03/31,2008/08/13,60,10,0.6461082539999999,11085,60,7,3
30896,2014/03/31,2008/07/12,355,5,0.700107527,10230,355,4,1
30897,2014/03/31,2013/03/02,1,17,0.564222012,12693,1,0,17
30898,2014/03/31,2010/09/13,95,9,0.666684975,10742,95,4,5
30899,2014/03/31,2011/06/14,153,9,0.8351866109999999,8574,153,7,2
30900,2014/03/31,2007/08/31,146,4,0.8031292059999999,8916,146,2,2
30901,2014/03/31,2012/09/22,123,4,0.6939905009999999,10317,123,2,2
30902,2014/03/31,2007/02/22,136,8,0.766255351,9344,136,4,4
30903,2014/03/31,2008/06/10,8,5,0.728,9835,8,0,5
30904,2014/03/31,2007/02/22,12,16,0.539968323,13259,12,12,4
30905,2014/03/31,2008/11/11,121,5,0.982192345,7289,121,2,3
30906,2014/03/31,2009/01/02,212,9,0.721154427,9927,212,7,2
30907,2014/03/31,2012/05/01,94,8,0.644005038,11116,94,4,4
30908,2014/03/31,2011/11/12,537,7,0.81543456,8779,537,7,0
30909,2014/03/31,2013/02/05,172,6,0.8764262979999999,8168,172,2,4
30910,2014/03/31,2009/03/20,6,6,0.5610478879999999,12759,6,4,2
30911,2014/03/31,2011/08/10,104,9,0.7002181359999999,10223,104,4,5
30912,2014/03/31,2012/12/07,82,8,0.651498134,10987,82,5,3
30913,2014/03/31,2007/11/22,28,8,0.632195725,11322,28,6,2
30914,2014/03/31,2007/02/01,421,5,0.722270434,9910,421,5,0
30915,2014/03/31,2005/05/13,20,7,0.711912862,10053,20,2,5
30916,2014/03/31,2013/01/19,167,6,0.80197333,8924,167,1,5
30917,2014/03/31,2010/06/17,185,9,0.750175052,9540,185,2,7
30918,2014/03/31,2005/11/05,364,4,1.136493568,6297,364,3,1
30919,2014/03/31,2006/10/09,117,6,0.773235008,9255,117,5,1
30920,2014/03/31,2005/07/04,183,6,0.918262543,7793,183,2,4
30921,2014/03/31,2008/11/30,107,8,0.641837998,11148,107,2,6
30922,2014/03/31,2011/01/04,130,8,0.528639823,13535,130,3,5
30923,2014/03/31,2010/05/02,22,6,0.785799012,9105,22,0,6
30924,2014/03/31,2010/09/19,144,7,0.857661232,8342,144,3,4
30925,2014/03/31,2012/08/06,147,6,0.917009741,7802,147,5,1
30926,2014/03/31,2010/08/27,238,8,0.923190089,7749,238,6,2
30927,2014/03/31,2009/07/16,343,8,0.822525009,8697,343,7,1
30928,2014/03/31,2013/03/23,78,4,0.711776119,10050,78,0,4
30929,2014/03/31,2008/04/17,217,6,0.700484771,10211,217,2,4
30930,2014/03/31,2012/12/21,7,8,0.617691311,11578,7,1,7
30931,2014/03/31,2008/05/19,220,9,0.7230819009999999,9890,220,6,3
30932,2014/03/31,2006/02/23,9,16,0.7577757759999999,9437,9,0,16
30933,2014/03/31,2009/07/23,508,4,1.0,7150,508,4,0
30934,2014/03/31,2008/02/14,117,7,0.737574538,9693,117,5,2
30935,2014/03/31,2008/08/01,85,12,0.73175435,9770,85,9,3
30936,2014/03/31,2012/04/04,9,9,0.608685398,11745,9,3,6
30937,2014/03/31,2012/08/02,184,4,0.681302897,10492,184,1,3
30938,2014/03/31,2012/12/18,256,5,0.7960841959999999,8979,256,3,2
30939,2014/03/31,2008/04/09,240,3,0.959009795,7453,240,2,1
30940,2014/03/31,2012/02/11,79,13,0.59303933,12052,79,9,4
30941,2014/03/31,2012/01/28,96,8,0.6953215290000001,10279,96,2,6
30942,2014/03/31,2011/08/26,84,7,0.714142686,10008,84,0,7
30943,2014/03/31,2008/07/03,231,8,0.7562962959999999,9450,231,6,2
30944,2014/03/31,2006/06/27,63,4,0.7748650109999999,9223,63,1,3
30945,2014/03/31,2005/04/20,45,6,0.6994108440000001,10218,45,2,4
30946,2014/03/31,2007/02/01,141,6,0.6644546720000001,10755,141,3,3
30947,2014/03/31,2007/09/24,27,6,0.91336273,7824,27,0,6
30948,2014/03/31,2008/02/03,16,10,0.558229688,12800,16,1,9
30949,2014/03/31,2008/01/07,26,9,0.75356043,9482,26,6,3
30950,2014/03/31,2008/05/31,127,9,0.600034431,11908,127,5,4
30951,2014/03/31,2011/07/02,159,11,0.687220352,10397,159,5,6
30952,2014/03/31,2012/12/07,354,8,0.661263304,10805,354,6,2
30953,2014/03/31,2011/09/11,88,10,0.580351718,12311,88,8,2
30954,2014/03/31,2008/10/10,59,7,0.754948214,9462,59,5,2
30955,2014/03/31,2013/02/01,121,5,0.8564868109999999,8340,121,1,4
30956,2014/03/31,2007/11/01,206,8,0.713765364,10007,206,7,1
30957,2014/03/31,2008/03/19,679,4,0.476832688,14978,679,4,0
30958,2014/03/31,2013/03/28,34,8,0.657242776,10866,34,0,8
30959,2014/03/31,2010/09/19,144,9,0.566473388,12607,144,5,4
30960,2014/03/31,2013/01/07,44,5,0.626382773,11401,44,1,4
30961,2014/03/31,2011/04/27,52,10,0.898297899,7949,52,4,6
30962,2014/03/31,2009/11/08,126,7,0.5794595029999999,12322,126,5,2
30963,2014/03/31,2011/11/22,60,8,0.575530389,12406,60,4,4
30964,2014/03/31,2011/03/09,304,10,0.8231242790000001,8674,304,8,2
30965,2014/03/31,2010/09/20,229,11,0.512815687,13922,229,7,4
30966,2014/03/31,2013/02/06,224,6,0.953811623,7485,224,1,5
30967,2014/03/31,2012/05/23,375,11,0.821052329,8695,375,11,0
30968,2014/03/31,2011/11/03,196,5,0.938724523,7605,196,1,4
30969,2014/03/31,2007/01/27,292,6,0.8265312029999999,8637,292,3,3
30970,2014/03/31,2011/05/22,277,5,0.6946472020000001,10275,277,2,3
30971,2014/03/31,2012/03/21,466,9,0.7009034670000001,10183,466,9,0
30972,2014/03/31,2012/10/31,190,5,0.955565671,7469,190,2,3
30973,2014/03/31,2010/12/17,168,13,0.463471654,15399,168,6,7
30974,2014/03/31,2011/02/24,102,9,0.665966402,10715,102,8,1
30975,2014/03/31,2011/10/26,20,7,0.8347905940000001,8548,20,5,2
30976,2014/03/31,2011/11/30,199,10,0.799606679,8924,199,5,5
30977,2014/03/31,2006/10/08,141,13,0.920797522,7749,141,2,11
30978,2014/03/31,2009/06/20,71,6,0.616386177,11575,71,2,4
30979,2014/03/31,2013/02/12,69,7,0.858603755,8308,69,1,6
30980,2014/03/31,2006/07/02,675,4,0.85,8392,675,4,0
30981,2014/03/31,2009/10/06,35,13,0.467252063,15266,35,10,3
30982,2014/03/31,2012/07/24,137,11,0.562404005,12683,137,7,4
30983,2014/03/31,2012/01/08,5,10,0.724279041,9848,5,6,4
30984,2014/03/31,2012/11/10,274,5,0.7468534029999999,9550,274,2,3
30985,2014/03/31,2012/02/26,506,6,0.673328927,10592,506,6,0
30986,2014/03/31,2012/05/29,245,4,1.4848032480000002,4803,245,2,2
30987,2014/03/31,2012/07/07,287,7,0.859292686,8299,287,4,3
30988,2014/03/31,2012/11/11,456,3,1.5,4754,456,3,0
30989,2014/03/31,2011/10/13,247,7,0.70926298,10054,247,3,4
30990,2014/03/31,2012/07/06,238,9,0.779401027,9149,238,5,4
30991,2014/03/31,2006/12/03,212,5,0.7775313490000001,9171,212,4,1
30992,2014/03/31,2011/07/31,102,13,0.598394596,11916,102,8,5
30993,2014/03/31,2005/08/05,162,7,0.879923485,8103,162,6,1
30994,2014/03/31,2008/06/18,17,10,0.617556518,11545,17,8,2
30995,2014/03/31,2009/08/21,144,3,1.018782509,6998,144,2,1
30996,2014/03/31,2005/12/14,73,6,0.570408065,12498,73,0,6
30997,2014/03/31,2012/05/16,215,7,0.608756512,11709,215,4,3
30998,2014/03/31,2005/04/02,83,10,0.575674475,12380,83,5,5
30999,2014/03/31,2012/12/05,11,12,0.668480443,10661,11,2,10
31000,2014/03/31,2012/01/04,385,11,0.724169292,9841,385,11,0
31001,2014/03/31,2006/08/28,91,10,0.484411585,14709,91,5,5
31002,2014/03/31,2012/03/23,113,10,0.681152964,10460,113,7,3
31003,2014/03/31,2012/01/05,12,8,0.4392540070000001,16220,12,2,6
31004,2014/03/31,2013/01/10,57,6,0.8062799909999999,8836,57,4,2
31005,2014/03/31,2012/04/30,247,10,0.572045126,12454,247,9,1
31006,2014/03/31,2009/10/11,460,10,0.57989825,12285,460,10,0
31007,2014/03/31,2006/06/14,78,6,0.8698461540000001,8190,78,0,6
31008,2014/03/31,2011/05/02,550,8,0.659977765,10794,550,8,0
31009,2014/03/31,2011/09/11,474,7,0.500783831,14225,474,7,0
31010,2014/03/31,2012/03/12,275,8,0.7232267240000001,9849,275,4,4
31011,2014/03/31,2010/02/14,33,11,0.5987651310000001,11896,33,6,5
31012,2014/03/31,2009/01/20,160,11,0.616753832,11549,160,6,5
31013,2014/03/31,2009/02/11,267,6,0.622689516,11437,267,5,1
31014,2014/03/31,2004/11/27,179,6,0.581906357,12238,179,4,2
31015,2014/03/31,2013/01/11,13,10,0.770699134,9240,13,2,8
31016,2014/03/31,2010/11/02,105,6,0.715451623,9953,105,3,3
31017,2014/03/31,2012/05/27,116,8,0.715140102,9957,116,5,3
31018,2014/03/31,2010/04/07,376,3,1.5,4747,376,3,0
31019,2014/03/31,2007/05/01,2,5,1.41,5050,2,0,5
31020,2014/03/31,2009/01/23,130,14,0.7363185109999999,9670,130,7,7
31021,2014/03/31,2010/11/29,50,3,0.800289985,8897,50,1,2
31022,2014/03/31,2011/08/27,482,4,1.0,7120,482,4,0
31023,2014/03/31,2006/05/11,65,10,0.869642116,8187,65,6,4
31024,2014/03/31,2009/07/31,27,8,0.537616099,13243,27,2,6
31025,2014/03/31,2012/05/21,14,6,0.8252300920000001,8627,14,2,4
31026,2014/03/31,2008/08/09,486,6,0.670551945,10617,486,6,0
31027,2014/03/31,2012/07/29,145,6,0.576359294,12352,145,4,2
31028,2014/03/31,2010/07/01,257,20,0.563606999,12631,257,15,5
31029,2014/03/31,2007/11/16,241,5,0.618053482,11518,241,2,3
31030,2014/03/31,2007/11/19,72,7,0.7745723609999999,9190,72,1,6
31031,2014/03/31,2010/12/04,19,10,0.578895576,12296,19,7,3
31032,2014/03/31,2011/01/12,86,8,0.632729374,11248,86,4,4
31033,2014/03/31,2007/04/17,44,7,0.742417067,9586,44,4,3
31034,2014/03/31,2012/09/03,527,6,0.8918045109999999,7980,527,6,0
31035,2014/03/31,2008/03/12,3,12,0.6332479089999999,11238,3,4,8
31036,2014/03/31,2009/09/16,42,7,0.664576018,10708,42,2,5
31037,2014/03/31,2011/12/11,2,3,1.451960824,4901,2,1,2
31038,2014/03/31,2009/01/12,310,7,0.676733568,10513,310,2,5
31039,2014/03/31,2012/08/15,384,13,0.705583656,10083,384,13,0
31040,2014/03/31,2012/06/08,61,8,0.78081001,9111,61,3,5
31041,2014/03/31,2011/09/03,216,7,0.699663618,10167,216,2,5
31042,2014/03/31,2012/09/19,5,9,0.58945554,12067,5,5,4
31043,2014/03/31,2011/11/14,19,8,0.8201014640000001,8673,19,1,7
31044,2014/03/31,2010/11/09,97,10,0.720297752,9874,97,4,6
31045,2014/03/31,2011/01/04,11,12,0.408125789,17426,11,0,12
31046,2014/03/31,2011/11/02,11,8,0.718210463,9902,11,0,8
31047,2014/03/31,2009/09/08,30,8,0.655904815,10842,30,4,4
31048,2014/03/31,2007/03/05,150,9,0.43685035,16278,150,7,2
31049,2014/03/31,2009/09/16,330,6,0.741361693,9591,330,4,2
31050,2014/03/31,2006/06/01,9,11,0.631709462,11255,9,2,9
31051,2014/03/31,2011/12/23,178,8,0.6028873060000001,11793,178,2,6
31052,2014/03/31,2011/03/28,58,7,0.7479726459999999,9505,58,1,6
31053,2014/03/31,2010/04/30,101,7,0.562887569,12630,101,1,6
31054,2014/03/31,2008/05/07,156,10,0.5333478389999999,13328,156,3,7
31055,2014/03/31,2012/08/31,127,7,0.860473308,8261,127,0,7
31056,2014/03/31,2005/01/28,56,10,1.109453722,6407,56,7,3
31057,2014/03/31,2012/07/21,14,8,0.7776195159999999,9141,14,3,5
31058,2014/03/31,2008/06/14,227,6,0.493620139,14400,227,4,2
31059,2014/03/31,2008/11/04,9,6,0.744986899,9541,9,2,4
31060,2014/03/31,2011/11/08,63,9,0.494377826,14377,63,7,2
31061,2014/03/31,2012/09/28,58,7,0.7263280529999999,9785,58,6,1
31062,2014/03/31,2012/09/25,194,13,0.4969230770000001,14300,194,9,4
31063,2014/03/31,2008/07/16,232,5,0.8268128929999999,8594,232,3,2
31064,2014/03/31,2005/10/27,249,11,0.960860041,7395,249,7,4
31065,2014/03/31,2011/11/07,77,11,0.533758263,13312,77,6,5
31066,2014/03/31,2009/09/05,118,5,0.799766997,8884,118,1,4
31067,2014/03/31,2009/10/13,78,5,1.054484192,6737,78,3,2
31068,2014/03/31,2012/05/11,111,8,0.88800375,8000,111,3,5
31069,2014/03/31,2012/11/18,213,8,0.429843845,16522,213,4,4
31070,2014/03/31,2012/11/10,6,5,0.73815092,9621,6,1,4
31071,2014/03/31,2006/11/17,83,6,0.5656834479999999,12554,83,1,5
31072,2014/03/31,2012/10/18,419,7,0.6308990760000001,11256,419,7,0
31073,2014/03/31,2006/01/16,4,9,0.85713096,8285,4,3,6
31074,2014/03/31,2005/02/12,13,5,0.692646313,10252,13,0,5
31075,2014/03/31,2013/02/10,157,7,0.782465014,9075,157,0,7
31076,2014/03/31,2010/10/08,211,5,0.773159442,9182,211,2,3
31077,2014/03/31,2012/06/27,15,7,0.673849075,10535,15,6,1
31078,2014/03/31,2007/03/10,73,5,0.8241165540000001,8614,73,3,2
31079,2014/03/31,2009/11/26,72,8,0.905544074,7839,72,2,6
31080,2014/03/31,2006/05/29,50,6,0.7754205809999999,9154,50,0,6
31081,2014/03/31,2012/02/25,25,8,0.569943793,12454,25,1,7
31082,2014/03/31,2008/11/25,476,3,1.5,4732,476,3,0
31083,2014/03/31,2005/09/26,226,6,0.569799277,12455,226,4,2
31084,2014/03/31,2011/04/01,238,7,0.4908459570000001,14457,238,3,4
31085,2014/03/31,2011/06/27,147,3,0.610791082,11617,147,1,2
31086,2014/03/31,2012/06/05,182,10,0.7204924859999999,9848,182,8,2
31087,2014/03/31,2005/03/18,170,7,0.804102448,8824,170,6,1
31088,2014/03/31,2012/12/27,167,9,0.607364321,11682,167,3,6
31089,2014/03/31,2007/08/23,100,7,0.8244950609999999,8605,100,6,1
31090,2014/03/31,2006/10/27,1,10,0.769657192,9218,1,7,3
31091,2014/03/31,2007/09/20,73,7,0.839302023,8453,73,0,7
31092,2014/03/31,2011/06/29,200,5,0.6124171270000001,11584,200,1,4
31093,2014/03/31,2006/03/28,80,11,0.6734298459999999,10534,80,3,8
31094,2014/03/31,2006/01/13,38,6,0.615811773,11518,38,5,1
31095,2014/03/31,2013/01/23,30,5,0.75047614,9451,30,0,5
31096,2014/03/31,2007/03/15,297,7,0.392882069,18053,297,4,3
31097,2014/03/31,2013/03/08,41,8,0.7642984909999999,9280,41,2,6
31098,2014/03/31,2008/07/02,201,7,0.685935203,10340,201,3,4
31099,2014/03/31,2007/03/04,18,10,0.77013901,9208,18,4,6
31100,2014/03/31,2012/05/22,115,4,0.801134335,8851,115,2,2
31101,2014/03/31,2005/03/14,127,6,0.61097458,11605,127,1,5
31102,2014/03/31,2008/03/28,110,10,0.8553625290000001,8289,110,6,4
31103,2014/03/31,2010/11/29,66,9,0.524485871,13518,66,4,5
31104,2014/03/31,2010/11/04,262,5,0.69,10275,262,2,3
31105,2014/03/31,2011/02/06,418,6,0.681435025,10404,418,6,0
31106,2014/03/31,2010/08/28,11,10,0.6088637929999999,11644,11,3,7
31107,2014/03/31,2012/09/27,544,4,0.495831585,14298,544,4,0
31108,2014/03/31,2009/11/03,83,11,0.727835729,9740,83,5,6
31109,2014/03/31,2006/07/25,19,10,0.743476665,9535,19,2,8
31110,2014/03/31,2011/10/23,103,6,0.637411204,11121,103,4,2
31111,2014/03/31,2010/06/09,251,6,0.812449284,8725,251,4,2
31112,2014/03/31,2006/01/04,52,5,0.871567687,8133,52,2,3
31113,2014/03/31,2012/02/23,452,6,0.792142618,8947,452,6,0
31114,2014/03/31,2011/05/20,98,7,0.558511309,12689,98,2,5
31115,2014/03/31,2008/12/03,484,9,0.7144772659999999,9919,484,9,0
31116,2014/03/31,2009/04/05,66,7,0.77436455,9151,66,3,4
31117,2014/03/31,2012/04/05,436,10,0.86060238,8234,436,10,0
31118,2014/03/31,2005/10/08,674,4,1.0,7086,674,4,0
31119,2014/03/31,2008/08/20,64,4,0.785577605,9020,64,1,3
31120,2014/03/31,2012/11/27,8,10,0.6026441570000001,11758,8,0,10
31121,2014/03/31,2010/06/18,103,5,0.549334781,12898,103,4,1
31122,2014/03/31,2011/07/10,5,9,0.7164607140000001,9889,5,3,6
31123,2014/03/31,2008/02/22,32,14,0.5699943679999999,12430,32,13,1
31124,2014/03/31,2006/08/23,61,7,0.6382816720000001,11098,61,3,4
31125,2014/03/31,2009/07/22,143,6,0.688431334,10289,143,3,3
31126,2014/03/31,2006/12/11,10,6,0.7545658890000001,9387,10,2,4
31127,2014/03/31,2007/02/05,9,11,0.4520314,15669,9,3,8
31128,2014/03/31,2011/10/17,19,3,1.062794118,6664,19,1,2
31129,2014/03/31,2012/10/08,279,8,0.7316549590000001,9680,279,7,1
31130,2014/03/31,2008/04/05,64,11,0.483559334,14646,64,6,5
31131,2014/03/31,2008/01/22,369,5,0.61,11610,369,5,0
31132,2014/03/31,2008/06/06,14,6,0.8344791420000001,8486,14,4,2
31133,2014/03/31,2006/11/26,10,8,0.669761657,10573,10,3,5
31134,2014/03/31,2013/03/01,37,6,0.761605894,9297,37,1,5
31135,2014/03/31,2008/11/20,7,5,0.6708176220000001,10555,7,0,5
31136,2014/03/31,2008/07/27,305,11,0.641568503,11036,305,10,1
31137,2014/03/31,2011/08/11,48,8,0.59751287,11849,48,3,5
31138,2014/03/31,2007/12/10,6,6,0.8466610859999999,8362,6,2,4
31139,2014/03/31,2011/09/22,20,3,0.6466666670000001,10947,20,2,1
31140,2014/03/31,2013/01/28,179,5,0.7381595409999999,9590,179,1,4
31141,2014/03/31,2007/11/24,4,23,0.745217391,9499,4,9,14
31142,2014/03/31,2011/08/09,138,4,0.786085508,9005,138,2,2
31143,2014/03/31,2008/04/04,1,10,0.602235835,11754,1,3,7
31144,2014/03/31,2010/08/19,39,7,0.8271009579999999,8558,39,0,7
31145,2014/03/31,2010/02/25,169,5,0.6906283540000001,10249,169,4,1
31146,2014/03/31,2009/09/26,82,5,0.681618993,10383,82,2,3
31147,2014/03/31,2013/02/05,91,6,0.740914992,9552,91,3,3
31148,2014/03/31,2011/11/12,645,6,0.71332527,9921,645,6,0
31149,2014/03/31,2010/11/28,581,7,0.8053431209999999,8787,581,7,0
31150,2014/03/31,2011/08/11,66,8,0.67625,10464,66,4,4
31151,2014/03/31,2008/09/13,159,5,0.8200846079999999,8628,159,0,5
31152,2014/03/31,2012/06/08,124,7,0.7998473890000001,8846,124,5,2
31153,2014/03/31,2010/12/17,516,7,0.676599407,10457,516,7,0
31154,2014/03/31,2008/08/27,302,5,0.8332104579999999,8491,302,4,1
31155,2014/03/31,2006/11/17,166,5,0.97026471,7291,166,4,1
31156,2014/03/31,2010/05/28,349,6,0.900139967,7859,349,4,2
31157,2014/03/31,2013/01/15,164,7,0.71784656,9854,164,1,6
31158,2014/03/31,2013/03/26,43,3,0.87,8130,43,1,2
31159,2014/03/31,2008/09/28,36,6,0.8838752809999999,8002,36,0,6
31160,2014/03/31,2012/07/25,142,8,0.643373056,10993,142,7,1
31161,2014/03/31,2011/09/03,115,6,0.688117338,10278,115,2,4
31162,2014/03/31,2011/04/12,249,6,0.961378467,7356,249,4,2
31163,2014/03/31,2008/08/07,60,7,0.5661228079999999,12491,60,3,4
31164,2014/03/31,2010/09/01,15,5,0.718922326,9836,15,2,3
31165,2014/03/31,2009/06/19,135,9,0.714619505,9895,135,8,1
31166,2014/03/31,2009/01/22,395,3,1.5,4714,395,3,0
31167,2014/03/31,2011/05/29,578,5,0.8339938659999999,8478,578,5,0
31168,2014/03/31,2005/10/20,43,2,0.435,16254,43,0,2
31169,2014/03/31,2011/04/27,100,7,0.571575586,12370,100,4,3
31170,2014/03/31,2012/04/30,1,8,0.6909313009999999,10233,1,3,5
31171,2014/03/31,2013/02/12,50,2,0.53,13340,50,0,2
31172,2014/03/31,2011/01/22,25,13,0.728058902,9711,25,10,3
31173,2014/03/31,2013/03/25,73,6,0.659142271,10726,73,1,5
31174,2014/03/31,2012/07/20,236,6,0.6047775879999999,11690,236,5,1
31175,2014/03/31,2012/09/26,432,7,0.7149271840000001,9888,432,7,0
31176,2014/03/31,2009/02/03,23,10,0.587758836,12025,23,3,7
31177,2014/03/31,2009/06/19,195,4,0.917377985,7704,195,0,4
31178,2014/03/31,2008/05/29,188,7,1.013378262,6974,188,1,6
31179,2014/03/31,2006/03/19,11,4,0.8854955520000001,7981,11,0,4
31180,2014/03/31,2012/03/12,13,7,0.7106194690000001,9944,13,5,2
31181,2014/03/31,2011/12/31,68,10,0.8852781259999999,7982,68,1,9
31182,2014/03/31,2007/07/19,233,6,0.7213148220000001,9796,233,3,3
31183,2014/03/31,2010/10/24,131,6,0.736678136,9591,131,1,5
31184,2014/03/31,2008/02/07,23,5,0.848840562,8323,23,1,4
31185,2014/03/31,2007/01/19,50,7,0.681175393,10371,50,3,4
31186,2014/03/31,2008/12/18,273,7,0.762382083,9265,273,5,2
31187,2014/03/31,2011/11/24,458,10,0.8927136,7912,458,10,0
31188,2014/03/31,2007/07/01,18,8,0.6897402340000001,10240,18,2,6
31189,2014/03/31,2011/09/19,136,7,0.7144167929999999,9885,136,2,5
31190,2014/03/31,2009/09/09,80,8,0.508239655,13895,80,5,3
31191,2014/03/31,2010/12/08,39,14,0.7148602959999999,9878,39,5,9
31192,2014/03/31,2006/09/25,82,6,0.6800173340000001,10384,82,5,1
31193,2014/03/31,2009/05/25,32,10,0.642200091,10995,32,4,6
31194,2014/03/31,2011/03/29,97,9,0.8066819009999999,8752,97,4,5
31195,2014/03/31,2010/06/11,226,5,0.657351955,10740,226,2,3
31196,2014/03/31,2011/01/15,246,6,0.7515009579999999,9394,246,5,1
31197,2014/03/31,2013/02/04,337,4,0.754897872,9351,337,2,2
31198,2014/03/31,2010/05/21,21,10,1.023,6900,21,7,3
31199,2014/03/31,2009/07/29,205,2,0.92,7672,205,0,2
31200,2014/03/31,2010/11/20,157,6,0.728903119,9682,157,3,3
31201,2014/03/31,2012/08/08,22,7,0.577400589,12222,22,1,6
31202,2014/03/31,2010/07/05,612,6,0.627395982,11248,612,6,0
31203,2014/03/31,2008/04/23,37,5,0.778589871,9063,37,0,5
31204,2014/03/31,2012/09/16,5,10,0.539680306,13075,5,6,4
31205,2014/03/31,2009/09/25,191,6,0.810535325,8705,191,4,2
31206,2014/03/31,2012/01/08,607,6,0.845482325,8345,607,6,0
31207,2014/03/31,2013/02/08,44,6,0.616572577,11443,44,1,5
31208,2014/03/31,2007/11/25,69,4,0.734290175,9608,69,0,4
31209,2014/03/31,2010/01/16,659,4,0.625,11288,659,4,0
31210,2014/03/31,2013/01/20,88,7,0.8979088709999999,7857,88,2,5
31211,2014/03/31,2012/03/22,2,6,1.035191489,6815,2,0,6
31212,2014/03/31,2009/06/24,127,10,0.847678443,8322,127,7,3
31213,2014/03/31,2009/04/09,9,9,0.74500845,9468,9,1,8
31214,2014/03/31,2010/02/02,149,11,0.706631937,9982,149,5,6
31215,2014/03/31,2013/01/22,164,8,0.822652204,8574,164,2,6
31216,2014/03/31,2012/10/23,3,4,0.74650471,9447,3,1,3
31217,2014/03/31,2011/09/22,155,9,0.608680939,11584,155,5,4
31218,2014/03/31,2010/12/19,170,10,0.6795845779999999,10375,170,6,4
31219,2014/03/31,2012/07/02,102,10,0.718495873,9813,102,6,4
31220,2014/03/31,2011/08/22,243,11,0.558683835,12620,243,7,4
31221,2014/03/31,2009/07/25,377,8,0.575871927,12243,377,8,0
31222,2014/03/31,2011/10/31,193,6,0.863985294,8160,193,5,1
31223,2014/03/31,2008/07/13,2,9,0.7987559479999999,8826,2,6,3
31224,2014/03/31,2011/03/29,207,7,0.970625086,7263,207,5,2
31225,2014/03/31,2012/10/31,347,3,1.172766595,6011,347,2,1
31226,2014/03/31,2010/07/29,538,7,0.86610763,8139,538,7,0
31227,2014/03/31,2009/01/23,60,10,0.8620154090000001,8177,60,2,8
31228,2014/03/31,2012/06/12,214,9,0.83782004,8413,214,3,6
31229,2014/03/31,2010/05/25,236,8,0.613655202,11485,236,7,1
31230,2014/03/31,2009/08/08,553,4,0.591655473,11912,553,4,0
31231,2014/03/31,2005/12/17,148,6,0.925124705,7618,148,1,5
31232,2014/03/31,2011/04/03,120,8,0.718042792,9815,120,4,4
31233,2014/03/31,2010/12/27,178,6,0.7134095970000001,9878,178,2,4
31234,2014/03/31,2011/07/27,185,9,0.767143479,9186,185,6,3
31235,2014/03/31,2009/10/13,96,8,0.45125,15616,96,4,4
31236,2014/03/31,2012/04/20,463,7,1.0010796990000002,7039,463,7,0
31237,2014/03/31,2006/03/25,153,5,0.689324985,10222,153,0,5
31238,2014/03/31,2010/12/09,205,9,0.829929329,8490,205,7,2
31239,2014/03/31,2008/05/09,161,7,0.660343018,10670,161,4,3
31240,2014/03/31,2011/04/12,123,8,0.800809275,8798,123,4,4
31241,2014/03/31,2011/11/23,128,6,0.6586995139999999,10696,128,0,6
31242,2014/03/31,2010/12/10,50,7,0.680337035,10355,50,4,3
31243,2014/03/31,2008/03/01,15,16,0.683876323,10301,15,7,9
31244,2014/03/31,2008/02/26,295,7,0.8703447,8094,295,6,1
31245,2014/03/31,2004/12/20,263,8,0.650404395,10831,263,1,7
31246,2014/03/31,2012/03/20,281,9,0.6595159629999999,10681,281,7,2
31247,2014/03/31,2008/12/26,186,7,0.7743299990000001,9097,186,3,4
31248,2014/03/31,2011/01/25,400,2,0.8474494709999999,8312,400,2,0
31249,2014/03/31,2008/07/02,140,9,0.7745458540000001,9094,140,6,3
31250,2014/03/31,2007/05/23,418,6,0.459351767,15334,418,6,0
31251,2014/03/31,2007/12/28,112,3,1.384044017,5089,112,1,2
31252,2014/03/31,2007/04/26,19,7,0.618414259,11389,19,5,2
31253,2014/03/31,2009/11/23,85,19,0.7637237040000001,9222,85,10,9
31254,2014/03/31,2012/08/11,118,3,0.8390564690000001,8394,118,1,2
31255,2014/03/31,2006/08/01,10,4,0.658224299,10700,10,0,4
31256,2014/03/31,2011/12/12,329,9,0.789474274,8921,329,7,2
31257,2014/03/31,2007/02/04,97,8,1.103000783,6385,97,1,7
31258,2014/03/31,2010/06/01,98,5,0.7947838840000001,8861,98,2,3
31259,2014/03/31,2011/10/24,113,11,0.538892715,13068,113,6,5
31260,2014/03/31,2012/11/26,16,9,0.733314589,9603,16,3,6
31261,2014/03/31,2007/08/01,34,5,0.716,9835,34,4,1
31262,2014/03/31,2006/01/09,119,4,0.955008816,7373,119,2,2
31263,2014/03/31,2011/10/26,24,12,0.659084527,10683,24,4,8
31264,2014/03/31,2013/03/02,13,6,0.683732155,10297,13,0,6
31265,2014/03/31,2009/08/22,13,8,0.5719922,12308,13,3,5
31266,2014/03/31,2009/01/30,139,10,0.55491329,12686,139,3,7
31267,2014/03/31,2008/03/16,306,9,0.686522333,10254,306,8,1
31268,2014/03/31,2013/01/01,62,5,0.803673935,8759,62,2,3
31269,2014/03/31,2008/04/11,25,7,0.855455761,8228,25,2,5
31270,2014/03/31,2011/08/17,222,7,0.68135334,10330,222,6,1
31271,2014/03/31,2012/11/28,124,7,1.058390977,6650,124,2,5
31272,2014/03/31,2011/12/21,555,2,1.5,4692,555,2,0
31273,2014/03/31,2010/05/13,96,7,0.824508494,8535,96,4,3
31274,2014/03/31,2006/07/15,341,7,0.7493344690000001,9391,341,6,1
31275,2014/03/31,2009/06/13,17,8,0.769448879,9145,17,2,6
31276,2014/03/31,2012/07/23,235,9,0.7161659029999999,9825,235,4,5
31277,2014/03/31,2007/10/16,105,10,0.865298241,8131,105,3,7
31278,2014/03/31,2009/09/30,81,6,0.643825037,10928,81,3,3
31279,2014/03/31,2009/12/01,3,12,0.80050751,8788,3,3,9
31280,2014/03/31,2007/09/28,255,4,0.975377149,7212,255,0,4
31281,2014/03/31,2008/05/01,3,4,1.346588168,5223,3,0,4
31282,2014/03/31,2012/08/01,205,5,0.84149677,8358,205,2,3
31283,2014/03/31,2008/10/31,47,8,0.687430359,10231,47,2,6
31284,2014/03/31,2010/01/14,216,8,0.7687713159999999,9148,216,3,5
31285,2014/03/31,2008/11/11,23,11,0.728279648,9655,23,5,6
31286,2014/03/31,2011/04/17,338,6,0.707155788,9943,338,5,1
31287,2014/03/31,2012/02/06,518,5,0.79,8900,518,5,0
31288,2014/03/31,2011/03/19,114,7,0.799416714,8795,114,4,3
31289,2014/03/31,2008/09/07,74,2,1.41,4986,74,0,2
31290,2014/03/31,2012/11/23,32,4,0.852033693,8251,32,1,3
31291,2014/03/31,2011/07/31,14,10,0.628410655,11187,14,4,6
31292,2014/03/31,2010/12/18,39,9,0.8819031490000001,7971,39,6,3
31293,2014/03/31,2011/10/07,38,7,0.593022863,11853,38,3,4
31294,2014/03/31,2013/03/09,18,11,0.787797579,8922,18,1,10
31295,2014/03/31,2010/06/23,402,5,0.8412567320000001,8355,402,5,0
31296,2014/03/31,2013/01/04,37,9,0.879370621,7992,37,0,9
31297,2014/03/31,2011/09/27,362,9,0.932393525,7537,362,7,2
31298,2014/03/31,2013/02/09,166,4,0.510236712,13772,166,1,3
31299,2014/03/31,2010/03/19,207,13,0.516128985,13614,207,9,4
31300,2014/03/31,2012/05/24,130,5,0.577976474,12157,130,4,1
31301,2014/03/31,2011/09/14,254,7,0.701359553,10018,254,4,3
31302,2014/03/31,2012/12/14,203,11,0.942908334,7451,203,4,7
31303,2014/03/31,2011/02/01,41,8,0.61092,11500,41,5,3
31304,2014/03/31,2008/08/23,123,8,0.560874251,12525,123,3,5
31305,2014/03/31,2010/05/06,194,8,0.381571141,18407,194,6,2
31306,2014/03/31,2013/03/23,214,8,0.595418786,11796,214,2,6
31307,2014/03/31,2008/10/31,67,11,0.442896513,15857,67,10,1
31308,2014/03/31,2009/07/19,549,5,0.798028185,8799,549,5,0
31309,2014/03/31,2013/01/11,18,11,0.462931364,15167,18,0,11
31310,2014/03/31,2012/11/16,280,3,0.683329764,10274,280,0,3
31311,2014/03/31,2012/06/20,362,4,0.7591985720000001,9246,362,2,2
31312,2014/03/31,2012/04/21,100,8,0.797584365,8801,100,3,5
31313,2014/03/31,2008/03/15,81,9,0.751147138,9345,81,3,6
31314,2014/03/31,2010/04/10,117,5,0.7865609590000001,8924,117,3,2
31315,2014/03/31,2008/11/01,235,5,0.67547878,10391,235,0,5
31316,2014/03/31,2013/01/17,75,7,0.621218022,11297,75,0,7
31317,2014/03/31,2011/05/25,26,7,0.822708089,8530,26,6,1
31318,2014/03/31,2008/12/25,52,11,0.7091248109999999,9895,52,8,3
31319,2014/03/31,2010/05/30,114,13,0.7083161720000001,9906,114,9,4
31320,2014/03/31,2005/10/10,133,8,0.627864877,11175,133,3,5
31321,2014/03/31,2006/01/18,146,10,0.657684664,10668,146,9,1
31322,2014/03/31,2011/10/29,58,10,0.6877717870000001,10201,58,4,6
31323,2014/03/31,2011/11/11,117,10,0.678685305,10337,117,6,4
31324,2014/03/31,2012/03/15,115,12,0.891652262,7868,115,11,1
31325,2014/03/31,2009/09/01,6,8,0.780857079,8984,6,0,8
31326,2014/03/31,2013/03/25,178,4,0.7375,9512,178,0,4
31327,2014/03/31,2013/03/09,183,8,0.511301749,13720,183,2,6
31328,2014/03/31,2010/12/08,112,18,0.34637369100000004,20252,112,9,9
31329,2014/03/31,2010/03/01,20,9,0.943718552,7433,20,6,3
31330,2014/03/31,2012/04/28,581,4,0.67921468,10327,581,4,0
31331,2014/03/31,2008/01/28,699,3,1.359829391,5158,699,3,0
31332,2014/03/31,2007/02/20,257,7,0.6898003540000001,10168,257,3,4
31333,2014/03/31,2011/12/28,20,11,0.509852428,13756,20,1,10
31334,2014/03/31,2005/08/06,235,6,0.867131553,8088,235,3,3
31335,2014/03/31,2009/09/30,168,6,0.59586746,11770,168,2,4
31336,2014/03/31,2007/09/11,72,5,0.805752528,8704,72,3,2
31337,2014/03/31,2013/02/10,84,6,0.9023263,7772,84,0,6
31338,2014/03/31,2012/12/11,65,8,0.588940959,11907,65,3,5
31339,2014/03/31,2008/03/20,347,9,0.5944307870000001,11797,347,8,1
31340,2014/03/31,2011/05/01,67,9,0.570387994,12294,67,4,5
31341,2014/03/31,2006/07/06,5,9,0.629296419,11143,5,8,1
31342,2014/03/31,2007/12/10,21,13,0.852766087,8221,21,12,1
31343,2014/03/31,2010/10/28,314,8,0.893233945,7848,314,7,1
31344,2014/03/31,2012/10/05,277,5,0.754772262,9287,277,4,1
31345,2014/03/31,2012/07/23,153,10,0.553928713,12653,153,8,2
31346,2014/03/31,2008/06/13,337,7,0.947027027,7400,337,6,1
31347,2014/03/31,2008/02/06,135,8,0.995256356,7041,135,3,5
31348,2014/03/31,2012/02/13,37,8,0.5698495570000001,12297,37,4,4
31349,2014/03/31,2012/01/14,160,10,0.8803115579999999,7960,160,4,6
31350,2014/03/31,2012/08/23,580,5,0.732376921,9567,580,5,0
31351,2014/03/31,2008/07/02,227,3,0.910515919,7695,227,0,3
31352,2014/03/31,2011/06/09,24,12,0.7681394579999999,9121,24,3,9
31353,2014/03/31,2005/04/19,36,9,0.535665571,13079,36,5,4
31354,2014/03/31,2009/10/12,6,9,0.847325835,8268,6,3,6
31355,2014/03/31,2010/07/29,49,7,0.7468667379999999,9380,49,0,7
31356,2014/03/31,2010/03/29,69,9,0.657922615,10648,69,0,9
31357,2014/03/31,2012/03/20,232,7,0.777950028,9005,232,6,1
31358,2014/03/31,2011/03/10,79,6,0.7930850220000001,8833,79,4,2
31359,2014/03/31,2010/11/12,398,4,0.876780573,7989,398,4,0
31360,2014/03/31,2011/03/26,186,10,0.661379864,10588,186,7,3
31361,2014/03/31,2012/07/02,68,8,0.553348084,12655,68,4,4
31362,2014/03/31,2008/06/20,1,11,0.7643080109999999,9162,1,4,7
31363,2014/03/31,2007/06/20,175,7,0.541032218,12943,175,2,5
31364,2014/03/31,2012/10/27,214,7,0.7160793540000001,9779,214,4,3
31365,2014/03/31,2008/11/10,33,7,0.767307692,9126,33,5,2
31366,2014/03/31,2009/04/07,421,4,0.587437081,11920,421,4,0
31367,2014/03/31,2013/02/24,9,7,0.8582142420000001,8159,9,1,6
31368,2014/03/31,2006/01/21,145,7,0.44977261,15568,145,4,3
31369,2014/03/31,2005/04/30,280,12,0.681445255,10275,280,9,3
31370,2014/03/31,2008/08/10,83,7,0.779354408,8984,83,0,7
31371,2014/03/31,2006/08/16,45,7,0.660278197,10604,45,2,5
31372,2014/03/31,2011/04/05,253,4,0.8618266859999999,8124,253,3,1
31373,2014/03/31,2010/02/23,1,11,0.490095205,14285,1,5,6
31374,2014/03/31,2009/01/16,231,10,0.591277872,11840,231,6,4
31375,2014/03/31,2011/04/24,77,4,0.610322581,11470,77,3,1
31376,2014/03/31,2008/05/22,71,9,0.8049212370000001,8697,71,6,3
31377,2014/03/31,2012/02/13,263,6,0.598367242,11698,263,4,2
31378,2014/03/31,2013/01/26,146,4,0.8533942940000001,8202,146,1,3
31379,2014/03/31,2008/05/08,326,7,0.717455925,9756,326,5,2
31380,2014/03/31,2008/10/07,106,4,0.899429453,7782,106,1,3
31381,2014/03/31,2010/04/08,7,12,0.662739324,10561,7,5,7
31382,2014/03/31,2011/08/03,509,7,0.93344892,7498,509,7,0
31383,2014/03/31,2012/08/30,160,8,0.8099432940000001,8641,160,3,5
31384,2014/03/31,2005/09/15,132,14,0.674054705,10383,132,11,3
31385,2014/03/31,2010/09/26,472,7,0.820416178,8530,472,7,0
31386,2014/03/31,2013/01/01,47,9,0.930518617,7520,47,0,9
31387,2014/03/31,2011/03/29,285,12,0.95110507,7357,285,8,4
31388,2014/03/31,2012/08/03,123,8,0.7397726790000001,9458,123,4,4
31389,2014/03/31,2008/02/26,77,7,0.650974135,10748,77,3,4
31390,2014/03/31,2005/02/17,199,12,0.698496406,10016,199,7,5
31391,2014/03/31,2011/06/29,1,7,0.6093641670000001,11481,1,0,7
31392,2014/03/31,2011/03/22,577,5,0.761876497,9182,577,5,0
31393,2014/03/31,2007/06/01,196,7,0.651596498,10736,196,3,4
31394,2014/03/31,2010/03/20,163,3,0.6178482470000001,11321,163,0,3
31395,2014/03/31,2012/01/16,428,3,0.683333333,10236,428,3,0
31396,2014/03/31,2007/08/26,94,11,1.076882217,6495,94,9,2
31397,2014/03/31,2013/01/18,47,8,0.74940105,9333,47,3,5
31398,2014/03/31,2006/10/27,47,7,0.6777267440000001,10320,47,4,3
31399,2014/03/31,2012/08/07,579,6,0.6309517370000001,11085,579,6,0
31400,2014/03/31,2012/09/05,73,7,0.544664746,12841,73,3,4
31401,2014/03/31,2008/05/14,169,6,0.495666903,14110,169,5,1
31402,2014/03/31,2012/06/16,559,3,1.041053885,6718,559,3,0
31403,2014/03/31,2011/03/22,197,8,0.6444554,10852,197,4,4
31404,2014/03/31,2010/05/23,48,7,0.822443843,8503,48,4,3
31405,2014/03/31,2013/02/09,35,10,0.506814031,13798,35,0,10
31406,2014/03/31,2012/10/31,108,5,0.6827946490000001,10241,108,1,4
31407,2014/03/31,2008/04/02,7,7,0.904336524,7732,7,5,2
31408,2014/03/31,2012/10/14,6,8,0.650009296,10757,6,2,6
31409,2014/03/31,2008/03/17,20,8,0.537277129,13012,20,4,4
31410,2014/03/31,2010/04/11,7,6,0.602745301,11598,7,4,2
31411,2014/03/31,2009/09/26,22,7,0.73645807,9492,22,4,3
31412,2014/03/31,2007/07/02,9,6,0.90524864,7722,9,0,6
31413,2014/03/31,2011/08/25,125,9,0.726107822,9627,125,2,7
31414,2014/03/31,2012/08/04,541,4,1.0,6990,541,4,0
31415,2014/03/31,2009/10/06,7,7,0.717620123,9740,7,2,5
31416,2014/03/31,2012/04/11,580,5,0.794058169,8802,580,5,0
31417,2014/03/31,2011/09/18,533,6,0.936070185,7466,533,6,0
31418,2014/03/31,2008/02/08,402,4,0.9,7764,402,4,0
31419,2014/03/31,2010/02/20,238,8,0.875736308,7979,238,7,1
31420,2014/03/31,2010/05/06,45,8,0.6861007459999999,10184,45,2,6
31421,2014/03/31,2011/04/01,169,6,0.596836081,11707,169,3,3
31422,2014/03/31,2006/04/11,451,6,0.977633972,7147,451,6,0
31423,2014/03/31,2012/08/12,87,4,0.81,8626,87,2,2
31424,2014/03/31,2008/06/10,22,11,0.6898321479999999,10128,22,3,8
31425,2014/03/31,2008/12/12,12,6,0.5547752539999999,12592,12,4,2
31426,2014/03/31,2006/11/04,567,10,0.731936295,9544,567,10,0
31427,2014/03/31,2011/08/11,17,2,0.70778397,9869,17,0,2
31428,2014/03/31,2010/11/01,36,10,0.504125586,13855,36,6,4
31429,2014/03/31,2012/06/08,361,4,0.694116478,10062,361,3,1
31430,2014/03/31,2012/11/08,156,5,0.72936188,9575,156,2,3
31431,2014/03/31,2008/07/13,69,8,0.5896352579999999,11844,69,1,7
31432,2014/03/31,2012/11/14,26,8,0.7143815859999999,9775,26,7,1
31433,2014/03/31,2012/02/17,522,5,0.71,9835,522,5,0
31434,2014/03/31,2004/11/26,4,7,0.664133536,10514,4,5,2
31435,2014/03/31,2011/05/17,457,3,0.833333333,8379,457,3,0
31436,2014/03/31,2013/02/05,28,8,0.751901788,9286,28,2,6
31437,2014/03/31,2010/05/21,74,11,0.586568644,11902,74,3,8
31438,2014/03/31,2010/06/30,162,12,0.6014611870000001,11607,162,7,5
31439,2014/03/31,2009/09/08,192,10,0.6756581490000001,10332,192,5,5
31440,2014/03/31,2008/04/04,72,7,0.766168368,9111,72,5,2
31441,2014/03/31,2013/03/14,188,5,0.740133602,9431,188,1,4
31442,2014/03/31,2011/10/24,280,13,0.7104947070000001,9824,280,11,2
31443,2014/03/31,2011/07/09,155,12,0.872867684,7996,155,10,2
31444,2014/03/31,2009/08/01,207,6,0.69601935,10026,207,5,1
31445,2014/03/31,2008/03/03,56,8,0.698450606,9991,56,5,3
31446,2014/03/31,2008/07/31,151,4,0.701608687,9946,151,0,4
31447,2014/03/31,2005/11/30,462,10,0.8783008179999999,7945,462,10,0
31448,2014/03/31,2010/03/20,236,10,0.643194764,10849,236,7,3
31449,2014/03/31,2008/10/25,81,3,0.72,9690,81,1,2
31450,2014/03/31,2013/01/07,43,8,0.745929648,9353,43,2,6
31451,2014/03/31,2007/10/17,71,7,0.933576877,7473,71,3,4
31452,2014/03/31,2007/03/06,16,9,0.7794357540000001,8950,16,5,4
31453,2014/03/31,2012/08/16,103,12,0.749609929,9306,103,4,8
31454,2014/03/31,2011/06/23,127,7,1.167816842,5973,127,2,5
31455,2014/03/31,2007/10/06,481,9,0.500157751,13946,481,9,0
31456,2014/03/31,2005/03/19,32,13,0.81343247,8574,32,7,6
31457,2014/03/31,2008/11/11,23,6,0.8111562170000001,8597,23,0,6
31458,2014/03/31,2012/02/05,57,12,0.716032447,9739,57,6,6
31459,2014/03/31,2006/11/11,678,3,0.911436414,7651,678,3,0
31460,2014/03/31,2007/04/17,523,6,0.6914328209999999,10085,523,6,0
31461,2014/03/31,2011/10/28,283,8,0.860577635,8102,283,2,6
31462,2014/03/31,2008/02/27,160,6,0.842652889,8274,160,5,1
31463,2014/03/31,2012/08/10,34,7,0.7114285709999999,9800,34,4,3
31464,2014/03/31,2010/10/26,21,8,0.7581404959999999,9196,21,5,3
31465,2014/03/31,2009/01/15,11,7,0.660589406,10553,11,1,6
31466,2014/03/31,2012/09/14,176,4,0.8080514659999999,8627,176,1,3
31467,2014/03/31,2011/10/11,459,8,0.592725959,11761,459,8,0
31468,2014/03/31,2011/05/17,169,5,0.6781642179999999,10279,169,2,3
31469,2014/03/31,2011/03/21,131,6,0.8779219140000001,7940,131,2,4
31470,2014/03/31,2006/10/14,13,14,0.422266917,16507,13,0,14
31471,2014/03/31,2009/02/16,272,11,0.702725073,9919,272,9,2
31472,2014/03/31,2008/06/16,27,9,0.754562087,9237,27,5,4
31473,2014/03/31,2012/06/26,223,4,0.6725,10364,223,0,4
31474,2014/03/31,2012/04/12,7,9,1.0232961390000002,6811,7,4,5
31475,2014/03/31,2011/03/01,403,6,0.813641139,8566,403,6,0
31476,2014/03/31,2009/02/13,143,7,0.67920573,10261,143,3,4
31477,2014/03/31,2010/04/14,71,7,0.6983445229999999,9979,71,2,5
31478,2014/03/31,2012/04/29,660,3,0.972275708,7167,660,3,0
31479,2014/03/31,2011/11/15,246,7,0.6932043370000001,10052,246,5,2
31480,2014/03/31,2012/02/07,161,12,0.7890204959999999,8831,161,10,2
31481,2014/03/31,2010/09/23,4,9,0.5341774,13044,4,0,9
31482,2014/03/31,2011/09/19,138,5,0.880427145,7913,138,3,2
31483,2014/03/31,2013/01/05,246,4,0.75,9288,246,2,2
31484,2014/03/31,2008/11/28,438,4,0.75,9288,438,4,0
31485,2014/03/31,2013/01/03,205,4,0.75,9288,205,1,3
31486,2014/03/31,2012/10/08,466,4,0.75,9288,466,4,0
31487,2014/03/31,2010/12/29,152,4,0.955397065,7291,152,1,3
31488,2014/03/31,2011/04/22,266,8,0.581729581,11974,266,1,7
31489,2014/03/31,2008/04/28,205,7,0.8786047690000001,7927,205,6,1
31490,2014/03/31,2010/06/29,326,10,0.688706487,10112,326,8,2
31491,2014/03/31,2009/01/28,120,11,0.6924321370000001,10057,120,6,5
31492,2014/03/31,2008/03/07,548,6,0.775030607,8985,548,6,0
31493,2014/03/31,2007/10/31,22,7,0.943327012,7382,22,3,4
31494,2014/03/31,2013/01/31,142,6,0.758270718,9183,142,0,6
31495,2014/03/31,2009/07/11,35,10,0.771784527,9022,35,3,7
31496,2014/03/31,2008/09/13,533,5,0.549175803,12679,533,5,0
31497,2014/03/31,2012/12/13,4,6,0.7746995990000001,8988,4,1,5
31498,2014/03/31,2008/04/29,424,6,0.6239761629999999,11159,424,6,0
31499,2014/03/31,2007/01/14,137,6,0.7844456959999999,8876,137,4,2
31500,2014/03/31,2008/09/04,192,5,0.753294385,9243,192,4,1
31501,2014/03/31,2011/09/12,30,5,0.817590418,8516,30,0,5
31502,2014/03/31,2009/09/03,543,5,0.706868718,9849,543,5,0
31503,2014/03/31,2006/12/26,400,12,0.472072286,14747,400,12,0
31504,2014/03/31,2005/06/17,27,7,0.8658950120000001,8039,27,1,6
31505,2014/03/31,2007/04/27,34,6,0.754307542,9228,34,3,3
31506,2014/03/31,2012/11/27,348,4,0.7828815659999999,8891,348,3,1
31507,2014/03/31,2013/01/29,46,6,0.640737365,10863,46,1,5
31508,2014/03/31,2010/07/08,343,4,0.652018735,10675,343,3,1
31509,2014/03/31,2010/01/01,22,11,0.584902933,11899,22,2,9
31510,2014/03/31,2011/08/18,201,8,0.534041443,13030,201,5,3
31511,2014/03/31,2010/02/11,306,4,0.849011713,8196,306,3,1
31512,2014/03/31,2012/02/16,4,6,0.830150322,8382,4,0,6
31513,2014/03/31,2005/08/13,323,9,0.608136689,11442,323,7,2
31514,2014/03/31,2011/09/19,11,8,0.85178602,8169,11,5,3
31515,2014/03/31,2013/03/27,3,9,0.738299024,9424,3,0,9
31516,2014/03/31,2005/07/09,215,6,0.543333333,12804,215,2,4
31517,2014/03/31,2009/06/05,379,10,0.736938559,9440,379,10,0
31518,2014/03/31,2011/05/17,47,10,0.639046482,10886,47,5,5
31519,2014/03/31,2010/06/14,54,8,0.659687055,10545,54,0,8
31520,2014/03/31,2008/04/08,8,13,0.512616802,13570,8,2,11
31521,2014/03/31,2005/07/29,126,9,0.503132007,13825,126,6,3
31522,2014/03/31,2010/05/26,293,4,0.805068287,8640,293,3,1
31523,2014/03/31,2009/09/30,77,8,0.548562303,12680,77,4,4
31524,2014/03/31,2012/02/28,141,11,0.749058798,9286,141,8,3
31525,2014/03/31,2009/03/06,5,15,0.401250144,17334,5,9,6
31526,2014/03/31,2007/09/09,327,4,0.675,10304,327,3,1
31527,2014/03/31,2010/05/06,198,8,0.5443800879999999,12776,198,7,1
31528,2014/03/31,2010/05/01,50,9,0.499622845,13920,50,6,3
31529,2014/03/31,2012/05/24,26,11,0.605888657,11478,26,4,7
31530,2014/03/31,2011/04/25,194,7,0.842538163,8254,194,6,1
31531,2014/03/31,2005/09/30,107,4,0.611124879,11379,107,0,4
31532,2014/03/31,2008/02/13,3,9,0.506073664,13738,3,6,3
31533,2014/03/31,2008/04/05,125,9,0.7284524309999999,9544,125,4,5
31534,2014/03/31,2009/11/25,203,5,1.052325159,6606,203,4,1
31535,2014/03/31,2010/06/01,42,6,0.671450787,10353,42,3,3
31536,2014/03/31,2005/09/09,45,7,0.557711008,12464,45,1,6
31537,2014/03/31,2011/07/13,312,11,0.6044960429999999,11499,312,9,2
31538,2014/03/31,2012/12/08,179,8,0.7838046909999999,8868,179,2,6
31539,2014/03/31,2007/09/21,394,8,0.724997392,9587,394,8,0
31540,2014/03/31,2007/01/01,189,3,0.6933017459999999,10025,189,2,1
31541,2014/03/31,2006/05/10,44,2,0.82,8476,44,0,2
31542,2014/03/31,2009/05/15,407,14,0.6355248720000001,10936,407,14,0
31543,2014/03/31,2006/06/08,254,7,0.498387721,13943,254,4,3
31544,2014/03/31,2006/01/09,14,7,0.683701663,10163,14,0,7
31545,2014/03/31,2007/08/20,483,5,0.75713196,9177,483,5,0
31546,2014/03/31,2006/11/10,165,7,0.61780722,11246,165,4,3
31547,2014/03/31,2012/11/16,141,7,0.35576044700000004,19528,141,3,4
31548,2014/03/31,2007/04/17,28,5,0.67511759,10290,28,0,5
31549,2014/03/31,2005/09/13,7,5,0.705917082,9841,7,3,2
31550,2014/03/31,2012/04/12,32,10,0.662395347,10487,32,3,7
31551,2014/03/31,2006/07/26,356,5,0.7325213540000001,9483,356,4,1
31552,2014/03/31,2006/07/10,491,4,0.656239962,10585,491,4,0
31553,2014/03/31,2011/09/22,35,5,0.7728126390000001,8988,35,2,3
31554,2014/03/31,2007/06/15,81,5,0.650620082,10676,81,2,3
31555,2014/03/31,2012/12/04,22,10,0.7234875,9600,22,4,6
31556,2014/03/31,2011/11/03,49,6,0.7547337540000001,9202,49,1,5
31557,2014/03/31,2012/09/01,234,7,0.556093362,12489,234,2,5
31558,2014/03/31,2012/05/24,280,6,0.8299402490000001,8368,280,2,4
31559,2014/03/31,2007/03/15,165,8,0.907830065,7650,165,3,5
31560,2014/03/31,2012/06/22,41,9,0.619485281,11210,41,2,7
31561,2014/03/31,2012/05/23,166,7,0.463593698,14979,166,2,5
31562,2014/03/31,2010/07/09,324,6,0.445794813,15576,324,4,2
31563,2014/03/31,2010/11/22,257,4,1.487487147,4668,257,3,1
31564,2014/03/31,2011/08/01,243,6,0.769870245,9017,243,4,2
31565,2014/03/31,2010/09/06,155,4,1.087843598,6381,155,1,3
31566,2014/03/31,2011/10/15,96,9,0.660941815,10501,96,4,5
31567,2014/03/31,2009/04/01,85,3,1.36427757,5087,85,2,1
31568,2014/03/31,2011/09/18,316,11,0.651342219,10654,316,7,4
31569,2014/03/31,2010/12/02,5,13,0.528930396,13117,5,9,4
31570,2014/03/31,2008/12/11,293,8,0.7157598270000001,9693,293,4,4
31571,2014/03/31,2011/10/12,47,7,0.827207583,8387,47,3,4
31572,2014/03/31,2011/03/23,20,10,0.7214862190000001,9615,20,4,6
31573,2014/03/31,2010/07/04,91,13,0.578856809,11984,91,9,4
31574,2014/03/31,2012/09/17,384,12,0.959936341,7226,384,12,0
31575,2014/03/31,2012/08/05,125,7,0.610002638,11371,125,4,3
31576,2014/03/31,2010/03/06,415,10,0.6511689039999999,10651,415,10,0
31577,2014/03/31,2010/07/29,377,10,0.75567117,9178,377,10,0
31578,2014/03/31,2012/10/09,36,8,0.499476413,13885,36,1,7
31579,2014/03/31,2009/09/10,113,14,0.426307021,16266,113,9,5
31580,2014/03/31,2009/08/02,184,4,0.673586555,10294,184,0,4
31581,2014/03/31,2012/05/29,184,12,0.791794198,8756,184,8,4
31582,2014/03/31,2011/03/26,535,6,0.936345219,7404,535,6,0
31583,2014/03/31,2009/05/25,138,11,0.86815506,7984,138,5,6
31584,2014/03/31,2009/11/26,64,5,0.748219799,9263,64,1,4
31585,2014/03/31,2004/11/11,12,12,0.720891408,9614,12,5,7
31586,2014/03/31,2012/10/30,36,13,0.630811032,10986,36,4,9
31587,2014/03/31,2011/05/24,81,7,1.110461538,6240,81,1,6
31588,2014/03/31,2013/01/21,2,11,0.7108987379999999,9747,2,1,10
31589,2014/03/31,2013/01/09,207,10,0.7469030940000001,9277,207,2,8
31590,2014/03/31,2007/04/13,21,6,0.8148288840000001,8503,21,3,3
31591,2014/03/31,2012/10/22,266,9,0.7485964340000001,9255,266,5,4
31592,2014/03/31,2010/08/01,403,6,0.625605021,11074,403,6,0
31593,2014/03/31,2006/12/24,258,11,0.587536896,11790,258,5,6
31594,2014/03/31,2008/06/14,165,6,0.568580809,12183,165,0,6
31595,2014/03/31,2008/03/11,6,6,0.661218022,10476,6,2,4
31596,2014/03/31,2010/02/14,131,8,0.7878548679999999,8792,131,6,2
31597,2014/03/31,2008/08/09,3,3,0.670208051,10334,3,0,3
31598,2014/03/31,2011/06/08,190,3,0.8056677520000001,8596,190,1,2
31599,2014/03/31,2009/03/11,242,11,0.7926610959999999,8737,242,8,3
31600,2014/03/31,2011/02/08,42,8,0.37714737,18362,42,2,6
31601,2014/03/31,2012/02/28,13,5,0.90702685,7635,13,0,5
31602,2014/03/31,2009/11/27,165,5,0.835542954,8288,165,1,4
31603,2014/03/31,2012/01/08,74,5,0.4320000000000001,16030,74,3,2
31604,2014/03/31,2012/11/28,42,6,0.759896839,9112,42,0,6
31605,2014/03/31,2007/10/06,72,4,0.88,7868,72,3,1
31606,2014/03/31,2012/12/07,342,6,0.7094476890000001,9759,342,5,1
31607,2014/03/31,2007/05/25,377,7,0.6985420240000001,9911,377,7,0
31608,2014/03/31,2006/11/27,426,4,0.628757606,11011,426,4,0
31609,2014/03/31,2010/08/05,123,5,0.792086957,8740,123,4,1
31610,2014/03/31,2007/07/14,133,8,0.8688929329999999,7967,133,5,3
31611,2014/03/31,2010/03/29,163,8,0.911459047,7594,163,4,4
31612,2014/03/31,2005/08/05,231,8,0.515427465,13428,231,4,4
31613,2014/03/31,2010/01/30,82,14,0.846521526,8176,82,2,12
31614,2014/03/31,2008/03/18,103,8,0.6653206420000001,10401,103,5,3
31615,2014/03/31,2008/04/28,241,6,0.721189161,9595,241,5,1
31616,2014/03/31,2009/06/30,95,14,0.6788041990000001,10194,95,7,7
31617,2014/03/31,2011/08/12,71,6,0.526458952,13143,71,3,3
31618,2014/03/31,2006/02/15,161,7,0.612683964,11293,161,1,6
31619,2014/03/31,2010/10/01,102,8,1.028666369,6726,102,4,4
31620,2014/03/31,2008/01/15,84,6,0.876215805,7896,84,1,5
31621,2014/03/31,2011/05/17,17,12,0.658972283,10499,17,0,12
31622,2014/03/31,2008/09/15,246,7,0.518303866,13348,246,4,3
31623,2014/03/31,2012/06/10,643,3,0.667342016,10365,643,3,0
31624,2014/03/31,2013/01/24,65,8,0.722486159,9573,65,0,8
31625,2014/03/31,2007/12/07,93,4,0.923509147,7489,93,0,4
31626,2014/03/31,2006/03/22,50,5,0.882946508,7833,50,4,1
31627,2014/03/31,2010/05/17,10,8,0.485713884,14239,10,3,5
31628,2014/03/31,2009/02/25,272,6,0.744127394,9294,272,2,4
31629,2014/03/31,2007/09/06,277,7,0.837613568,8255,277,6,1
31630,2014/03/31,2012/04/19,17,12,0.7380582840000001,9368,17,4,8
31631,2014/03/31,2007/12/04,14,11,0.50724358,13630,14,5,6
31632,2014/03/31,2006/05/20,74,5,0.6727708029999999,10275,74,3,2
31633,2014/03/31,2007/08/14,4,6,1.005270506,6876,4,0,6
31634,2014/03/31,2011/01/11,322,7,0.584503171,11825,322,4,3
31635,2014/03/31,2008/07/26,112,4,0.64486658,10718,112,0,4
31636,2014/03/31,2009/12/08,19,7,0.631081081,10952,19,1,6
31637,2014/03/31,2008/03/19,3,5,0.8007866990000001,8631,3,0,5
31638,2014/03/31,2013/01/13,281,7,0.758189797,9115,281,4,3
31639,2014/03/31,2011/07/13,83,8,0.68943336,10024,83,4,4
31640,2014/03/31,2006/12/15,122,10,0.72300722,9557,122,4,6
31641,2014/03/31,2007/06/14,28,8,0.71321635,9688,28,6,2
31642,2014/03/31,2010/02/20,181,6,0.6801240279999999,10159,181,4,2
31643,2014/03/31,2006/05/05,17,10,0.551024005,12539,17,4,6
31644,2014/03/31,2012/12/11,149,11,0.563730418,12256,149,2,9
31645,2014/03/31,2010/06/27,88,5,0.7663294509999999,9015,88,2,3
31646,2014/03/31,2005/09/27,169,6,0.574644818,12022,169,5,1
31647,2014/03/31,2011/02/08,518,8,0.8654472559999999,7982,518,8,0
31648,2014/03/31,2012/10/17,151,14,0.5584324979999999,12370,151,4,10
31649,2014/03/31,2005/03/06,89,5,0.741609405,9314,89,4,1
31650,2014/03/31,2010/07/07,41,8,0.552632421,12498,41,6,2
31651,2014/03/31,2009/06/20,88,5,0.658515446,10488,88,1,4
31652,2014/03/31,2013/02/10,34,3,0.81,8526,34,2,1
31653,2014/03/31,2012/09/20,112,7,0.634013955,10892,112,3,4
31654,2014/03/31,2012/09/22,265,7,0.778884503,8866,265,6,1
31655,2014/03/31,2012/05/19,309,8,0.666222865,10365,309,7,1
31656,2014/03/31,2012/10/11,146,9,0.644025368,10722,146,5,4
31657,2014/03/31,2011/07/20,388,3,0.6,11508,388,3,0
31658,2014/03/31,2009/11/06,398,4,0.45,15344,398,4,0
31659,2014/03/31,2010/07/08,278,10,0.8220812,8399,278,3,7
31660,2014/03/31,2009/12/22,20,9,0.525605207,13136,20,0,9
31661,2014/03/31,2012/12/14,179,6,0.937071118,7368,179,3,3
31662,2014/03/31,2010/01/12,14,10,0.503326529,13717,14,4,6
31663,2014/03/31,2009/04/04,14,8,0.79540553,8680,14,1,7
31664,2014/03/31,2005/10/18,82,8,0.7754610809999999,8903,82,2,6
31665,2014/03/31,2005/08/05,130,12,0.136016589,50758,130,6,6
31666,2014/03/31,2010/05/25,391,5,0.89670087,7699,391,5,0
31667,2014/03/31,2011/07/05,18,10,0.589890626,11703,18,3,7
31668,2014/03/31,2012/09/10,374,4,0.8999739240000001,7670,374,4,0
31669,2014/03/31,2010/07/12,5,11,0.640163235,10782,5,4,7
31670,2014/03/31,2008/09/07,291,5,0.7715235859999999,8946,291,4,1
31671,2014/03/31,2011/10/07,58,8,0.852613959,8095,58,1,7
31672,2014/03/31,2009/12/24,149,7,0.7308238029999999,9444,149,4,3
31673,2014/03/31,2006/11/07,28,8,0.627490453,10998,28,4,4
31674,2014/03/31,2010/12/10,204,12,0.725833596,9507,204,4,8
31675,2014/03/31,2009/03/25,2,9,0.624308722,11052,2,2,7
31676,2014/03/31,2010/03/06,448,4,0.811705882,8500,448,4,0
31677,2014/03/31,2012/08/15,127,11,0.392602436,17572,127,6,5
31678,2014/03/31,2012/04/21,21,5,0.5592363810000001,12336,21,2,3
31679,2014/03/31,2010/03/10,169,8,0.5890283470000001,11712,169,5,3
31680,2014/03/31,2008/04/23,22,12,0.596977066,11555,22,2,10
31681,2014/03/31,2011/08/19,10,9,0.601596895,11466,10,0,9
31682,2014/03/31,2013/02/26,277,9,0.71523849,9644,277,4,5
31683,2014/03/31,2012/04/08,264,10,0.658344946,10477,264,8,2
31684,2014/03/31,2007/09/30,99,7,0.599050721,11514,99,5,2
31685,2014/03/31,2008/02/24,167,6,0.746023797,9245,167,4,2
31686,2014/03/31,2006/11/28,75,6,0.6257835039999999,11021,75,1,5
31687,2014/03/31,2011/05/31,39,10,0.85165473,8098,39,2,8
31688,2014/03/31,2013/01/23,2,7,0.827329655,8336,2,1,6
31689,2014/03/31,2010/09/30,247,6,0.6803887129999999,10136,247,3,3
31690,2014/03/31,2012/10/21,4,10,0.8364050940000001,8245,4,4,6
31691,2014/03/31,2012/07/21,194,6,0.707910892,9741,194,4,2
31692,2014/03/31,2012/01/15,76,5,0.6929675409999999,9951,76,2,3
31693,2014/03/31,2011/09/14,99,19,0.6904626009999999,9987,99,11,8
31694,2014/03/31,2008/02/06,57,12,0.640295292,10769,57,6,6
31695,2014/03/31,2011/09/27,187,5,0.712392809,9679,187,3,2
31696,2014/03/31,2012/07/16,16,8,0.658198396,10474,16,2,6
31697,2014/03/31,2011/10/01,7,17,0.54409708,12670,7,3,14
31698,2014/03/31,2007/12/06,16,6,0.7754798070000001,8889,16,1,5
31699,2014/03/31,2005/07/19,15,10,0.5986217979999999,11515,15,4,6
31700,2014/03/31,2011/09/12,44,6,0.744222006,9261,44,3,3
31701,2014/03/31,2010/11/15,333,6,0.752171778,9163,333,2,4
31702,2014/03/31,2012/05/11,123,3,1.468287175,4694,123,2,1
31703,2014/03/31,2009/10/05,186,8,0.710799299,9696,186,7,1
31704,2014/03/31,2011/05/27,407,5,0.659638208,10448,407,5,0
31705,2014/03/31,2009/08/12,557,5,1.1851418740000002,5815,557,5,0
31706,2014/03/31,2013/01/30,43,10,0.6349765039999999,10853,43,4,6
31707,2014/03/31,2012/07/23,127,8,0.7574455920000001,9098,127,4,4
31708,2014/03/31,2012/06/10,148,7,0.645087999,10682,148,2,5
31709,2014/03/31,2008/12/08,197,6,0.7827638309999999,8803,197,3,3
31710,2014/03/31,2013/01/11,120,6,0.695386013,9909,120,1,5
31711,2014/03/31,2012/06/01,115,6,0.791011365,8711,115,2,4
31712,2014/03/31,2011/03/23,74,8,0.669361764,10294,74,5,3
31713,2014/03/31,2012/09/12,149,8,0.693907745,9929,149,7,1
31714,2014/03/31,2009/02/10,69,7,0.921709699,7475,69,3,4
31715,2014/03/31,2011/05/09,121,11,0.6211404620000001,11092,121,4,7
31716,2014/03/31,2007/09/18,153,8,0.961814882,7163,153,6,2
31717,2014/03/31,2005/12/12,224,11,0.602473983,11435,224,5,6
31718,2014/03/31,2012/09/13,38,6,0.982543146,7011,38,4,2
31719,2014/03/31,2012/08/07,584,4,0.912357616,7550,584,4,0
31720,2014/03/31,2012/05/30,164,9,0.6977522290000001,9872,164,4,5
31721,2014/03/31,2011/11/18,18,13,0.49315194,13966,18,6,7
31722,2014/03/31,2008/07/07,98,13,0.5660874570000001,12166,98,8,5
31723,2014/03/31,2009/09/24,241,6,0.578527386,11904,241,5,1
31724,2014/03/31,2009/02/07,421,8,0.7096084490000001,9705,421,8,0
31725,2014/03/31,2008/05/31,361,7,1.295954084,5314,361,6,1
31726,2014/03/31,2011/10/13,118,5,0.813891975,8461,118,2,3
31727,2014/03/31,2007/04/26,75,8,0.911372419,7556,75,3,5
31728,2014/03/31,2010/11/15,110,4,0.881949283,7808,110,1,3
31729,2014/03/31,2011/10/09,9,14,0.381903943,18031,9,1,13
31730,2014/03/31,2012/06/19,77,22,0.554022045,12429,77,5,17
31731,2014/03/31,2012/11/09,248,7,0.946348268,7276,248,4,3
31732,2014/03/31,2010/05/16,71,8,0.591041202,11650,71,3,5
31733,2014/03/31,2012/05/12,121,7,0.728789162,9448,121,4,3
31734,2014/03/31,2008/05/18,120,6,0.599399321,11487,120,3,3
31735,2014/03/31,2011/02/01,147,8,0.7636982809999999,9015,147,5,3
31736,2014/03/31,2012/03/13,111,8,0.4575,15048,111,3,5
31737,2014/03/31,2008/03/03,304,5,0.8433627340000001,8163,304,4,1
31738,2014/03/31,2012/08/14,206,4,0.8108775029999999,8490,206,2,2
31739,2014/03/31,2007/07/23,6,5,0.602,11435,6,2,3
31740,2014/03/31,2011/01/13,80,10,0.552762387,12453,80,5,5
31741,2014/03/31,2009/03/17,5,7,0.706018053,9749,5,4,3
31742,2014/03/31,2011/07/04,32,9,0.70526181,9759,32,2,7
31743,2014/03/31,2012/10/18,39,11,0.737650589,9330,39,1,10
31744,2014/03/31,2012/10/19,15,6,0.629317849,10936,15,3,3
31745,2014/03/31,2009/05/13,285,12,0.8731349909999999,7882,285,10,2
31746,2014/03/31,2013/02/08,1,9,0.721765076,9535,1,3,6
31747,2014/03/31,2006/08/30,68,8,0.641324324,10730,68,2,6
31748,2014/03/31,2006/06/01,238,9,0.582272997,11817,238,6,3
31749,2014/03/31,2012/11/12,30,9,0.5137512129999999,13393,30,4,5
31750,2014/03/31,2012/10/14,22,6,0.7269822490000001,9464,22,3,3
31751,2014/03/31,2007/12/08,142,5,0.682360643,10082,142,2,3
31752,2014/03/31,2009/11/13,307,7,0.747343835,9205,307,5,2
31753,2014/03/31,2010/05/01,42,6,0.526298676,13071,42,1,5
31754,2014/03/31,2010/11/17,508,6,0.660606934,10413,508,6,0
31755,2014/03/31,2011/11/22,126,3,1.366206554,5035,126,0,3
31756,2014/03/31,2012/09/10,72,8,0.511983625,13435,72,6,2
31757,2014/03/31,2013/02/27,176,7,0.7142575290000001,9630,176,1,6
31758,2014/03/31,2012/10/27,296,7,0.74710189,9206,296,5,2
31759,2014/03/31,2013/02/20,145,4,0.7973348020000001,8626,145,2,2
31760,2014/03/31,2009/11/27,185,6,0.724662803,9490,185,3,3
31761,2014/03/31,2011/02/09,194,6,0.7103357090000001,9681,194,4,2
31762,2014/03/31,2013/03/10,20,7,0.514851752,13356,20,2,5
31763,2014/03/31,2011/09/03,230,12,0.657187649,10461,230,8,4
31764,2014/03/31,2011/07/06,562,3,1.5,4583,562,3,0
31765,2014/03/31,2013/01/24,5,6,0.599297297,11470,5,2,4
31766,2014/03/31,2012/12/06,36,10,0.6052188079999999,11357,36,2,8
31767,2014/03/31,2011/04/17,108,6,0.791498158,8684,108,4,2
31768,2014/03/31,2011/10/18,506,12,0.8150735290000001,8432,506,12,0
31769,2014/03/31,2011/04/06,315,7,0.71425899,9622,315,5,2
31770,2014/03/31,2012/08/11,103,6,0.851514063,8071,103,5,1
31771,2014/03/31,2012/04/05,701,3,1.432964971,4796,701,3,0
31772,2014/03/31,2011/06/10,292,6,0.831670096,8263,292,3,3
31773,2014/03/31,2008/06/24,148,8,0.5501449039999999,12491,148,2,6
31774,2014/03/31,2008/10/06,487,2,1.3,5286,487,2,0
31775,2014/03/31,2010/09/15,6,12,0.815823341,8423,6,5,7
31776,2014/03/31,2011/10/08,295,11,0.727430658,9446,295,9,2
31777,2014/03/31,2008/08/05,92,3,0.904351145,7598,92,0,3
31778,2014/03/31,2007/11/12,281,7,0.559486198,12281,281,6,1
31779,2014/03/31,2007/11/06,46,4,1.336653696,5140,46,0,4
31780,2014/03/31,2011/01/13,87,6,0.75865614,9056,87,3,3
31781,2014/03/31,2013/03/25,140,7,0.7911354209999999,8684,140,1,6
31782,2014/03/31,2012/01/08,492,7,0.814089347,8439,492,7,0
31783,2014/03/31,2005/09/09,407,4,0.758110792,9062,407,4,0
31784,2014/03/31,2011/03/31,13,9,0.729756745,9414,13,4,5
31785,2014/03/31,2013/01/24,18,14,0.637508352,10776,18,0,14
31786,2014/03/31,2006/11/14,620,5,0.646302221,10628,620,5,0
31787,2014/03/31,2011/04/10,9,7,0.786793814,8730,9,2,5
31788,2014/03/31,2009/06/25,600,8,0.85766829,8007,600,8,0
31789,2014/03/31,2011/09/14,517,8,0.654998092,10484,517,8,0
31790,2014/03/31,2012/07/25,468,3,0.671990605,10218,468,3,0
31791,2014/03/31,2008/08/17,241,4,0.953390725,7202,241,1,3
31792,2014/03/31,2009/01/01,77,7,0.839124908,8182,77,4,3
31793,2014/03/31,2013/03/08,102,9,0.867504423,7914,102,2,7
31794,2014/03/31,2006/03/22,12,12,0.645,10644,12,0,12
31795,2014/03/31,2009/04/18,41,8,0.925975182,7414,41,5,3
31796,2014/03/31,2009/01/15,235,7,0.86634528,7924,235,5,2
31797,2014/03/31,2012/11/20,158,5,0.698,9835,158,2,3
31798,2014/03/31,2012/09/17,13,9,0.6422866770000001,10688,13,6,3
31799,2014/03/31,2012/08/14,63,6,0.8148658590000001,8424,63,1,5
31800,2014/03/31,2010/09/22,257,8,0.746982261,9189,257,6,2
31801,2014/03/31,2011/10/19,426,6,0.821445668,8356,426,6,0
31802,2014/03/31,2011/01/18,200,4,0.977587238,7021,200,2,2
31803,2014/03/31,2012/07/24,181,6,0.600124158,11437,181,3,3
31804,2014/03/31,2012/04/07,5,7,0.6899447129999999,9948,5,1,6
31805,2014/03/31,2012/04/04,462,15,0.450196786,15245,462,15,0
31806,2014/03/31,2012/11/27,49,5,0.744617555,9217,49,2,3
31807,2014/03/31,2005/12/07,67,5,0.887905292,7729,67,1,4
31808,2014/03/31,2007/07/07,75,4,0.801326483,8564,75,1,3
31809,2014/03/31,2013/02/05,58,3,0.7333333329999999,9357,58,0,3
31810,2014/03/31,2010/05/30,211,6,0.977848083,7017,211,3,3
31811,2014/03/31,2006/01/19,339,6,0.913283642,7513,339,5,1
31812,2014/03/31,2012/09/20,197,7,0.566952318,12101,197,4,3
31813,2014/03/31,2008/12/17,309,7,0.7,9800,309,5,2
31814,2014/03/31,2012/02/22,165,3,0.65988456,10395,165,1,2
31815,2014/03/31,2008/01/10,129,7,0.503367579,13627,129,1,6
31816,2014/03/31,2006/07/15,98,9,0.998888889,6867,98,4,5
31817,2014/03/31,2007/01/08,118,12,0.754210468,9094,118,3,9
31818,2014/03/31,2012/03/03,368,3,0.769084997,8918,368,3,0
31819,2014/03/31,2008/06/16,249,7,0.66685142,10284,249,0,7
31820,2014/03/31,2012/08/28,117,7,0.584590402,11731,117,5,2
31821,2014/03/31,2012/07/20,264,2,0.55,12468,264,0,2
31822,2014/03/31,2012/07/28,611,3,0.83298105,8232,611,3,0
31823,2014/03/31,2010/09/30,132,5,0.80674197,8499,132,1,4
31824,2014/03/31,2012/08/27,296,7,0.507678638,13505,296,3,4
31825,2014/03/31,2006/03/28,358,7,0.63449329,10805,358,6,1
31826,2014/03/31,2009/08/27,178,11,0.550012837,12464,178,10,1
31827,2014/03/31,2011/05/02,545,2,1.5,4570,545,2,0
31828,2014/03/31,2008/12/17,495,3,1.4349801130000002,4777,495,3,0
31829,2014/03/31,2004/12/08,480,5,0.66,10385,480,5,0
31830,2014/03/31,2010/11/10,1,4,0.825,8308,1,2,2
31831,2014/03/31,2012/09/10,536,5,0.66,10385,536,5,0
31832,2014/03/31,2012/06/13,256,5,0.541174891,12665,256,2,3
31833,2014/03/31,2012/03/27,302,7,0.648221886,10573,302,5,2
31834,2014/03/31,2011/10/05,92,4,0.621751951,11022,92,2,2
31835,2014/03/31,2012/12/23,126,8,0.652778624,10498,126,2,6
31836,2014/03/31,2013/03/10,189,8,0.678808321,10095,189,1,7
31837,2014/03/31,2012/06/12,226,7,0.9651,7100,226,6,1
31838,2014/03/31,2006/02/01,122,10,0.521496309,13139,122,3,7
31839,2014/03/31,2011/11/21,24,8,0.472003307,14516,24,3,5
31840,2014/03/31,2006/08/10,58,9,0.709995855,9650,58,3,6
31841,2014/03/31,2011/07/16,11,7,0.496944223,13787,11,1,6
31842,2014/03/31,2010/11/08,38,11,0.577740766,11858,38,1,10
31843,2014/03/31,2008/07/01,167,6,0.7153467,9576,167,5,1
31844,2014/03/31,2005/08/27,199,6,0.58308046,11745,199,2,4
31845,2014/03/31,2006/08/29,479,5,0.79777493,8584,479,5,0
31846,2014/03/31,2012/10/22,89,7,0.7240241070000001,9458,89,2,5
31847,2014/03/31,2011/10/21,313,8,0.756239647,9055,313,6,2
31848,2014/03/31,2008/09/01,235,9,0.908877091,7534,235,7,2
31849,2014/03/31,2008/09/20,192,11,0.63387706,10802,192,5,6
31850,2014/03/31,2008/10/13,331,10,0.513804878,13325,331,7,3
31851,2014/03/31,2008/08/09,205,8,0.953448468,7180,205,6,2
31852,2014/03/31,2012/02/21,169,7,0.78703725,8698,169,5,2
31853,2014/03/31,2012/10/23,61,8,0.506808826,13506,61,2,6
31854,2014/03/31,2011/12/06,262,4,0.7844699140000001,8725,262,1,3
31855,2014/03/31,2010/05/18,387,7,0.912965186,7497,387,7,0
31856,2014/03/31,2008/12/28,8,10,0.826213182,8284,8,4,6
31857,2014/03/31,2009/06/24,7,11,0.684835902,9994,7,9,2
31858,2014/03/31,2008/08/17,409,4,0.720804804,9493,409,4,0
31859,2014/03/31,2010/07/24,233,6,0.6977717720000001,9806,233,5,1
31860,2014/03/31,2010/06/11,173,9,0.676783383,10110,173,3,6
31861,2014/03/31,2013/03/10,49,5,0.801102915,8541,49,0,5
31862,2014/03/31,2012/08/02,419,10,0.773217313,8849,419,10,0
31863,2014/03/31,2010/10/25,180,9,0.628378031,10888,180,5,4
31864,2014/03/31,2011/08/01,295,9,0.581111111,11772,295,6,3
31865,2014/03/31,2007/11/24,76,10,0.686280096,9968,76,4,6
31866,2014/03/31,2011/04/25,230,8,0.65375,10464,230,6,2
31867,2014/03/31,2010/11/15,167,11,0.665567231,10278,167,4,7
31868,2014/03/31,2008/01/23,78,5,0.627927299,10894,78,0,5
31869,2014/03/31,2009/10/01,383,10,0.756185054,9046,383,10,0
31870,2014/03/31,2004/11/18,1,8,0.641618047,10661,1,4,4
31871,2014/03/31,2012/06/14,66,9,0.7591587129999999,9010,66,1,8
31872,2014/03/31,2009/09/05,78,5,0.67554963,10125,78,3,2
31873,2014/03/31,2008/07/26,4,6,0.532367684,12848,4,0,6
31874,2014/03/31,2012/06/22,162,9,0.564143847,12124,162,4,5
31875,2014/03/31,2010/10/14,81,15,0.5261215379999999,13000,81,7,8
31876,2014/03/31,2012/04/28,177,6,0.838073765,8161,177,5,1
31877,2014/03/31,2012/05/06,401,10,0.54918895,12453,401,10,0
31878,2014/03/31,2011/03/07,27,7,0.675243409,10127,27,4,3
31879,2014/03/31,2008/02/03,47,8,0.717812303,9526,47,4,4
31880,2014/03/31,2009/02/09,82,13,0.685443609,9975,82,6,7
31881,2014/03/31,2005/07/28,6,10,0.658264009,10386,6,0,10
31882,2014/03/31,2007/04/24,114,8,0.810078218,8438,114,5,3
31883,2014/03/31,2008/04/20,25,22,0.464286102,14722,25,13,9
31884,2014/03/31,2012/07/25,234,13,0.725063117,9427,234,1,12
31885,2014/03/31,2008/01/06,149,2,0.8480322579999999,8060,149,0,2
31886,2014/03/31,2009/06/01,331,6,0.854576144,7998,331,5,1
31887,2014/03/31,2010/04/13,63,4,0.849597215,8044,63,0,4
31888,2014/03/31,2012/02/23,26,4,0.664519642,10284,26,0,4
31889,2014/03/31,2010/01/20,35,5,0.87,7855,35,3,2
31890,2014/03/31,2011/04/15,643,5,0.6899636509999999,9904,643,5,0
31891,2014/03/31,2011/05/17,61,7,0.564700826,12100,61,2,5
31892,2014/03/31,2006/11/17,211,11,0.63801382,10709,211,8,3
31893,2014/03/31,2006/03/20,96,8,0.440551973,15508,96,5,3
31894,2014/03/31,2011/04/07,154,11,0.651440015,10486,154,10,1
31895,2014/03/31,2006/11/30,92,15,1.345626478,5076,92,9,6
31896,2014/03/31,2009/04/01,88,14,0.8015702379999999,8521,88,8,6
31897,2014/03/31,2008/09/28,56,7,0.774264823,8821,56,0,7
31898,2014/03/31,2012/01/05,72,7,0.877257547,7785,72,2,5
31899,2014/03/31,2012/07/13,445,4,0.870313496,7847,445,4,0
31900,2014/03/31,2007/11/01,319,8,0.8281045359999999,8246,319,7,1
31901,2014/03/31,2011/11/25,165,4,0.61807748,11048,165,0,4
31902,2014/03/31,2005/12/10,237,8,0.7394606890000001,9234,237,3,5
31903,2014/03/31,2011/12/05,436,6,0.6684893279999999,10214,436,6,0
31904,2014/03/31,2010/04/20,273,10,0.915988731,7454,273,8,2
31905,2014/03/31,2011/09/13,254,7,0.614393053,11113,254,4,3
31906,2014/03/31,2011/08/03,46,8,0.606470954,11258,46,5,3
31907,2014/03/31,2007/07/06,125,4,0.870829082,7840,125,0,4
31908,2014/03/31,2010/03/26,330,7,0.653830684,10442,330,6,1
31909,2014/03/31,2012/02/21,129,3,0.8922781340000001,7651,129,1,2
31910,2014/03/31,2006/06/23,18,3,0.82624062,8262,18,1,2
31911,2014/03/31,2009/03/19,251,6,0.720673564,9472,251,1,5
31912,2014/03/31,2011/10/05,316,8,0.801079685,8521,316,7,1
31913,2014/03/31,2005/01/28,398,3,0.592602882,11518,398,3,0
31914,2014/03/31,2011/01/05,210,4,0.8675,7868,210,2,2
31915,2014/03/31,2007/07/06,99,5,0.7664723720000001,8904,99,0,5
31916,2014/03/31,2007/08/09,44,5,0.581240099,11741,44,0,5
31917,2014/03/31,2008/02/04,7,7,0.599973624,11374,7,6,1
31918,2014/03/31,2007/04/12,57,9,0.79925978,8538,57,7,2
31919,2014/03/31,2012/08/14,589,2,1.0,6824,589,2,0
31920,2014/03/31,2008/11/30,380,6,0.839329643,8130,380,6,0
31921,2014/03/31,2010/08/08,4,6,0.554485617,12306,4,1,5
31922,2014/03/31,2013/01/29,102,4,0.8989552040000001,7590,102,1,3
31923,2014/03/31,2011/09/21,351,7,0.715623033,9534,351,6,1
31924,2014/03/31,2006/09/20,167,5,0.7602640959999999,8974,167,2,3
31925,2014/03/31,2007/10/30,145,6,0.6216967379999999,10974,145,4,2
31926,2014/03/31,2010/05/22,137,7,0.7688910179999999,8873,137,2,5
31927,2014/03/31,2011/07/21,76,8,0.760996096,8965,76,6,2
31928,2014/03/31,2006/12/01,8,10,0.568196052,12007,8,4,6
31929,2014/03/31,2005/04/02,210,7,1.0183728909999998,6699,210,4,3
31930,2014/03/31,2011/01/04,4,6,0.821540222,8304,4,2,4
31931,2014/03/31,2012/07/18,181,5,0.819086215,8328,181,4,1
31932,2014/03/31,2008/04/18,3,8,0.6692415620000001,10192,3,1,7
31933,2014/03/31,2007/04/30,226,3,0.8,8526,226,0,3
31934,2014/03/31,2010/01/08,74,10,0.472248148,14443,74,4,6
31935,2014/03/31,2006/10/02,584,10,0.701909025,9717,584,10,0
31936,2014/03/31,2006/08/31,284,7,0.8533833829999999,7992,284,5,2
31937,2014/03/31,2005/11/14,391,4,0.709089018,9616,391,4,0
31938,2014/03/31,2011/07/11,126,8,0.70275201,9702,126,4,4
31939,2014/03/31,2007/04/08,132,9,0.553213242,12324,132,4,5
31940,2014/03/31,2012/06/06,13,6,0.920194358,7409,13,5,1
31941,2014/03/31,2007/09/09,53,8,0.802082353,8500,53,3,5
31942,2014/03/31,2008/01/12,340,5,1.4397676869999998,4735,340,4,1
31943,2014/03/31,2008/12/13,170,6,0.88074677,7740,170,1,5
31944,2014/03/31,2012/05/15,36,8,0.598691375,11386,36,0,8
31945,2014/03/31,2012/08/17,223,8,0.911172303,7481,223,1,7
31946,2014/03/31,2012/03/05,195,5,0.7794259579999999,8745,195,4,1
31947,2014/03/31,2010/05/19,5,9,0.786704755,8664,5,2,7
31948,2014/03/31,2008/10/28,300,5,0.863659402,7892,300,4,1
31949,2014/03/31,2005/10/26,19,9,0.848285003,8035,19,0,9
31950,2014/03/31,2007/07/13,331,7,0.62882646,10839,331,5,2
31951,2014/03/31,2008/06/29,138,4,0.5225,13044,138,2,2
31952,2014/03/31,2010/04/04,566,5,0.671230178,10153,566,5,0
31953,2014/03/31,2006/09/06,423,7,0.731472735,9316,423,7,0
31954,2014/03/31,2012/05/02,89,14,0.446135664,15273,89,11,3
31955,2014/03/31,2010/04/16,37,10,0.667015861,10214,37,5,5
31956,2014/03/31,2006/03/28,149,3,0.700199404,9729,149,0,3
31957,2014/03/31,2011/06/05,177,7,0.8080225390000001,8430,177,6,1
31958,2014/03/31,2011/08/31,216,9,0.579652766,11750,216,6,3
31959,2014/03/31,2008/04/01,600,5,0.8686264509999999,7841,600,5,0
31960,2014/03/31,2013/02/14,112,10,0.57061416,11935,112,0,10
31961,2014/03/31,2012/11/05,122,7,0.632200149,10772,122,3,4
31962,2014/03/31,2008/09/13,7,8,0.782858128,8698,7,0,8
31963,2014/03/31,2012/07/15,263,6,0.753559097,9036,263,4,2
31964,2014/03/31,2009/03/01,1,6,0.5938735279999999,11465,1,3,3
31965,2014/03/31,2013/01/22,194,6,0.8650304959999999,7870,194,2,4
31966,2014/03/31,2008/08/01,104,4,0.98634164,6902,104,2,2
31967,2014/03/31,2009/09/06,18,13,0.5462590270000001,12462,18,0,13
31968,2014/03/31,2008/12/11,348,6,0.614663657,11075,348,5,1
31969,2014/03/31,2011/03/04,28,7,0.825814631,8243,28,3,4
31970,2014/03/31,2008/10/18,171,6,0.8027750909999999,8479,171,3,3
31971,2014/03/31,2007/03/22,201,10,0.7150120809999999,9519,201,4,6
31972,2014/03/31,2010/09/01,278,4,0.701509998,9702,278,2,2
31973,2014/03/31,2011/12/11,60,10,0.8618234770000001,7897,60,2,8
31974,2014/03/31,2008/01/24,11,4,0.877322418,7757,11,0,4
31975,2014/03/31,2013/01/01,6,7,0.582820315,11676,6,0,7
31976,2014/03/31,2011/01/13,6,9,0.662155508,10276,6,2,7
31977,2014/03/31,2011/01/13,16,12,0.717662694,9481,16,0,12
31978,2014/03/31,2007/10/10,128,8,0.6075,11200,128,6,2
31979,2014/03/31,2012/12/22,80,8,0.633040566,10748,80,2,6
31980,2014/03/31,2013/01/10,72,7,0.459195519,14817,72,6,1
31981,2014/03/31,2008/07/16,103,5,1.297878672,5242,103,1,4
31982,2014/03/31,2010/11/07,135,7,0.775601414,8771,135,4,3
31983,2014/03/31,2009/10/30,81,8,0.733683132,9272,81,2,6
31984,2014/03/31,2010/12/19,89,10,0.6996842209999999,9722,89,4,6
31985,2014/03/31,2011/08/20,45,7,0.878704302,7741,45,4,3
31986,2014/03/31,2008/12/09,145,8,0.631750116,10765,145,5,3
31987,2014/03/31,2011/05/24,290,7,0.687141558,9897,290,5,2
31988,2014/03/31,2013/02/12,121,10,0.576322034,11800,121,2,8
31989,2014/03/31,2005/03/29,22,7,0.71327145,9534,22,3,4
31990,2014/03/31,2011/12/11,261,9,0.738737643,9205,261,8,1
31991,2014/03/31,2010/11/04,24,6,0.765257709,8886,24,5,1
31992,2014/03/31,2013/03/13,183,8,0.370770992,18340,183,3,5
31993,2014/03/31,2008/08/30,64,7,0.574540769,11835,64,3,4
31994,2014/03/31,2013/03/29,346,2,0.781943646,8695,346,0,2
31995,2014/03/31,2010/04/08,4,7,0.683723854,9944,4,0,7
31996,2014/03/31,2012/06/26,316,9,0.616275381,11032,316,7,2
31997,2014/03/31,2012/09/21,20,9,0.617661488,11007,20,0,9
31998,2014/03/31,2011/03/23,357,5,0.770280988,8826,357,3,2
31999,2014/03/31,2012/06/26,154,8,0.668477726,10169,154,2,6
32000,2014/03/31,2009/01/20,12,13,0.80173272,8478,12,5,8
32001,2014/03/31,2005/04/26,32,6,0.776710857,8750,32,2,4
32002,2014/03/31,2011/11/03,130,6,0.8162990990000001,8325,130,5,1
32003,2014/03/31,2006/12/07,95,7,0.551398896,12324,95,2,5
32004,2014/03/31,2008/04/30,132,12,0.6762814770000001,10047,132,6,6
32005,2014/03/31,2011/06/21,331,8,0.73165518,9286,331,7,1
32006,2014/03/31,2011/04/11,266,9,0.571527719,11887,266,8,1
32007,2014/03/31,2007/02/12,106,9,0.503387934,13492,106,3,6
32008,2014/03/31,2005/07/01,188,9,0.525288112,12929,188,6,3
32009,2014/03/31,2007/03/20,186,6,0.635580721,10685,186,5,1
32010,2014/03/31,2013/01/16,262,8,0.844631841,8040,262,1,7
32011,2014/03/31,2012/01/03,160,6,0.6293595329999999,10789,160,3,3
32012,2014/03/31,2010/02/19,399,4,0.838271605,8100,399,4,0
32013,2014/03/31,2011/11/24,123,6,0.604711436,11228,123,3,3
32014,2014/03/31,2012/01/11,47,7,0.8036695079999999,8448,47,3,4
32015,2014/03/31,2010/03/10,594,7,0.7167388090000001,9472,594,7,0
32016,2014/03/31,2011/11/03,248,8,0.731063967,9286,248,4,4
32017,2014/03/31,2006/03/22,628,4,0.5399538660000001,12572,628,4,0
32018,2014/03/31,2010/06/24,126,10,0.8233871159999999,8243,126,6,4
32019,2014/03/31,2006/08/26,400,6,0.7948354609999999,8539,400,6,0
32020,2014/03/31,2013/03/15,102,12,0.581881859,11664,102,1,11
32021,2014/03/31,2010/08/01,28,9,0.758412113,8949,28,1,8
32022,2014/03/31,2011/08/03,7,15,0.609014628,11143,7,7,8
32023,2014/03/31,2011/09/08,176,10,0.47822891,14189,176,7,3
32024,2014/03/31,2009/11/04,529,6,0.686076845,9890,529,6,0
32025,2014/03/31,2006/09/05,174,4,0.6625625,10240,174,1,3
32026,2014/03/31,2011/05/15,77,7,0.689057485,9846,77,3,4
32027,2014/03/31,2007/10/07,212,7,0.7343942840000001,9237,212,4,3
32028,2014/03/31,2011/08/22,427,2,1.05,6460,427,2,0
32029,2014/03/31,2008/08/28,276,2,1.05,6460,276,0,2
32030,2014/03/31,2010/10/20,2,14,0.552131054,12285,2,7,7
32031,2014/03/31,2012/07/25,248,5,0.6201179370000001,10938,248,3,2
32032,2014/03/31,2011/04/12,77,14,0.508527515,13338,77,13,1
32033,2014/03/31,2011/01/15,346,4,0.6493441839999999,10445,346,3,1
32034,2014/03/31,2009/11/08,120,13,0.6794269690000001,9982,120,6,7
32035,2014/03/31,2010/11/11,237,11,0.534634608,12685,237,10,1
32036,2014/03/31,2012/12/07,84,3,1.27,5340,84,1,2
32037,2014/03/31,2012/05/02,25,9,0.751030014,9029,25,2,7
32038,2014/03/31,2012/04/25,530,6,0.710935207,9538,530,6,0
32039,2014/03/31,2009/08/09,113,6,0.6659542279999999,10181,113,4,2
32040,2014/03/31,2011/07/01,107,6,0.54646139,12406,107,4,2
32041,2014/03/31,2007/07/08,18,10,0.727251368,9321,18,2,8
32042,2014/03/31,2007/08/26,82,5,0.929569391,7292,82,1,4
32043,2014/03/31,2011/01/14,49,7,0.851323788,7962,49,4,3
32044,2014/03/31,2011/03/04,113,6,0.6860475709999999,9880,113,2,4
32045,2014/03/31,2012/08/20,177,10,0.468170201,14477,177,5,5
32046,2014/03/31,2010/09/22,107,10,0.7407278690000001,9150,107,5,5
32047,2014/03/31,2012/09/14,266,4,0.717778013,9442,266,1,3
32048,2014/03/31,2004/11/13,56,8,0.82287154,8236,56,2,6
32049,2014/03/31,2010/03/20,10,7,0.7640450959999999,8870,10,0,7
32050,2014/03/31,2006/05/23,159,7,0.82249909,8239,159,2,5
32051,2014/03/31,2012/08/28,117,8,0.7677520959999999,8826,117,3,5
32052,2014/03/31,2012/09/11,187,7,0.8439618879999999,8029,187,1,6
32053,2014/03/31,2009/11/04,174,8,0.642468949,10547,174,7,1
32054,2014/03/31,2013/01/12,46,7,0.568230311,11923,46,1,6
32055,2014/03/31,2013/02/12,328,2,1.25,5420,328,1,1
32056,2014/03/31,2012/02/23,21,10,0.505165909,13411,21,7,3
32057,2014/03/31,2011/06/12,109,3,0.6754941659999999,10027,109,0,3
32058,2014/03/31,2006/08/02,1,12,0.613263606,11043,1,6,6
32059,2014/03/31,2010/12/07,227,9,0.6907180740000001,9804,227,4,5
32060,2014/03/31,2005/11/27,25,12,0.828303364,8175,25,0,12
32061,2014/03/31,2010/06/17,583,4,0.882905203,7669,583,4,0
32062,2014/03/31,2012/12/24,97,6,0.6131669989999999,11042,97,2,4
32063,2014/03/31,2009/09/07,93,3,0.779820318,8682,93,0,3
32064,2014/03/31,2012/05/06,182,5,0.947286974,7147,182,4,1
32065,2014/03/31,2010/08/14,534,4,0.825,8206,534,4,0
32066,2014/03/31,2011/01/23,253,2,1.41,4801,253,0,2
32067,2014/03/31,2012/12/13,343,7,0.8797374579999999,7694,343,5,2
32068,2014/03/31,2011/12/13,454,5,0.6759862179999999,10013,454,5,0
32069,2014/03/31,2005/09/22,95,6,0.621886255,10884,95,0,6
32070,2014/03/31,2012/03/08,654,8,0.617818348,10955,654,8,0
32071,2014/03/31,2011/09/11,636,5,0.73271625,9237,636,5,0
32072,2014/03/31,2008/03/11,100,8,0.5575113270000001,12139,100,5,3
32073,2014/03/31,2010/08/11,31,4,0.7762629040000001,8718,31,0,4
32074,2014/03/31,2007/11/18,327,5,1.34,5050,327,2,3
32075,2014/03/31,2008/02/05,9,9,0.529953008,12768,9,4,5
32076,2014/03/31,2011/09/01,326,7,0.591304728,11443,326,4,3
32077,2014/03/31,2011/06/03,24,9,0.770989061,8776,24,0,9
32078,2014/03/31,2012/01/05,6,7,0.689225833,9817,6,2,5
32079,2014/03/31,2006/04/12,76,7,0.737836423,9170,76,0,7
32080,2014/03/31,2010/07/04,80,4,0.905732262,7470,80,0,4
32081,2014/03/31,2012/09/01,196,6,0.780902585,8664,196,2,4
32082,2014/03/31,2005/12/12,15,4,0.7234392040000001,9351,15,2,2
32083,2014/03/31,2012/07/04,286,11,0.605769679,11167,286,9,2
32084,2014/03/31,2012/12/30,229,4,0.745470575,9074,229,2,2
32085,2014/03/31,2013/01/02,46,8,0.6308841629999999,10722,46,1,7
32086,2014/03/31,2011/01/27,413,9,0.8807617190000001,7680,413,9,0
32087,2014/03/31,2012/08/17,212,5,0.476,14210,212,3,2
32088,2014/03/31,2007/01/06,647,2,0.768531985,8801,647,2,0
32089,2014/03/31,2012/10/13,471,6,0.5411578779999999,12497,471,6,0
32090,2014/03/31,2013/01/24,344,9,0.893834259,7566,344,6,3
32091,2014/03/31,2009/03/20,51,9,0.469754776,14395,51,6,3
32092,2014/03/31,2007/06/11,39,9,0.7381386459999999,9160,39,5,4
32093,2014/03/31,2011/04/20,288,7,0.47,14385,288,5,2
32094,2014/03/31,2007/05/23,162,9,0.529474467,12768,162,6,3
32095,2014/03/31,2011/06/12,128,5,0.749883527,9015,128,2,3
32096,2014/03/31,2008/01/18,15,10,0.7182384190000001,9412,15,0,10
32097,2014/03/31,2011/07/29,501,4,0.600239744,11262,501,4,0
32098,2014/03/31,2011/08/11,21,8,0.6355566,10636,21,5,3
32099,2014/03/31,2009/07/25,2,7,0.56139025,12041,2,3,4
32100,2014/03/31,2012/11/26,213,5,0.662904776,10197,213,1,4
32101,2014/03/31,2011/06/05,141,9,0.408017143,16567,141,3,6
32102,2014/03/31,2009/12/28,6,7,0.576822294,11716,6,2,5
32103,2014/03/31,2010/05/23,146,3,0.891077268,7584,146,0,3
32104,2014/03/31,2007/05/27,144,5,0.8232013640000001,8209,144,4,1
32105,2014/03/31,2011/06/29,36,13,0.551930899,12243,36,5,8
32106,2014/03/31,2011/02/25,18,6,0.570993747,11834,18,1,5
32107,2014/03/31,2011/08/19,87,10,0.495310805,13642,87,4,6
32108,2014/03/31,2006/12/18,25,11,0.769804011,8776,25,6,5
32109,2014/03/31,2007/07/16,2,14,0.487417749,13860,2,4,10
32110,2014/03/31,2006/08/24,523,3,0.8803231690000001,7674,523,3,0
32111,2014/03/31,2010/01/18,347,9,0.8022325140000001,8421,347,8,1
32112,2014/03/31,2011/12/14,194,11,0.547177576,12344,194,7,4
32113,2014/03/31,2005/01/06,1,7,0.650582852,10380,1,4,3
32114,2014/03/31,2011/04/30,69,8,0.65327271,10337,69,3,5
32115,2014/03/31,2011/11/09,172,9,0.590594718,11434,172,4,5
32116,2014/03/31,2011/03/09,173,11,0.591313485,11420,173,7,4
32117,2014/03/31,2012/03/28,32,3,0.59212557,11404,32,0,3
32118,2014/03/31,2012/03/28,32,3,0.59212557,11404,32,0,3
32119,2014/03/31,2011/02/07,73,8,0.8661313490000001,7796,73,2,6
32120,2014/03/31,2013/02/10,225,3,0.91173913,7406,225,1,2
32121,2014/03/31,2012/12/13,23,6,0.553766915,12193,23,4,2
32122,2014/03/31,2008/08/18,498,5,1.229424618,5492,498,5,0
32123,2014/03/31,2009/12/05,344,5,1.0,6752,344,4,1
32124,2014/03/31,2009/11/11,13,4,0.7469001000000001,9039,13,0,4
32125,2014/03/31,2011/01/20,8,20,0.5820000000000001,11600,8,9,11
32126,2014/03/31,2011/07/30,110,7,0.5998889279999999,11254,110,6,1
32127,2014/03/31,2010/03/23,44,7,0.893711941,7554,44,3,4
32128,2014/03/31,2010/06/21,199,4,0.859966879,7850,199,2,2
32129,2014/03/31,2013/02/15,15,9,0.672505479,10038,15,2,7
32130,2014/03/31,2011/09/12,274,4,0.961187527,7023,274,3,1
32131,2014/03/31,2006/08/05,29,4,0.8125,8308,29,0,4
32132,2014/03/31,2009/04/11,70,11,0.599162894,11265,70,5,6
32133,2014/03/31,2012/06/06,266,11,0.719641753,9379,266,9,2
32134,2014/03/31,2012/07/02,44,12,0.521616169,12938,44,8,4
32135,2014/03/31,2007/10/27,129,6,0.79694615,8468,129,3,3
32136,2014/03/31,2012/10/26,31,8,0.72007149,9372,31,3,5
32137,2014/03/31,2007/03/08,470,8,0.794103107,8496,470,8,0
32138,2014/03/31,2012/01/01,35,12,0.470311607,14345,35,5,7
32139,2014/03/31,2010/08/11,245,10,0.901352037,7485,245,5,5
32140,2014/03/31,2008/10/30,9,10,0.35420350700000003,19046,9,5,5
32141,2014/03/31,2010/07/25,30,6,0.5428730079999999,12426,30,3,3
32142,2014/03/31,2012/03/19,229,4,0.882435897,7644,229,1,3
32143,2014/03/31,2012/09/14,58,12,0.742806167,9080,58,6,6
32144,2014/03/31,2012/12/06,123,6,0.526666667,12804,123,2,4
32145,2014/03/31,2006/03/28,55,10,0.7076991709999999,9527,55,5,5
32146,2014/03/31,2005/10/05,18,10,0.574197752,11742,18,4,6
32147,2014/03/31,2013/01/25,38,6,0.51520862,13086,38,2,4
32148,2014/03/31,2011/10/12,531,5,0.6562639929999999,10273,531,5,0
32149,2014/03/31,2009/09/09,197,8,0.606750068,11111,197,6,2
32150,2014/03/31,2011/12/11,14,6,0.909413193,7413,14,0,6
32151,2014/03/31,2008/10/20,47,6,0.877977338,7678,47,4,2
32152,2014/03/31,2010/02/15,124,7,0.581856711,11585,124,4,3
32153,2014/03/31,2011/08/17,79,9,0.7762950590000001,8683,79,5,4
32154,2014/03/31,2008/05/08,129,7,0.763536475,8828,129,3,4
32155,2014/03/31,2012/09/05,375,5,0.919326241,7332,375,5,0
32156,2014/03/31,2011/09/28,296,5,0.706911379,9535,296,3,2
32157,2014/03/31,2010/06/27,28,7,0.548125407,12296,28,3,4
32158,2014/03/31,2008/09/27,425,3,0.85,7929,425,3,0
32159,2014/03/31,2008/10/12,168,10,0.738024529,9132,168,6,4
32160,2014/03/31,2012/10/29,331,4,0.6952955740000001,9693,331,1,3
32161,2014/03/31,2012/12/30,141,8,0.489287063,13774,141,2,6
32162,2014/03/31,2013/03/24,160,2,1.341178109,5025,160,1,1
32163,2014/03/31,2011/04/22,294,6,0.614057773,10974,294,4,2
32164,2014/03/31,2012/06/07,367,6,0.659956901,10209,367,6,0
32165,2014/03/31,2012/07/10,18,6,0.840167103,8019,18,2,4
32166,2014/03/31,2008/08/06,50,6,0.565589322,11912,50,2,4
32167,2014/03/31,2007/06/04,117,10,0.386539101,17429,117,5,5
32168,2014/03/31,2013/03/08,141,7,0.734348158,9174,141,0,7
32169,2014/03/31,2009/04/13,89,8,0.510635233,13192,89,5,3
32170,2014/03/31,2011/07/26,48,6,0.5610127429999999,12007,48,3,3
32171,2014/03/31,2006/04/01,105,6,0.8035743259999999,8382,105,2,4
32172,2014/03/31,2008/07/18,297,12,0.8675,7764,297,4,8
32173,2014/03/31,2011/09/25,73,6,0.713079936,9445,73,1,5
32174,2014/03/31,2011/11/04,438,9,0.66623306,10109,438,9,0
32175,2014/03/31,2009/09/28,508,7,0.861649181,7816,508,7,0
32176,2014/03/31,2010/12/12,471,10,0.8480795870000001,7941,471,10,0
32177,2014/03/31,2005/01/16,64,10,0.8438834590000001,7980,64,3,7
32178,2014/03/31,2010/04/05,152,8,0.405959127,16588,152,4,4
32179,2014/03/31,2009/06/26,368,6,0.554591501,12142,368,6,0
32180,2014/03/31,2012/01/07,616,4,0.725,9288,616,4,0
32181,2014/03/31,2013/02/08,253,4,0.725,9288,253,2,2
32182,2014/03/31,2012/01/26,297,6,0.613916849,10968,297,2,4
32183,2014/03/31,2012/03/28,118,7,0.6554984420000001,10272,118,3,4
32184,2014/03/31,2012/02/20,371,4,1.173031359,5740,371,4,0
32185,2014/03/31,2009/09/02,329,8,0.7560583940000001,8905,329,6,2
32186,2014/03/31,2012/11/02,24,10,0.52981821,12707,24,5,5
32187,2014/03/31,2009/03/26,5,5,0.642338517,10481,5,3,2
32188,2014/03/31,2011/01/19,229,6,0.8214067840000001,8196,229,5,1
32189,2014/03/31,2012/10/29,43,6,0.7092909070000001,9491,43,2,4
32190,2014/03/31,2006/08/29,162,12,0.5936146379999999,11340,162,11,1
32191,2014/03/31,2012/04/13,359,8,0.834399405,8067,359,7,1
32192,2014/03/31,2009/09/18,103,8,0.7741138590000001,8695,103,3,5
32193,2014/03/31,2013/02/01,36,5,0.703352492,9569,36,1,4
32194,2014/03/31,2012/07/31,12,8,0.648773858,10374,12,3,5
32195,2014/03/31,2009/02/05,25,10,0.439330243,15319,25,2,8
32196,2014/03/31,2012/02/23,93,5,0.66,10195,93,1,4
32197,2014/03/31,2011/02/05,256,6,0.822886497,8176,256,5,1
32198,2014/03/31,2011/04/18,322,6,0.654347826,10281,322,5,1
32199,2014/03/31,2012/05/25,264,7,0.513064369,13112,264,6,1
32200,2014/03/31,2012/06/27,161,9,0.572714115,11746,161,8,1
32201,2014/03/31,2007/11/15,63,9,0.688368642,9771,63,0,9
32202,2014/03/31,2013/03/28,38,5,0.6856978290000001,9809,38,0,5
32203,2014/03/31,2007/05/16,20,5,0.515979745,13034,20,4,1
32204,2014/03/31,2006/02/09,62,5,0.568,11840,62,2,3
32205,2014/03/31,2012/10/23,176,8,0.589861404,11400,176,0,8
32206,2014/03/31,2007/05/22,4,4,1.4635807580000002,4594,4,2,2
32207,2014/03/31,2008/09/04,17,15,0.834666667,8055,17,7,8
32208,2014/03/31,2012/05/15,64,7,0.622110669,10807,64,0,7
32209,2014/03/31,2012/12/08,115,13,0.564804235,11902,115,6,7
32210,2014/03/31,2005/11/03,343,3,1.5,4481,343,2,1
32211,2014/03/31,2012/11/20,253,10,0.544500972,12344,253,4,6
32212,2014/03/31,2012/12/11,26,8,0.54378479,12360,26,2,6
32213,2014/03/31,2009/01/06,2,9,1.000860759,6715,2,0,9
32214,2014/03/31,2010/12/13,269,5,0.7760600459999999,8660,269,2,3
32215,2014/03/31,2011/04/15,1,9,0.561772131,11963,1,5,4
32216,2014/03/31,2010/02/10,167,8,0.807232432,8325,167,4,4
32217,2014/03/31,2010/03/01,32,5,0.925762502,7259,32,3,2
32218,2014/03/31,2012/04/01,247,9,0.775588133,8663,247,6,3
32219,2014/03/31,2009/10/20,229,9,0.726277159,9251,229,4,5
32220,2014/03/31,2013/02/09,192,7,0.6996334479999999,9603,192,3,4
32221,2014/03/31,2012/04/25,190,8,0.587421527,11437,190,6,2
32222,2014/03/31,2011/03/16,287,4,0.735043764,9140,287,2,2
32223,2014/03/31,2010/02/02,135,10,0.626745032,10719,135,8,2
32224,2014/03/31,2006/05/18,114,3,0.644773971,10419,114,0,3
32225,2014/03/31,2013/03/08,104,6,0.5967090070000001,11258,104,1,5
32226,2014/03/31,2012/01/25,51,7,0.66190068,10149,51,3,4
32227,2014/03/31,2007/11/07,89,7,0.76516118,8779,89,0,7
32228,2014/03/31,2011/09/13,10,8,0.7981345059999999,8416,10,3,5
32229,2014/03/31,2010/12/30,355,9,0.636250829,10557,355,8,1
32230,2014/03/31,2012/09/25,127,6,0.860904896,7802,127,1,5
32231,2014/03/31,2008/04/09,71,12,0.525651561,12777,71,9,3
32232,2014/03/31,2012/10/29,115,4,0.5791273610000001,11597,115,2,2
32233,2014/03/31,2011/06/12,3,11,0.454295765,14782,3,4,7
32234,2014/03/31,2011/02/16,67,5,0.7140000000000001,9405,67,2,3
32235,2014/03/31,2011/09/28,45,8,0.598931407,11211,45,5,3
32236,2014/03/31,2008/11/14,6,11,0.654888325,10253,6,3,8
32237,2014/03/31,2011/07/13,6,9,0.777902908,8631,6,4,5
32238,2014/03/31,2004/11/01,14,9,0.529876884,12671,14,4,5
32239,2014/03/31,2008/04/17,23,13,0.453358768,14809,23,7,6
32240,2014/03/31,2011/02/28,436,2,0.875,7672,436,2,0
32241,2014/03/31,2012/11/12,466,5,0.773185902,8682,466,5,0
32242,2014/03/31,2012/05/18,516,7,0.752190722,8924,516,7,0
32243,2014/03/31,2012/07/15,206,9,0.596097691,11260,206,7,2
32244,2014/03/31,2006/08/13,23,5,0.779848943,8606,23,0,5
32245,2014/03/31,2012/09/22,274,6,0.7083912170000001,9473,274,5,1
32246,2014/03/31,2012/06/12,50,6,0.710386407,9446,50,1,5
32247,2014/03/31,2007/05/04,37,5,1.236688168,5426,37,0,5
32248,2014/03/31,2006/11/30,4,21,1.206617515,5561,4,9,12
32249,2014/03/31,2010/11/16,34,5,0.549237004,12215,34,3,2
32250,2014/03/31,2008/01/14,342,5,0.621185185,10800,342,4,1
32251,2014/03/31,2008/11/18,566,4,1.391516283,4821,566,4,0
32252,2014/03/31,2012/09/14,153,6,0.978686898,6854,153,4,2
32253,2014/03/31,2010/10/17,158,8,0.8381992,8002,158,4,4
32254,2014/03/31,2010/05/29,240,7,0.775286094,8651,240,6,1
32255,2014/03/31,2007/12/28,95,5,0.7798488370000001,8600,95,3,2
32256,2014/03/31,2010/10/16,22,7,0.504130958,13302,22,3,4
32257,2014/03/31,2005/12/17,125,4,0.92,7289,125,0,4
32258,2014/03/31,2012/06/07,214,7,0.4756245120000001,14099,214,4,3
32259,2014/03/31,2010/05/28,207,8,0.7399017990000001,9063,207,4,4
32260,2014/03/31,2012/07/12,17,11,0.467279443,14350,17,1,10
32261,2014/03/31,2009/02/04,90,6,0.873517457,7676,90,1,5
32262,2014/03/31,2012/12/09,11,8,0.888894339,7543,11,3,5
32263,2014/03/31,2011/05/17,120,4,0.927739034,7227,120,2,2
32264,2014/03/31,2011/09/03,70,5,0.720777252,9302,70,2,3
32265,2014/03/31,2012/12/28,50,9,0.502943736,13330,50,4,5
32266,2014/03/31,2012/11/02,141,9,0.735753485,9111,141,5,4
32267,2014/03/31,2012/03/17,235,7,0.811217475,8263,235,3,4
32268,2014/03/31,2010/09/09,616,7,0.501110197,13376,616,7,0
32269,2014/03/31,2012/02/08,45,5,0.837522179,8003,45,3,2
32270,2014/03/31,2009/12/15,43,8,0.557256402,12028,43,1,7
32271,2014/03/31,2011/05/12,129,8,0.81848211,8189,129,3,5
32272,2014/03/31,2007/12/02,371,9,0.66990005,10005,371,9,0
32273,2014/03/31,2007/08/07,352,7,0.81634592,8210,352,6,1
32274,2014/03/31,2007/07/31,331,8,0.535443796,12517,331,6,2
32275,2014/03/31,2011/10/14,149,4,0.659116837,10168,149,3,1
32276,2014/03/31,2012/11/20,25,8,0.784757611,8540,25,2,6
32277,2014/03/31,2006/04/03,45,7,0.429679426,15597,45,3,4
32278,2014/03/31,2011/07/09,25,7,0.631553105,10611,25,1,6
32279,2014/03/31,2012/05/10,649,6,1.0,6700,649,6,0
32280,2014/03/31,2010/02/27,96,3,0.598310413,11198,96,1,2
32281,2014/03/31,2012/03/13,111,5,0.64626893,10367,111,2,3
32282,2014/03/31,2009/07/23,14,5,0.739741608,9056,14,0,5
32283,2014/03/31,2012/09/04,138,4,1.373045706,4879,138,2,2
32284,2014/03/31,2007/03/07,263,10,0.5364381810000001,12488,263,7,3
32285,2014/03/31,2012/11/08,86,7,0.752594091,8901,86,2,5
32286,2014/03/31,2009/01/07,110,5,0.680740929,9839,110,0,5
32287,2014/03/31,2012/01/03,82,7,0.638643906,10486,82,3,4
32288,2014/03/31,2008/04/16,436,7,0.725305968,9233,436,7,0
32289,2014/03/31,2012/10/05,179,4,0.764550748,8759,179,1,3
32290,2014/03/31,2012/08/21,86,7,0.571725581,11712,86,5,2
32291,2014/03/31,2012/06/23,644,4,0.6969244379999999,9608,644,4,0
32292,2014/03/31,2011/03/08,69,5,0.813168569,8234,69,0,5
32293,2014/03/31,2010/11/29,77,5,0.7605770759999999,8803,77,4,1
32294,2014/03/31,2007/06/23,151,5,0.6859999999999999,9760,151,1,4
32295,2014/03/31,2007/06/27,184,10,0.741279894,9032,184,4,6
32296,2014/03/31,2007/06/07,94,4,0.953375107,7022,94,3,1
32297,2014/03/31,2011/09/11,125,4,0.947698188,7064,125,2,2
32298,2014/03/31,2012/11/25,174,11,0.72463845,9238,174,6,5
32299,2014/03/31,2012/10/16,85,12,0.887224652,7545,85,3,9
32300,2014/03/31,2011/10/11,404,7,0.580152539,11538,404,7,0
32301,2014/03/31,2007/05/23,79,8,0.7218927959999999,9272,79,0,8
32302,2014/03/31,2007/07/19,244,5,0.619987959,10796,244,2,3
32303,2014/03/31,2010/09/11,94,12,0.6908680840000001,9688,94,8,4
32304,2014/03/31,2011/10/26,567,9,0.8712928,7681,567,9,0
32305,2014/03/31,2009/06/15,27,9,0.634241304,10551,27,6,3
32306,2014/03/31,2007/10/10,348,6,0.6647213670000001,10067,348,5,1
32307,2014/03/31,2010/01/05,42,13,0.6645922320000001,10067,42,0,13
32308,2014/03/31,2011/05/04,5,10,0.826383399,8096,5,7,3
32309,2014/03/31,2013/02/12,291,7,0.7194429509999999,9299,291,1,6
32310,2014/03/31,2007/05/10,1,8,0.667573096,10021,1,3,5
32311,2014/03/31,2010/02/17,87,10,0.7170000000000001,9330,87,7,3
32312,2014/03/31,2008/06/10,190,8,0.578876774,11556,190,4,4
32313,2014/03/31,2012/09/07,71,6,0.667548902,10020,71,2,4
32314,2014/03/31,2011/06/23,38,9,0.686751206,9739,38,3,6
32315,2014/03/31,2009/10/20,204,6,0.574293688,11645,204,3,3
32316,2014/03/31,2012/09/03,43,9,0.8114270109999999,8241,43,3,6
32317,2014/03/31,2009/10/20,95,11,0.615286161,10868,95,4,7
32318,2014/03/31,2011/12/05,142,7,0.6767479759999999,9880,142,0,7
32319,2014/03/31,2011/01/13,7,7,0.616508068,10845,7,0,7
32320,2014/03/31,2005/12/20,275,10,0.50594975,13214,275,5,5
32321,2014/03/31,2012/07/23,393,3,1.072173216,6235,393,3,0
32322,2014/03/31,2007/08/21,1,13,0.7311462320000001,9143,1,6,7
32323,2014/03/31,2012/12/21,182,5,0.636287836,10506,182,2,3
32324,2014/03/31,2011/10/28,101,6,0.6772765959999999,9870,101,1,5
32325,2014/03/31,2009/01/17,57,10,0.526715783,12691,57,3,7
32326,2014/03/31,2005/09/19,118,9,0.827480812,8078,118,2,7
32327,2014/03/31,2012/09/05,28,4,0.821442792,8137,28,2,2
32328,2014/03/31,2012/09/01,112,6,0.807026081,8282,112,4,2
32329,2014/03/31,2011/09/15,190,7,0.67267814,9936,190,2,5
32330,2014/03/31,2007/02/07,10,9,0.824631709,8105,10,4,5
32331,2014/03/31,2008/03/05,94,8,0.657052694,10172,94,4,4
32332,2014/03/31,2011/05/19,447,4,1.0,6683,447,4,0
32333,2014/03/31,2007/10/16,1,8,0.577091286,11579,1,4,4
32334,2014/03/31,2008/01/18,4,6,0.86172814,7754,4,3,3
32335,2014/03/31,2011/09/15,38,8,0.596373617,11204,38,5,3
32336,2014/03/31,2011/12/05,232,12,0.497587876,13428,232,9,3
32337,2014/03/31,2008/03/22,298,8,0.740322473,9024,298,7,1
32338,2014/03/31,2010/09/18,1,6,0.635210611,10517,1,0,6
32339,2014/03/31,2010/08/25,228,5,0.795939473,8393,228,2,3
32340,2014/03/31,2012/09/05,62,10,0.511272769,13066,62,6,4
32341,2014/03/31,2010/11/03,425,5,0.6921821570000001,9651,425,5,0
32342,2014/03/31,2007/04/02,181,6,0.760241266,8787,181,5,1
32343,2014/03/31,2012/06/20,210,8,0.647486672,10317,210,6,2
32344,2014/03/31,2012/01/28,42,4,0.56049505,11918,42,0,4
32345,2014/03/31,2012/03/09,261,10,0.67726351,9863,261,6,4
32346,2014/03/31,2009/09/04,31,8,0.685240049,9748,31,0,8
32347,2014/03/31,2008/06/20,104,9,0.7046703240000001,9479,104,4,5
32348,2014/03/31,2010/03/05,155,9,0.495911352,13469,155,5,4
32349,2014/03/31,2012/08/08,49,6,0.8433181820000001,7920,49,0,6
32350,2014/03/31,2013/02/09,249,5,0.664509999,10051,249,1,4
32351,2014/03/31,2012/10/13,274,9,0.475804659,14037,274,3,6
32352,2014/03/31,2012/04/26,661,3,0.783333333,8526,661,3,0
32353,2014/03/31,2010/01/28,5,4,0.741738116,9004,5,1,3
32354,2014/03/31,2010/01/21,34,3,0.715729904,9330,34,0,3
32355,2014/03/31,2013/02/07,6,9,0.653901293,10212,6,2,7
32356,2014/03/31,2011/01/31,34,12,0.421637936,15837,34,5,7
32357,2014/03/31,2012/10/26,44,7,0.737568762,9053,44,3,4
32358,2014/03/31,2012/12/27,10,7,0.7363824859999999,9067,10,0,7
32359,2014/03/31,2009/10/01,192,6,0.658956771,10132,192,5,1
32360,2014/03/31,2010/01/03,6,4,0.5451984320000001,12246,6,1,3
32361,2014/03/31,2010/11/18,166,7,0.557035461,11985,166,2,5
32362,2014/03/31,2007/09/10,6,10,0.6757865959999999,9878,6,0,10
32363,2014/03/31,2009/09/18,5,11,0.605363686,11026,5,8,3
32364,2014/03/31,2009/12/13,170,10,0.36966602,18055,170,2,8
32365,2014/03/31,2012/06/02,121,9,0.7779123440000001,8579,121,7,2
32366,2014/03/31,2010/03/23,196,8,0.7332501920000001,9101,196,6,2
32367,2014/03/31,2011/07/28,113,6,0.6056075870000001,11019,113,4,2
32368,2014/03/31,2010/08/05,8,14,0.6747947009999999,9888,8,4,10
32369,2014/03/31,2008/12/23,36,12,0.5058259420000001,13191,36,7,5
32370,2014/03/31,2006/11/29,77,5,0.506237481,13180,77,1,4
32371,2014/03/31,2006/06/01,252,9,0.7577660420000001,8805,252,6,3
32372,2014/03/31,2010/11/25,125,10,0.55221321,12082,125,7,3
32373,2014/03/31,2013/03/13,35,6,0.7571864709999999,8811,35,0,6
32374,2014/03/31,2008/02/16,7,7,0.567289116,11760,7,3,4
32375,2014/03/31,2012/10/24,190,4,0.560859257,11894,190,1,3
32376,2014/03/31,2011/12/20,165,9,0.7462087479999999,8939,165,7,2
32377,2014/03/31,2011/12/24,298,9,0.7428466420000001,8979,298,7,2
32378,2014/03/31,2011/04/23,105,7,0.782649613,8522,105,3,4
32379,2014/03/31,2008/01/11,18,6,0.698822297,9544,18,0,6
32380,2014/03/31,2010/02/19,112,12,0.666412511,10007,112,9,3
32381,2014/03/31,2008/04/14,84,5,1.181978022,5642,84,0,5
32382,2014/03/31,2012/04/08,123,10,0.861433923,7741,123,4,6
32383,2014/03/31,2011/08/30,673,8,0.467091622,14276,673,8,0
32384,2014/03/31,2012/01/05,66,9,0.5520500079999999,12078,66,2,7
32385,2014/03/31,2012/09/04,569,5,0.921448314,7236,569,5,0
32386,2014/03/31,2009/12/20,29,8,0.7952600190000001,8384,29,3,5
32387,2014/03/31,2012/05/30,628,6,0.655922282,10165,628,6,0
32388,2014/03/31,2009/05/28,56,8,0.684581579,9739,56,2,6
32389,2014/03/31,2011/01/21,128,10,0.621965668,10719,128,3,7
32390,2014/03/31,2012/09/27,358,5,0.607043344,10982,358,4,1
32391,2014/03/31,2012/11/14,131,4,1.201247072,5549,131,0,4
32392,2014/03/31,2011/11/21,612,5,0.906035069,7357,612,5,0
32393,2014/03/31,2011/08/30,366,6,0.7374142509999999,9038,366,5,1
32394,2014/03/31,2009/08/29,1,8,0.786364602,8475,1,4,4
32395,2014/03/31,2013/01/20,418,2,0.7881267740000001,8456,418,2,0
32396,2014/03/31,2007/08/12,51,7,0.922847251,7221,51,4,3
32397,2014/03/31,2012/08/14,96,11,0.636646604,10467,96,4,7
32398,2014/03/31,2011/04/15,155,5,0.8071039240000001,8256,155,2,3
32399,2014/03/31,2012/07/21,107,10,0.654940043,10174,107,5,5
32400,2014/03/31,2013/01/09,32,8,0.668112905,9973,32,1,7
32401,2014/03/31,2007/04/16,80,8,0.681428864,9777,80,0,8
32402,2014/03/31,2011/03/28,216,6,0.677259327,9837,216,3,3
32403,2014/03/31,2010/09/28,208,7,0.8546568309999999,7795,208,3,4
32404,2014/03/31,2011/09/22,163,20,0.456390354,14597,163,16,4
32405,2014/03/31,2006/03/21,20,7,0.770604974,8645,20,3,4
32406,2014/03/31,2010/06/18,4,9,0.657182598,10137,4,6,3
32407,2014/03/31,2012/05/19,159,10,0.660107015,10092,159,9,1
32408,2014/03/31,2005/09/09,383,10,0.91910872,7248,383,10,0
32409,2014/03/31,2006/10/22,11,7,0.6642337220000001,10029,11,3,4
32410,2014/03/31,2012/08/09,112,11,0.7607948840000001,8756,112,10,1
32411,2014/03/31,2008/01/04,106,10,0.483132434,13788,106,4,6
32412,2014/03/31,2011/09/28,85,11,0.764442277,8714,85,2,9
32413,2014/03/31,2008/07/25,422,6,0.585973786,11368,422,6,0
32414,2014/03/31,2012/12/27,62,10,0.541261173,12306,62,2,8
32415,2014/03/31,2012/04/19,123,8,0.81475841,8175,123,4,4
32416,2014/03/31,2011/11/16,30,4,0.59,11288,30,0,4
32417,2014/03/31,2006/04/26,442,5,0.8229794859999999,8092,442,5,0
32418,2014/03/31,2006/07/07,385,7,0.764294732,8713,385,7,0
32419,2014/03/31,2006/08/02,75,8,0.985238941,6759,75,7,1
32420,2014/03/31,2004/12/08,11,16,0.504059496,13211,11,6,10
32421,2014/03/31,2012/02/11,300,15,0.769333333,8655,300,13,2
32422,2014/03/31,2009/09/26,173,6,0.781091037,8524,173,2,4
32423,2014/03/31,2006/03/02,437,8,0.71518423,9309,437,8,0
32424,2014/03/31,2012/12/21,447,2,0.6970264890000001,9551,447,2,0
32425,2014/03/31,2007/09/03,265,9,0.793090671,8393,265,6,3
32426,2014/03/31,2012/10/05,242,7,0.639045699,10416,242,2,5
32427,2014/03/31,2007/04/15,317,4,0.410465618,16215,317,3,1
32428,2014/03/31,2007/04/08,5,4,1.175063559,5664,5,1,3
32429,2014/03/31,2009/07/14,280,8,0.645597051,10309,280,5,3
32430,2014/03/31,2010/07/29,431,7,0.671998384,9903,431,7,0
32431,2014/03/31,2005/04/12,44,7,0.72141804,9224,44,3,4
32432,2014/03/31,2011/06/27,488,7,0.7752708840000001,8583,488,7,0
32433,2014/03/31,2012/08/08,379,6,0.859258781,7744,379,6,0
32434,2014/03/31,2009/07/03,214,7,0.732558626,9083,214,4,3
32435,2014/03/31,2008/05/05,124,8,0.734255131,9062,124,6,2
32436,2014/03/31,2009/03/20,219,5,0.530460018,12543,219,4,1
32437,2014/03/31,2012/08/26,277,5,0.823629611,8078,277,2,3
32438,2014/03/31,2011/05/09,304,12,0.883983524,7526,304,11,1
32439,2014/03/31,2010/04/16,215,4,1.357363803,4901,215,3,1
32440,2014/03/31,2013/03/25,326,4,0.452298069,14708,326,2,2
32441,2014/03/31,2009/07/24,283,6,0.72235639,9209,283,4,2
32442,2014/03/31,2011/08/31,558,5,0.92,7230,558,5,0
32443,2014/03/31,2011/02/22,8,10,0.551788618,12054,8,3,7
32444,2014/03/31,2012/06/04,46,2,1.1324961690000002,5873,46,0,2
32445,2014/03/31,2011/11/09,57,10,0.74914733,8878,57,6,4
32446,2014/03/31,2008/07/12,612,5,0.71807385,9262,612,5,0
32447,2014/03/31,2013/02/06,281,8,0.601138932,11063,281,5,3
32448,2014/03/31,2006/11/28,134,4,0.585,11368,134,0,4
32449,2014/03/31,2007/02/02,28,6,0.869518828,7648,28,3,3
32450,2014/03/31,2006/06/12,123,7,0.609618629,10908,123,0,7
32451,2014/03/31,2010/03/30,117,7,0.6879257190000001,9666,117,3,4
32452,2014/03/31,2009/10/02,127,9,0.760344197,8745,127,4,5
32453,2014/03/31,2007/07/31,120,8,0.786598841,8453,120,6,2
32454,2014/03/31,2008/08/22,65,3,1.4485686269999998,4590,65,0,3
32455,2014/03/31,2012/08/10,20,8,0.6988951959999999,9513,20,5,3
32456,2014/03/31,2007/03/01,82,5,0.5368900910000001,12383,82,0,5
32457,2014/03/31,2009/02/14,70,6,0.522211138,12731,70,4,2
32458,2014/03/31,2011/10/09,23,3,0.6634278020000001,10021,23,1,2
32459,2014/03/31,2009/01/06,213,9,0.630025588,10552,213,0,9
32460,2014/03/31,2012/03/03,265,6,0.543677409,12226,265,3,3
32461,2014/03/31,2006/06/02,117,11,0.715033348,9296,117,7,4
32462,2014/03/31,2006/07/17,141,8,0.519671618,12790,141,4,4
32463,2014/03/31,2006/04/14,30,8,0.74278498,8948,30,0,8
32464,2014/03/31,2010/11/20,482,5,0.64,10385,482,5,0
32465,2014/03/31,2011/12/12,635,2,0.80953715,8210,635,2,0
32466,2014/03/31,2009/01/10,26,14,0.5888384870000001,11287,26,1,13
32467,2014/03/31,2008/02/15,56,8,0.729628938,9109,56,4,4
32468,2014/03/31,2012/12/30,86,8,0.489401237,13578,86,1,7
32469,2014/03/31,2012/08/14,133,6,0.720093195,9228,133,4,2
32470,2014/03/31,2007/03/11,575,5,0.840819942,7903,575,5,0
32471,2014/03/31,2012/07/07,622,7,0.686178232,9684,622,7,0
32472,2014/03/31,2012/01/25,64,11,0.923498263,7195,64,7,4
32473,2014/03/31,2009/07/04,7,8,0.467712938,14206,7,3,5
32474,2014/03/31,2012/06/04,161,6,0.638445277,10407,161,3,3
32475,2014/03/31,2006/07/22,64,4,0.969687682,6852,64,3,1
32476,2014/03/31,2013/02/27,86,9,0.6500146760000001,10221,86,0,9
32477,2014/03/31,2007/09/26,57,7,0.5955315529999999,11156,57,3,4
32478,2014/03/31,2007/08/16,8,8,0.8304024999999999,8000,8,4,4
32479,2014/03/31,2011/07/16,112,5,0.702224101,9460,112,3,2
32480,2014/03/31,2011/04/14,33,5,0.975746181,6808,33,4,1
32481,2014/03/31,2011/08/30,510,7,0.708570667,9375,510,7,0
32482,2014/03/31,2008/10/17,74,12,0.47780679,13902,74,6,6
32483,2014/03/31,2009/10/21,564,4,0.6359858279999999,10443,564,4,0
32484,2014/03/31,2012/04/14,103,8,0.68186961,9740,103,5,3
32485,2014/03/31,2010/05/05,73,3,0.606666667,10947,73,2,1
32486,2014/03/31,2011/04/18,298,5,0.864020297,7686,298,4,1
32487,2014/03/31,2012/07/04,8,14,0.4255594720000001,15604,8,6,8
32488,2014/03/31,2006/04/12,157,2,1.183235923,5612,157,1,1
32489,2014/03/31,2012/03/13,20,9,0.60008676,11065,20,3,6
32490,2014/03/31,2013/03/26,141,5,0.634977527,10457,141,0,5
32491,2014/03/31,2011/04/01,75,4,0.7373159359999999,9005,75,1,3
32492,2014/03/31,2011/03/14,472,3,0.816666667,8130,472,3,0
32493,2014/03/31,2006/07/17,130,6,0.7686915240000001,8636,130,0,6
32494,2014/03/31,2013/03/03,43,6,0.64044959,10365,43,4,2
32495,2014/03/31,2012/06/20,117,13,0.686099225,9675,117,5,8
32496,2014/03/31,2007/05/02,68,6,0.830980343,7987,68,1,5
32497,2014/03/31,2007/09/01,40,11,0.694237448,9560,40,3,8
32498,2014/03/31,2005/10/18,150,4,0.796438258,8333,150,3,1
32499,2014/03/31,2007/03/02,30,4,0.901603043,7361,30,0,4
32500,2014/03/31,2008/01/27,10,6,0.686938205,9661,10,3,3
32501,2014/03/31,2006/10/17,152,13,0.667320261,9945,152,8,5
32502,2014/03/31,2012/04/21,24,13,0.680166035,9757,24,11,2
32503,2014/03/31,2012/10/16,109,11,0.7771764840000001,8539,109,1,10
32504,2014/03/31,2012/11/22,207,5,0.65361962,10153,207,0,5
32505,2014/03/31,2012/10/16,11,9,0.68214741,9728,11,0,9
32506,2014/03/31,2008/02/23,311,11,0.6637177439999999,9998,311,6,5
32507,2014/03/31,2011/12/06,6,14,0.70998395,9346,6,4,10
32508,2014/03/31,2013/01/25,51,6,0.665418714,9971,51,2,4
32509,2014/03/31,2012/04/10,1,18,0.65364335,10150,1,9,9
32510,2014/03/31,2009/10/23,122,5,0.731444322,9070,122,2,3
32511,2014/03/31,2010/04/02,260,9,0.7045443929999999,9416,260,3,6
32512,2014/03/31,2010/10/11,30,8,0.865940478,7661,30,3,5
32513,2014/03/31,2012/03/29,168,3,1.076389745,6163,168,0,3
32514,2014/03/31,2012/09/30,415,5,1.272980234,5211,415,5,0
32515,2014/03/31,2006/07/23,40,5,0.75883995,8741,40,4,1
32516,2014/03/31,2011/10/14,97,6,0.603711659,10987,97,3,3
32517,2014/03/31,2012/06/08,564,5,0.47,14110,564,5,0
32518,2014/03/31,2012/10/24,127,8,0.615139147,10780,127,4,4
32519,2014/03/31,2006/07/23,178,4,1.452545455,4565,178,0,4
32520,2014/03/31,2011/10/08,593,6,0.7828630459999999,8470,593,6,0
32521,2014/03/31,2012/08/21,125,10,0.59926254,11065,125,8,2
32522,2014/03/31,2010/09/27,191,6,0.8573441940000001,7734,191,2,4
32523,2014/03/31,2011/06/14,32,5,0.8009724570000001,8278,32,2,3
32524,2014/03/31,2009/09/07,48,6,0.6851777590000001,9676,48,4,2
32525,2014/03/31,2008/01/01,12,6,0.65549733,10114,12,2,4
32526,2014/03/31,2012/10/24,17,6,0.72563704,9136,17,2,4
32527,2014/03/31,2005/01/15,115,4,0.931603429,7116,115,1,3
32528,2014/03/31,2006/09/08,57,6,0.956741233,6929,57,3,3
32529,2014/03/31,2007/10/17,248,6,0.52292656,12677,248,5,1
32530,2014/03/31,2008/06/14,226,5,0.674,9835,226,1,4
32531,2014/03/31,2008/02/12,21,10,0.667406363,9932,21,7,3
32532,2014/03/31,2012/12/26,107,6,0.66978173,9896,107,0,6
32533,2014/03/31,2008/06/19,4,9,0.443352508,14950,4,0,9
32534,2014/03/31,2012/08/08,400,3,0.8720036840000001,7601,400,3,0
32535,2014/03/31,2011/02/05,175,4,0.7854882670000001,8438,175,1,3
32536,2014/03/31,2013/03/08,203,7,0.634526568,10445,203,3,4
32537,2014/03/31,2010/12/09,125,6,0.942072495,7035,125,1,5
32538,2014/03/31,2007/03/12,106,7,0.693667574,9554,106,5,2
32539,2014/03/31,2007/04/18,154,10,0.6756193290000001,9809,154,5,5
32540,2014/03/31,2009/07/07,591,4,0.681629294,9722,591,4,0
32541,2014/03/31,2012/05/11,22,8,0.748427829,8854,22,6,2
32542,2014/03/31,2012/08/07,551,5,0.58,11425,551,5,0
32543,2014/03/31,2012/08/30,50,4,0.826342437,8019,50,3,1
32544,2014/03/31,2011/06/14,33,9,0.686169618,9657,33,4,5
32545,2014/03/31,2008/04/22,144,6,0.6935608120000001,9554,144,3,3
32546,2014/03/31,2012/02/05,105,3,0.722286898,9174,105,0,3
32547,2014/03/31,2007/11/01,354,9,0.909824248,7283,354,7,2
32548,2014/03/31,2012/04/11,19,7,1.441926007,4595,19,2,5
32549,2014/03/31,2009/04/08,128,7,0.726256714,9123,128,3,4
32550,2014/03/31,2009/07/08,203,4,0.702043022,9437,203,0,4
32551,2014/03/31,2007/06/09,347,5,0.872500988,7593,347,3,2
32552,2014/03/31,2010/09/16,31,8,0.597463925,11088,31,3,5
32553,2014/03/31,2010/07/01,35,4,0.8190318990000001,8088,35,3,1
32554,2014/03/31,2012/06/16,290,8,0.572902612,11562,290,4,4
32555,2014/03/31,2011/02/21,16,7,0.5741868929999999,11536,16,3,4
32556,2014/03/31,2013/02/16,135,13,0.53681984,12339,135,3,10
32557,2014/03/31,2006/10/14,7,17,0.534426335,12394,7,3,14
32558,2014/03/31,2007/03/04,212,7,0.610517098,10849,212,1,6
32559,2014/03/31,2011/11/21,24,8,0.546037923,12130,24,5,3
32560,2014/03/31,2011/08/08,226,7,0.70951473,9335,226,3,4
32561,2014/03/31,2009/11/23,260,5,0.786855174,8417,260,2,3
32562,2014/03/31,2008/08/07,62,4,0.836542882,7917,62,0,4
32563,2014/03/31,2009/06/25,524,6,0.64085059,10334,524,6,0
32564,2014/03/31,2009/08/19,142,7,0.814117285,8134,142,3,4
32565,2014/03/31,2011/04/16,68,8,0.655325614,10104,68,5,3
32566,2014/03/31,2008/06/02,235,9,0.83525041,7927,235,5,4
32567,2014/03/31,2012/10/01,139,6,0.603658826,10968,139,3,3
32568,2014/03/31,2006/07/18,239,6,0.920561735,7192,239,4,2
32569,2014/03/31,2010/03/01,149,6,0.7704689859999999,8593,149,1,5
32570,2014/03/31,2007/03/14,151,10,0.688876171,9610,151,8,2
32571,2014/03/31,2012/01/06,85,7,0.614704244,10769,85,2,5
32572,2014/03/31,2010/01/01,256,10,0.8113187890000001,8159,256,8,2
32573,2014/03/31,2007/07/07,14,9,0.580738726,11398,14,3,6
32574,2014/03/31,2009/01/16,128,8,0.620622597,10665,128,6,2
32575,2014/03/31,2012/08/10,196,11,0.657877945,10061,196,9,2
32576,2014/03/31,2007/12/28,5,5,0.729890825,9068,5,2,3
32577,2014/03/31,2013/03/28,12,10,0.532059651,12439,12,1,9
32578,2014/03/31,2012/11/30,30,12,0.55785636,11863,30,0,12
32579,2014/03/31,2009/03/27,219,8,0.604583409,10946,219,3,5
32580,2014/03/31,2010/11/04,26,5,0.57,11610,26,3,2
32581,2014/03/31,2007/10/24,244,9,0.693926174,9536,244,6,3
32582,2014/03/31,2007/02/25,2,9,0.625541269,10577,2,6,3
32583,2014/03/31,2009/12/11,127,7,0.755882555,8753,127,2,5
32584,2014/03/31,2007/05/29,35,7,0.672722928,9835,35,1,6
32585,2014/03/31,2006/11/22,581,4,0.630181939,10498,581,4,0
32586,2014/03/31,2012/09/02,36,8,0.522010574,12673,36,1,7
32587,2014/03/31,2011/08/01,22,8,0.509352429,12987,22,5,3
32588,2014/03/31,2009/02/21,11,7,0.57407221,11522,11,1,6
32589,2014/03/31,2011/09/22,3,7,0.700013758,9449,3,1,6
32590,2014/03/31,2008/06/14,76,8,0.86285062,7665,76,3,5
32591,2014/03/31,2012/05/13,64,12,0.6844856140000001,9662,64,3,9
32592,2014/03/31,2010/07/15,129,5,0.867900262,7620,129,3,2
32593,2014/03/31,2011/06/03,6,4,0.75440794,8766,6,1,3
32594,2014/03/31,2008/05/24,83,10,0.467856941,14134,83,4,6
32595,2014/03/31,2005/10/17,49,7,0.575259678,11495,49,4,3
32596,2014/03/31,2010/04/15,490,5,0.819127849,8072,490,5,0
32597,2014/03/31,2011/01/24,243,5,0.880536689,7509,243,4,1
32598,2014/03/31,2010/01/20,389,8,0.7764091120000001,8516,389,8,0
32599,2014/03/31,2007/02/17,33,6,0.878879436,7523,33,0,6
32600,2014/03/31,2008/07/18,16,14,0.655,10094,16,0,14
32601,2014/03/31,2007/12/21,188,5,1.473758359,4486,188,4,1
32602,2014/03/31,2011/11/11,128,9,0.762431092,8671,128,7,2
32603,2014/03/31,2012/08/08,8,7,0.567757643,11644,8,5,2
32604,2014/03/31,2008/03/26,22,13,0.6797449609999999,9724,22,2,11
32605,2014/03/31,2013/03/17,6,13,0.6849911909999999,9649,6,1,12
32606,2014/03/31,2008/08/18,79,4,0.69179192,9554,79,0,4
32607,2014/03/31,2011/01/13,52,4,0.69076505,9568,52,0,4
32608,2014/03/31,2006/07/25,293,6,0.56,11802,293,4,2
32609,2014/03/31,2012/04/21,563,4,0.7875,8392,563,4,0
32610,2014/03/31,2012/08/16,9,7,0.621221094,10638,9,3,4
32611,2014/03/31,2011/10/16,204,8,0.494923607,13352,204,5,3
32612,2014/03/31,2011/02/20,387,5,0.734166667,9000,387,5,0
32613,2014/03/31,2008/07/06,306,4,0.663574729,9956,306,3,1
32614,2014/03/31,2011/10/04,112,7,0.569046429,11609,112,4,3
32615,2014/03/31,2008/02/10,86,7,0.639685291,10327,86,4,3
32616,2014/03/31,2012/10/02,271,7,0.668197451,9886,271,3,4
32617,2014/03/31,2008/04/21,224,5,0.72036096,9170,224,3,2
32618,2014/03/31,2012/11/25,81,7,0.684285714,9653,81,4,3
32619,2014/03/31,2013/01/06,234,6,0.648903625,10179,234,2,4
32620,2014/03/31,2005/10/18,234,3,0.938342094,7039,234,2,1
32621,2014/03/31,2009/04/06,170,6,0.641632019,10294,170,0,6
32622,2014/03/31,2009/12/11,2,2,0.905,7298,2,0,2
32623,2014/03/31,2011/03/05,14,6,0.651600237,10136,14,2,4
32624,2014/03/31,2009/10/27,1,7,0.765825603,8624,1,1,6
32625,2014/03/31,2006/07/21,296,12,0.842656629,7837,296,9,3
32626,2014/03/31,2011/01/15,17,5,0.633083118,10431,17,2,3
32627,2014/03/31,2012/05/29,48,9,0.642931555,10271,48,7,2
32628,2014/03/31,2012/01/10,112,5,0.70631258,9348,112,0,5
32629,2014/03/31,2012/11/10,34,8,0.678583616,9729,34,3,5
32630,2014/03/31,2011/12/05,2,15,0.433618391,15225,2,0,15
32631,2014/03/31,2012/04/07,65,6,0.80800612,8170,65,0,6
32632,2014/03/31,2011/03/03,151,8,0.69079008,9556,151,6,2
32633,2014/03/31,2010/11/25,15,7,0.7103906590000001,9292,15,0,7
32634,2014/03/31,2012/06/04,36,10,0.554187726,11911,36,5,5
32635,2014/03/31,2012/10/21,331,12,0.562767499,11729,331,9,3
32636,2014/03/31,2009/01/17,218,4,0.7857785709999999,8400,218,0,4
32637,2014/03/31,2011/12/18,17,8,0.7816534409999999,8443,17,5,3
32638,2014/03/31,2010/02/12,350,5,0.829904427,7952,350,4,1
32639,2014/03/31,2005/11/22,222,5,1.00892677,6541,222,4,1
32640,2014/03/31,2011/12/21,141,5,0.827367101,7976,141,4,1
32641,2014/03/31,2007/03/02,31,4,0.8274357370000001,7975,31,0,4
32642,2014/03/31,2012/04/18,343,6,1.349938625,4888,343,4,2
32643,2014/03/31,2008/05/16,512,4,0.78822124,8371,512,4,0
32644,2014/03/31,2012/03/17,74,10,0.8337035629999999,7914,74,2,8
32645,2014/03/31,2008/04/26,252,6,0.834294385,7908,252,4,2
32646,2014/03/31,2007/12/03,4,13,0.5,13195,4,4,9
32647,2014/03/31,2005/08/20,140,4,0.859372151,7677,140,1,3
32648,2014/03/31,2012/05/01,396,7,0.486576191,13558,396,7,0
32649,2014/03/31,2010/01/05,23,6,0.925806542,7123,23,1,5
32650,2014/03/31,2011/09/19,187,5,0.718596338,9176,187,3,2
32651,2014/03/31,2009/12/03,646,4,0.820087065,8040,646,4,0
32652,2014/03/31,2011/07/12,351,5,0.713567486,9239,351,4,1
32653,2014/03/31,2011/04/01,18,5,0.69029113,9549,18,2,3
32654,2014/03/31,2013/03/03,47,6,0.787142004,8373,47,0,6
32655,2014/03/31,2008/07/28,292,6,0.797618298,8263,292,5,1
32656,2014/03/31,2009/08/26,523,6,0.8913308090000001,7394,523,6,0
32657,2014/03/31,2012/10/24,105,8,0.759431897,8678,105,3,5
32658,2014/03/31,2012/10/18,162,3,1.206576346,5462,162,1,2
32659,2014/03/31,2008/12/19,447,5,0.736971595,8942,447,5,0
32660,2014/03/31,2005/12/28,44,7,0.5733716179999999,11493,44,4,3
32661,2014/03/31,2005/01/18,37,8,0.583364023,11296,37,2,6
32662,2014/03/31,2009/12/31,65,9,0.494668568,13321,65,3,6
32663,2014/03/31,2008/08/28,11,9,0.652966009,10091,11,4,5
32664,2014/03/31,2012/06/09,2,7,0.839228124,7851,2,2,5
32665,2014/03/31,2006/08/28,210,8,0.444301996,14828,210,6,2
32666,2014/03/31,2008/09/06,190,4,1.023620261,6436,190,2,2
32667,2014/03/31,2012/09/14,83,7,0.738137815,8925,83,2,5
32668,2014/03/31,2009/10/22,128,6,0.685733319,9607,128,0,6
32669,2014/03/31,2007/01/21,29,7,0.485021352,13582,29,2,5
32670,2014/03/31,2012/10/01,103,8,0.648952813,10151,103,6,2
32671,2014/03/31,2008/08/17,134,5,0.684108422,9629,134,0,5
32672,2014/03/31,2013/03/27,51,6,0.489065261,13469,51,0,6
32673,2014/03/31,2008/04/24,189,7,0.728366692,9043,189,5,2
32674,2014/03/31,2012/03/17,226,8,0.647900846,10166,226,5,3
32675,2014/03/31,2007/07/12,271,8,0.653866773,10073,271,7,1
32676,2014/03/31,2009/11/18,313,8,0.749288965,8790,313,7,1
32677,2014/03/31,2010/01/11,48,5,0.6954255540000001,9470,48,2,3
32678,2014/03/31,2009/09/22,356,7,0.776299658,8483,356,6,1
32679,2014/03/31,2012/04/19,39,3,0.81,8130,39,0,3
32680,2014/03/31,2011/03/19,34,11,0.81137999,8116,34,5,6
32681,2014/03/31,2013/01/28,59,4,0.677012132,9726,59,2,2
32682,2014/03/31,2009/12/07,66,8,0.491920807,13385,66,6,2
32683,2014/03/31,2010/08/30,40,9,0.64,10287,40,1,8
32684,2014/03/31,2010/08/06,61,14,0.385883008,17061,61,2,12
32685,2014/03/31,2011/11/28,473,5,0.490587972,13419,473,5,0
32686,2014/03/31,2011/04/20,101,6,0.910711123,7228,101,3,3
32687,2014/03/31,2008/06/04,86,8,0.660437487,9966,86,4,4
32688,2014/03/31,2010/04/07,208,9,0.58828551,11187,208,4,5
32689,2014/03/31,2006/11/20,114,4,1.084892845,6066,114,1,3
32690,2014/03/31,2013/03/27,103,6,0.7388760390000001,8906,103,1,5
32691,2014/03/31,2010/12/05,106,4,0.952855488,6906,106,2,2
32692,2014/03/31,2012/07/09,94,7,0.767625992,8572,94,4,3
32693,2014/03/31,2013/02/09,66,9,0.650956668,10108,66,1,8
32694,2014/03/31,2008/08/24,108,4,0.65886441,9986,108,1,3
32695,2014/03/31,2008/06/16,522,5,0.634144578,10375,522,5,0
32696,2014/03/31,2012/08/21,248,9,0.384883286,17093,248,7,2
32697,2014/03/31,2012/05/22,70,7,0.5045551460000001,13038,70,0,7
32698,2014/03/31,2008/05/17,258,8,0.823398423,7989,258,6,2
32699,2014/03/31,2006/09/18,44,5,0.5870149920000001,11206,44,4,1
32700,2014/03/31,2011/10/09,8,10,0.6546666,10048,8,5,5
32701,2014/03/31,2010/09/21,381,5,0.933683463,7045,381,5,0
32702,2014/03/31,2009/12/16,109,5,0.771535484,8525,109,0,5
32703,2014/03/31,2007/05/07,2,3,1.449001983,4539,2,1,2
32704,2014/03/31,2008/01/20,22,13,0.5097775370000001,12901,22,5,8
32705,2014/03/31,2011/09/01,38,7,0.548991569,11979,38,3,4
32706,2014/03/31,2010/02/09,35,7,0.659201083,9976,35,4,3
32707,2014/03/31,2007/09/28,594,5,0.68155058,9648,594,5,0
32708,2014/03/31,2011/12/22,27,5,0.720748657,9123,27,2,3
32709,2014/03/31,2012/03/22,322,8,0.461097475,14260,322,6,2
32710,2014/03/31,2006/08/06,24,9,0.456265353,14411,24,5,4
32711,2014/03/31,2007/03/15,105,8,0.468179746,14042,105,6,2
32712,2014/03/31,2005/06/06,83,5,0.7342504470000001,8952,83,2,3
32713,2014/03/31,2010/05/19,41,7,0.580064436,11329,41,2,5
32714,2014/03/31,2008/09/28,325,9,0.716948505,9166,325,6,3
32715,2014/03/31,2010/06/04,42,8,0.602112883,10914,42,4,4
32716,2014/03/31,2009/04/09,127,8,0.655273235,10028,127,5,3
32717,2014/03/31,2012/03/14,20,7,0.6638930989999999,9897,20,1,6
32718,2014/03/31,2009/06/23,141,6,0.8374608029999999,7845,141,4,2
32719,2014/03/31,2012/02/14,112,10,0.6459999999999999,10170,112,5,5
32720,2014/03/31,2011/05/16,493,7,0.5719658710000001,11486,493,7,0
32721,2014/03/31,2013/03/15,7,5,0.61814076,10628,7,2,3
32722,2014/03/31,2006/03/08,144,5,1.411237379,4655,144,4,1
32723,2014/03/31,2007/06/19,205,6,0.664694931,9883,205,2,4
32724,2014/03/31,2012/10/22,194,6,0.806590128,8144,194,1,5
32725,2014/03/31,2011/12/27,135,10,0.676817105,9705,135,5,5
32726,2014/03/31,2012/08/23,583,2,0.9,7298,583,2,0
32727,2014/03/31,2010/05/01,228,6,0.858556863,7650,228,2,4
32728,2014/03/31,2009/02/17,122,9,0.629013504,10441,122,6,3
32729,2014/03/31,2005/08/12,2,9,0.8235991970000001,7974,2,6,3
32730,2014/03/31,2013/01/11,33,7,0.55236437,11889,33,0,7
32731,2014/03/31,2012/04/04,571,5,0.936213288,7014,571,5,0
32732,2014/03/31,2012/10/11,113,10,0.559989766,11726,113,3,7
32733,2014/03/31,2011/01/15,8,10,0.538000819,12205,8,5,5
32734,2014/03/31,2012/12/03,472,3,0.80222358,8185,472,3,0
32735,2014/03/31,2011/01/13,117,8,0.572259892,11474,117,3,5
32736,2014/03/31,2008/09/20,34,9,0.681008194,9641,34,5,4
32737,2014/03/31,2012/11/23,24,15,0.605872635,10835,24,1,14
32738,2014/03/31,2013/03/29,141,12,0.56547334,11609,141,0,12
32739,2014/03/31,2013/03/02,112,6,0.616887511,10641,112,0,6
32740,2014/03/31,2007/02/14,81,8,0.5613768920000001,11693,81,2,6
32741,2014/03/31,2010/11/14,270,7,0.8116780020000001,8087,270,3,4
32742,2014/03/31,2012/09/21,417,4,0.431592792,15206,417,4,0
32743,2014/03/31,2012/07/20,416,5,0.793759071,8268,416,5,0
32744,2014/03/31,2013/02/24,147,7,0.7228097809999999,9079,147,0,7
32745,2014/03/31,2010/09/25,248,6,0.580150309,11310,248,2,4
32746,2014/03/31,2006/04/06,230,6,0.853593547,7686,230,2,4
32747,2014/03/31,2007/05/17,113,6,0.6337480679999999,10352,113,1,5
32748,2014/03/31,2009/10/07,42,8,0.626222434,10475,42,1,7
32749,2014/03/31,2007/06/19,23,10,0.7407046070000001,8856,23,4,6
32750,2014/03/31,2011/07/08,351,8,0.8123281729999999,8075,351,6,2
32751,2014/03/31,2012/09/21,156,8,0.702739447,9334,156,3,5
32752,2014/03/31,2012/06/25,620,4,0.764481352,8580,620,4,0
32753,2014/03/31,2008/08/04,192,6,0.908984061,7215,192,4,2
32754,2014/03/31,2009/02/12,9,7,0.548413083,11954,9,0,7
32755,2014/03/31,2007/11/17,172,5,0.727747558,9008,172,4,1
32756,2014/03/31,2008/12/14,73,10,0.8465095559999999,7744,73,5,5
32757,2014/03/31,2012/07/27,164,8,0.6145157960000001,10667,164,5,3
32758,2014/03/31,2011/07/25,423,3,1.279513957,5123,423,3,0
32759,2014/03/31,2010/11/18,107,8,0.659096028,9945,107,6,2
32760,2014/03/31,2010/03/01,16,5,0.748848395,8753,16,2,3
32761,2014/03/31,2008/03/14,380,6,0.748675043,8755,380,6,0
32762,2014/03/31,2006/08/18,3,6,0.6081403120000001,10776,3,0,6
32763,2014/03/31,2012/11/06,192,7,0.65316356,10033,192,1,6
32764,2014/03/31,2012/12/29,282,5,0.787111111,8325,282,1,4
32765,2014/03/31,2012/07/02,376,6,0.685607408,9557,376,6,0
32766,2014/03/31,2010/09/02,524,3,1.5,4368,524,3,0
32767,2014/03/31,2006/03/01,97,6,0.492184495,13312,97,0,6
32768,2014/03/31,2009/11/04,58,7,0.8697544140000001,7533,58,2,5
32769,2014/03/31,2012/01/10,343,5,1.075956643,6089,343,1,4
32770,2014/03/31,2009/02/14,6,6,0.7071006040000001,9264,6,0,6
32771,2014/03/31,2007/06/10,231,6,0.713561002,9180,231,5,1
32772,2014/03/31,2004/12/12,20,10,0.671914239,9748,20,7,3
32773,2014/03/31,2010/12/20,87,5,0.760261172,8615,87,1,4
32774,2014/03/31,2012/04/01,238,11,0.707157974,9261,238,4,7
32775,2014/03/31,2011/09/29,65,5,0.772367024,8479,65,0,5
32776,2014/03/31,2012/06/19,331,4,0.604188965,10838,331,2,2
32777,2014/03/31,2006/11/19,487,4,0.688300221,9513,487,4,0
32778,2014/03/31,2012/06/27,45,6,0.842996009,7767,45,5,1
32779,2014/03/31,2012/07/11,208,9,0.916630267,7143,208,4,5
32780,2014/03/31,2012/09/21,13,9,0.561242071,11666,13,1,8
32781,2014/03/31,2006/03/12,57,7,0.583704199,11217,57,1,6
32782,2014/03/31,2011/09/27,90,3,1.351597853,4844,90,1,2
32783,2014/03/31,2011/03/25,402,6,1.031641979,6346,402,6,0
32784,2014/03/31,2012/03/15,118,5,0.760725076,8606,118,3,2
32785,2014/03/31,2012/08/11,39,6,0.536961122,12192,39,1,5
32786,2014/03/31,2012/11/27,398,6,0.814160448,8040,398,6,0
32787,2014/03/31,2012/11/06,136,3,1.351585794,4843,136,0,3
32788,2014/03/31,2011/07/12,34,10,0.5034781939999999,13001,34,6,4
32789,2014/03/31,2007/09/26,43,8,0.617640842,10597,43,3,5
32790,2014/03/31,2012/03/24,166,7,0.877128116,7462,166,4,3
32791,2014/03/31,2008/04/06,18,5,0.7904347829999999,8280,18,0,5
32792,2014/03/31,2010/05/25,62,4,0.521968416,12538,62,0,4
32793,2014/03/31,2009/04/08,3,11,0.477769259,13695,3,5,6
32794,2014/03/31,2012/05/07,42,7,0.750688389,8716,42,5,2
32795,2014/03/31,2011/11/30,154,8,0.6731327159999999,9720,154,4,4
32796,2014/03/31,2010/07/29,95,7,0.573720624,11404,95,5,2
32797,2014/03/31,2013/02/15,36,9,0.6022885020000001,10863,36,1,8
32798,2014/03/31,2012/06/06,389,7,0.45,14539,389,7,0
32799,2014/03/31,2012/06/06,389,7,0.45,14539,389,7,0
32800,2014/03/31,2012/06/20,152,10,0.746807078,8760,152,6,4
32801,2014/03/31,2010/05/18,150,7,0.567542946,11526,150,2,5
32802,2014/03/31,2012/10/16,48,6,0.652380572,10027,48,2,4
32803,2014/03/31,2007/08/22,86,6,0.731697058,8939,86,3,3
32804,2014/03/31,2011/01/27,489,5,1.0,6540,489,5,0
32805,2014/03/31,2010/01/28,375,3,0.961155203,6804,375,3,0
32806,2014/03/31,2011/08/08,14,9,0.596453849,10964,14,6,3
32807,2014/03/31,2010/09/10,504,10,0.6935518079999999,9429,504,10,0
32808,2014/03/31,2013/03/13,19,5,0.830457201,7874,19,1,4
32809,2014/03/31,2012/06/16,76,9,0.727597374,8986,76,6,3
32810,2014/03/31,2011/06/18,155,7,0.786868456,8309,155,4,3
32811,2014/03/31,2011/06/22,37,10,0.647943508,10090,37,3,7
32812,2014/03/31,2008/06/16,165,6,0.629473329,10386,165,3,3
32813,2014/03/31,2013/03/22,185,4,0.731422018,8938,185,0,4
32814,2014/03/31,2013/01/01,361,7,0.639420914,10223,361,6,1
32815,2014/03/31,2006/12/15,147,3,0.7666666670000001,8526,147,0,3
32816,2014/03/31,2006/05/08,71,7,0.464649179,14067,71,4,3
32817,2014/03/31,2005/10/31,229,7,0.643943842,10150,229,4,3
32818,2014/03/31,2012/12/13,45,6,0.7533333329999999,8676,45,1,5
32819,2014/03/31,2012/12/02,34,9,0.94828787,6892,34,2,7
32820,2014/03/31,2010/06/06,493,5,0.889425694,7348,493,5,0
32821,2014/03/31,2008/03/25,84,11,0.686556361,9519,84,6,5
32822,2014/03/31,2013/02/11,1,10,0.6945743440000001,9409,1,1,9
32823,2014/03/31,2009/04/13,622,4,0.941778354,6939,622,4,0
32824,2014/03/31,2010/06/20,497,4,0.490732953,13316,497,4,0
32825,2014/03/31,2012/01/13,292,8,0.5495676310000001,11888,292,5,3
32826,2014/03/31,2010/12/13,7,9,0.7414890479999999,8811,7,7,2
32827,2014/03/31,2008/01/06,60,7,0.69390547,9415,60,3,4
32828,2014/03/31,2012/03/06,278,8,0.645924461,10114,278,7,1
32829,2014/03/31,2013/03/07,346,4,0.8125,8040,346,2,2
32830,2014/03/31,2011/05/08,59,7,0.714718757,9138,59,4,3
32831,2014/03/31,2008/03/01,7,9,0.70226129,9300,7,3,6
32832,2014/03/31,2011/03/15,195,7,0.652766617,10005,195,3,4
32833,2014/03/31,2013/03/19,158,6,0.718189816,9093,158,2,4
32834,2014/03/31,2008/09/12,123,10,0.615254381,10614,123,6,4
32835,2014/03/31,2011/11/19,358,5,0.7613734409999999,8577,358,4,1
32836,2014/03/31,2008/11/29,105,11,0.5955513000000001,10965,105,5,6
32837,2014/03/31,2012/12/04,159,6,0.51,12804,159,0,6
32838,2014/03/31,2010/08/28,184,3,0.684556033,9539,184,0,3
32839,2014/03/31,2008/03/05,149,8,0.699658165,9332,149,2,6
32840,2014/03/31,2006/12/14,403,4,0.6363742689999999,10260,403,4,0
32841,2014/03/31,2013/03/01,2,6,0.8015222190000001,8146,2,2,4
32842,2014/03/31,2005/05/08,130,7,0.7150821470000001,9130,130,1,6
32843,2014/03/31,2009/08/08,4,6,0.749733578,8708,4,1,5
32844,2014/03/31,2013/02/08,260,7,0.661857259,9864,260,4,3
32845,2014/03/31,2012/01/26,57,4,0.908863984,7183,57,3,1
32846,2014/03/31,2010/02/22,291,7,0.508480293,12838,291,5,2
32847,2014/03/31,2006/05/02,211,5,0.476011814,13713,211,3,2
32848,2014/03/31,2007/06/07,131,6,0.8072372,8086,131,3,3
32849,2014/03/31,2007/11/29,141,7,0.7636901840000001,8547,141,3,4
32850,2014/03/31,2010/07/02,23,18,0.5225900720000001,12490,23,5,13
32851,2014/03/31,2005/11/30,84,4,0.7975,8184,84,2,2
32852,2014/03/31,2012/02/24,142,7,0.5092562820000001,12814,142,6,1
32853,2014/03/31,2012/07/06,4,5,0.79579095,8199,4,1,4
32854,2014/03/31,2012/10/30,31,8,0.789037368,8269,31,3,5
32855,2014/03/31,2013/02/13,166,8,0.827754377,7882,166,1,7
32856,2014/03/31,2008/02/19,219,10,0.631378109,10333,219,6,4
32857,2014/03/31,2009/11/28,83,11,0.5864653000000001,11124,83,9,2
32858,2014/03/31,2011/01/24,227,6,0.600948038,10854,227,4,2
32859,2014/03/31,2009/11/10,30,16,0.8006923640000001,8146,30,5,11
32860,2014/03/31,2012/08/23,91,8,0.582825485,11191,91,6,2
32861,2014/03/31,2012/09/16,218,4,0.510040663,12788,218,1,3
32862,2014/03/31,2010/12/29,67,9,0.663686781,9827,67,0,9
32863,2014/03/31,2007/12/24,17,4,0.785,8308,17,0,4
32864,2014/03/31,2011/03/09,140,9,0.646422837,10089,140,5,4
32865,2014/03/31,2012/12/15,130,8,0.65099421,10018,130,2,6
32866,2014/03/31,2008/02/13,46,6,0.832796935,7830,46,2,4
32867,2014/03/31,2011/10/05,20,5,0.7253676720000001,8989,20,2,3
32868,2014/03/31,2008/03/24,34,5,0.755593927,8629,34,0,5
32869,2014/03/31,2012/03/26,502,4,0.536581351,12151,502,4,0
32870,2014/03/31,2011/01/24,83,8,0.785152355,8303,83,6,2
32871,2014/03/31,2006/04/14,358,8,0.593238693,10989,358,5,3
32872,2014/03/31,2012/08/25,332,4,0.752864072,8659,332,3,1
32873,2014/03/31,2009/04/14,48,13,0.6322199589999999,10311,48,7,6
32874,2014/03/31,2012/05/07,123,11,0.659115268,9890,123,1,10
32875,2014/03/31,2012/04/12,204,5,0.601988364,10828,204,4,1
32876,2014/03/31,2011/04/24,9,4,0.75506835,8632,9,0,4
32877,2014/03/31,2008/07/17,19,5,0.640539611,10174,19,0,5
32878,2014/03/31,2012/08/23,11,9,0.729491772,8933,11,7,2
32879,2014/03/31,2012/05/04,80,8,0.8025,8120,80,5,3
32880,2014/03/31,2007/02/09,101,7,0.6416563270000001,10155,101,4,3
32881,2014/03/31,2011/12/05,115,3,0.755110673,8629,115,2,1
32882,2014/03/31,2011/06/10,81,9,0.601642659,10830,81,3,6
32883,2014/03/31,2010/08/12,103,6,0.99845977,6525,103,0,6
32884,2014/03/31,2011/06/21,101,9,0.6000571060000001,10857,101,6,3
32885,2014/03/31,2009/01/22,342,10,0.45875,14200,342,8,2
32886,2014/03/31,2012/06/19,134,8,0.6385950979999999,10200,134,3,5
32887,2014/03/31,2012/02/17,15,5,0.520378685,12517,15,0,5
32888,2014/03/31,2011/09/18,84,7,0.76062011,8563,84,5,2
32889,2014/03/31,2010/12/15,17,8,0.67930941,9586,17,5,3
32890,2014/03/31,2012/02/08,478,9,0.8102276970000001,8037,478,9,0
32891,2014/03/31,2008/07/27,533,7,0.933820998,6972,533,7,0
32892,2014/03/31,2009/06/05,682,6,0.914788534,7117,682,6,0
32893,2014/03/31,2013/01/13,207,4,0.7868382890000001,8274,207,2,2
32894,2014/03/31,2007/06/22,48,10,0.846798907,7688,48,5,5
32895,2014/03/31,2012/09/03,557,4,0.7422243759999999,8771,557,4,0
32896,2014/03/31,2010/02/27,275,11,0.86776193,7502,275,7,4
32897,2014/03/31,2012/03/16,210,7,0.897380755,7254,210,6,1
32898,2014/03/31,2013/02/14,61,5,0.6941889729999999,9377,61,0,5
32899,2014/03/31,2011/07/09,69,5,0.8939027740000001,7282,69,3,2
32900,2014/03/31,2006/11/12,188,6,0.960070796,6780,188,2,4
32901,2014/03/31,2012/05/21,300,8,0.7630101979999999,8531,300,5,3
32902,2014/03/31,2008/07/05,66,10,0.724221653,8987,66,4,6
32903,2014/03/31,2011/07/08,268,8,0.8159302909999999,7976,268,7,1
32904,2014/03/31,2007/09/24,14,7,0.7120811909999999,9139,14,2,5
32905,2014/03/31,2010/02/13,27,15,0.557587182,11671,27,1,14
32906,2014/03/31,2011/08/16,502,7,1.0,6507,502,7,0
32907,2014/03/31,2008/10/10,148,12,0.696373074,9344,148,6,6
32908,2014/03/31,2008/03/31,97,5,1.443954727,4506,97,0,5
32909,2014/03/31,2006/11/13,44,5,0.611737495,10636,44,2,3
32910,2014/03/31,2007/06/20,44,11,0.5827272729999999,11165,44,0,11
32911,2014/03/31,2007/04/12,67,8,0.778967912,8352,67,5,3
32912,2014/03/31,2008/06/24,19,10,0.603981989,10771,19,0,10
32913,2014/03/31,2012/12/14,173,5,0.693338307,9382,173,2,3
32914,2014/03/31,2012/09/19,208,8,0.621365113,10468,208,1,7
32915,2014/03/31,2009/06/07,250,3,0.719469027,9040,250,2,1
32916,2014/03/31,2006/11/13,79,4,0.7646890059999999,8505,79,2,2
32917,2014/03/31,2012/05/08,361,9,0.651011011,9990,361,7,2
32918,2014/03/31,2013/03/01,116,6,0.832080348,7816,116,2,4
32919,2014/03/31,2008/09/09,418,9,0.755138179,8612,418,9,0
32920,2014/03/31,2010/10/12,114,9,0.489016393,13298,114,5,4
32921,2014/03/31,2012/07/14,285,5,0.780821326,8328,285,0,5
32922,2014/03/31,2009/11/10,324,5,0.6716174340000001,9682,324,1,4
32923,2014/03/31,2012/06/13,574,5,0.742209793,8761,574,5,0
32924,2014/03/31,2013/01/01,32,5,0.59302052,10965,32,0,5
32925,2014/03/31,2012/10/07,49,6,0.844677838,7698,49,2,4
32926,2014/03/31,2012/02/27,25,10,0.4200116270000001,15481,25,5,5
32927,2014/03/31,2006/10/24,124,7,0.766978884,8477,124,4,3
32928,2014/03/31,2010/10/09,39,9,0.930339153,6988,39,8,1
32929,2014/03/31,2008/10/16,136,6,0.759917008,8555,136,5,1
32930,2014/03/31,2011/09/29,257,6,0.828333333,7848,257,5,1
32931,2014/03/31,2009/05/20,123,8,0.591287975,10994,123,5,3
32932,2014/03/31,2011/05/22,488,7,0.701933045,9260,488,7,0
32933,2014/03/31,2012/09/29,43,4,0.672156153,9670,43,0,4
32934,2014/03/31,2009/12/31,32,8,0.694336075,9361,32,3,5
32935,2014/03/31,2009/11/17,165,4,0.87133664,7459,165,1,3
32936,2014/03/31,2006/09/27,135,5,0.622160636,10446,135,2,3
32937,2014/03/31,2012/01/21,475,6,0.699005055,9297,475,6,0
32938,2014/03/31,2008/10/18,191,9,0.6666800039999999,9747,191,2,7
32939,2014/03/31,2012/02/22,6,9,0.912746172,7119,6,4,5
32940,2014/03/31,2010/07/18,199,8,0.8034623470000001,8087,199,1,7
32941,2014/03/31,2012/10/28,21,10,0.660642603,9835,21,1,9
32942,2014/03/31,2012/01/21,286,11,0.923539446,7035,286,8,3
32943,2014/03/31,2012/11/06,12,17,0.568965759,11419,12,4,13
32944,2014/03/31,2011/11/14,424,5,0.73,8900,424,5,0
32945,2014/03/31,2010/10/15,14,4,0.7192416690000001,9033,14,2,2
32946,2014/03/31,2011/05/26,258,9,0.818769851,7934,258,6,3
32947,2014/03/31,2011/06/30,71,8,0.56625,11472,71,2,6
32948,2014/03/31,2011/07/08,159,9,0.556256208,11678,159,8,1
32949,2014/03/31,2007/08/29,30,2,1.086826167,5977,30,0,2
32950,2014/03/31,2012/09/05,571,2,1.0,6495,571,2,0
32951,2014/03/31,2009/08/11,135,9,0.850430797,7637,135,6,3
32952,2014/03/31,2012/07/16,91,7,0.492844134,13178,91,5,2
32953,2014/03/31,2013/01/16,254,7,0.733344625,8856,254,5,2
32954,2014/03/31,2012/08/01,155,6,0.620869981,10460,155,3,3
32955,2014/03/31,2011/11/08,460,6,0.808333333,8034,460,6,0
32956,2014/03/31,2012/09/14,175,9,0.589180729,11022,175,7,2
32957,2014/03/31,2012/06/28,181,10,0.941,6900,181,5,5
32958,2014/03/31,2012/11/03,3,8,0.932887931,6960,3,4,4
32959,2014/03/31,2010/02/25,32,10,0.718108616,9041,32,7,3
32960,2014/03/31,2012/11/06,247,9,0.5033602110000001,12898,247,1,8
32961,2014/03/31,2011/04/12,626,2,0.8472983559999999,7662,626,2,0
32962,2014/03/31,2012/01/02,44,6,0.638333333,10170,44,2,4
32963,2014/03/31,2011/11/23,74,5,0.670125942,9687,74,2,3
32964,2014/03/31,2012/06/03,417,5,0.66,9835,417,5,0
32965,2014/03/31,2010/01/01,4,11,0.634917343,10223,4,6,5
32966,2014/03/31,2011/05/14,459,5,0.8422982090000001,7706,459,5,0
32967,2014/03/31,2004/11/14,85,6,0.899602218,7215,85,0,6
32968,2014/03/31,2011/12/30,7,8,0.7015348029999999,9252,7,2,6
32969,2014/03/31,2008/01/17,12,10,0.6746798340000001,9620,12,1,9
32970,2014/03/31,2010/10/19,623,4,0.818630172,7928,623,4,0
32971,2014/03/31,2007/06/16,98,9,0.746577706,8693,98,0,9
32972,2014/03/31,2009/02/24,224,6,0.968331841,6702,224,3,3
32973,2014/03/31,2009/10/10,274,8,0.5331712129999999,12172,274,4,4
32974,2014/03/31,2012/07/05,113,6,0.7866278790000001,8250,113,2,4
32975,2014/03/31,2005/08/30,324,4,0.573826156,11309,324,3,1
32976,2014/03/31,2013/02/15,35,5,0.398,16305,35,2,3
32977,2014/03/31,2006/06/16,57,10,0.6989873959999999,9283,57,4,6
32978,2014/03/31,2012/11/20,18,8,0.630212725,10295,18,2,6
32979,2014/03/31,2012/04/20,682,3,1.0,6487,682,3,0
32980,2014/03/31,2012/01/16,310,6,0.6621682320000001,9796,310,4,2
32981,2014/03/31,2009/09/15,411,6,0.7915547959999999,8194,411,6,0
32982,2014/03/31,2008/12/10,3,6,0.765033027,8478,3,1,5
32983,2014/03/31,2007/07/07,3,8,0.706982448,9173,3,4,4
32984,2014/03/31,2008/01/13,1,7,0.774153038,8377,1,1,6
32985,2014/03/31,2011/11/11,104,8,0.624102021,10390,104,0,8
32986,2014/03/31,2013/03/02,45,8,0.7616173359999999,8514,45,2,6
32987,2014/03/31,2009/11/25,321,5,0.688563237,9417,321,4,1
32988,2014/03/31,2005/08/05,369,5,0.912325876,7107,369,5,0
32989,2014/03/31,2010/01/16,293,5,0.753412735,8606,293,3,2
32990,2014/03/31,2012/06/02,313,10,0.599791859,10810,313,8,2
32991,2014/03/31,2008/06/07,100,8,0.367886972,17624,100,0,8
32992,2014/03/31,2010/02/06,95,9,0.8458630140000001,7665,95,1,8
32993,2014/03/31,2010/01/16,190,6,0.86978535,7454,190,4,2
32994,2014/03/31,2012/08/30,412,5,0.68726145,9432,412,5,0
32995,2014/03/31,2011/09/15,13,12,0.501564531,12924,13,10,2
32996,2014/03/31,2009/12/09,23,10,0.436819867,14839,23,0,10
32997,2014/03/31,2011/09/30,24,9,0.64283249,10083,24,1,8
32998,2014/03/31,2010/01/20,4,8,0.6240088570000001,10387,4,2,6
32999,2014/03/31,2012/11/25,195,4,0.6084791589999999,10652,195,3,1
33000,2014/03/31,2012/05/23,346,4,0.5201685389999999,12460,346,2,2
33001,2014/03/31,2006/07/16,97,10,0.616840853,10506,97,3,7
33002,2014/03/31,2011/09/13,68,7,0.613147885,10569,68,1,6
33003,2014/03/31,2008/12/21,404,8,0.659531807,9825,404,8,0
33004,2014/03/31,2011/04/14,105,8,0.8163915840000001,7937,105,6,2
33005,2014/03/31,2012/05/16,253,7,0.597336591,10847,253,5,2
33006,2014/03/31,2005/08/12,16,11,0.4853265920000001,13350,16,4,7
33007,2014/03/31,2009/09/14,112,10,0.533550194,12143,112,5,5
33008,2014/03/31,2011/08/05,15,7,0.64664737,10019,15,3,4
33009,2014/03/31,2010/11/01,7,11,0.5027035,12887,7,4,7
33010,2014/03/31,2011/09/15,142,8,0.5899899820000001,10980,142,4,4
33011,2014/03/31,2012/06/12,460,10,0.507084149,12775,460,10,0
33012,2014/03/31,2012/08/12,14,10,0.900109783,7196,14,3,7
33013,2014/03/31,2007/09/18,9,6,0.802024517,8076,9,4,2
33014,2014/03/31,2008/09/27,103,11,0.558217702,11603,103,7,4
33015,2014/03/31,2006/11/01,76,6,0.796666667,8130,76,1,5
33016,2014/03/31,2012/02/03,152,8,0.623365736,10390,152,2,6
33017,2014/03/31,2006/05/18,47,3,0.673333333,9618,47,1,2
33018,2014/03/31,2011/07/26,402,6,0.7537302140000001,8592,402,6,0
33019,2014/03/31,2010/11/25,473,3,0.942728199,6869,473,3,0
33020,2014/03/31,2012/04/25,523,3,0.816666667,7929,523,3,0
33021,2014/03/31,2010/12/19,231,3,0.816666667,7929,231,1,2
33022,2014/03/31,2011/08/05,4,9,0.610825472,10600,4,1,8
33023,2014/03/31,2005/11/13,201,5,0.54087218,11970,201,2,3
33024,2014/03/31,2012/08/24,212,6,0.692414973,9350,212,2,4
33025,2014/03/31,2010/04/02,256,6,0.7708263870000001,8398,256,1,5
33026,2014/03/31,2009/01/23,382,6,0.664862366,9736,382,6,0
33027,2014/03/31,2007/11/07,378,4,0.844267641,7667,378,4,0
33028,2014/03/31,2007/03/18,26,5,0.727463475,8898,26,0,5
33029,2014/03/31,2011/08/29,199,6,0.634892594,10195,199,2,4
33030,2014/03/31,2010/11/28,66,4,0.7751257490000001,8350,66,2,2
33031,2014/03/31,2012/03/05,528,9,0.619467841,10448,528,9,0
33032,2014/03/31,2005/12/28,36,6,0.718298557,9010,36,0,6
33033,2014/03/31,2009/03/06,25,9,0.580353332,11151,25,3,6
33034,2014/03/31,2011/07/27,118,7,0.7534648970000001,8589,118,4,3
33035,2014/03/31,2006/04/30,62,4,0.8225,7868,62,0,4
33036,2014/03/31,2007/12/24,75,4,0.8225,7868,75,0,4
33037,2014/03/31,2010/09/24,384,3,1.322771872,4892,384,3,0
33038,2014/03/31,2011/09/09,143,4,0.923232986,7009,143,0,4
33039,2014/03/31,2007/08/17,60,9,0.751178314,8614,60,4,5
33040,2014/03/31,2011/07/05,274,8,0.637053264,10157,274,6,2
33041,2014/03/31,2010/11/26,619,4,0.75,8626,619,4,0
33042,2014/03/31,2006/05/15,197,7,0.648265357,9979,197,3,4
33043,2014/03/31,2010/08/06,107,6,0.608650734,10628,107,4,2
33044,2014/03/31,2012/10/01,315,5,0.588750341,10987,315,3,2
33045,2014/03/31,2010/09/21,484,3,1.5,4312,484,3,0
33046,2014/03/31,2008/10/08,341,17,0.602941176,10727,341,16,1
33047,2014/03/31,2013/03/12,157,5,0.85054708,7604,157,1,4
33048,2014/03/31,2010/03/01,44,12,0.7381145859999999,8762,44,6,6
33049,2014/03/31,2013/02/11,44,4,0.8428528609999999,7673,44,1,3
33050,2014/03/31,2011/08/13,29,7,0.66711471,9694,29,4,3
33051,2014/03/31,2012/01/26,38,8,0.558643629,11575,38,1,7
33052,2014/03/31,2010/10/06,230,7,0.722671286,8947,230,6,1
33053,2014/03/31,2010/09/19,257,4,0.6330590660000001,10209,257,0,4
33054,2014/03/31,2013/01/12,5,6,0.730154785,8851,5,2,4
33055,2014/03/31,2012/12/14,261,8,0.7775,8312,261,5,3
33056,2014/03/31,2013/02/09,137,7,0.612788735,10546,137,1,6
33057,2014/03/31,2012/03/06,25,6,0.513333333,12588,25,1,5
33058,2014/03/31,2005/04/04,168,8,0.930527074,6944,168,5,3
33059,2014/03/31,2012/04/17,2,6,0.685205726,9430,2,2,4
33060,2014/03/31,2008/08/22,580,3,0.739713795,8735,580,3,0
33061,2014/03/31,2011/06/22,613,3,0.820510541,7874,613,3,0
33062,2014/03/31,2011/10/30,327,10,0.946658851,6824,327,6,4
33063,2014/03/31,2006/06/14,109,6,0.727124043,8884,109,3,3
33064,2014/03/31,2012/04/04,38,8,0.623094434,10367,38,5,3
33065,2014/03/31,2008/12/05,34,7,0.748848829,8626,34,2,5
33066,2014/03/31,2012/09/24,4,5,0.622,10385,4,0,5
33067,2014/03/31,2008/07/14,89,15,0.490050831,13181,89,5,10
33068,2014/03/31,2011/09/26,99,6,0.7012593640000001,9211,99,4,2
33069,2014/03/31,2010/12/20,246,5,0.644244963,10026,246,3,2
33070,2014/03/31,2010/07/21,192,7,0.665190525,9710,192,2,5
33071,2014/03/31,2009/02/28,1,13,0.6966091459999999,9272,1,5,8
33072,2014/03/31,2012/10/16,218,8,0.5033769779999999,12831,218,6,2
33073,2014/03/31,2011/08/17,14,6,0.451950451,14289,14,5,1
33074,2014/03/31,2012/04/12,179,8,0.63179728,10221,179,3,5
33075,2014/03/31,2009/06/30,8,7,0.693091456,9316,8,1,6
33076,2014/03/31,2011/05/27,72,9,0.639656231,10094,72,2,7
33077,2014/03/31,2008/09/16,4,13,0.68411316,9438,4,2,11
33078,2014/03/31,2012/12/04,104,10,0.631660307,10221,104,7,3
33079,2014/03/31,2009/03/11,11,10,0.606266316,10649,11,4,6
33080,2014/03/31,2007/02/06,114,4,0.618743531,10434,114,2,2
33081,2014/03/31,2007/05/09,37,18,0.623375821,10356,37,8,10
33082,2014/03/31,2012/10/29,49,4,0.7155758790000001,9021,49,1,3
33083,2014/03/31,2011/01/15,289,7,0.8156558,7914,289,6,1
33084,2014/03/31,2011/06/24,232,11,0.8494538759999999,7599,232,6,5
33085,2014/03/31,2013/02/27,43,4,0.793638264,8133,43,3,1
33086,2014/03/31,2012/09/29,184,7,0.8004836909999999,8063,184,4,3
33087,2014/03/31,2008/06/24,35,7,0.67211935,9602,35,5,2
33088,2014/03/31,2007/02/01,40,7,0.491841323,13121,40,6,1
33089,2014/03/31,2011/12/07,219,5,0.782799612,8244,219,4,1
33090,2014/03/31,2010/12/09,253,5,0.721764903,8941,253,0,5
33091,2014/03/31,2008/02/04,116,5,0.9005401259999999,7165,116,1,4
33092,2014/03/31,2013/03/22,68,4,0.82,7868,68,0,4
33093,2014/03/31,2011/01/15,10,6,0.546666667,11802,10,0,6
33094,2014/03/31,2011/08/14,93,16,0.60214299,10714,93,7,9
33095,2014/03/31,2006/06/23,105,6,0.7164749,9004,105,0,6
33096,2014/03/31,2012/01/05,291,9,0.774978376,8324,291,8,1
33097,2014/03/31,2010/07/14,105,9,0.8009411470000001,8054,105,4,5
33098,2014/03/31,2011/09/15,19,4,0.67565099,9547,19,2,2
33099,2014/03/31,2011/05/07,388,6,0.816869301,7896,388,6,0
33100,2014/03/31,2012/06/24,580,5,0.631609871,10212,580,5,0
33101,2014/03/31,2011/08/01,308,4,1.0,6450,308,2,2
33102,2014/03/31,2007/10/30,290,7,0.844790411,7634,290,2,5
33103,2014/03/31,2009/09/04,106,13,0.795297817,8109,106,5,8
33104,2014/03/31,2012/07/28,128,6,0.508119288,12692,128,5,1
33105,2014/03/31,2012/10/22,248,6,0.740213523,8711,248,3,3
33106,2014/03/31,2009/07/24,187,4,1.062197694,6070,187,1,3
33107,2014/03/31,2011/08/08,438,4,1.0,6447,438,4,0
33108,2014/03/31,2010/01/12,8,13,0.683019708,9438,8,6,7
33109,2014/03/31,2011/07/31,34,8,0.7168153009999999,8993,34,5,3
33110,2014/03/31,2013/01/03,309,6,0.468153098,13769,309,4,2
33111,2014/03/31,2006/08/10,5,6,0.561106468,11487,5,0,6
33112,2014/03/31,2011/07/12,92,9,0.531883149,12118,92,7,2
33113,2014/03/31,2012/07/23,604,3,0.7,9207,604,3,0
33114,2014/03/31,2011/12/13,49,4,0.7112724859999999,9061,49,2,2
33115,2014/03/31,2007/04/12,231,6,0.6889223859999999,9354,231,4,2
33116,2014/03/31,2012/08/13,32,7,0.5391249060000001,11953,32,3,4
33117,2014/03/31,2012/11/06,20,14,0.592320279,10878,20,6,8
33118,2014/03/31,2012/09/21,6,8,0.578137114,11144,6,3,5
33119,2014/03/31,2009/03/03,603,4,0.921132399,6994,603,4,0
33120,2014/03/31,2011/11/11,107,8,0.9001341340000001,7157,107,7,1
33121,2014/03/31,2007/09/30,197,9,0.643805717,10006,197,3,6
33122,2014/03/31,2012/09/10,74,8,0.6203495760000001,10384,74,2,6
33123,2014/03/31,2012/09/21,30,5,0.828822697,7772,30,1,4
33124,2014/03/31,2007/09/08,177,9,0.46124096,13965,177,6,3
33125,2014/03/31,2011/05/17,83,3,1.026666667,6273,83,1,2
33126,2014/03/31,2010/07/16,26,10,0.46983585,13707,26,5,5
33127,2014/03/31,2010/02/23,14,8,0.7151593559999999,9005,14,3,5
33128,2014/03/31,2012/03/01,3,7,0.5926467879999999,10866,3,2,5
33129,2014/03/31,2005/10/13,81,6,0.5790432520000001,11121,81,1,5
33130,2014/03/31,2011/02/11,33,4,0.7289268729999999,8834,33,2,2
33131,2014/03/31,2008/09/08,416,4,0.727094625,8856,416,4,0
33132,2014/03/31,2009/10/24,73,5,0.763082484,8438,73,3,2
33133,2014/03/31,2008/05/21,366,7,0.547741194,11754,366,6,1
33134,2014/03/31,2005/04/19,62,4,0.90972022,7077,62,0,4
33135,2014/03/31,2011/01/09,1,7,0.603804164,10662,1,6,1
33136,2014/03/31,2010/04/25,259,5,0.809161534,7955,259,3,2
33137,2014/03/31,2012/03/01,18,6,0.856715027,7513,18,0,6
33138,2014/03/31,2012/02/10,213,5,0.5066333439999999,12704,213,3,2
33139,2014/03/31,2006/11/10,52,2,1.41,4564,52,0,2
33140,2014/03/31,2013/02/17,340,4,0.750279818,8577,340,3,1
33141,2014/03/31,2008/07/25,4,10,0.476841793,13495,4,4,6
33142,2014/03/31,2011/09/05,214,6,0.568333333,11322,214,3,3
33143,2014/03/31,2007/06/23,185,4,0.618081099,10407,185,1,3
33144,2014/03/31,2004/11/20,32,3,1.09,5901,32,1,2
33145,2014/03/31,2011/12/06,74,8,0.7450480709999999,8633,74,6,2
33146,2014/03/31,2012/02/16,105,6,0.637321375,10091,105,4,2
33147,2014/03/31,2008/11/04,13,10,0.609943085,10542,13,5,5
33148,2014/03/31,2006/05/15,652,4,1.0,6430,652,4,0
33149,2014/03/31,2007/10/27,25,5,0.8187928179999999,7853,25,0,5
33150,2014/03/31,2007/04/11,138,8,0.729911454,8809,138,1,7
33151,2014/03/31,2007/04/23,62,10,0.624238835,10300,62,3,7
33152,2014/03/31,2011/09/08,311,7,0.779918729,8244,311,4,3
33153,2014/03/31,2009/06/20,272,9,0.646647556,9942,272,7,2
33154,2014/03/31,2012/05/26,652,6,0.647753149,9925,652,6,0
33155,2014/03/31,2009/11/13,134,14,0.83165718,7730,134,9,5
33156,2014/03/31,2006/07/15,186,5,0.83175055,7729,186,2,3
33157,2014/03/31,2010/04/07,44,7,0.509048147,12628,44,3,4
33158,2014/03/31,2013/03/08,40,9,0.7874727429999999,8163,40,2,7
33159,2014/03/31,2008/09/12,65,9,0.833363153,7713,65,7,2
33160,2014/03/31,2013/03/12,332,3,0.929904514,6912,332,0,3
33161,2014/03/31,2012/10/09,63,6,0.59528758,10797,63,0,6
33162,2014/03/31,2009/08/21,77,7,0.95110404,6757,77,2,5
33163,2014/03/31,2012/05/23,33,13,0.7330838559999999,8765,33,6,7
33164,2014/03/31,2008/05/07,216,4,0.5415854689999999,11864,216,2,2
33165,2014/03/31,2010/06/05,172,4,0.545348837,11782,172,2,2
33166,2014/03/31,2007/04/24,93,5,0.744350093,8632,93,2,3
33167,2014/03/31,2007/10/10,50,8,0.550535561,11670,50,6,2
33168,2014/03/31,2012/07/11,18,6,0.647131346,9928,18,2,4
33169,2014/03/31,2009/03/31,328,4,0.8457872559999999,7596,328,3,1
33170,2014/03/31,2013/01/12,338,5,0.7799902870000001,8236,338,3,2
33171,2014/03/31,2012/11/06,19,11,0.450457191,14261,19,5,6
33172,2014/03/31,2006/06/24,155,3,0.616615148,10417,155,0,3
33173,2014/03/31,2007/09/12,143,8,0.62452212,10285,143,4,4
33174,2014/03/31,2011/01/09,17,7,0.837548572,7669,17,1,6
33175,2014/03/31,2010/04/01,379,4,0.5964524520000001,10768,379,4,0
33176,2014/03/31,2010/03/15,229,8,0.8809753090000001,7290,229,4,4
33177,2014/03/31,2010/05/01,444,7,0.7112913940000001,9029,444,7,0
33178,2014/03/31,2008/07/02,67,10,0.719617884,8924,67,7,3
33179,2014/03/31,2011/08/30,6,8,0.6861384759999999,9359,6,2,6
33180,2014/03/31,2011/06/19,258,5,0.657113181,9772,258,2,3
33181,2014/03/31,2008/02/26,68,5,0.7692152870000001,8347,68,2,3
33182,2014/03/31,2012/09/06,22,10,0.597678272,10742,22,4,6
33183,2014/03/31,2007/03/24,40,10,0.7075796320000001,9073,40,5,5
33184,2014/03/31,2013/03/06,37,10,0.740104911,8674,37,3,7
33185,2014/03/31,2009/03/07,31,10,0.657314151,9766,31,4,6
33186,2014/03/31,2010/12/06,83,2,0.803821688,7986,83,0,2
33187,2014/03/31,2013/02/06,48,5,0.534626468,12007,48,1,4
33188,2014/03/31,2006/01/30,601,4,0.901165239,7123,601,4,0
33189,2014/03/31,2009/11/01,179,8,0.5956607279999999,10776,179,2,6
33190,2014/03/31,2011/06/29,30,5,0.7711136470000001,8324,30,1,4
33191,2014/03/31,2012/09/13,81,10,0.742433777,8645,81,0,10
33192,2014/03/31,2007/04/19,8,8,0.893037429,7187,8,3,5
33193,2014/03/31,2012/02/27,232,4,0.969928971,6617,232,2,2
33194,2014/03/31,2011/08/22,7,8,0.547050801,11732,7,5,3
33195,2014/03/31,2010/06/04,14,7,0.504998426,12708,14,2,5
33196,2014/03/31,2009/09/10,446,4,1.5,4278,446,4,0
33197,2014/03/31,2012/11/03,200,5,1.055431814,6079,200,0,5
33198,2014/03/31,2006/10/23,2,7,0.543860303,11797,2,4,3
33199,2014/03/31,2011/03/07,410,4,0.806892215,7951,410,4,0
33200,2014/03/31,2007/04/03,32,6,0.6610995470000001,9704,32,3,3
33201,2014/03/31,2011/02/21,151,6,0.73250628,8758,151,5,1
33202,2014/03/31,2005/06/17,254,2,0.730097883,8786,254,1,1
33203,2014/03/31,2009/09/02,262,8,0.5993786210000001,10702,262,7,1
33204,2014/03/31,2005/12/13,228,8,0.794937415,8069,228,5,3
33205,2014/03/31,2012/09/03,25,6,0.5481302339999999,11702,25,1,5
33206,2014/03/31,2008/05/04,153,8,0.525828005,12198,153,4,4
33207,2014/03/31,2008/09/13,458,8,0.521677241,12294,458,8,0
33208,2014/03/31,2007/11/14,29,6,0.5487131,11687,29,3,3
33209,2014/03/31,2011/11/01,256,5,0.715940605,8957,256,4,1
33210,2014/03/31,2010/04/18,198,4,0.815,7868,198,0,4
33211,2014/03/31,2010/04/16,65,6,0.68867655,9309,65,3,3
33212,2014/03/31,2012/08/03,86,7,0.6798642490000001,9429,86,3,4
33213,2014/03/31,2011/04/06,32,4,0.7732677929999999,8290,32,2,2
33214,2014/03/31,2011/09/14,81,8,0.880403791,7281,81,5,3
33215,2014/03/31,2012/06/03,258,16,0.5396699779999999,11878,258,10,6
33216,2014/03/31,2012/07/08,1,8,0.72896736,8793,1,6,2
33217,2014/03/31,2009/12/13,153,6,0.750526932,8540,153,3,3
33218,2014/03/31,2012/09/19,92,4,0.69,9288,92,2,2
33219,2014/03/31,2010/11/19,170,6,0.833050825,7693,170,2,4
33220,2014/03/31,2011/05/24,12,7,0.6108034689999999,10492,12,6,1
33221,2014/03/31,2012/07/22,196,9,0.502630795,12749,196,5,4
33222,2014/03/31,2009/01/22,354,4,0.795691047,8053,354,3,1
33223,2014/03/31,2011/04/18,21,9,0.842573645,7604,21,3,6
33224,2014/03/31,2010/07/05,663,2,0.875,7322,663,2,0
33225,2014/03/31,2012/12/15,84,7,0.625272301,10246,84,0,7
33226,2014/03/31,2012/08/19,138,3,1.030806114,6215,138,1,2
33227,2014/03/31,2008/11/17,85,10,0.645607175,9923,85,2,8
33228,2014/03/31,2009/01/09,205,2,0.835,7672,205,0,2
33229,2014/03/31,2013/03/02,169,13,0.653128059,9808,169,2,11
33230,2014/03/31,2012/05/07,24,5,0.7232972,8856,24,2,3
33231,2014/03/31,2007/04/01,7,12,0.555959552,11521,7,6,6
33232,2014/03/31,2007/02/06,555,5,0.932872124,6866,555,5,0
33233,2014/03/31,2013/01/29,286,8,0.7427577409999999,8623,286,4,4
33234,2014/03/31,2007/04/09,216,4,0.693453876,9236,216,3,1
33235,2014/03/31,2012/12/02,135,4,0.852146088,7516,135,3,1
33236,2014/03/31,2007/03/19,244,5,0.639573597,10014,244,2,3
33237,2014/03/31,2008/04/21,12,11,0.57394211,11159,12,5,6
33238,2014/03/31,2012/10/01,150,5,0.6828563809999999,9379,150,4,1
33239,2014/03/31,2011/10/01,213,4,0.827254877,7741,213,2,2
33240,2014/03/31,2012/04/10,694,5,0.643906486,9945,694,5,0
33241,2014/03/31,2012/07/06,61,10,0.823497942,7776,61,6,4
33242,2014/03/31,2009/07/20,18,12,0.7417713159999999,8632,18,3,9
33243,2014/03/31,2005/03/19,14,13,0.664277415,9639,14,3,10
33244,2014/03/31,2010/08/08,45,8,0.433664319,14764,45,4,4
33245,2014/03/31,2012/10/05,24,6,0.80312845,7972,24,1,5
33246,2014/03/31,2010/11/01,265,16,0.663748704,9646,265,9,7
33247,2014/03/31,2007/04/02,74,10,0.786912488,8136,74,6,4
33248,2014/03/31,2009/12/19,197,11,0.817319035,7833,197,6,5
33249,2014/03/31,2012/03/15,377,5,0.803470131,7968,377,5,0
33250,2014/03/31,2011/10/26,534,4,0.75,8536,534,4,0
33251,2014/03/31,2011/07/07,514,4,0.75,8536,514,4,0
33252,2014/03/31,2010/07/15,551,3,1.0,6402,551,3,0
33253,2014/03/31,2009/03/13,125,5,1.217246625,5259,125,3,2
33254,2014/03/31,2007/09/01,592,4,0.928346628,6895,592,4,0
33255,2014/03/31,2012/07/30,27,6,0.622036929,10290,27,0,6
33256,2014/03/31,2011/09/24,409,7,0.6832763959999999,9367,409,7,0
33257,2014/03/31,2008/04/17,365,3,1.2260919540000002,5220,365,2,1
33258,2014/03/31,2007/01/08,7,5,0.5232071620000001,12232,7,2,3
33259,2014/03/31,2011/10/20,18,2,1.268497522,5045,18,0,2
33260,2014/03/31,2008/12/03,197,6,0.857820375,7460,197,4,2
33261,2014/03/31,2012/05/16,13,7,0.616297794,10383,13,1,6
33262,2014/03/31,2012/10/09,66,6,0.513687084,12457,66,3,3
33263,2014/03/31,2012/04/06,272,7,0.602769405,10616,272,5,2
33264,2014/03/31,2007/11/19,487,5,0.541128964,11825,487,5,0
33265,2014/03/31,2013/02/12,3,9,0.540388514,11840,3,1,8
33266,2014/03/31,2012/08/01,102,3,0.9,7109,102,2,1
33267,2014/03/31,2011/12/15,177,4,0.7078335920000001,9038,177,2,2
33268,2014/03/31,2013/02/18,2,6,0.4931637370000001,12972,2,0,6
33269,2014/03/31,2006/07/23,7,14,0.514967799,12422,7,3,11
33270,2014/03/31,2011/10/31,22,8,0.612191597,10449,22,2,6
33271,2014/03/31,2008/09/26,214,6,0.718476918,8903,214,5,1
33272,2014/03/31,2012/11/11,60,3,0.701911555,9113,60,0,3
33273,2014/03/31,2012/01/23,327,5,0.6290146520000001,10169,327,2,3
33274,2014/03/31,2007/08/20,40,8,0.6567166320000001,9740,40,4,4
33275,2014/03/31,2005/12/09,10,7,0.530730999,12052,10,1,6
33276,2014/03/31,2011/02/26,45,3,0.806666667,7929,45,2,1
33277,2014/03/31,2007/09/03,67,5,0.68,9405,67,1,4
33278,2014/03/31,2011/09/13,436,4,0.5625,11368,436,4,0
33279,2014/03/31,2012/09/16,213,9,0.655226481,9758,213,5,4
33280,2014/03/31,2010/01/07,608,5,0.942021512,6787,608,5,0
33281,2014/03/31,2011/11/09,172,5,0.711705444,8983,172,1,4
33282,2014/03/31,2011/06/24,48,10,0.642599256,9949,48,6,4
33283,2014/03/31,2008/02/19,165,5,0.65,9835,165,1,4
33284,2014/03/31,2008/09/26,103,8,0.5562168279999999,11493,103,3,5
33285,2014/03/31,2012/11/02,24,8,0.6919517209999999,9238,24,0,8
33286,2014/03/31,2012/10/30,18,9,0.496256211,12880,18,1,8
33287,2014/03/31,2013/03/30,49,4,0.769513605,8306,49,0,4
33288,2014/03/31,2011/07/23,107,7,0.763400621,8372,107,6,1
33289,2014/03/31,2009/03/12,435,8,0.719059406,8888,435,8,0
33290,2014/03/31,2012/06/28,56,7,0.622945706,10259,56,5,2
33291,2014/03/31,2011/09/12,506,5,0.672042276,9509,506,5,0
33292,2014/03/31,2009/01/12,397,7,0.752590979,8491,397,7,0
33293,2014/03/31,2010/03/29,16,8,0.441381502,14477,16,3,5
33294,2014/03/31,2009/01/11,2,9,0.5378499870000001,11879,2,2,7
33295,2014/03/31,2010/04/26,310,4,0.928363848,6882,310,3,1
33296,2014/03/31,2013/03/09,58,5,0.736732011,8672,58,1,4
33297,2014/03/31,2007/03/31,336,11,0.8174129990000001,7816,336,10,1
33298,2014/03/31,2011/05/26,412,10,0.7077886109999999,9026,412,10,0
33299,2014/03/31,2006/11/01,177,4,0.72,8872,177,3,1
33300,2014/03/31,2012/11/01,349,2,1.5,4258,349,1,1
33301,2014/03/31,2007/09/17,191,6,0.890970982,7168,191,3,3
33302,2014/03/31,2012/11/14,175,11,0.718663065,8886,175,8,3
33303,2014/03/31,2010/12/17,417,6,0.959290972,6657,417,6,0
33304,2014/03/31,2012/10/01,122,6,0.542980189,11761,122,2,4
33305,2014/03/31,2011/02/28,165,7,0.991428571,6440,165,6,1
33306,2014/03/31,2006/08/28,241,3,1.109558568,5754,241,2,1
33307,2014/03/31,2008/11/19,43,9,0.477253495,13377,43,4,5
33308,2014/03/31,2010/10/29,17,6,0.487731683,13089,17,0,6
33309,2014/03/31,2012/05/16,509,8,0.484399423,13179,509,8,0
33310,2014/03/31,2012/02/05,34,10,0.612096078,10429,34,2,8
33311,2014/03/31,2010/03/14,94,9,0.646945373,9867,94,2,7
33312,2014/03/31,2013/03/04,39,4,0.600050761,10638,39,0,4
33313,2014/03/31,2011/10/19,80,6,0.663389108,9622,80,4,2
33314,2014/03/31,2006/09/07,18,8,0.392568125,16257,18,2,6
33315,2014/03/31,2009/11/27,207,8,0.845826375,7545,207,3,5
33316,2014/03/31,2006/10/08,6,12,0.436087878,14634,6,3,9
33317,2014/03/31,2009/01/20,15,6,0.5376978170000001,11867,15,0,6
33318,2014/03/31,2011/12/14,153,7,0.549217593,11618,153,6,1
33319,2014/03/31,2008/02/18,44,7,0.598504831,10661,44,3,4
33320,2014/03/31,2009/12/17,215,10,0.509262511,12529,215,8,2
33321,2014/03/31,2011/07/01,212,9,0.776253802,8219,212,6,3
33322,2014/03/31,2013/03/29,81,7,0.840650942,7589,81,2,5
33323,2014/03/31,2005/11/08,112,8,0.565918566,11273,112,6,2
33324,2014/03/31,2012/03/26,511,7,0.713841334,8937,511,7,0
33325,2014/03/31,2012/10/04,3,5,0.754340783,8457,3,1,4
33326,2014/03/31,2011/06/30,430,10,0.8864716509999999,7196,430,10,0
33327,2014/03/31,2011/04/18,31,7,0.663334027,9616,31,1,6
33328,2014/03/31,2009/11/05,590,2,1.153227265,5531,590,2,0
33329,2014/03/31,2012/02/22,197,3,0.846674632,7533,197,1,2
33330,2014/03/31,2012/11/14,37,11,0.5999858889999999,10630,37,7,4
33331,2014/03/31,2011/08/16,107,5,0.7101247079999999,8981,107,0,5
33332,2014/03/31,2006/09/07,345,6,0.6497859979999999,9813,345,4,2
33333,2014/03/31,2011/12/03,474,9,0.487630009,13076,474,9,0
33334,2014/03/31,2007/06/09,217,6,0.863736115,7382,217,2,4
33335,2014/03/31,2005/09/19,291,7,0.601035068,10608,291,6,1
33336,2014/03/31,2005/09/10,332,8,0.4854717120000001,13133,332,6,2
33337,2014/03/31,2008/07/26,129,8,0.888216773,7178,129,2,6
33338,2014/03/31,2007/06/11,68,11,0.84,7590,68,2,9
33339,2014/03/31,2013/01/12,83,11,0.73054658,8727,83,3,8
33340,2014/03/31,2010/03/23,77,10,0.7175239170000001,8885,77,4,6
33341,2014/03/31,2007/07/10,191,6,0.617851328,10318,191,3,3
33342,2014/03/31,2006/07/07,137,8,0.708797954,8993,137,2,6
33343,2014/03/31,2012/01/15,443,6,0.699232119,9116,443,6,0
33344,2014/03/31,2012/10/08,128,4,0.535272086,11908,128,2,2
33345,2014/03/31,2006/01/22,3,7,0.654016419,9745,3,3,4
33346,2014/03/31,2007/08/02,376,9,0.865114701,7367,376,9,0
33347,2014/03/31,2008/03/15,178,8,0.55476149,11488,178,5,3
33348,2014/03/31,2012/01/06,634,3,0.91093482,6996,634,3,0
33349,2014/03/31,2012/01/08,5,6,0.6967125829999999,9147,5,0,6
33350,2014/03/31,2013/03/07,3,8,0.638989271,9973,3,1,7
33351,2014/03/31,2012/03/02,97,8,0.814620302,7822,97,1,7
33352,2014/03/31,2009/09/01,10,10,0.68346455,9323,10,5,5
33353,2014/03/31,2011/05/12,22,12,0.753749408,8452,22,4,8
33354,2014/03/31,2009/11/18,590,4,0.775,8220,590,4,0
33355,2014/03/31,2013/02/10,74,5,0.62,10275,74,0,5
33356,2014/03/31,2012/07/25,85,11,0.650224559,9797,85,5,6
33357,2014/03/31,2011/05/20,82,7,0.695714286,9156,82,1,6
33358,2014/03/31,2012/03/01,15,10,0.7366485490000001,8647,15,7,3
33359,2014/03/31,2009/10/27,231,6,0.682635302,9331,231,4,2
33360,2014/03/31,2006/10/18,14,8,0.677715471,9398,14,6,2
33361,2014/03/31,2012/03/01,197,7,0.74854943,8507,197,2,5
33362,2014/03/31,2011/07/14,5,10,0.826415315,7705,5,3,7
33363,2014/03/31,2007/02/23,247,7,0.660630836,9638,247,5,2
33364,2014/03/31,2008/12/04,166,7,0.6019523489999999,10577,166,4,3
33365,2014/03/31,2007/07/18,10,6,0.376247045,16920,10,1,5
33366,2014/03/31,2012/08/06,388,6,0.868813976,7327,388,6,0
33367,2014/03/31,2006/03/30,67,10,0.504319784,12621,67,2,8
33368,2014/03/31,2008/07/07,49,7,0.529062344,12030,49,4,3
33369,2014/03/31,2009/10/12,686,8,0.782466495,8133,686,8,0
33370,2014/03/31,2012/09/05,387,4,0.9375,6788,387,4,0
33371,2014/03/31,2008/12/08,158,8,0.623300029,10209,158,5,3
33372,2014/03/31,2012/06/01,267,5,0.568401072,11195,267,3,2
33373,2014/03/31,2012/03/06,130,8,0.8054734179999999,7900,130,3,5
33374,2014/03/31,2008/09/19,467,2,0.9,7070,467,2,0
33375,2014/03/31,2007/11/19,84,6,0.89266835,7128,84,1,5
33376,2014/03/31,2012/04/22,580,6,0.518474452,12271,580,6,0
33377,2014/03/31,2008/07/08,470,5,0.506855481,12552,470,5,0
33378,2014/03/31,2008/02/27,385,7,0.478391487,13298,385,7,0
33379,2014/03/31,2007/12/16,236,3,1.3261059,4797,236,0,3
33380,2014/03/31,2011/08/13,377,8,0.743454885,8556,377,8,0
33381,2014/03/31,2010/11/06,71,5,0.7240614679999999,8785,71,1,4
33382,2014/03/31,2010/12/06,11,9,0.643485078,9885,11,1,8
33383,2014/03/31,2007/12/31,99,4,1.431284878,4444,99,1,3
33384,2014/03/31,2007/09/09,98,7,0.563283741,11292,98,2,5
33385,2014/03/31,2011/08/30,121,8,0.563643212,11284,121,3,5
33386,2014/03/31,2010/05/07,165,8,0.8066983759999999,7884,165,3,5
33387,2014/03/31,2008/06/24,3,7,0.855874041,7431,3,0,7
33388,2014/03/31,2011/06/28,216,7,1.004698262,6330,216,3,4
33389,2014/03/31,2012/12/14,38,6,0.626563208,10149,38,0,6
33390,2014/03/31,2007/10/16,5,6,0.76509686,8311,5,0,6
33391,2014/03/31,2010/08/01,42,8,0.765,8312,42,3,5
33392,2014/03/31,2012/09/28,37,8,0.67875,9368,37,5,3
33393,2014/03/31,2011/07/29,395,5,0.4,15895,395,5,0
33394,2014/03/31,2011/05/12,24,15,0.527865327,12044,24,2,13
33395,2014/03/31,2008/11/08,81,6,1.0387892159999998,6120,81,5,1
33396,2014/03/31,2012/03/05,276,6,0.691662496,9191,276,3,3
33397,2014/03/31,2010/03/16,56,4,0.595,10684,56,1,3
33398,2014/03/31,2012/05/13,197,4,0.787810138,8069,197,1,3
33399,2014/03/31,2005/03/06,102,7,0.559069399,11369,102,3,4
33400,2014/03/31,2010/03/03,134,8,0.599134615,10608,134,2,6
33401,2014/03/31,2012/11/23,272,5,0.746201714,8517,272,2,3
33402,2014/03/31,2007/07/22,118,8,0.740533675,8582,118,4,4
33403,2014/03/31,2012/05/24,109,7,0.589188688,10785,109,4,3
33404,2014/03/31,2012/07/16,254,5,0.932224178,6816,254,4,1
33405,2014/03/31,2012/12/22,130,7,0.637622679,9965,130,1,6
33406,2014/03/31,2011/07/01,287,8,0.6672495270000001,9522,287,5,3
33407,2014/03/31,2011/12/04,209,7,0.735690134,8636,209,4,3
33408,2014/03/31,2010/10/29,209,6,0.789965183,8042,209,3,3
33409,2014/03/31,2008/03/04,242,9,0.907739354,6998,242,6,3
33410,2014/03/31,2011/08/03,27,6,0.610837581,10399,27,1,5
33411,2014/03/31,2012/05/23,224,4,0.636285686,9983,224,3,1
33412,2014/03/31,2012/07/10,211,4,0.7244251820000001,8768,211,2,2
33413,2014/03/31,2007/09/17,160,4,0.7632299929999999,8322,160,2,2
33414,2014/03/31,2012/12/05,328,12,0.853892175,7438,328,9,3
33415,2014/03/31,2011/08/31,264,7,0.913570196,6952,264,3,4
33416,2014/03/31,2012/08/18,511,5,0.909364261,6984,511,5,0
33417,2014/03/31,2012/06/23,331,15,0.73,8700,331,13,2
33418,2014/03/31,2010/01/16,39,9,0.79876242,7951,39,0,9
33419,2014/03/31,2012/09/11,61,9,0.6175901970000001,10283,61,2,7
33420,2014/03/31,2006/02/03,40,5,0.793309182,8005,40,2,3
33421,2014/03/31,2009/03/20,75,7,0.5455618560000001,11640,75,2,5
33422,2014/03/31,2012/08/31,20,8,0.639816625,9925,20,0,8
33423,2014/03/31,2012/02/18,67,7,0.671612903,9455,67,4,3
33424,2014/03/31,2008/07/01,265,5,0.45,14110,265,4,1
33425,2014/03/31,2008/07/13,66,6,0.818738878,7755,66,3,3
33426,2014/03/31,2007/08/24,6,8,0.656153369,9676,6,2,6
33427,2014/03/31,2008/10/05,116,4,0.8381056109999999,7575,116,0,4
33428,2014/03/31,2012/10/18,515,5,0.608147332,10439,515,5,0
33429,2014/03/31,2008/05/10,14,9,0.611587669,10380,14,4,5
33430,2014/03/31,2007/01/12,29,9,0.523436134,12127,29,6,3
33431,2014/03/31,2006/03/05,309,10,0.562087134,11293,309,8,2
33432,2014/03/31,2012/09/17,262,9,0.716753613,8856,262,8,1
33433,2014/03/31,2011/01/28,100,5,1.058232744,5998,100,2,3
33434,2014/03/31,2007/12/15,628,4,0.8,7934,628,4,0
33435,2014/03/31,2009/12/08,714,4,0.96479173,6578,714,4,0
33436,2014/03/31,2008/04/25,113,8,0.8343807520000001,7606,113,4,4
33437,2014/03/31,2010/08/18,21,7,0.772325666,8217,21,2,5
33438,2014/03/31,2009/10/23,83,7,0.566611607,11200,83,3,4
33439,2014/03/31,2011/07/08,64,5,0.829512418,7650,64,4,1
33440,2014/03/31,2009/11/09,157,5,0.724675651,8756,157,2,3
33441,2014/03/31,2012/03/11,186,7,0.8503403909999999,7462,186,3,4
33442,2014/03/31,2011/09/09,60,7,0.524039478,12108,60,3,4
33443,2014/03/31,2007/12/19,67,9,0.512967904,12369,67,4,5
33444,2014/03/31,2011/09/20,268,7,0.625664136,10141,268,6,1
33445,2014/03/31,2007/02/15,188,3,0.85,7464,188,2,1
33446,2014/03/31,2007/11/15,8,10,0.420782038,15076,8,3,7
33447,2014/03/31,2011/10/12,70,8,0.625640166,10138,70,5,3
33448,2014/03/31,2009/01/02,151,8,0.568439685,11158,151,0,8
33449,2014/03/31,2011/09/22,172,4,0.774407814,8190,172,2,2
33450,2014/03/31,2011/04/06,210,5,0.8305474070000001,7636,210,2,3
33451,2014/03/31,2012/07/21,219,5,0.7753056229999999,8180,219,1,4
33452,2014/03/31,2012/06/05,254,11,0.485193941,13071,254,7,4
33453,2014/03/31,2012/12/10,6,7,0.817922095,7753,6,2,5
33454,2014/03/31,2012/04/20,195,9,0.616438223,10287,195,8,1
33455,2014/03/31,2010/08/03,472,4,0.698518396,9078,472,4,0
33456,2014/03/31,2007/08/31,11,9,0.575070295,11025,11,7,2
33457,2014/03/31,2011/09/24,166,7,0.750651196,8446,166,6,1
33458,2014/03/31,2009/07/22,199,5,0.541545229,11707,199,2,3
33459,2014/03/31,2007/10/24,135,9,0.689909675,9189,135,2,7
33460,2014/03/31,2010/08/01,64,5,0.657482887,9642,64,2,3
33461,2014/03/31,2007/03/20,7,7,0.577413243,10979,7,1,6
33462,2014/03/31,2009/11/13,32,8,0.80585431,7866,32,6,2
33463,2014/03/31,2012/08/07,26,4,1.1525,5500,26,1,3
33464,2014/03/31,2008/10/25,18,8,0.649503023,9759,18,2,6
33465,2014/03/31,2013/03/01,103,6,0.720074983,8802,103,1,5
33466,2014/03/31,2013/03/11,143,4,0.89,7120,143,1,3
33467,2014/03/31,2013/02/09,6,10,0.5997236420000001,10566,6,1,9
33468,2014/03/31,2013/01/19,112,5,0.591328854,10716,112,0,5
33469,2014/03/31,2010/05/24,248,6,0.702026368,9026,248,4,2
33470,2014/03/31,2012/11/01,332,5,0.8150694620000001,7774,332,4,1
33471,2014/03/31,2012/02/11,235,4,0.755,8392,235,2,2
33472,2014/03/31,2010/02/09,151,5,0.6736299840000001,9405,151,4,1
33473,2014/03/31,2010/06/20,22,6,0.653547555,9694,22,4,2
33474,2014/03/31,2011/11/16,23,9,0.80770496,7843,23,7,2
33475,2014/03/31,2010/09/10,115,11,0.698481641,9069,115,7,4
33476,2014/03/31,2012/10/14,226,7,0.74846981,8463,226,3,4
33477,2014/03/31,2012/06/30,226,7,0.812874743,7792,226,5,2
33478,2014/03/31,2012/11/14,106,4,0.8114990390000001,7805,106,0,4
33479,2014/03/31,2012/08/22,37,7,0.747142857,8477,37,3,4
33480,2014/03/31,2008/07/23,75,10,0.742810228,8526,75,7,3
33481,2014/03/31,2007/09/26,500,5,0.645530071,9810,500,5,0
33482,2014/03/31,2012/11/06,433,4,0.605826636,10452,433,4,0
33483,2014/03/31,2011/11/28,45,3,0.676666667,9357,45,0,3
33484,2014/03/31,2011/07/25,34,6,0.8329522429999999,7601,34,2,4
33485,2014/03/31,2008/10/12,268,6,0.806666667,7848,268,4,2
33486,2014/03/31,2013/02/13,289,4,0.7562819590000001,8370,289,1,3
33487,2014/03/31,2011/01/16,206,11,0.758093413,8350,206,9,2
33488,2014/03/31,2011/11/29,18,8,0.6601939920000001,9588,18,6,2
33489,2014/03/31,2010/01/04,191,7,0.61675436,10263,191,2,5
33490,2014/03/31,2010/07/21,142,7,0.610562361,10367,142,5,2
33491,2014/03/31,2012/08/09,353,8,0.509912994,12413,353,6,2
33492,2014/03/31,2012/06/26,48,3,0.55,11508,48,1,2
33493,2014/03/31,2012/11/02,417,2,0.825,7672,417,2,0
33494,2014/03/31,2010/01/29,184,5,0.641784628,9862,184,3,2
33495,2014/03/31,2012/11/30,395,4,0.750082958,8438,395,4,0
33496,2014/03/31,2012/09/26,13,10,0.605251984,10457,13,5,5
33497,2014/03/31,2012/04/04,428,8,0.536670059,11793,428,8,0
33498,2014/03/31,2012/09/15,145,9,0.505335356,12524,145,0,9
33499,2014/03/31,2010/05/17,291,13,0.593330208,10666,291,7,6
33500,2014/03/31,2009/01/10,72,10,0.767529412,8245,72,7,3
33501,2014/03/31,2012/11/10,108,8,0.707491055,8944,108,2,6
33502,2014/03/31,2013/01/23,6,8,0.522611497,12108,6,2,6
33503,2014/03/31,2010/02/19,41,9,0.681424725,9286,41,0,9
33504,2014/03/31,2012/07/08,454,4,0.732106907,8643,454,4,0
33505,2014/03/31,2007/04/10,49,11,0.686348845,9219,49,0,11
33506,2014/03/31,2011/03/06,465,4,0.6753576,9368,465,4,0
33507,2014/03/31,2013/01/01,250,5,0.602224655,10505,250,0,5
33508,2014/03/31,2008/09/22,102,8,0.555781058,11382,102,4,4
33509,2014/03/31,2004/12/08,517,3,1.5,4217,517,3,0
33510,2014/03/31,2007/09/28,349,4,0.961614472,6578,349,2,2
33511,2014/03/31,2011/02/04,397,6,0.491923316,12858,397,6,0
33512,2014/03/31,2009/07/10,44,5,0.432353544,14629,44,2,3
33513,2014/03/31,2012/10/23,202,4,0.822799532,7687,202,2,2
33514,2014/03/31,2013/02/11,151,6,0.612230397,10330,151,2,4
33515,2014/03/31,2011/11/27,432,4,0.5954802260000001,10620,432,4,0
33516,2014/03/31,2009/08/29,195,12,0.660534782,9574,195,8,4
33517,2014/03/31,2006/08/20,5,6,0.534251922,11837,5,0,6
33518,2014/03/31,2005/05/18,32,13,0.575529669,10988,32,6,7
33519,2014/03/31,2006/05/10,12,7,0.69392187,9113,12,0,7
33520,2014/03/31,2007/10/01,33,7,0.486336717,13002,33,6,1
33521,2014/03/31,2009/03/25,146,7,0.58040481,10894,146,6,1
33522,2014/03/31,2008/12/18,190,7,0.707130075,8941,190,2,5
33523,2014/03/31,2011/10/11,354,5,0.82,7710,354,4,1
33524,2014/03/31,2011/10/28,39,4,0.721625385,8761,39,1,3
33525,2014/03/31,2012/10/28,309,6,0.674850555,9368,309,4,2
33526,2014/03/31,2012/08/11,227,8,0.8182228840000001,7726,227,5,3
33527,2014/03/31,2010/11/02,87,9,0.6799505159999999,9296,87,5,4
33528,2014/03/31,2012/03/26,9,4,0.7375831490000001,8569,9,1,3
33529,2014/03/31,2012/03/13,13,7,0.680308968,9289,13,4,3
33530,2014/03/31,2008/10/29,83,7,0.77489393,8155,83,3,4
33531,2014/03/31,2006/11/24,5,8,0.715954,8826,5,2,6
33532,2014/03/31,2012/03/23,18,7,0.808239959,7818,18,4,3
33533,2014/03/31,2007/07/12,75,12,0.529858281,11925,75,6,6
33534,2014/03/31,2007/03/12,68,8,0.664967375,9502,68,4,4
33535,2014/03/31,2011/04/12,138,8,0.561726529,11248,138,6,2
33536,2014/03/31,2011/08/04,99,7,0.646291939,9776,99,4,3
33537,2014/03/31,2011/11/12,244,11,0.418635038,15092,244,8,3
33538,2014/03/31,2012/06/23,11,10,0.668563869,9449,11,1,9
33539,2014/03/31,2012/09/07,449,7,0.5302023,11913,449,7,0
33540,2014/03/31,2012/08/04,46,7,0.426455098,14810,46,4,3
33541,2014/03/31,2008/12/21,29,10,0.7120793870000001,8868,29,8,2
33542,2014/03/31,2011/05/21,548,6,0.8258043420000001,7646,548,6,0
33543,2014/03/31,2013/03/19,12,9,0.7167737540000001,8809,12,1,8
33544,2014/03/31,2011/04/18,218,6,0.978308026,6454,218,5,1
33545,2014/03/31,2005/08/03,160,7,0.703205614,8978,160,4,3
33546,2014/03/31,2010/05/26,192,8,0.5738614670000001,11001,192,7,1
33547,2014/03/31,2012/05/26,440,10,0.550671668,11464,440,10,0
33548,2014/03/31,2010/03/13,317,7,0.696529847,9063,317,4,3
33549,2014/03/31,2010/11/12,220,7,0.6120031029999999,10314,220,6,1
33550,2014/03/31,2008/06/28,332,6,0.706893269,8929,332,5,1
33551,2014/03/31,2008/04/29,280,5,0.6776892520000001,9313,280,3,2
33552,2014/03/31,2012/08/08,597,3,0.9,7011,597,3,0
33553,2014/03/31,2012/12/03,29,9,0.500802445,12599,29,2,7
33554,2014/03/31,2013/02/15,27,3,0.74,8526,27,0,3
33555,2014/03/31,2012/04/05,176,4,0.807719882,7811,176,2,2
33556,2014/03/31,2005/11/18,4,4,0.7384174179999999,8543,4,2,2
33557,2014/03/31,2009/01/27,14,5,0.98758259,6387,14,3,2
33558,2014/03/31,2009/03/13,186,7,0.965714286,6531,186,4,3
33559,2014/03/31,2005/08/12,576,8,0.86668957,7277,576,8,0
33560,2014/03/31,2008/11/20,76,8,0.831574367,7584,76,4,4
33561,2014/03/31,2013/03/19,76,8,0.88875,7096,76,1,7
33562,2014/03/31,2013/03/04,35,11,0.843347152,7478,35,2,9
33563,2014/03/31,2011/04/12,181,7,0.755479813,8347,181,6,1
33564,2014/03/31,2010/08/20,33,7,0.606286895,10401,33,1,6
33565,2014/03/31,2007/03/25,134,5,0.618947678,10187,134,1,4
33566,2014/03/31,2006/12/15,100,9,0.606154586,10402,100,4,5
33567,2014/03/31,2008/03/13,53,6,0.501109522,12582,53,4,2
33568,2014/03/31,2009/10/30,479,4,0.7039749890000001,8956,479,4,0
33569,2014/03/31,2011/03/02,613,6,0.753856272,8363,613,6,0
33570,2014/03/31,2006/04/23,60,5,0.8342747490000001,7556,60,1,4
33571,2014/03/31,2010/06/12,110,10,0.744642646,8465,110,8,2
33572,2014/03/31,2007/08/08,156,4,0.73685761,8554,156,0,4
33573,2014/03/31,2008/06/01,450,5,0.829359126,7599,450,5,0
33574,2014/03/31,2013/03/05,305,2,0.657623669,9582,305,0,2
33575,2014/03/31,2008/04/28,276,2,0.70593771,8926,276,0,2
33576,2014/03/31,2006/12/15,101,7,0.540891999,11648,101,0,7
33577,2014/03/31,2013/03/23,214,5,0.653687487,9638,214,2,3
33578,2014/03/31,2010/04/13,55,10,0.6416500310000001,9818,55,5,5
33579,2014/03/31,2007/03/27,304,5,0.8054813959999999,7821,304,4,1
33580,2014/03/31,2011/11/19,10,12,0.74490363,8457,10,8,4
33581,2014/03/31,2011/01/04,254,5,0.7604309509999999,8284,254,3,2
33582,2014/03/31,2007/09/25,3,10,0.584518883,10777,3,0,10
33583,2014/03/31,2008/08/27,198,11,0.738570759,8529,198,7,4
33584,2014/03/31,2010/04/22,210,4,0.669028147,9415,210,2,2
33585,2014/03/31,2010/12/20,486,4,0.7594164459999999,8294,486,4,0
33586,2014/03/31,2012/04/27,51,5,0.546013004,11535,51,2,3
33587,2014/03/31,2012/04/14,577,6,0.6307711570000001,9985,577,6,0
33588,2014/03/31,2013/01/15,21,6,0.6812082209999999,9245,21,0,6
33589,2014/03/31,2011/03/11,95,9,0.5735628420000001,10980,95,3,6
33590,2014/03/31,2012/06/17,364,6,0.901409963,6986,364,5,1
33591,2014/03/31,2006/08/20,99,6,0.548943423,11471,99,1,5
33592,2014/03/31,2011/01/15,34,9,0.563624239,11172,34,5,4
33593,2014/03/31,2008/07/20,443,6,0.788868705,7982,443,6,0
33594,2014/03/31,2010/11/05,252,8,0.6985034390000001,9014,252,4,4
33595,2014/03/31,2009/03/07,344,7,0.655517959,9605,344,6,1
33596,2014/03/31,2013/02/02,74,5,0.938473692,6709,74,2,3
33597,2014/03/31,2010/01/06,168,7,0.892399717,7055,168,4,3
33598,2014/03/31,2012/07/10,11,8,0.644863259,9763,11,3,5
33599,2014/03/31,2012/11/06,469,3,0.715095411,8804,469,3,0
33600,2014/03/31,2012/05/30,26,7,0.675182325,9324,26,2,5
33601,2014/03/31,2008/10/25,4,7,0.699196934,9003,4,2,5
33602,2014/03/31,2010/11/17,201,9,0.6569275729999999,9582,201,4,5
33603,2014/03/31,2011/04/25,468,2,0.6575368220000001,9573,468,2,0
33604,2014/03/31,2007/06/12,560,5,0.781039831,8059,560,5,0
33605,2014/03/31,2007/08/29,159,4,0.8,7868,159,2,2
33606,2014/03/31,2012/08/24,585,2,1.5,4196,585,2,0
33607,2014/03/31,2008/05/16,337,7,0.65,9683,337,5,2
33608,2014/03/31,2009/07/11,44,7,0.7094071240000001,8872,44,4,3
33609,2014/03/31,2011/08/28,552,4,0.555989928,11319,552,4,0
33610,2014/03/31,2011/07/12,142,10,0.611150932,10296,142,4,6
33611,2014/03/31,2012/04/26,157,3,0.891893692,7055,157,1,2
33612,2014/03/31,2009/09/18,72,9,0.620288841,10144,72,4,5
33613,2014/03/31,2006/09/19,264,6,0.8469592140000001,7429,264,3,3
33614,2014/03/31,2013/02/27,33,5,0.673468208,9342,33,1,4
33615,2014/03/31,2011/07/08,296,7,0.6909170790000001,9105,296,4,3
33616,2014/03/31,2008/07/12,107,6,0.4851754720000001,12965,107,0,6
33617,2014/03/31,2009/09/21,42,7,0.6925289000000001,9083,42,3,4
33618,2014/03/31,2011/11/16,146,6,0.747763909,8412,146,4,2
33619,2014/03/31,2011/07/18,283,5,0.7662394929999999,8209,283,3,2
33620,2014/03/31,2011/07/27,56,9,0.570203971,11031,56,0,9
33621,2014/03/31,2008/10/04,613,7,0.693025562,9076,613,7,0
33622,2014/03/31,2011/12/26,50,5,0.974258055,6456,50,0,5
33623,2014/03/31,2012/05/20,42,9,0.380600266,16526,42,4,5
33624,2014/03/31,2008/08/08,164,6,0.506335534,12422,164,4,2
33625,2014/03/31,2012/11/30,49,6,0.720277142,8732,49,1,5
33626,2014/03/31,2012/11/13,251,4,0.81,7764,251,2,2
33627,2014/03/31,2011/11/10,681,3,1.048258043,5999,681,3,0
33628,2014/03/31,2012/03/25,1,9,0.62724389,10025,1,1,8
33629,2014/03/31,2012/11/13,25,9,0.780617008,8055,25,0,9
33630,2014/03/31,2007/11/23,137,9,0.7262277659999999,8658,137,2,7
33631,2014/03/31,2011/08/16,171,4,0.912957746,6887,171,1,3
33632,2014/03/31,2006/01/30,429,7,0.6407765999999999,9812,429,7,0
33633,2014/03/31,2007/10/09,139,7,0.533941401,11775,139,4,3
33634,2014/03/31,2013/02/03,127,9,0.43389303,14490,127,0,9
33635,2014/03/31,2012/03/18,279,7,0.746032989,8427,279,3,4
33636,2014/03/31,2011/01/24,11,6,0.956603257,6571,11,3,3
33637,2014/03/31,2012/08/29,422,8,0.5052081660000001,12442,422,8,0
33638,2014/03/31,2008/10/28,5,4,0.905213134,6944,5,0,4
33639,2014/03/31,2012/12/15,33,7,0.847506742,7416,33,2,5
33640,2014/03/31,2012/06/12,216,6,0.797804011,7878,216,4,2
33641,2014/03/31,2012/03/15,298,7,0.667757119,9412,298,5,2
33642,2014/03/31,2011/08/16,44,2,0.796866996,7887,44,0,2
33643,2014/03/31,2011/09/07,108,7,0.487454433,12893,108,4,3
33644,2014/03/31,2012/01/02,236,3,0.6985938190000001,8996,236,1,2
33645,2014/03/31,2012/07/22,61,3,0.787009393,7985,61,0,3
33646,2014/03/31,2009/08/11,166,10,0.668460802,9401,166,2,8
33647,2014/03/31,2012/06/14,376,3,0.969188647,6483,376,3,0
33648,2014/03/31,2008/12/07,160,6,0.853110659,7365,160,1,5
33649,2014/03/31,2011/06/07,191,6,0.614004691,10233,191,3,3
33650,2014/03/31,2010/05/20,248,6,0.810921528,7748,248,5,1
33651,2014/03/31,2012/06/21,422,8,0.6196814279999999,10139,422,8,0
33652,2014/03/31,2005/02/25,48,4,0.6871497320000001,9143,48,0,4
33653,2014/03/31,2011/11/23,423,5,0.612747489,10253,423,5,0
33654,2014/03/31,2009/09/07,190,4,0.795391238,7898,190,2,2
33655,2014/03/31,2009/02/14,18,3,0.8629107140000001,7280,18,0,3
33656,2014/03/31,2012/09/09,477,4,0.7449952559999999,8432,477,4,0
33657,2014/03/31,2012/10/18,5,11,0.578115222,10866,5,7,4
33658,2014/03/31,2011/11/03,269,9,0.599301593,10481,269,8,1
33659,2014/03/31,2010/10/15,7,10,0.711903197,8822,7,5,5
33660,2014/03/31,2005/02/01,78,5,0.721106901,8709,78,3,2
33661,2014/03/31,2009/02/08,5,7,0.708062697,8868,5,2,5
33662,2014/03/31,2006/09/27,31,6,0.8788479840000001,7144,31,1,5
33663,2014/03/31,2007/04/23,269,3,0.98825122,6353,269,2,1
33664,2014/03/31,2008/12/13,168,2,0.65732384,9551,168,0,2
33665,2014/03/31,2010/02/13,33,7,0.520614479,12059,33,4,3
33666,2014/03/31,2012/08/13,592,4,1.0,6278,592,4,0
33667,2014/03/31,2012/11/06,403,3,0.716666667,8760,403,3,0
33668,2014/03/31,2010/08/27,191,6,1.123242083,5589,191,1,5
33669,2014/03/31,2006/05/19,76,11,0.8777432890000001,7152,76,4,7
33670,2014/03/31,2008/12/24,664,5,0.861688401,7285,664,5,0
33671,2014/03/31,2012/12/05,34,8,0.7868935690000001,7977,34,1,7
33672,2014/03/31,2007/11/21,2,3,0.723578098,8675,2,0,3
33673,2014/03/31,2007/12/25,595,3,0.6688119339999999,9385,595,3,0
33674,2014/03/31,2010/02/27,11,6,0.723357151,8677,11,2,4
33675,2014/03/31,2012/08/11,212,4,0.603929946,10392,212,0,4
33676,2014/03/31,2011/12/18,301,5,0.868,7230,301,2,3
33677,2014/03/31,2011/12/25,600,5,0.52495399,11954,600,5,0
33678,2014/03/31,2012/04/01,105,10,0.470394303,13340,105,7,3
33679,2014/03/31,2011/11/01,125,5,0.843751513,7437,125,4,1
33680,2014/03/31,2009/04/06,10,6,0.62730054,10002,10,0,6
33681,2014/03/31,2007/05/27,569,8,0.751305233,8351,569,8,0
33682,2014/03/31,2012/09/30,159,5,0.78172315,8026,159,1,4
33683,2014/03/31,2009/12/16,44,6,0.7040002240000001,8912,44,1,5
33684,2014/03/31,2012/09/02,38,4,0.735,8536,38,2,2
33685,2014/03/31,2012/12/27,107,4,0.568540874,11034,107,1,3
33686,2014/03/31,2012/04/07,32,6,0.940610286,6669,32,2,4
33687,2014/03/31,2008/09/02,519,5,0.742923132,8443,519,5,0
33688,2014/03/31,2008/08/22,75,8,0.484360618,12950,75,5,3
33689,2014/03/31,2009/03/23,172,6,0.874084448,7176,172,1,5
33690,2014/03/31,2012/05/26,618,3,0.902864546,6947,618,3,0
33691,2014/03/31,2011/06/08,27,10,0.6531188170000001,9603,27,3,7
33692,2014/03/31,2007/02/22,92,6,0.512108444,12246,92,2,4
33693,2014/03/31,2012/12/06,453,3,0.7924744090000001,7913,453,3,0
33694,2014/03/31,2006/02/21,142,6,0.846569461,7407,142,0,6
33695,2014/03/31,2011/05/13,381,10,0.766564792,8180,381,10,0
33696,2014/03/31,2010/03/17,124,5,0.6655482429999999,9421,124,0,5
33697,2014/03/31,2009/03/17,37,8,0.84,7464,37,0,8
33698,2014/03/31,2007/09/08,425,7,0.752033105,8337,425,7,0
33699,2014/03/31,2012/05/18,116,3,0.606046399,10345,116,2,1
33700,2014/03/31,2011/07/14,221,5,0.7185534159999999,8724,221,3,2
33701,2014/03/31,2006/11/30,318,6,0.71201295,8803,318,2,4
33702,2014/03/31,2013/03/13,226,3,0.688703297,9100,226,0,3
33703,2014/03/31,2005/10/19,447,8,0.695974012,9004,447,8,0
33704,2014/03/31,2008/11/21,12,9,0.558810416,11214,12,3,6
33705,2014/03/31,2009/04/09,103,7,0.7080237290000001,8850,103,3,4
33706,2014/03/31,2011/06/21,3,6,0.567828727,11035,3,4,2
33707,2014/03/31,2008/06/23,395,8,0.6996873259999999,8955,395,8,0
33708,2014/03/31,2013/01/29,32,7,0.723599723,8659,32,2,5
33709,2014/03/31,2008/01/03,261,7,0.855714286,7322,261,4,3
33710,2014/03/31,2012/10/02,289,5,0.763622182,8205,289,4,1
33711,2014/03/31,2009/07/03,64,4,0.555,11288,64,0,4
33712,2014/03/31,2010/02/13,62,8,0.601663465,10412,62,1,7
33713,2014/03/31,2012/04/22,532,3,1.5,4176,532,3,0
33714,2014/03/31,2007/08/14,100,4,0.774472057,8088,100,2,2
33715,2014/03/31,2006/05/11,21,7,0.72406427,8651,21,3,4
33716,2014/03/31,2011/08/05,157,9,0.482346373,12986,157,8,1
33717,2014/03/31,2006/04/29,286,3,0.727298804,8611,286,0,3
33718,2014/03/31,2007/07/02,128,6,0.615315386,10178,128,2,4
33719,2014/03/31,2012/12/30,12,6,0.774589981,8085,12,4,2
33720,2014/03/31,2011/05/01,212,9,0.586619204,10675,212,7,2
33721,2014/03/31,2008/10/23,28,14,0.432519859,14477,28,6,8
33722,2014/03/31,2012/08/19,563,3,0.574133504,10906,563,3,0
33723,2014/03/31,2012/10/05,260,6,0.5404125670000001,11586,260,4,2
33724,2014/03/31,2008/07/16,501,5,0.6901014109999999,9072,501,5,0
33725,2014/03/31,2012/12/16,72,10,0.636669379,9833,72,4,6
33726,2014/03/31,2008/06/03,64,4,0.7188952690000001,8708,64,2,2
33727,2014/03/31,2010/09/30,52,2,1.155,5420,52,0,2
33728,2014/03/31,2013/03/05,38,5,0.534996581,11700,38,0,5
33729,2014/03/31,2010/12/03,350,6,0.761059095,8224,350,5,1
33730,2014/03/31,2012/06/25,464,9,0.567378298,11031,464,9,0
33731,2014/03/31,2012/12/07,103,7,0.76579907,8172,103,2,5
33732,2014/03/31,2013/03/05,22,4,0.636107949,9838,22,0,4
33733,2014/03/31,2008/02/04,16,15,0.678620091,9218,16,4,11
33734,2014/03/31,2005/11/27,290,8,0.7283742870000001,8587,290,7,1
33735,2014/03/31,2006/03/10,331,5,0.608000389,10287,331,4,1
33736,2014/03/31,2008/08/22,311,3,0.7597618759999999,8231,311,2,1
33737,2014/03/31,2010/06/27,47,7,0.48067953,13009,47,0,7
33738,2014/03/31,2011/01/04,85,8,0.7024297909999999,8902,85,1,7
33739,2014/03/31,2012/02/13,265,7,0.490520907,12747,265,4,3
33740,2014/03/31,2009/10/05,39,4,0.7325,8536,39,3,1
33741,2014/03/31,2008/05/20,76,8,0.5762197029999999,10851,76,2,6
33742,2014/03/31,2012/08/23,61,7,0.6933669729999999,9017,61,1,6
33743,2014/03/31,2008/11/26,23,7,0.513427234,12176,23,4,3
33744,2014/03/31,2011/09/01,40,11,0.614164865,10178,40,5,6
33745,2014/03/31,2008/11/02,344,6,0.645538573,9683,344,5,1
33746,2014/03/31,2007/05/28,11,11,0.875454545,7139,11,8,3
33747,2014/03/31,2008/10/21,152,6,0.8221747140000001,7601,152,2,4
33748,2014/03/31,2010/07/13,201,7,0.509691655,12259,201,4,3
33749,2014/03/31,2013/02/26,4,7,0.442605554,14116,4,1,6
33750,2014/03/31,2010/06/19,58,8,0.638092125,9791,58,2,6
33751,2014/03/31,2011/10/25,21,5,0.478739464,13050,21,4,1
33752,2014/03/31,2012/05/16,126,14,0.613389298,10185,126,10,4
33753,2014/03/31,2006/10/06,202,10,0.802526978,7784,202,9,1
33754,2014/03/31,2012/04/12,696,4,0.8482753940000001,7364,696,4,0
33755,2014/03/31,2011/07/15,186,6,0.787305268,7934,186,4,2
33756,2014/03/31,2010/03/06,319,4,0.8,7808,319,3,1
33757,2014/03/31,2011/12/23,418,5,0.64,9760,418,5,0
33758,2014/03/31,2010/09/21,509,5,0.64,9760,509,5,0
33759,2014/03/31,2012/10/23,39,7,0.550718632,11341,39,2,5
33760,2014/03/31,2012/03/04,212,4,0.654396479,9544,212,3,1
33761,2014/03/31,2009/12/08,11,8,0.397548059,15710,11,2,6
33762,2014/03/31,2009/06/07,111,7,0.7860566390000001,7945,111,4,3
33763,2014/03/31,2012/01/16,32,9,0.59847724,10435,32,4,5
33764,2014/03/31,2011/10/19,259,8,0.594044335,10511,259,5,3
33765,2014/03/31,2007/01/16,292,7,0.628776435,9930,292,6,1
33766,2014/03/31,2008/06/13,208,6,0.962905614,6484,208,4,2
33767,2014/03/31,2008/12/01,88,6,0.677961777,9209,88,3,3
33768,2014/03/31,2012/11/06,39,9,0.599221614,10419,39,6,3
33769,2014/03/31,2013/03/22,18,6,0.7910415609999999,7892,18,1,5
33770,2014/03/31,2010/04/26,353,3,0.668184737,9343,353,2,1
33771,2014/03/31,2009/11/08,21,17,0.6664705879999999,9367,21,12,5
33772,2014/03/31,2007/12/05,393,9,0.612680342,10189,393,9,0
33773,2014/03/31,2012/09/06,79,11,0.8926698129999999,6993,79,3,8
33774,2014/03/31,2012/07/14,53,5,0.691590959,9026,53,3,2
33775,2014/03/31,2011/03/14,12,10,0.650774604,9592,12,1,9
33776,2014/03/31,2012/06/04,91,8,0.525749179,11873,91,6,2
33777,2014/03/31,2012/05/14,115,8,0.477483935,13072,115,4,4
33778,2014/03/31,2012/09/08,542,2,1.5,4161,542,2,0
33779,2014/03/31,2013/01/29,426,2,1.5,4161,426,2,0
33780,2014/03/31,2012/04/01,156,6,1.015969396,6143,156,3,3
33781,2014/03/31,2006/06/05,368,5,0.6591465989999999,9468,368,5,0
33782,2014/03/31,2012/09/19,306,7,0.482827853,12925,306,3,4
33783,2014/03/31,2012/03/14,417,6,0.714320055,8736,417,6,0
33784,2014/03/31,2006/12/11,228,7,0.828376477,7533,228,2,5
33785,2014/03/31,2007/04/17,1,10,0.550034376,11345,1,3,7
33786,2014/03/31,2013/01/01,91,7,0.7460043040000001,8364,91,0,7
33787,2014/03/31,2007/07/12,4,3,1.262048948,4944,4,2,1
33788,2014/03/31,2013/02/05,277,5,0.840793694,7421,277,1,4
33789,2014/03/31,2009/03/02,210,6,0.815172459,7654,210,4,2
33790,2014/03/31,2012/04/18,162,5,0.794313725,7854,162,4,1
33791,2014/03/31,2012/01/11,188,6,0.401863042,15523,188,5,1
33792,2014/03/31,2007/04/05,17,9,0.434915987,14343,17,1,8
33793,2014/03/31,2009/03/09,54,10,0.568576246,10971,54,8,2
33794,2014/03/31,2006/03/18,8,5,0.885932396,7041,8,1,4
33795,2014/03/31,2009/07/25,88,6,0.593158045,10516,88,2,4
33796,2014/03/31,2011/05/08,338,5,0.66755137,9344,338,4,1
33797,2014/03/31,2011/07/14,336,6,0.5532195120000001,11275,336,5,1
33798,2014/03/31,2012/08/24,457,4,0.585891415,10646,457,4,0
33799,2014/03/31,2009/07/19,208,7,0.582448637,10708,208,5,2
33800,2014/03/31,2009/09/27,6,6,0.707498582,8815,6,3,3
33801,2014/03/31,2012/08/15,50,6,0.700097665,8908,50,2,4
33802,2014/03/31,2012/11/06,1,3,1.217489262,5122,1,0,3
33803,2014/03/31,2011/09/12,109,9,0.759185537,8214,109,7,2
33804,2014/03/31,2012/09/22,203,8,0.745,8368,203,3,5
33805,2014/03/31,2011/05/04,28,6,0.792750858,7863,28,4,2
33806,2014/03/31,2008/02/28,13,6,0.7398480709999999,8425,13,3,3
33807,2014/03/31,2010/04/11,569,10,0.5495106679999999,11342,569,10,0
33808,2014/03/31,2012/06/11,24,7,0.806259542,7729,24,4,3
33809,2014/03/31,2005/11/27,24,10,0.5946030529999999,10480,24,0,10
33810,2014/03/31,2013/01/09,3,7,0.577564186,10789,3,0,7
33811,2014/03/31,2009/01/21,185,11,0.614087908,10147,185,8,3
33812,2014/03/31,2013/01/13,391,2,1.5,4154,391,2,0
33813,2014/03/31,2011/07/31,377,2,1.5,4154,377,2,0
33814,2014/03/31,2012/10/25,97,8,0.819539655,7603,97,3,5
33815,2014/03/31,2007/05/11,205,4,0.847862294,7349,205,2,2
33816,2014/03/31,2005/04/05,94,6,0.5425635670000001,11484,94,4,2
33817,2014/03/31,2008/12/14,2,7,0.479401354,12996,2,2,5
33818,2014/03/31,2011/09/15,79,8,0.502278297,12404,79,5,3
33819,2014/03/31,2012/08/14,14,7,0.635714286,9800,14,0,7
33820,2014/03/31,2013/02/17,3,14,0.5931638579999999,10503,3,0,14
33821,2014/03/31,2011/10/17,455,5,0.7,8900,455,5,0
33822,2014/03/31,2012/06/07,664,2,1.5,4153,664,2,0
33823,2014/03/31,2008/05/09,528,5,0.968922072,6429,528,5,0
33824,2014/03/31,2011/08/21,94,4,0.803005028,7757,94,1,3
33825,2014/03/31,2005/09/09,30,3,0.693541922,8981,30,2,1
33826,2014/03/31,2012/03/09,27,12,0.591179765,10536,27,2,10
33827,2014/03/31,2011/03/27,166,9,0.770196612,8087,166,6,3
33828,2014/03/31,2009/09/11,346,4,0.567626686,10972,346,2,2
33829,2014/03/31,2011/08/10,152,6,0.8255501059999999,7544,152,4,2
33830,2014/03/31,2008/10/17,39,5,0.8865859909999999,7024,39,2,3
33831,2014/03/31,2009/07/02,27,8,0.718653203,8665,27,3,5
33832,2014/03/31,2009/04/09,114,9,0.8002878809999999,7781,114,3,6
33833,2014/03/31,2012/05/11,133,4,0.674628386,9230,133,3,1
33834,2014/03/31,2008/04/25,95,4,1.443379694,4314,95,2,2
33835,2014/03/31,2008/02/28,89,9,0.407621604,15275,89,0,9
33836,2014/03/31,2008/12/25,328,5,0.745837326,8348,328,4,1
33837,2014/03/31,2010/12/03,610,3,1.187714613,5242,610,3,0
33838,2014/03/31,2012/07/28,35,4,0.5825,10688,35,1,3
33839,2014/03/31,2012/08/18,207,13,0.710822106,8758,207,12,1
33840,2014/03/31,2010/11/29,156,5,0.882145388,7057,156,3,2
33841,2014/03/31,2010/06/06,427,5,0.7354914929999999,8464,427,5,0
33842,2014/03/31,2011/12/11,107,10,0.712510302,8736,107,7,3
33843,2014/03/31,2010/11/10,46,13,0.535379322,11626,46,5,8
33844,2014/03/31,2009/06/19,10,19,0.521289782,11940,10,4,15
33845,2014/03/31,2008/02/07,10,6,0.6932962009999999,8977,10,0,6
33846,2014/03/31,2007/05/15,345,5,0.935952775,6649,345,4,1
33847,2014/03/31,2011/03/14,56,10,0.80797585,7702,56,2,8
33848,2014/03/31,2011/02/01,429,5,0.62788316,9911,429,5,0
33849,2014/03/31,2013/01/25,31,5,0.7089757320000001,8777,31,2,3
33850,2014/03/31,2012/10/09,293,8,0.789675127,7880,293,5,3
33851,2014/03/31,2005/09/29,4,12,0.805924103,7721,4,3,9
33852,2014/03/31,2007/04/05,170,11,0.49377351,12601,170,7,4
33853,2014/03/31,2012/07/19,464,4,0.695150838,8950,464,4,0
33854,2014/03/31,2012/03/19,605,12,0.839115187,7414,605,12,0
33855,2014/03/31,2007/01/11,49,6,0.667033026,9326,49,0,6
33856,2014/03/31,2010/10/21,212,4,0.758621951,8200,212,2,2
33857,2014/03/31,2011/06/05,107,12,0.581573485,10696,107,6,6
33858,2014/03/31,2012/04/07,511,9,0.520977469,11939,511,9,0
33859,2014/03/31,2009/12/03,29,11,0.7518109279999999,8272,29,4,7
33860,2014/03/31,2009/02/26,47,7,0.6054108260000001,10272,47,1,6
33861,2014/03/31,2008/04/27,142,6,0.450296886,13810,142,3,3
33862,2014/03/31,2012/08/25,61,5,0.789650794,7875,61,3,2
33863,2014/03/31,2009/05/14,187,12,0.384033354,16190,187,7,5
33864,2014/03/31,2007/09/19,105,6,0.71601198,8681,105,1,5
33865,2014/03/31,2011/01/24,141,4,0.574077769,10827,141,0,4
33866,2014/03/31,2011/01/09,195,9,0.8522597009999999,7293,195,6,3
33867,2014/03/31,2011/10/24,121,6,0.6577026460000001,9450,121,1,5
33868,2014/03/31,2007/08/23,233,4,0.8067082040000001,7704,233,0,4
33869,2014/03/31,2011/03/10,199,6,0.679886227,9141,199,4,2
33870,2014/03/31,2011/02/12,149,6,0.649676981,9566,149,3,3
33871,2014/03/31,2012/04/25,244,5,0.7850732690000001,7916,244,2,3
33872,2014/03/31,2012/11/03,508,3,0.8,7768,508,3,0
33873,2014/03/31,2012/07/15,233,3,0.662567438,9379,233,2,1
33874,2014/03/31,2005/11/18,10,6,0.640559736,9701,10,0,6
33875,2014/03/31,2012/03/16,413,5,0.620898281,10008,413,5,0
33876,2014/03/31,2005/12/19,3,6,0.611682418,10158,3,0,6
33877,2014/03/31,2008/05/02,246,10,0.475,13080,246,8,2
33878,2014/03/31,2010/08/10,164,4,0.690231085,9001,164,2,2
33879,2014/03/31,2012/07/04,101,7,0.730946105,8498,101,3,4
33880,2014/03/31,2008/01/03,33,7,0.749191895,8291,33,0,7
33881,2014/03/31,2012/11/11,7,7,0.710776977,8739,7,0,7
33882,2014/03/31,2007/04/27,9,6,0.580481308,10700,9,4,2
33883,2014/03/31,2010/08/06,91,6,0.795297733,7809,91,3,3
33884,2014/03/31,2012/05/26,491,4,0.7,8872,491,4,0
33885,2014/03/31,2012/03/28,554,7,0.823872081,7536,554,7,0
33886,2014/03/31,2007/06/06,25,5,0.998159164,6220,25,3,2
33887,2014/03/31,2009/11/18,81,7,0.640544779,9692,81,2,5
33888,2014/03/31,2013/01/01,80,6,0.547162877,11346,80,2,4
33889,2014/03/31,2011/04/14,165,6,0.7266034640000001,8544,165,3,3
33890,2014/03/31,2010/02/22,143,6,0.682561847,9095,143,4,2
33891,2014/03/31,2010/04/17,160,3,1.451391162,4277,160,1,2
33892,2014/03/31,2007/10/11,148,8,0.7249918240000001,8562,148,5,3
33893,2014/03/31,2012/10/12,61,6,0.828062967,7496,61,4,2
33894,2014/03/31,2011/05/28,102,9,0.929375562,6678,102,6,3
33895,2014/03/31,2012/08/29,10,7,0.780645283,7950,10,0,7
33896,2014/03/31,2011/09/14,148,6,0.652305024,9514,148,4,2
33897,2014/03/31,2012/11/20,103,6,0.8349280240000001,7433,103,0,6
33898,2014/03/31,2005/06/07,102,4,0.5725,10840,102,2,2
33899,2014/03/31,2009/02/12,34,9,0.624267176,9941,34,4,5
33900,2014/03/31,2012/05/02,514,9,0.679842244,9128,514,9,0
33901,2014/03/31,2012/07/14,111,6,0.644215116,9632,111,3,3
33902,2014/03/31,2006/06/23,123,8,0.659198895,9412,123,3,5
33903,2014/03/31,2009/07/29,283,6,0.856831929,7241,283,4,2
33904,2014/03/31,2005/09/26,7,7,0.622983231,9959,7,3,4
33905,2014/03/31,2010/08/19,188,7,0.678464567,9144,188,3,4
33906,2014/03/31,2012/04/15,672,5,0.615573526,10078,672,5,0
33907,2014/03/31,2010/02/21,564,2,0.771759144,8038,564,2,0
33908,2014/03/31,2006/06/19,710,2,0.85,7298,710,2,0
33909,2014/03/31,2005/05/18,27,7,0.6143369320000001,10097,27,3,4
33910,2014/03/31,2008/01/31,4,6,0.667334051,9295,4,2,4
33911,2014/03/31,2011/01/25,375,8,0.854858718,7255,375,8,0
33912,2014/03/31,2010/11/17,121,6,0.636474754,9744,121,0,6
33913,2014/03/31,2011/03/27,12,7,0.493005008,12579,12,0,7
33914,2014/03/31,2012/08/24,115,7,0.628346337,9869,115,4,3
33915,2014/03/31,2011/08/15,52,8,0.661643192,9372,52,5,3
33916,2014/03/31,2012/01/01,177,4,1.001434109,6192,177,2,2
33917,2014/03/31,2012/08/02,26,5,0.889771847,6969,26,2,3
33918,2014/03/31,2008/07/05,25,9,0.628920783,9859,25,3,6
33919,2014/03/31,2009/12/21,441,4,0.889129499,6973,441,4,0
33920,2014/03/31,2010/02/22,100,2,0.905,6850,100,0,2
33921,2014/03/31,2006/11/08,60,11,0.612670488,10118,60,3,8
33922,2014/03/31,2010/03/26,51,5,0.8796409820000001,7047,51,4,1
33923,2014/03/31,2011/04/28,297,5,0.6461069420000001,9594,297,3,2
33924,2014/03/31,2012/11/12,350,9,0.604776076,10249,350,7,2
33925,2014/03/31,2012/01/25,62,5,0.598,10365,62,3,2
33926,2014/03/31,2010/08/24,33,6,0.76349963,8118,33,3,3
33927,2014/03/31,2012/03/28,73,7,0.591527009,10478,73,3,4
33928,2014/03/31,2009/06/29,225,3,1.016699475,6096,225,2,1
33929,2014/03/31,2011/07/31,156,6,0.757574869,8181,156,4,2
33930,2014/03/31,2007/04/10,32,6,0.911666667,6798,32,0,6
33931,2014/03/31,2011/08/25,107,5,0.504095494,12294,107,3,2
33932,2014/03/31,2007/05/17,367,4,0.754474069,8214,367,4,0
33933,2014/03/31,2011/07/11,6,6,0.647363418,9573,6,5,1
33934,2014/03/31,2012/12/24,74,10,0.72379117,8562,74,2,8
33935,2014/03/31,2009/11/08,135,7,0.7642180559999999,8108,135,3,4
33936,2014/03/31,2008/04/25,188,7,0.859341193,7210,188,3,4
33937,2014/03/31,2012/05/08,301,7,0.6668604029999999,9291,301,5,2
33938,2014/03/31,2010/11/17,159,5,0.7870172759999999,7872,159,2,3
33939,2014/03/31,2011/07/10,75,7,0.766467896,8083,75,3,4
33940,2014/03/31,2011/02/20,418,8,0.767480178,8072,418,8,0
33941,2014/03/31,2008/07/20,107,8,0.861425393,7191,107,2,6
33942,2014/03/31,2011/12/18,5,12,0.442833858,13988,5,4,8
33943,2014/03/31,2005/08/12,206,5,0.834369612,7424,206,0,5
33944,2014/03/31,2013/03/26,53,5,0.6749291629999999,9176,53,0,5
33945,2014/03/31,2012/07/11,122,10,0.520488317,11898,122,3,7
33946,2014/03/31,2011/11/30,115,11,0.609806992,10155,115,5,6
33947,2014/03/31,2013/03/01,208,7,0.724085594,8552,208,4,3
33948,2014/03/31,2011/12/16,228,6,0.7043096,8792,228,2,4
33949,2014/03/31,2007/07/12,225,6,0.627815066,9863,225,4,2
33950,2014/03/31,2010/07/08,64,8,0.614901688,10070,64,2,6
33951,2014/03/31,2011/09/23,268,4,0.776420063,7975,268,0,4
33952,2014/03/31,2005/12/11,268,6,0.622804547,9941,268,5,1
33953,2014/03/31,2012/09/19,116,9,0.748774794,8268,116,1,8
33954,2014/03/31,2011/01/12,577,6,0.7644109659999999,8098,577,6,0
33955,2014/03/31,2005/12/21,122,4,0.717019576,8633,122,1,3
33956,2014/03/31,2005/09/06,67,10,0.470075942,13168,67,3,7
33957,2014/03/31,2011/01/13,64,11,0.452762051,13671,64,1,10
33958,2014/03/31,2012/08/04,67,7,0.725708758,8529,67,3,4
33959,2014/03/31,2013/01/01,12,6,0.992226675,6238,12,0,6
33960,2014/03/31,2008/08/16,203,9,0.744911542,8309,203,8,1
33961,2014/03/31,2011/11/22,67,5,0.6447270829999999,9600,67,3,2
33962,2014/03/31,2013/03/31,57,8,0.601109169,10296,57,0,8
33963,2014/03/31,2012/10/13,297,6,0.990677125,6247,297,4,2
33964,2014/03/31,2013/02/13,188,5,0.7609024959999999,8133,188,1,4
33965,2014/03/31,2008/12/05,148,9,0.524444444,11799,148,7,2
33966,2014/03/31,2012/05/01,101,5,0.528608406,11706,101,3,2
33967,2014/03/31,2011/11/14,114,5,0.602222871,10275,114,2,3
33968,2014/03/31,2009/02/21,35,6,0.914185875,6768,35,2,4
33969,2014/03/31,2008/04/09,427,5,0.980662546,6309,427,5,0
33970,2014/03/31,2006/12/03,15,6,0.6725568000000001,9199,15,2,4
33971,2014/03/31,2011/03/31,96,5,0.489125553,12648,96,1,4
33972,2014/03/31,2006/03/23,48,8,0.873031329,7086,48,0,8
33973,2014/03/31,2012/07/18,530,4,0.5605055720000001,11037,530,4,0
33974,2014/03/31,2007/01/20,520,10,0.755133057,8192,520,10,0
33975,2014/03/31,2007/12/01,59,8,0.7802724520000001,7928,59,5,3
33976,2014/03/31,2011/06/08,286,6,0.6632983060000001,9326,286,5,1
33977,2014/03/31,2012/05/01,564,8,0.8710011259999999,7102,564,8,0
33978,2014/03/31,2011/03/10,69,2,1.41,4387,69,0,2
33979,2014/03/31,2005/09/01,358,5,0.604588994,10231,358,3,2
33980,2014/03/31,2009/01/05,102,6,0.656359295,9424,102,4,2
33981,2014/03/31,2012/01/25,177,9,0.668010584,9259,177,3,6
33982,2014/03/31,2012/07/24,327,4,0.958617483,6452,327,3,1
33983,2014/03/31,2011/04/22,492,5,0.783084325,7898,492,5,0
33984,2014/03/31,2007/12/24,143,6,0.708507275,8729,143,0,6
33985,2014/03/31,2011/12/15,34,7,0.737299714,8388,34,5,2
33986,2014/03/31,2007/03/09,265,7,0.634562898,9746,265,6,1
33987,2014/03/31,2012/04/10,236,5,0.525022498,11779,236,3,2
33988,2014/03/31,2012/08/05,232,2,0.875137277,7066,232,1,1
33989,2014/03/31,2011/01/19,48,7,0.755324945,8186,48,3,4
33990,2014/03/31,2007/10/24,39,6,0.975861742,6336,39,3,3
33991,2014/03/31,2012/03/19,505,3,0.8901526059999999,6946,505,3,0
33992,2014/03/31,2011/08/10,149,7,0.818571429,7553,149,5,2
33993,2014/03/31,2008/11/06,209,7,0.652925335,9469,209,4,3
33994,2014/03/31,2011/05/25,67,12,0.445457886,13879,67,8,4
33995,2014/03/31,2009/03/13,346,5,0.802609373,7703,346,3,2
33996,2014/03/31,2010/11/18,227,7,0.89129902,6936,227,2,5
33997,2014/03/31,2008/12/01,80,4,0.7489760059999999,8252,80,1,3
33998,2014/03/31,2012/08/05,580,3,0.783333333,7890,580,3,0
33999,2014/03/31,2010/11/03,48,8,0.695020243,8892,48,3,5
34000,2014/03/31,2010/01/30,36,5,1.049650076,5887,36,1,4
34001,2014/03/31,2008/06/07,156,6,0.895230368,6902,156,3,3
34002,2014/03/31,2008/11/26,20,12,0.77118697,8012,20,6,6
34003,2014/03/31,2011/07/16,414,7,0.7206321440000001,8574,414,7,0
34004,2014/03/31,2012/04/13,197,11,0.451310446,13690,197,9,2
34005,2014/03/31,2011/02/05,425,4,0.738248297,8369,425,4,0
34006,2014/03/31,2009/01/04,107,5,0.652483895,9469,107,1,4
34007,2014/03/31,2006/12/23,214,6,0.603705296,10234,214,4,2
34008,2014/03/31,2012/03/01,269,4,0.740023958,8348,269,3,1
34009,2014/03/31,2011/05/09,161,6,0.7391313709999999,8358,161,2,4
34010,2014/03/31,2006/02/22,248,8,0.665678879,9280,248,4,4
34011,2014/03/31,2011/02/05,9,7,0.77295045,7992,9,2,5
34012,2014/03/31,2013/03/24,106,4,0.487816473,12663,106,1,3
34013,2014/03/31,2006/02/16,111,8,0.844069418,7318,111,5,3
34014,2014/03/31,2010/06/24,67,4,0.785,7868,67,0,4
34015,2014/03/31,2004/11/16,34,5,0.873945655,7066,34,0,5
34016,2014/03/31,2011/06/27,209,9,0.7060702040000001,8746,209,5,4
34017,2014/03/31,2005/12/12,138,6,0.624845173,9882,138,1,5
34018,2014/03/31,2012/09/12,21,7,0.769014821,8029,21,1,6
34019,2014/03/31,2011/12/09,16,8,0.544043528,11349,16,5,3
34020,2014/03/31,2013/02/18,248,3,0.840957505,7342,248,0,3
34021,2014/03/31,2007/02/10,86,8,0.82919957,7446,86,6,2
34022,2014/03/31,2010/10/26,375,14,0.764285714,8078,375,14,0
34023,2014/03/31,2010/07/30,62,6,0.942385895,6551,62,3,3
34024,2014/03/31,2012/09/18,87,7,0.7538788470000001,8188,87,4,3
34025,2014/03/31,2007/11/01,246,7,0.742048569,8318,246,5,2
34026,2014/03/31,2010/08/27,498,7,0.7088022509999999,8708,498,7,0
34027,2014/03/31,2012/06/18,82,6,0.64558159,9560,82,3,3
34028,2014/03/31,2007/02/07,509,7,0.794553882,7767,509,7,0
34029,2014/03/31,2009/06/19,502,6,0.6247038570000001,9877,502,6,0
34030,2014/03/31,2005/06/20,272,10,0.527890144,11688,272,6,4
34031,2014/03/31,2007/10/30,482,6,0.867777778,7110,482,6,0
34032,2014/03/31,2012/11/02,1,9,0.691218911,8926,1,1,8
34033,2014/03/31,2008/07/16,10,7,0.735194233,8392,10,4,3
34034,2014/03/31,2011/12/24,230,6,0.588688931,10480,230,4,2
34035,2014/03/31,2007/06/09,20,7,0.610413575,10107,20,3,4
34036,2014/03/31,2011/01/29,383,3,0.8424621059999999,7323,383,3,0
34037,2014/03/31,2009/10/17,212,7,0.6383671360000001,9664,212,3,4
34038,2014/03/31,2010/12/23,191,5,0.969635335,6362,191,3,2
34039,2014/03/31,2009/07/21,23,4,0.7425,8308,23,0,4
34040,2014/03/31,2011/02/20,153,4,0.7425,8308,153,3,1
34041,2014/03/31,2012/09/06,4,6,0.785893744,7849,4,2,4
34042,2014/03/31,2011/12/10,574,6,0.75,8224,574,6,0
34043,2014/03/31,2012/05/05,17,14,0.6546274679999999,9422,17,7,7
34044,2014/03/31,2012/05/14,167,12,0.502501222,12274,167,10,2
34045,2014/03/31,2008/08/13,141,7,0.918060435,6718,141,4,3
34046,2014/03/31,2009/06/24,593,7,0.918048526,6718,593,7,0
34047,2014/03/31,2012/02/16,25,7,0.481440281,12810,25,6,1
34048,2014/03/31,2008/01/25,13,7,0.56869052,10844,13,5,2
34049,2014/03/31,2006/08/29,447,5,0.688461538,8957,447,5,0
34050,2014/03/31,2012/02/10,4,9,0.560808549,10995,4,6,3
34051,2014/03/31,2012/05/12,569,5,1.0,6166,569,5,0
34052,2014/03/31,2009/09/13,156,6,0.645243826,9556,156,5,1
34053,2014/03/31,2011/03/05,669,9,0.396852674,15537,669,9,0
34054,2014/03/31,2005/01/26,188,6,0.562996073,10951,188,4,2
34055,2014/03/31,2008/03/05,65,7,0.702923603,8770,65,4,3
34056,2014/03/31,2011/10/09,112,8,0.7150336429999999,8620,112,6,2
34057,2014/03/31,2008/01/22,149,6,0.96020564,6419,149,3,3
34058,2014/03/31,2008/11/03,8,5,0.7281923440000001,8464,8,1,4
34059,2014/03/31,2011/01/29,34,9,0.528535289,11661,34,5,4
34060,2014/03/31,2011/12/17,550,4,1.119166515,5507,550,4,0
34061,2014/03/31,2012/02/11,256,8,0.681562707,9042,256,1,7
34062,2014/03/31,2010/03/10,234,6,0.456889087,13488,234,4,2
34063,2014/03/31,2011/09/14,25,7,0.6181602970000001,9969,25,4,3
34064,2014/03/31,2011/07/30,152,4,0.625931945,9845,152,2,2
34065,2014/03/31,2012/06/21,23,8,0.6750734009999999,9128,23,1,7
34066,2014/03/31,2006/06/28,36,8,0.529046965,11647,36,0,8
34067,2014/03/31,2011/09/17,112,5,0.905115322,6807,112,2,3
34068,2014/03/31,2009/12/24,19,6,0.820956823,7504,19,1,5
34069,2014/03/31,2008/03/29,426,6,0.7658378920000001,8044,426,6,0
34070,2014/03/31,2012/04/23,149,10,0.591094799,10422,149,4,6
34071,2014/03/31,2007/01/31,574,7,0.377903196,16301,574,7,0
34072,2014/03/31,2012/08/03,123,6,0.525390192,11725,123,1,5
34073,2014/03/31,2010/04/20,151,7,0.736648726,8361,151,4,3
34074,2014/03/31,2006/11/04,103,16,0.338710405,18184,103,8,8
34075,2014/03/31,2007/08/14,496,6,0.706065123,8722,496,6,0
34076,2014/03/31,2013/03/16,248,4,0.724138053,8504,248,1,3
34077,2014/03/31,2008/09/27,148,10,0.628884804,9792,148,6,4
34078,2014/03/31,2009/11/25,156,7,0.908798701,6776,156,4,3
34079,2014/03/31,2012/08/23,140,4,0.927254931,6641,140,0,4
34080,2014/03/31,2011/12/20,143,8,0.663216286,9284,143,3,5
34081,2014/03/31,2011/03/29,112,8,0.6820327909999999,9027,112,2,6
34082,2014/03/31,2009/02/21,134,6,0.627120302,9817,134,1,5
34083,2014/03/31,2006/11/08,165,4,0.955925466,6440,165,2,2
34084,2014/03/31,2007/05/25,1,8,0.814622205,7557,1,4,4
34085,2014/03/31,2008/10/08,180,5,0.707665249,8699,180,2,3
34086,2014/03/31,2012/08/19,150,9,0.709018659,8682,150,7,2
34087,2014/03/31,2005/11/11,590,6,0.775447216,7938,590,6,0
34088,2014/03/31,2010/11/08,167,7,0.697783698,8821,167,6,1
34089,2014/03/31,2007/01/30,65,4,0.607593287,10130,65,0,4
34090,2014/03/31,2011/12/22,24,12,0.413077181,14900,24,6,6
34091,2014/03/31,2009/08/31,7,10,0.536459514,11473,7,6,4
34092,2014/03/31,2012/04/20,20,8,0.945382488,6510,20,2,6
34093,2014/03/31,2012/03/31,62,13,0.493293524,12476,62,6,7
34094,2014/03/31,2008/05/23,432,8,0.80997631,7598,432,8,0
34095,2014/03/31,2012/03/13,199,13,0.506997858,12138,199,7,6
34096,2014/03/31,2013/01/12,341,2,0.616227719,9986,341,1,1
34097,2014/03/31,2010/11/10,65,7,0.625492986,9838,65,4,3
34098,2014/03/31,2012/05/08,306,4,0.5664120029999999,10864,306,3,1
34099,2014/03/31,2011/05/01,262,6,0.510424755,12054,262,4,2
34100,2014/03/31,2013/03/20,21,6,0.73253989,8398,21,1,5
34101,2014/03/31,2006/12/10,55,6,0.638145228,9640,55,4,2
34102,2014/03/31,2011/11/05,99,4,0.531416847,11575,99,0,4
34103,2014/03/31,2010/12/06,8,10,0.676082656,9098,8,3,7
34104,2014/03/31,2012/10/23,30,9,0.44906031,13696,30,2,7
34105,2014/03/31,2007/07/31,447,5,0.663749191,9266,447,5,0
34106,2014/03/31,2012/02/11,21,10,0.904544786,6799,21,2,8
34107,2014/03/31,2010/07/06,235,9,0.636777801,9658,235,6,3
34108,2014/03/31,2012/05/15,16,5,0.778703305,7897,16,2,3
34109,2014/03/31,2006/06/11,155,9,0.681951869,9017,155,3,6
34110,2014/03/31,2011/04/29,162,8,0.819192646,7506,162,5,3
34111,2014/03/31,2010/07/22,26,10,0.5019756710000001,12249,26,5,5
34112,2014/03/31,2010/01/30,19,8,0.596313646,10311,19,1,7
34113,2014/03/31,2011/08/25,179,9,0.732222222,8397,179,4,5
34114,2014/03/31,2011/11/24,439,7,0.925075233,6646,439,7,0
34115,2014/03/31,2013/01/26,141,5,0.7236381829999999,8496,141,2,3
34116,2014/03/31,2008/07/13,322,11,0.835591953,7357,322,10,1
34117,2014/03/31,2010/04/18,366,4,0.775,7932,366,3,1
34118,2014/03/31,2008/09/16,97,9,0.7608862479999999,8079,97,2,7
34119,2014/03/31,2012/05/31,269,8,0.8559754909999999,7181,269,4,4
34120,2014/03/31,2010/08/18,300,7,0.73478422,8365,300,5,2
34121,2014/03/31,2011/10/23,466,8,0.452858827,13572,466,8,0
34122,2014/03/31,2010/07/22,226,6,0.746652898,8231,226,4,2
34123,2014/03/31,2011/12/13,145,5,0.74470189,8252,145,3,2
34124,2014/03/31,2008/02/08,21,12,0.635941219,9663,21,10,2
34125,2014/03/31,2008/12/12,192,4,0.7714084859999999,7966,192,2,2
34126,2014/03/31,2010/06/05,424,3,0.7333333329999999,8379,424,3,0
34127,2014/03/31,2011/05/28,139,5,0.921771677,6666,139,3,2
34128,2014/03/31,2008/01/31,598,5,1.01797548,6036,598,5,0
34129,2014/03/31,2011/06/03,428,7,0.672231947,9140,428,7,0
34130,2014/03/31,2012/02/11,366,7,0.715405217,8588,366,6,1
34131,2014/03/31,2009/03/27,319,8,0.8736774740000001,7032,319,7,1
34132,2014/03/31,2009/04/08,146,10,0.8679725909999999,7078,146,1,9
34133,2014/03/31,2012/05/30,247,8,0.625037135,9829,247,4,4
34134,2014/03/31,2012/04/26,4,12,0.466441154,13170,4,6,6
34135,2014/03/31,2007/07/28,199,4,0.716537968,8573,199,1,3
34136,2014/03/31,2011/06/13,119,6,0.7681940970000001,7996,119,2,4
34137,2014/03/31,2012/06/08,428,4,0.739513605,8306,428,4,0
34138,2014/03/31,2010/03/02,174,6,0.518862984,11838,174,2,4
34139,2014/03/31,2006/04/18,94,15,0.54728504,11223,94,10,5
34140,2014/03/31,2007/10/24,301,5,0.7499340659999999,8190,301,4,1
34141,2014/03/31,2007/06/20,65,6,0.608620553,10091,65,5,1
34142,2014/03/31,2011/07/18,2,4,0.712025507,8625,2,2,2
34143,2014/03/31,2011/04/28,160,9,0.87726,7000,160,8,1
34144,2014/03/31,2007/05/20,6,4,0.8292505059999999,7405,6,0,4
34145,2014/03/31,2009/11/30,240,7,0.685787358,8954,240,5,2
34146,2014/03/31,2006/12/01,309,11,0.757512953,8106,309,9,2
34147,2014/03/31,2010/09/24,478,9,0.7666874770000001,8009,478,9,0
34148,2014/03/31,2011/03/07,190,3,0.73149869,8394,190,2,1
34149,2014/03/31,2012/03/09,447,6,0.636939834,9640,447,6,0
34150,2014/03/31,2007/06/21,176,9,0.625260692,9820,176,8,1
34151,2014/03/31,2011/11/20,20,6,0.5519101120000001,11125,20,4,2
34152,2014/03/31,2012/07/17,93,9,0.81056245,7574,93,7,2
34153,2014/03/31,2009/03/29,299,7,0.458819045,13379,299,6,1
34154,2014/03/31,2013/03/12,1,6,0.961049006,6387,1,2,4
34155,2014/03/31,2008/04/13,2,10,0.49548999,12388,2,0,10
34156,2014/03/31,2011/03/23,331,8,0.7310683659999999,8396,331,7,1
34157,2014/03/31,2012/08/21,576,2,0.8,7672,576,2,0
34158,2014/03/31,2007/02/08,199,2,0.8,7672,199,0,2
34159,2014/03/31,2012/09/12,449,4,0.638397129,9614,449,4,0
34160,2014/03/31,2012/08/01,387,6,0.649745924,9446,387,6,0
34161,2014/03/31,2007/04/26,69,6,0.7730620990000001,7939,69,2,4
34162,2014/03/31,2012/09/01,6,8,0.6315961720000001,9717,6,0,8
34163,2014/03/31,2012/07/03,7,9,0.6475152989999999,9478,7,3,6
34164,2014/03/31,2011/07/14,194,5,0.705078125,8704,194,4,1
34165,2014/03/31,2012/06/02,61,3,0.7512302609999999,8169,61,0,3
34166,2014/03/31,2007/02/15,333,8,0.8719238420000001,7038,333,7,1
34167,2014/03/31,2013/02/04,109,5,0.936737903,6551,109,1,4
34168,2014/03/31,2005/12/23,69,7,0.766555903,8005,69,6,1
34169,2014/03/31,2005/11/15,205,7,0.432468283,14188,205,4,3
34170,2014/03/31,2005/02/08,74,6,0.781666667,7848,74,4,2
34171,2014/03/31,2012/04/13,136,6,0.7150530359999999,8579,136,4,2
34172,2014/03/31,2009/01/14,486,4,0.85,7216,486,4,0
34173,2014/03/31,2013/03/07,266,6,0.664796748,9225,266,2,4
34174,2014/03/31,2012/11/15,23,9,0.489088444,12539,23,4,5
34175,2014/03/31,2007/06/22,87,4,0.716412383,8560,87,1,3
34176,2014/03/31,2012/09/13,349,6,0.792402119,7739,349,5,1
34177,2014/03/31,2012/07/14,278,10,0.6519455670000001,9406,278,8,2
34178,2014/03/31,2006/06/05,129,5,0.65180591,9408,129,0,5
34179,2014/03/31,2007/08/14,143,3,0.6029063020000001,10171,143,2,1
34180,2014/03/31,2011/10/16,241,6,0.702182526,8733,241,3,3
34181,2014/03/31,2013/02/18,35,6,0.712115898,8611,35,0,6
34182,2014/03/31,2005/06/30,32,10,0.560768246,10934,32,1,9
34183,2014/03/31,2011/06/14,86,8,0.618385275,9915,86,6,2
34184,2014/03/31,2012/11/17,28,10,0.788255336,7778,28,7,3
34185,2014/03/31,2006/06/25,64,4,0.712372763,8606,64,1,3
34186,2014/03/31,2007/07/21,98,9,0.7877014,7783,98,4,5
34187,2014/03/31,2010/01/01,260,6,0.925071676,6627,260,4,2
34188,2014/03/31,2008/02/14,188,5,0.8488410409999999,7222,188,3,2
34189,2014/03/31,2009/01/08,285,9,0.732257795,8371,285,7,2
34190,2014/03/31,2011/09/26,57,9,0.869982967,7045,57,5,4
34191,2014/03/31,2008/05/23,78,8,0.4073659020000001,15045,78,4,4
34192,2014/03/31,2005/11/27,9,7,0.612449286,10007,9,3,4
34193,2014/03/31,2012/03/23,14,9,0.683959147,8959,14,2,7
34194,2014/03/31,2012/06/30,93,6,0.866456448,7072,93,3,3
34195,2014/03/31,2007/06/03,331,4,0.7375,8308,331,3,1
34196,2014/03/31,2007/10/11,395,4,0.7375,8308,395,4,0
34197,2014/03/31,2007/03/22,190,5,0.743494722,8241,190,3,2
34198,2014/03/31,2009/02/14,162,9,0.5254343539999999,11661,162,2,7
34199,2014/03/31,2011/11/19,117,6,0.815290752,7515,117,0,6
34200,2014/03/31,2009/07/02,32,13,0.671122795,9129,32,1,12
34201,2014/03/31,2007/09/03,115,5,0.607037257,10092,115,1,4
34202,2014/03/31,2013/03/02,1,12,0.79437111,7712,1,0,12
34203,2014/03/31,2012/07/18,210,6,0.6036795429999999,10148,210,4,2
34204,2014/03/31,2013/03/07,38,3,0.777508567,7879,38,1,2
34205,2014/03/31,2011/04/21,470,3,0.843527954,7262,470,3,0
34206,2014/03/31,2005/12/07,31,10,0.673416887,9096,31,7,3
34207,2014/03/31,2012/12/01,362,4,0.627353273,9763,362,3,1
34208,2014/03/31,2010/10/26,202,7,0.643553641,9517,202,3,4
34209,2014/03/31,2008/07/10,2,3,0.903873967,6776,2,0,3
34210,2014/03/31,2012/01/04,338,5,1.070342538,5722,338,4,1
34211,2014/03/31,2007/03/23,180,6,0.838726376,7302,180,1,5
34212,2014/03/31,2012/02/13,4,13,0.605714568,10111,4,4,9
34213,2014/03/31,2012/01/15,37,9,0.6844064390000001,8946,37,7,2
34214,2014/03/31,2008/01/28,161,6,0.546149866,11210,161,4,2
34215,2014/03/31,2009/06/29,146,6,0.709412514,8630,146,4,2
34216,2014/03/31,2005/10/29,1,4,0.85126408,7191,1,0,4
34217,2014/03/31,2009/01/13,96,11,0.6052892320000001,10113,96,8,3
34218,2014/03/31,2011/06/19,512,8,0.615809859,9940,512,8,0
34219,2014/03/31,2009/11/05,189,9,0.8458104190000001,7237,189,5,4
34220,2014/03/31,2008/01/02,68,8,0.541184792,11310,68,4,4
34221,2014/03/31,2012/12/14,72,6,0.666666667,9180,72,2,4
34222,2014/03/31,2005/12/25,49,7,0.619472619,9879,49,2,5
34223,2014/03/31,2011/08/02,488,8,0.820995439,7454,488,8,0
34224,2014/03/31,2013/03/01,25,7,0.578466629,10578,25,1,6
34225,2014/03/31,2012/12/30,24,10,0.539909997,11333,24,5,5
34226,2014/03/31,2006/12/18,196,3,0.75,8158,196,2,1
34227,2014/03/31,2011/01/16,268,5,0.846561505,7227,268,4,1
34228,2014/03/31,2013/02/03,185,6,0.7666666670000001,7980,185,1,5
34229,2014/03/31,2011/08/24,20,2,0.83125,7360,20,0,2
34230,2014/03/31,2009/08/26,8,6,0.643644398,9505,8,2,4
34231,2014/03/31,2007/10/06,34,6,0.752721792,8127,34,1,5
34232,2014/03/31,2012/12/01,74,6,0.716588166,8535,74,3,3
34233,2014/03/31,2012/04/12,61,8,0.57991466,10546,61,1,7
34234,2014/03/31,2011/08/04,491,7,0.786888832,7772,491,7,0
34235,2014/03/31,2012/09/26,116,5,0.817580214,7480,116,4,1
34236,2014/03/31,2010/06/13,28,5,0.6257971760000001,9772,28,0,5
34237,2014/03/31,2012/08/28,3,7,0.5218912689999999,11717,3,2,5
34238,2014/03/31,2011/09/28,9,6,0.569887232,10730,9,0,6
34239,2014/03/31,2007/08/05,285,4,0.759840935,8047,285,2,2
34240,2014/03/31,2007/05/26,30,10,0.649831013,9409,30,2,8
34241,2014/03/31,2005/12/08,35,36,0.307729011,19868,35,16,20
34242,2014/03/31,2011/11/18,252,6,0.840955983,7270,252,4,2
34243,2014/03/31,2012/04/26,36,5,0.7681027770000001,7959,36,0,5
34244,2014/03/31,2012/08/19,581,3,0.7434269729999999,8223,581,3,0
34245,2014/03/31,2010/02/12,261,8,0.91542378,6678,261,7,1
34246,2014/03/31,2007/10/05,52,10,0.8519651570000001,7175,52,5,5
34247,2014/03/31,2011/07/17,153,10,0.619506436,9867,153,2,8
34248,2014/03/31,2012/08/09,81,10,0.661899296,9235,81,1,9
34249,2014/03/31,2010/09/23,464,3,0.7040428470000001,8682,464,3,0
34250,2014/03/31,2012/08/28,179,5,0.619507399,9866,179,2,3
34251,2014/03/31,2013/01/10,205,8,0.83413266,7327,205,4,4
34252,2014/03/31,2011/01/17,205,6,0.8745592440000001,6988,205,5,1
34253,2014/03/31,2006/11/27,116,5,0.7775849340000001,7859,116,0,5
34254,2014/03/31,2011/07/21,128,11,0.73,8371,128,3,8
34255,2014/03/31,2013/02/14,232,4,0.5375,11368,232,1,3
34256,2014/03/31,2011/12/16,67,3,0.812676244,7518,67,1,2
34257,2014/03/31,2008/12/18,103,6,0.706475486,8648,103,0,6
34258,2014/03/31,2008/09/19,259,6,0.6776231140000001,9016,259,2,4
34259,2014/03/31,2013/03/29,6,5,0.72,8485,6,1,4
34260,2014/03/31,2012/05/13,44,5,0.828302373,7375,44,3,2
34261,2014/03/31,2012/01/25,7,8,0.6837262140000001,8934,7,3,5
34262,2014/03/31,2009/12/01,35,4,1.204319795,5072,35,0,4
34263,2014/03/31,2011/01/17,217,4,0.6898870570000001,8854,217,2,2
34264,2014/03/31,2010/12/20,589,5,0.81516749,7493,589,5,0
34265,2014/03/31,2010/01/11,12,6,0.643415148,9493,12,1,5
34266,2014/03/31,2012/10/20,80,7,0.6114528889999999,9987,80,2,5
34267,2014/03/31,2005/08/04,3,4,0.5825884929999999,10481,3,3,1
34268,2014/03/31,2008/03/07,270,4,0.860724556,7094,270,1,3
34269,2014/03/31,2008/05/12,32,7,0.764647464,7985,32,0,7
34270,2014/03/31,2006/05/01,122,9,0.652293803,9360,122,2,7
34271,2014/03/31,2009/12/17,47,6,0.7679182390000001,7950,47,3,3
34272,2014/03/31,2012/08/07,485,3,0.934726688,6531,485,3,0
34273,2014/03/31,2012/02/14,92,8,0.383378344,15922,92,2,6
34274,2014/03/31,2011/10/18,202,3,1.41,4329,202,0,3
34275,2014/03/31,2008/12/09,266,6,0.7579324479999999,8053,266,5,1
34276,2014/03/31,2011/02/17,59,5,0.5720000000000001,10670,59,3,2
34277,2014/03/31,2009/11/03,6,9,0.8520636690000001,7162,6,3,6
34278,2014/03/31,2006/06/18,52,4,1.055,5784,52,0,4
34279,2014/03/31,2012/02/15,122,7,0.772021761,7904,122,1,6
34280,2014/03/31,2012/10/06,34,8,0.687912063,8870,34,6,2
34281,2014/03/31,2010/10/28,36,8,0.7840195320000001,7782,36,2,6
34282,2014/03/31,2006/10/30,134,6,0.746767442,8170,134,2,4
34283,2014/03/31,2010/08/05,34,12,0.524366996,11635,34,8,4
34284,2014/03/31,2008/12/25,37,7,0.5085960820000001,11995,37,5,2
34285,2014/03/31,2012/05/31,643,3,1.281781887,4759,643,3,0
34286,2014/03/31,2013/03/29,223,6,0.689799842,8843,223,1,5
34287,2014/03/31,2009/04/07,153,6,0.82095424,7430,153,3,3
34288,2014/03/31,2009/07/18,82,11,0.7268422309999999,8392,82,6,5
34289,2014/03/31,2008/03/15,199,6,0.805859427,7569,199,4,2
34290,2014/03/31,2005/05/20,618,10,0.568828686,10723,618,10,0
34291,2014/03/31,2007/12/23,191,2,0.795,7672,191,0,2
34292,2014/03/31,2012/04/28,510,5,0.608551187,10022,510,5,0
34293,2014/03/31,2012/09/08,37,16,0.936979567,6509,37,5,11
34294,2014/03/31,2013/03/16,18,8,0.719012025,8482,18,1,7
34295,2014/03/31,2009/02/23,71,5,0.765084682,7971,71,4,1
34296,2014/03/31,2010/09/16,343,6,0.548870387,11110,343,5,1
34297,2014/03/31,2012/01/03,542,9,0.841089655,7250,542,9,0
34298,2014/03/31,2012/05/13,213,7,0.841776643,7244,213,0,7
34299,2014/03/31,2012/08/09,581,4,0.775,7868,581,4,0
34300,2014/03/31,2012/09/05,73,7,0.340040712,17931,73,3,4
34301,2014/03/31,2010/12/02,175,8,0.5409590989999999,11271,175,1,7
34302,2014/03/31,2006/08/30,40,9,0.734913211,8296,40,3,6
34303,2014/03/31,2007/03/11,164,3,1.019872867,5978,164,1,2
34304,2014/03/31,2005/04/03,12,6,0.6751528240000001,9030,12,2,4
34305,2014/03/31,2012/01/16,56,8,0.67330793,9054,56,0,8
34306,2014/03/31,2012/03/27,37,6,0.8903227690000001,6847,37,4,2
34307,2014/03/31,2009/01/23,175,8,0.5351474979999999,11390,175,4,4
34308,2014/03/31,2009/09/10,190,4,1.128668519,5400,190,3,1
34309,2014/03/31,2011/02/08,47,9,0.499185027,12209,47,5,4
34310,2014/03/31,2010/05/21,317,7,0.47480134,12836,317,6,1
34311,2014/03/31,2006/08/12,580,3,0.657067385,9275,580,3,0
34312,2014/03/31,2010/12/01,54,7,0.8682601879999999,7018,54,5,2
34313,2014/03/31,2010/11/29,163,6,0.85617395,7117,163,3,3
34314,2014/03/31,2011/09/06,410,4,0.6490306770000001,9388,410,4,0
34315,2014/03/31,2011/09/19,75,9,0.841678409,7239,75,6,3
34316,2014/03/31,2013/02/16,6,5,0.8159247359999999,7467,6,1,4
34317,2014/03/31,2007/11/05,529,6,0.770287015,7909,529,6,0
34318,2014/03/31,2009/09/20,210,8,0.840948371,7244,210,0,8
34319,2014/03/31,2011/02/09,185,5,0.486970181,12509,185,1,4
34320,2014/03/31,2008/11/29,162,5,0.7697965370000001,7913,162,4,1
34321,2014/03/31,2006/08/30,480,3,0.6333333329999999,9618,480,3,0
34322,2014/03/31,2011/01/15,158,6,0.666963758,9133,158,2,4
34323,2014/03/31,2011/12/27,182,10,0.730377698,8340,182,7,3
34324,2014/03/31,2011/10/23,627,5,0.929781713,6551,627,5,0
34325,2014/03/31,2006/12/28,45,5,0.624766643,9749,45,1,4
34326,2014/03/31,2009/04/13,72,4,0.8008823140000001,7605,72,1,3
34327,2014/03/31,2010/09/21,88,6,0.575542009,10581,88,3,3
34328,2014/03/31,2009/07/01,21,7,0.554611111,10980,21,4,3
34329,2014/03/31,2006/02/01,111,6,0.769247094,7916,111,2,4
34330,2014/03/31,2011/01/26,297,5,0.944922408,6444,297,4,1
34331,2014/03/31,2012/11/13,344,5,0.6764859459999999,9001,344,3,2
34332,2014/03/31,2012/04/16,532,6,0.600819025,10134,532,6,0
34333,2014/03/31,2011/03/20,16,7,0.556906613,10933,16,6,1
34334,2014/03/31,2005/10/07,295,9,0.80525,7560,295,7,2
34335,2014/03/31,2008/04/30,13,5,0.587666763,10359,13,2,3
34336,2014/03/31,2007/05/18,523,5,0.847501044,7183,523,5,0
34337,2014/03/31,2009/11/14,5,6,0.666736035,9130,5,4,2
34338,2014/03/31,2011/02/18,118,6,0.626775124,9712,118,1,5
34339,2014/03/31,2008/01/16,31,4,0.827948857,7352,31,2,2
34340,2014/03/31,2012/09/14,150,10,0.679967605,8952,150,7,3
34341,2014/03/31,2005/04/26,4,7,0.547212982,11123,4,4,3
34342,2014/03/31,2010/08/30,209,6,0.663022876,9180,209,5,1
34343,2014/03/31,2006/03/17,307,5,0.8453535209999999,7199,307,4,1
34344,2014/03/31,2012/10/26,252,7,0.926987053,6565,252,4,3
34345,2014/03/31,2012/01/04,92,5,0.587350642,10361,92,4,1
34346,2014/03/31,2012/02/23,467,10,0.6786805709999999,8966,467,10,0
34347,2014/03/31,2011/05/29,204,6,0.630529534,9650,204,4,2
34348,2014/03/31,2010/05/13,14,9,0.860611033,7070,14,7,2
34349,2014/03/31,2012/10/11,180,8,0.586539092,10373,180,3,5
34350,2014/03/31,2011/11/30,138,8,0.7697671770000001,7903,138,5,3
34351,2014/03/31,2012/11/30,22,6,0.6629479079999999,9176,22,2,4
34352,2014/03/31,2007/02/06,41,4,1.432272192,4247,41,1,3
34353,2014/03/31,2009/09/14,200,7,0.8906267390000001,6829,200,2,5
34354,2014/03/31,2012/01/19,140,7,0.627467244,9693,140,1,6
34355,2014/03/31,2011/08/05,188,7,0.407142857,14938,188,5,2
34356,2014/03/31,2006/08/05,254,7,0.9032764,6733,254,5,2
34357,2014/03/31,2012/01/14,100,7,0.781110968,7786,100,3,4
34358,2014/03/31,2011/09/08,441,9,0.698609994,8705,441,9,0
34359,2014/03/31,2011/09/10,30,6,0.735,8274,30,3,3
34360,2014/03/31,2005/03/31,149,5,0.632215637,9618,149,1,4
34361,2014/03/31,2011/08/11,45,9,0.496776961,12240,45,5,4
34362,2014/03/31,2011/11/07,397,2,1.329663241,4573,397,2,0
34363,2014/03/31,2011/08/25,564,2,0.683805668,8892,564,2,0
34364,2014/03/31,2011/07/29,31,5,0.681885163,8917,31,0,5
34365,2014/03/31,2009/06/30,2,6,0.8853145020000001,6868,2,1,5
34366,2014/03/31,2005/06/22,146,4,0.7660627440000001,7937,146,1,3
34367,2014/03/31,2011/10/15,385,14,0.798765108,7612,385,14,0
34368,2014/03/31,2005/05/16,168,6,0.675046075,9007,168,4,2
34369,2014/03/31,2007/03/01,11,10,0.447627181,13583,11,3,7
34370,2014/03/31,2009/11/12,13,4,0.7305839940000001,8322,13,0,4
34371,2014/03/31,2011/05/15,26,11,0.647196849,9393,26,5,6
34372,2014/03/31,2012/07/01,159,6,0.762460805,7973,159,4,2
34373,2014/03/31,2012/03/03,57,9,0.578508755,10508,57,6,3
34374,2014/03/31,2007/05/10,5,6,0.517929448,11736,5,3,3
34375,2014/03/31,2007/06/03,18,6,0.370258285,16416,18,0,6
34376,2014/03/31,2011/06/17,112,4,0.604776119,10050,112,1,3
34377,2014/03/31,2011/08/01,309,6,0.768572151,7907,309,5,1
34378,2014/03/31,2010/04/01,156,8,0.708610075,8576,156,5,3
34379,2014/03/31,2012/09/06,573,2,1.441413662,4216,573,2,0
34380,2014/03/31,2012/09/06,573,2,1.441413662,4216,573,2,0
34381,2014/03/31,2010/09/16,6,9,0.715948398,8488,6,7,2
34382,2014/03/31,2009/11/22,326,10,0.771085025,7880,326,5,5
34383,2014/03/31,2012/04/20,78,7,0.638216387,9520,78,3,4
34384,2014/03/31,2011/06/22,261,9,0.6792029070000001,8945,261,3,6
34385,2014/03/31,2013/03/14,376,2,1.05,5786,376,2,0
34386,2014/03/31,2009/10/24,50,7,0.704133534,8627,50,3,4
34387,2014/03/31,2013/01/01,16,7,0.591062567,10277,16,0,7
34388,2014/03/31,2010/10/14,214,6,0.91854529,6613,214,4,2
34389,2014/03/31,2012/10/02,98,5,0.652168778,9314,98,1,4
34390,2014/03/31,2012/06/12,146,9,0.769523629,7893,146,5,4
34391,2014/03/31,2008/05/18,230,5,0.764721733,7942,230,4,1
34392,2014/03/31,2010/08/17,169,8,0.678140704,8955,169,3,5
34393,2014/03/31,2006/06/18,15,8,0.824976226,7361,15,3,5
34394,2014/03/31,2012/04/25,75,6,0.740475552,8201,75,5,1
34395,2014/03/31,2008/01/03,29,7,0.7148893340000001,8494,29,1,6
34396,2014/03/31,2012/09/27,306,5,0.888410887,6834,306,4,1
34397,2014/03/31,2010/03/19,583,3,0.852576885,7121,583,3,0
34398,2014/03/31,2007/09/01,148,7,0.875303533,6935,148,5,2
34399,2014/03/31,2013/03/03,15,7,0.6895671440000001,8802,15,2,5
34400,2014/03/31,2012/12/11,142,7,0.436603841,13901,142,1,6
34401,2014/03/31,2009/03/21,160,8,0.6122785070000001,9910,160,0,8
34402,2014/03/31,2012/05/24,620,3,0.829446343,7315,620,3,0
34403,2014/03/31,2011/03/10,187,6,0.562913342,10778,187,2,4
34404,2014/03/31,2008/11/05,11,10,0.636399874,9533,11,0,10
34405,2014/03/31,2012/10/27,24,6,0.529698743,11452,24,1,5
34406,2014/03/31,2010/12/14,511,6,0.675186463,8983,511,6,0
34407,2014/03/31,2010/09/19,348,3,0.569883481,10642,348,2,1
34408,2014/03/31,2010/11/25,70,8,0.684459368,8860,70,4,4
34409,2014/03/31,2011/07/09,22,7,0.5538100460000001,10950,22,4,3
34410,2014/03/31,2011/06/30,46,7,0.962399619,6301,46,5,2
34411,2014/03/31,2004/12/14,207,5,0.446735431,13573,207,4,1
34412,2014/03/31,2007/02/10,65,5,0.578,10490,65,1,4
34413,2014/03/31,2008/06/08,33,7,0.519374679,11674,33,6,1
34414,2014/03/31,2005/08/28,170,5,0.8730165590000001,6945,170,4,1
34415,2014/03/31,2012/05/25,352,4,1.0125,5988,352,3,1
34416,2014/03/31,2012/07/07,147,7,0.859899291,7050,147,3,4
34417,2014/03/31,2012/03/06,36,7,0.710023425,8538,36,1,6
34418,2014/03/31,2007/09/11,127,3,1.4699709019999998,4124,127,2,1
34419,2014/03/31,2010/08/06,419,8,0.96698038,6269,419,8,0
34420,2014/03/31,2012/01/16,253,5,0.563327138,10760,253,2,3
34421,2014/03/31,2007/09/28,11,3,1.256225907,4825,11,0,3
34422,2014/03/31,2012/04/20,343,8,0.7393924609999999,8197,343,7,1
34423,2014/03/31,2013/02/12,109,4,0.665858053,9102,109,0,4
34424,2014/03/31,2011/02/01,50,4,0.71,8536,50,1,3
34425,2014/03/31,2011/09/23,148,4,0.71,8536,148,2,2
34426,2014/03/31,2006/10/12,13,9,0.61071954,9923,13,0,9
34427,2014/03/31,2012/01/26,554,4,1.5,4040,554,4,0
34428,2014/03/31,2013/02/07,319,4,0.77018302,7868,319,2,2
34429,2014/03/31,2011/10/25,464,6,0.759652752,7977,464,6,0
34430,2014/03/31,2007/03/25,230,6,0.61301568,9885,230,2,4
34431,2014/03/31,2006/01/25,175,4,0.764118537,7930,175,3,1
34432,2014/03/31,2010/01/04,97,5,0.918175481,6599,97,3,2
34433,2014/03/31,2012/07/22,263,5,0.597876455,10134,263,3,2
34434,2014/03/31,2007/07/11,276,6,0.708490235,8551,276,0,6
34435,2014/03/31,2008/04/25,33,9,0.768510719,7883,33,0,9
34436,2014/03/31,2006/04/02,129,8,0.823112772,7360,129,2,6
34437,2014/03/31,2011/12/25,194,2,1.254743165,4828,194,1,1
34438,2014/03/31,2011/01/13,357,4,0.985793328,6145,357,2,2
34439,2014/03/31,2012/12/30,212,4,0.805,7524,212,2,2
34440,2014/03/31,2006/11/24,95,8,0.7441282709999999,8139,95,0,8
34441,2014/03/31,2013/03/23,31,5,0.76120538,7956,31,1,4
34442,2014/03/31,2007/06/28,76,6,0.77445965,7819,76,4,2
34443,2014/03/31,2013/03/10,175,4,0.674771562,8974,175,1,3
34444,2014/03/31,2009/12/28,111,7,0.592678869,10217,111,2,5
34445,2014/03/31,2008/01/24,156,10,0.620425205,9760,156,6,4
34446,2014/03/31,2012/04/18,111,7,0.927142857,6531,111,6,1
34447,2014/03/31,2012/07/05,244,13,0.564528249,10726,244,7,6
34448,2014/03/31,2012/12/29,44,10,0.417186165,14514,44,3,7
34449,2014/03/31,2009/10/10,30,4,0.948890456,6381,30,2,2
34450,2014/03/31,2007/11/08,25,6,0.687341355,8809,25,3,3
34451,2014/03/31,2010/11/17,83,6,0.727455245,8323,83,2,4
34452,2014/03/31,2012/06/26,23,5,0.692118441,8747,23,2,3
34453,2014/03/31,2009/05/29,280,5,0.83772765,7226,280,3,2
34454,2014/03/31,2010/09/23,123,3,0.926018051,6537,123,0,3
34455,2014/03/31,2012/08/02,132,7,0.564885218,10716,132,1,6
34456,2014/03/31,2007/07/20,121,5,0.639726274,9462,121,3,2
34457,2014/03/31,2011/07/15,380,7,0.624316658,9695,380,7,0
34458,2014/03/31,2012/05/07,40,6,0.616036641,9825,40,2,4
34459,2014/03/31,2007/08/06,175,10,0.690218953,8769,175,4,6
34460,2014/03/31,2011/07/20,287,13,0.657410385,9206,287,11,2
34461,2014/03/31,2012/07/03,87,5,0.4802380570000001,12602,87,4,1
34462,2014/03/31,2012/03/03,127,5,1.14029772,5307,127,1,4
34463,2014/03/31,2008/01/04,592,4,1.0,6051,592,4,0
34464,2014/03/31,2011/10/30,381,4,0.771404895,7844,381,4,0
34465,2014/03/31,2012/07/17,73,8,0.790552652,7654,73,1,7
34466,2014/03/31,2012/09/10,556,3,0.558397933,10836,556,3,0
34467,2014/03/31,2011/07/19,17,8,0.928563536,6516,17,2,6
34468,2014/03/31,2012/07/04,613,3,0.688171065,8792,613,3,0
34469,2014/03/31,2010/08/08,12,12,0.575726113,10508,12,4,8
34470,2014/03/31,2008/11/17,192,5,0.653940115,9251,192,3,2
34471,2014/03/31,2010/10/03,8,18,0.579444444,10440,8,7,11
34472,2014/03/31,2008/11/19,184,8,0.71930321,8410,184,1,7
34473,2014/03/31,2011/08/26,125,12,0.653460084,9257,125,9,3
34474,2014/03/31,2013/03/07,216,8,0.626877397,9649,216,1,7
34475,2014/03/31,2007/03/31,293,6,0.763899975,7918,293,2,4
34476,2014/03/31,2011/04/11,210,6,0.744527884,8123,210,4,2
34477,2014/03/31,2011/04/18,193,8,0.697905366,8665,193,2,6
34478,2014/03/31,2011/08/24,115,7,0.76587386,7896,115,5,2
34479,2014/03/31,2012/11/29,65,6,0.668695123,9043,65,2,4
34480,2014/03/31,2011/12/26,43,5,0.706215837,8562,43,2,3
34481,2014/03/31,2012/06/21,368,11,0.8873789259999999,6814,368,11,0
34482,2014/03/31,2011/08/10,360,8,0.8884643640000001,6805,360,7,1
34483,2014/03/31,2007/04/07,104,7,0.6863442329999999,8808,104,1,6
34484,2014/03/31,2005/04/27,198,5,0.72304223,8359,198,4,1
34485,2014/03/31,2012/12/13,161,11,0.523552495,11544,161,5,6
34486,2014/03/31,2012/07/06,488,4,0.891664208,6778,488,4,0
34487,2014/03/31,2010/08/01,11,4,0.4818386220000001,12542,11,0,4
34488,2014/03/31,2006/12/24,39,5,1.223766707,4938,39,3,2
34489,2014/03/31,2012/11/23,19,14,0.665,9086,19,9,5
34490,2014/03/31,2012/07/29,45,4,0.903554658,6687,45,1,3
34491,2014/03/31,2011/09/04,14,6,0.677278332,8921,14,2,4
34492,2014/03/31,2009/09/05,68,4,0.742706822,8135,68,2,2
34493,2014/03/31,2007/07/15,122,5,0.62962797,9596,122,1,4
34494,2014/03/31,2009/08/21,188,5,0.652683375,9257,188,4,1
34495,2014/03/31,2010/04/14,597,7,0.6986816240000001,8647,597,7,0
34496,2014/03/31,2011/09/29,294,7,0.8260927240000001,7312,294,6,1
34497,2014/03/31,2012/07/09,44,4,0.6334249160000001,9536,44,3,1
34498,2014/03/31,2007/01/30,46,4,0.726707977,8311,46,1,3
34499,2014/03/31,2010/03/07,345,5,0.813613094,7423,345,4,1
34500,2014/03/31,2007/11/11,632,4,1.033587198,5843,632,4,0
34501,2014/03/31,2012/02/21,65,10,0.812704885,7431,65,7,3
34502,2014/03/31,2013/01/31,217,3,1.037994156,5818,217,1,2
34503,2014/03/31,2009/12/22,92,11,0.8739507959999999,6910,92,1,10
34504,2014/03/31,2007/09/11,459,10,0.605823636,9968,459,10,0
34505,2014/03/31,2009/07/30,94,5,0.614,9835,94,0,5
34506,2014/03/31,2010/09/21,85,4,0.907652187,6653,85,3,1
34507,2014/03/31,2011/10/31,377,9,0.7872881359999999,7670,377,9,0
34508,2014/03/31,2006/11/14,45,4,0.7019344340000001,8602,45,1,3
34509,2014/03/31,2012/12/22,127,17,0.612352941,9860,127,7,10
34510,2014/03/31,2011/09/14,412,5,0.938812004,6431,412,5,0
34511,2014/03/31,2010/04/16,206,9,0.7243431309999999,8335,206,4,5
34512,2014/03/31,2008/05/26,169,7,0.691307683,8733,169,0,7
34513,2014/03/31,2008/09/08,5,8,0.725873016,8316,5,3,5
34514,2014/03/31,2009/08/01,31,6,0.660524185,9138,31,0,6
34515,2014/03/31,2007/04/05,572,5,0.7474674920000001,8075,572,5,0
34516,2014/03/31,2007/08/26,489,7,0.569889529,10591,489,7,0
34517,2014/03/31,2009/07/10,82,5,0.7456022240000001,8095,82,0,5
34518,2014/03/31,2005/08/20,18,7,0.670595622,8999,18,0,7
34519,2014/03/31,2005/11/17,115,12,0.6745539909999999,8946,115,8,4
34520,2014/03/31,2011/05/28,495,4,0.816971297,7386,495,4,0
34521,2014/03/31,2013/02/21,5,6,0.775627973,7779,5,0,6
34522,2014/03/31,2006/09/14,109,4,0.728478628,8282,109,2,2
34523,2014/03/31,2010/11/04,236,8,0.55557285,10858,236,4,4
34524,2014/03/31,2012/04/12,646,4,0.50387571,11972,646,4,0
34525,2014/03/31,2013/01/18,179,5,0.738793631,8165,179,3,2
34526,2014/03/31,2010/08/27,244,5,0.425370566,14181,244,4,1
34527,2014/03/31,2010/06/14,79,3,0.8164478140000001,7387,79,1,2
34528,2014/03/31,2008/11/03,112,13,0.779802172,7734,112,6,7
34529,2014/03/31,2005/04/01,113,5,0.922,6540,113,1,4
34530,2014/03/31,2008/06/10,236,5,0.8340000000000001,7230,236,4,1
34531,2014/03/31,2013/01/05,121,6,0.698216767,8636,121,3,3
34532,2014/03/31,2008/08/02,134,6,0.7442224140000001,8102,134,1,5
34533,2014/03/31,2012/09/25,118,5,0.6271899710000001,9612,118,0,5
34534,2014/03/31,2011/11/03,328,6,0.705665457,8543,328,4,2
34535,2014/03/31,2010/12/15,241,8,0.588825943,10238,241,6,2
34536,2014/03/31,2012/12/03,102,8,0.638027096,9448,102,0,8
34537,2014/03/31,2010/03/29,503,6,0.7286629590000001,8272,503,6,0
34538,2014/03/31,2012/11/20,248,7,0.6116614229999999,9853,248,3,4
34539,2014/03/31,2010/07/14,2,12,0.510685535,11801,2,8,4
34540,2014/03/31,2005/07/08,40,4,0.825720745,7298,40,0,4
34541,2014/03/31,2011/06/07,346,6,0.7433082520000001,8107,346,4,2
34542,2014/03/31,2013/01/08,178,5,0.740128977,8141,178,3,2
34543,2014/03/31,2012/10/30,82,17,0.70471462,8550,82,8,9
34544,2014/03/31,2006/01/27,88,11,0.7189118240000001,8381,88,2,9
34545,2014/03/31,2008/07/26,93,5,0.65304574,9226,93,1,4
34546,2014/03/31,2008/05/01,222,5,0.908879167,6629,222,2,3
34547,2014/03/31,2006/04/09,341,4,0.464054075,12982,341,3,1
34548,2014/03/31,2007/10/25,122,7,0.60054531,10031,122,6,1
34549,2014/03/31,2006/12/14,118,9,0.535946619,11240,118,5,4
34550,2014/03/31,2012/12/06,11,4,0.782930855,7694,11,1,3
34551,2014/03/31,2012/11/16,107,6,0.6827076959999999,8823,107,1,5
34552,2014/03/31,2006/03/01,44,8,0.5775139020000001,10430,44,1,7
34553,2014/03/31,2013/02/01,384,4,0.725,8308,384,4,0
34554,2014/03/31,2011/03/12,107,4,0.627616964,9597,107,1,3
34555,2014/03/31,2012/02/14,25,7,0.8418786690000001,7154,25,5,2
34556,2014/03/31,2008/07/15,49,4,0.774128535,7780,49,0,4
34557,2014/03/31,2011/07/24,193,5,0.578154939,10417,193,4,1
34558,2014/03/31,2011/11/18,139,8,0.7447236309999999,8087,139,5,3
34559,2014/03/31,2007/11/26,127,8,0.6209713339999999,9698,127,6,2
34560,2014/03/31,2011/11/10,244,5,0.806496585,7467,244,4,1
34561,2014/03/31,2009/03/27,361,6,0.7191246720000001,8374,361,5,1
34562,2014/03/31,2005/10/22,32,10,0.883094295,6819,32,4,6
34563,2014/03/31,2011/06/24,26,6,0.646299238,9317,26,2,4
34564,2014/03/31,2011/05/21,104,7,0.7953368559999999,7570,104,4,3
34565,2014/03/31,2009/12/07,478,5,0.67663294,8895,478,5,0
34566,2014/03/31,2006/01/18,237,4,0.705,8536,237,2,2
34567,2014/03/31,2011/07/18,3,10,0.5339662820000001,11270,3,4,6
34568,2014/03/31,2010/12/28,348,7,0.6205858089999999,9696,348,5,2
34569,2014/03/31,2005/05/21,580,5,0.92,6540,580,5,0
34570,2014/03/31,2011/05/08,1,3,1.41,4267,1,0,3
34571,2014/03/31,2012/12/28,10,4,0.879676853,6839,10,2,2
34572,2014/03/31,2011/02/03,49,7,0.73725,8160,49,2,5
34573,2014/03/31,2013/01/03,106,3,0.564686004,10653,106,0,3
34574,2014/03/31,2007/04/13,83,5,0.816095509,7371,83,3,2
34575,2014/03/31,2010/01/01,356,4,0.805504219,7467,356,3,1
34576,2014/03/31,2012/02/08,2,7,0.860197368,6992,2,2,5
34577,2014/03/31,2013/01/18,121,6,0.60618486,9921,121,1,5
34578,2014/03/31,2010/11/17,97,5,0.553526325,10864,97,3,2
34579,2014/03/31,2011/02/25,76,5,0.546433115,11004,76,1,4
34580,2014/03/31,2006/04/07,363,3,0.899655792,6682,363,2,1
34581,2014/03/31,2006/04/07,51,8,0.762925498,7879,51,0,8
34582,2014/03/31,2012/05/21,125,8,0.7092625370000001,8475,125,2,6
34583,2014/03/31,2012/04/11,49,7,0.706991296,8502,49,2,5
34584,2014/03/31,2011/12/21,135,6,0.634107407,9478,135,4,2
34585,2014/03/31,2005/04/08,421,6,0.455260965,13201,421,6,0
34586,2014/03/31,2013/01/15,114,6,0.6600109829999999,9105,114,1,5
34587,2014/03/31,2012/12/14,20,5,0.6371757339999999,9429,20,2,3
34588,2014/03/31,2011/03/23,236,6,0.715884175,8392,236,3,3
34589,2014/03/31,2011/09/09,18,7,0.6324402570000001,9499,18,3,4
34590,2014/03/31,2012/07/25,100,11,0.7552495909999999,7953,100,9,2
34591,2014/03/31,2012/10/19,17,8,0.594787087,10098,17,5,3
34592,2014/03/31,2012/02/05,29,4,0.385,15600,29,1,3
34593,2014/03/31,2011/11/07,30,13,0.619297793,9698,30,11,2
34594,2014/03/31,2009/08/22,470,4,0.65517674,9166,470,4,0
34595,2014/03/31,2008/09/30,29,6,0.8434339890000001,7120,29,2,4
34596,2014/03/31,2013/02/08,30,8,0.598999501,10025,30,3,5
34597,2014/03/31,2007/11/03,566,3,0.716666667,8379,566,3,0
34598,2014/03/31,2011/04/12,552,6,0.6684403870000001,8983,552,6,0
34599,2014/03/31,2005/05/10,197,7,0.47076917,12754,197,0,7
34600,2014/03/31,2005/04/06,247,6,0.599445887,10016,247,5,1
34601,2014/03/31,2010/08/22,279,7,0.927142857,6475,279,3,4
34602,2014/03/31,2008/09/24,44,10,0.884123711,6790,44,3,7
34603,2014/03/31,2007/04/08,66,7,0.8167088440000001,7350,66,4,3
34604,2014/03/31,2008/03/23,213,5,0.990888082,6058,213,4,1
34605,2014/03/31,2012/09/19,104,10,0.483735998,12409,104,3,7
34606,2014/03/31,2011/03/07,4,7,0.5513440510000001,10885,4,1,6
34607,2014/03/31,2012/06/27,305,6,0.7814975909999999,7679,305,4,2
34608,2014/03/31,2006/12/28,4,9,0.7112944520000001,8436,4,0,9
34609,2014/03/31,2006/12/30,499,7,0.7946430940000001,7551,499,7,0
34610,2014/03/31,2007/06/12,148,11,0.562164543,10672,148,10,1
34611,2014/03/31,2011/11/20,275,10,0.787715336,7616,275,6,4
34612,2014/03/31,2006/10/24,49,4,0.785987945,7632,49,1,3
34613,2014/03/31,2011/05/16,418,5,0.763051775,7861,418,5,0
34614,2014/03/31,2012/03/18,73,9,0.73077729,8208,73,5,4
34615,2014/03/31,2011/03/15,506,5,0.8437192290000001,7109,506,5,0
34616,2014/03/31,2011/03/29,35,7,0.96033787,6245,35,1,6
34617,2014/03/31,2007/05/30,13,6,1.012202532,5925,13,1,5
34618,2014/03/31,2010/09/01,128,9,0.7515400999999999,7980,128,5,4
34619,2014/03/31,2007/04/17,3,6,0.507650047,11813,3,3,3
34620,2014/03/31,2010/09/10,260,4,0.604493952,9920,260,0,4
34621,2014/03/31,2006/04/09,11,11,0.6057723,9899,11,0,11
34622,2014/03/31,2007/06/21,579,5,0.676641842,8862,579,5,0
34623,2014/03/31,2006/04/29,12,7,0.462502121,12965,12,2,5
34624,2014/03/31,2008/08/07,166,7,0.718139897,8349,166,4,3
34625,2014/03/31,2010/06/23,48,7,0.643732016,9314,48,0,7
34626,2014/03/31,2011/09/03,301,6,0.718370477,8346,301,5,1
34627,2014/03/31,2010/10/20,244,7,0.6804426290000001,8811,244,5,2
34628,2014/03/31,2011/11/01,18,5,0.73957809,8106,18,2,3
34629,2014/03/31,2007/06/12,50,7,0.669595666,8953,50,2,5
34630,2014/03/31,2008/03/24,284,4,1.089956364,5500,284,2,2
34631,2014/03/31,2008/03/21,471,7,0.954250239,6282,471,7,0
34632,2014/03/31,2012/04/12,34,6,0.7667370170000001,7818,34,1,5
34633,2014/03/31,2010/04/19,279,6,0.615472841,9739,279,5,1
34634,2014/03/31,2009/11/01,117,5,0.866171965,6920,117,4,1
34635,2014/03/31,2006/08/09,4,6,0.805846443,7437,4,3,3
34636,2014/03/31,2012/09/04,519,4,0.648301601,9244,519,4,0
34637,2014/03/31,2005/10/10,60,9,0.639503788,9371,60,1,8
34638,2014/03/31,2011/11/05,87,11,0.6002534310000001,9983,87,3,8
34639,2014/03/31,2012/03/07,11,7,0.711748426,8419,11,4,3
34640,2014/03/31,2012/03/21,176,6,0.515811311,11617,176,0,6
34641,2014/03/31,2013/01/25,231,4,0.8155859529999999,7347,231,1,3
34642,2014/03/31,2006/09/12,271,4,0.594554475,10078,271,0,4
34643,2014/03/31,2010/07/16,2,9,0.681037736,8798,2,6,3
34644,2014/03/31,2012/06/18,8,8,0.665145426,9008,8,2,6
34645,2014/03/31,2006/12/03,131,6,0.887857143,6748,131,0,6
34646,2014/03/31,2010/09/12,207,7,0.649984811,9217,207,5,2
34647,2014/03/31,2012/01/25,256,9,0.596928059,10036,256,7,2
34648,2014/03/31,2008/09/01,20,9,0.861505825,6953,20,5,4
34649,2014/03/31,2010/06/16,58,5,0.7187041040000001,8334,58,1,4
34650,2014/03/31,2009/09/03,9,10,0.72955542,8210,9,3,7
34651,2014/03/31,2006/01/14,87,5,0.495747393,12082,87,3,2
34652,2014/03/31,2006/10/12,39,5,0.557577732,10742,39,3,2
34653,2014/03/31,2011/10/22,596,4,0.7932516559999999,7550,596,4,0
34654,2014/03/31,2012/09/14,172,3,0.64,9357,172,1,2
34655,2014/03/31,2012/11/20,347,4,1.0,5988,347,2,2
34656,2014/03/31,2011/03/02,68,7,0.697006169,8591,68,1,6
34657,2014/03/31,2012/05/30,332,5,0.623739583,9600,332,3,2
34658,2014/03/31,2013/03/30,4,9,0.672618513,8902,4,1,8
34659,2014/03/31,2006/10/31,261,6,0.781677546,7660,261,5,1
34660,2014/03/31,2005/09/29,113,9,0.639784142,9358,113,1,8
34661,2014/03/31,2007/03/24,2,3,0.731156571,8188,2,1,2
34662,2014/03/31,2006/10/20,14,4,1.346201934,4447,14,0,4
34663,2014/03/31,2010/08/13,70,7,0.7395552259999999,8094,70,3,4
34664,2014/03/31,2010/12/12,274,7,0.512269576,11685,274,4,3
34665,2014/03/31,2011/10/12,378,4,0.654940365,9139,378,4,0
34666,2014/03/31,2012/09/21,304,5,0.695609019,8604,304,3,2
34667,2014/03/31,2011/06/25,14,6,0.7753025,7719,14,1,5
34668,2014/03/31,2012/12/07,231,6,0.55204059,10840,231,2,4
34669,2014/03/31,2005/10/19,160,10,0.634223635,9435,160,9,1
34670,2014/03/31,2010/09/28,376,5,0.8054718000000001,7429,376,5,0
34671,2014/03/31,2010/04/28,186,10,0.922,6490,186,5,5
34672,2014/03/31,2012/02/20,179,4,0.6625,9032,179,1,3
34673,2014/03/31,2007/12/23,76,7,0.695839051,8599,76,6,1
34674,2014/03/31,2007/05/11,104,7,0.857221665,6979,104,3,4
34675,2014/03/31,2011/06/01,45,2,0.8458235540000001,7073,45,0,2
34676,2014/03/31,2009/03/19,19,9,0.6188888889999999,9666,19,5,4
34677,2014/03/31,2011/06/24,25,7,0.621452317,9626,25,1,6
34678,2014/03/31,2012/03/27,192,8,0.577180625,10364,192,4,4
34679,2014/03/31,2007/04/17,67,6,0.900340157,6644,67,1,5
34680,2014/03/31,2005/11/18,1,4,1.295892548,4616,1,1,3
34681,2014/03/31,2011/01/03,123,6,0.583185142,10257,123,2,4
34682,2014/03/31,2008/01/05,272,5,0.572838537,10442,272,2,3
34683,2014/03/31,2012/11/11,142,3,0.77,7768,142,0,3
34684,2014/03/31,2010/10/25,17,2,0.6545759,9137,17,1,1
34685,2014/03/31,2012/04/25,35,3,0.914629148,6539,35,2,1
34686,2014/03/31,2011/07/13,133,9,0.702176823,8517,133,7,2
34687,2014/03/31,2011/08/31,338,7,0.720413203,8301,338,5,2
34688,2014/03/31,2013/03/03,222,6,0.803350349,7444,222,3,3
34689,2014/03/31,2012/07/28,166,6,0.656990771,9102,166,3,3
34690,2014/03/31,2012/11/23,255,4,0.76,7868,255,0,4
34691,2014/03/31,2009/01/25,368,4,0.7125,8392,368,4,0
34692,2014/03/31,2012/11/08,112,6,0.7260801459999999,8235,112,2,4
34693,2014/03/31,2012/02/10,100,8,0.609864341,9804,100,2,6
34694,2014/03/31,2012/09/11,132,7,0.736934172,8112,132,0,7
34695,2014/03/31,2011/10/09,457,6,1.0,5978,457,6,0
34696,2014/03/31,2009/12/09,223,7,0.739939349,8079,223,3,4
34697,2014/03/31,2011/07/12,23,6,0.585589734,10208,23,1,5
34698,2014/03/31,2006/05/07,87,8,0.57125,10464,87,3,5
34699,2014/03/31,2005/11/21,47,6,0.69271758,8629,47,3,3
34700,2014/03/31,2009/12/07,104,7,0.69119334,8648,104,5,2
34701,2014/03/31,2009/12/05,328,7,0.549563218,10875,328,6,1
34702,2014/03/31,2011/10/19,36,4,0.594210997,10057,36,3,1
34703,2014/03/31,2013/01/09,3,8,0.5886386920000001,10152,3,0,8
34704,2014/03/31,2010/04/14,266,4,0.585839216,10200,266,2,2
34705,2014/03/31,2012/08/17,169,5,0.657421058,9089,169,0,5
34706,2014/03/31,2012/08/19,78,6,0.57984472,10304,78,3,3
34707,2014/03/31,2008/07/10,13,5,0.7973985579999999,7492,13,2,3
34708,2014/03/31,2010/08/26,696,3,0.8027818840000001,7441,696,3,0
34709,2014/03/31,2008/12/16,156,5,0.725637225,8231,156,3,2
34710,2014/03/31,2011/06/02,33,10,0.6285529360000001,9502,33,7,3
34711,2014/03/31,2012/11/09,76,9,0.614364198,9720,76,5,4
34712,2014/03/31,2008/10/08,108,7,0.5372478629999999,11115,108,2,5
34713,2014/03/31,2009/07/02,44,10,0.7349439999999999,8125,44,5,5
34714,2014/03/31,2012/11/22,328,8,0.530456605,11257,328,7,1
34715,2014/03/31,2012/05/08,209,8,0.621945833,9600,209,4,4
34716,2014/03/31,2013/03/14,25,6,0.47182709,12654,25,0,6
34717,2014/03/31,2008/12/13,141,7,0.656019119,9101,141,2,5
34718,2014/03/31,2012/03/28,385,12,0.441459627,13524,385,12,0
34719,2014/03/31,2011/06/01,81,8,0.629216906,9488,81,6,2
34720,2014/03/31,2009/01/15,164,5,1.224090629,4877,164,3,2
34721,2014/03/31,2009/03/25,156,8,0.71067381,8400,156,2,6
34722,2014/03/31,2011/05/25,241,3,0.616566825,9682,241,1,2
34723,2014/03/31,2009/03/06,77,3,0.742114883,8043,77,1,2
34724,2014/03/31,2008/02/07,5,5,0.6125431029999999,9744,5,0,5
34725,2014/03/31,2011/10/01,41,9,0.6931827159999999,8609,41,4,5
34726,2014/03/31,2007/06/01,182,6,0.47468141,12571,182,4,2
34727,2014/03/31,2010/03/17,200,4,0.658463915,9062,200,1,3
34728,2014/03/31,2010/07/31,20,7,0.6232999060000001,9573,20,2,5
34729,2014/03/31,2012/05/15,145,6,0.72792729,8197,145,1,5
34730,2014/03/31,2011/05/12,29,3,0.7439825440000001,8020,29,2,1
34731,2014/03/31,2011/06/28,12,6,0.608844898,9800,12,5,1
34732,2014/03/31,2013/02/16,401,2,1.0,5966,401,2,0
34733,2014/03/31,2010/04/20,374,5,0.977391874,6104,374,5,0
34734,2014/03/31,2013/01/17,306,5,0.58306294,10232,306,1,4
34735,2014/03/31,2008/11/21,178,5,0.7059763309999999,8450,178,3,2
34736,2014/03/31,2010/07/09,459,7,0.746689198,7989,459,7,0
34737,2014/03/31,2010/12/02,357,4,0.561853631,10617,357,3,1
34738,2014/03/31,2011/11/14,506,8,0.570267686,10460,506,8,0
34739,2014/03/31,2011/06/06,296,5,0.889104188,6709,296,3,2
34740,2014/03/31,2011/03/26,149,5,0.734761025,8118,149,1,4
34741,2014/03/31,2009/09/05,10,3,0.8475049729999999,7038,10,2,1
34742,2014/03/31,2012/10/23,118,6,0.528513825,11284,118,2,4
34743,2014/03/31,2006/06/26,14,5,0.988615716,6032,14,4,1
34744,2014/03/31,2012/11/14,1,12,0.78320331,7614,1,4,8
34745,2014/03/31,2005/09/01,18,6,0.719666908,8286,18,1,5
34746,2014/03/31,2012/12/21,97,7,0.860398268,6930,97,2,5
34747,2014/03/31,2008/02/17,12,6,0.676575125,8812,12,0,6
34748,2014/03/31,2008/11/13,64,10,0.854641628,6976,64,6,4
34749,2014/03/31,2010/11/15,5,10,0.851702857,7000,5,0,10
34750,2014/03/31,2011/10/12,29,10,0.613989082,9709,29,6,4
34751,2014/03/31,2012/06/28,122,11,0.578360338,10307,122,7,4
34752,2014/03/31,2010/04/16,79,3,0.956666667,6231,79,2,1
34753,2014/03/31,2013/01/03,12,5,0.574,10385,12,0,5
34754,2014/03/31,2008/10/14,185,11,0.872892078,6829,185,3,8
34755,2014/03/31,2010/12/29,227,5,0.699348821,8523,227,4,1
34756,2014/03/31,2012/08/29,192,5,0.5024285589999999,11863,192,4,1
34757,2014/03/31,2011/09/24,39,4,0.7575,7868,39,3,1
34758,2014/03/31,2012/12/08,410,5,0.9,6622,410,5,0
34759,2014/03/31,2010/11/25,595,5,0.658614212,9049,595,5,0
34760,2014/03/31,2008/09/29,106,3,0.618264343,9639,106,0,3
34761,2014/03/31,2012/11/22,124,4,0.929772195,6409,124,2,2
34762,2014/03/31,2012/05/26,410,3,0.933333333,6384,410,3,0
34763,2014/03/31,2012/05/11,355,7,0.645740299,9226,355,5,2
34764,2014/03/31,2012/08/10,403,2,1.2111201459999998,4919,403,2,0
34765,2014/03/31,2008/02/21,128,9,0.450011332,13237,128,3,6
34766,2014/03/31,2007/04/19,629,3,0.611393964,9742,629,3,0
34767,2014/03/31,2010/08/15,188,8,0.832342418,7155,188,3,5
34768,2014/03/31,2005/08/02,139,4,0.829643355,7178,139,0,4
34769,2014/03/31,2012/01/24,175,6,0.723084396,8235,175,5,1
34770,2014/03/31,2009/07/19,591,5,0.635955356,9363,591,5,0
34771,2014/03/31,2011/12/12,128,9,0.385444423,15447,128,5,4
34772,2014/03/31,2011/11/28,151,13,0.790065021,7536,151,12,1
34773,2014/03/31,2010/07/18,149,4,0.896374586,6642,149,2,2
34774,2014/03/31,2008/03/27,1,7,0.695671886,8558,1,0,7
34775,2014/03/31,2006/08/20,102,5,0.7380473590000001,8066,102,4,1
34776,2014/03/31,2010/12/30,520,5,0.812592138,7326,520,5,0
34777,2014/03/31,2012/06/12,471,6,0.8339871109999999,7138,471,6,0
34778,2014/03/31,2010/03/01,259,11,0.527599929,11283,259,8,3
34779,2014/03/31,2008/11/28,24,7,0.560864977,10613,24,0,7
34780,2014/03/31,2008/03/08,22,7,0.541884559,10984,22,2,5
34781,2014/03/31,2005/05/01,224,8,0.71125,8368,224,3,5
34782,2014/03/31,2008/03/15,303,8,0.72051816,8260,303,7,1
34783,2014/03/31,2012/02/20,185,8,0.579062865,10276,185,6,2
34784,2014/03/31,2012/04/11,5,3,1.037193655,5737,5,0,3
34785,2014/03/31,2007/07/01,421,10,1.0,5950,421,10,0
34786,2014/03/31,2012/07/16,522,2,0.703547357,8457,522,2,0
34787,2014/03/31,2011/01/24,343,8,0.590335384,10078,343,7,1
34788,2014/03/31,2013/02/02,9,4,0.6734993770000001,8833,9,1,3
34789,2014/03/31,2009/11/11,46,7,0.7230290509999999,8227,46,3,4
34790,2014/03/31,2010/07/16,158,6,0.779043877,7635,158,4,2
34791,2014/03/31,2009/07/23,130,8,0.582936391,10203,130,4,4
34792,2014/03/31,2011/01/21,306,6,0.668639685,8895,306,5,1
34793,2014/03/31,2012/11/06,486,3,0.75,7929,486,3,0
34794,2014/03/31,2012/11/29,378,3,0.75,7929,378,3,0
34795,2014/03/31,2011/07/13,138,6,0.726719628,8182,138,2,4
34796,2014/03/31,2008/07/11,73,8,0.540390803,11003,73,1,7
34797,2014/03/31,2008/09/05,284,7,0.689539603,8623,284,2,5
34798,2014/03/31,2012/09/17,555,2,0.775,7672,555,2,0
34799,2014/03/31,2009/08/18,374,2,0.775,7672,374,2,0
34800,2014/03/31,2011/09/13,441,13,0.8570563640000001,6937,441,13,0
34801,2014/03/31,2012/01/26,45,3,0.6752521579999999,8804,45,1,2
34802,2014/03/31,2006/10/09,528,6,0.745336008,7976,528,6,0
34803,2014/03/31,2009/04/16,187,7,0.973402653,6107,187,6,1
34804,2014/03/31,2011/08/28,11,3,0.774926346,7671,11,0,3
34805,2014/03/31,2005/12/05,376,7,0.8292410709999999,7168,376,7,0
34806,2014/03/31,2012/08/30,39,7,0.451428571,13167,39,2,5
34807,2014/03/31,2011/11/08,35,8,0.783628214,7585,35,3,5
34808,2014/03/31,2006/10/20,140,9,0.533987421,11130,140,2,7
34809,2014/03/31,2012/09/24,546,4,0.616967715,9633,546,4,0
34810,2014/03/31,2008/09/06,158,5,0.7339718409999999,8097,158,2,3
34811,2014/03/31,2012/02/07,178,6,0.7241245279999999,8207,178,2,4
34812,2014/03/31,2009/09/28,79,6,0.6173436529999999,9626,79,1,5
34813,2014/03/31,2012/04/20,248,7,0.858735549,6920,248,5,2
34814,2014/03/31,2005/01/13,476,5,0.917006173,6480,476,5,0
34815,2014/03/31,2012/06/30,190,4,0.915195625,6492,190,1,3
34816,2014/03/31,2011/11/17,289,5,0.7658179709999999,7757,289,4,1
34817,2014/03/31,2011/09/13,277,6,0.832227515,7138,277,2,4
34818,2014/03/31,2008/03/23,34,4,0.755,7868,34,0,4
34819,2014/03/31,2012/08/01,575,2,0.9,6600,575,2,0
34820,2014/03/31,2012/02/18,138,4,0.915591182,6487,138,2,2
34821,2014/03/31,2011/08/30,28,8,0.824672313,7202,28,4,4
34822,2014/03/31,2008/06/23,174,4,0.986578073,6020,174,3,1
34823,2014/03/31,2012/11/02,24,8,0.940190024,6315,24,2,6
34824,2014/03/31,2011/07/02,138,4,0.871715125,6810,138,2,2
34825,2014/03/31,2007/09/25,209,4,0.566825169,10473,209,2,2
34826,2014/03/31,2009/04/06,131,7,0.5557142860000001,10682,131,2,5
34827,2014/03/31,2012/09/29,402,4,0.7239936570000001,8198,402,4,0
34828,2014/03/31,2011/10/20,473,4,0.617151918,9617,473,4,0
34829,2014/03/31,2008/10/20,89,7,0.8910073559999999,6661,89,6,1
34830,2014/03/31,2010/04/27,145,6,0.7467237040000001,7948,145,2,4
34831,2014/03/31,2010/11/25,43,9,0.646974488,9172,43,4,5
34832,2014/03/31,2008/11/01,8,8,0.54542605,10879,8,0,8
34833,2014/03/31,2010/02/08,77,4,0.6679781610000001,8883,77,1,3
34834,2014/03/31,2011/11/24,345,2,0.7,8476,345,1,1
34835,2014/03/31,2009/09/12,559,4,0.806771825,7354,559,4,0
34836,2014/03/31,2008/02/28,49,5,1.175689655,5046,49,3,2
34837,2014/03/31,2008/05/21,28,6,0.723456098,8200,28,0,6
34838,2014/03/31,2012/10/07,460,6,0.938639241,6320,460,6,0
34839,2014/03/31,2005/04/22,96,4,0.789486292,7514,96,3,1
34840,2014/03/31,2009/02/27,6,10,0.518132588,11449,6,4,6
34841,2014/03/31,2008/12/24,115,9,0.7668032570000001,7736,115,5,4
34842,2014/03/31,2012/05/16,343,5,0.643507268,9218,343,4,1
34843,2014/03/31,2011/01/13,38,8,0.5357922310000001,11070,38,1,7
34844,2014/03/31,2009/10/10,42,6,0.7948854040000001,7461,42,2,4
34845,2014/03/31,2007/03/21,292,3,0.8312068970000001,7134,292,2,1
34846,2014/03/31,2013/03/07,80,5,0.848485976,6988,80,0,5
34847,2014/03/31,2008/09/04,20,12,0.445942083,13295,20,7,5
34848,2014/03/31,2007/12/01,35,9,0.585644572,10123,35,3,6
34849,2014/03/31,2012/05/23,147,6,0.692254787,8564,147,5,1
34850,2014/03/31,2009/01/22,99,7,0.546244356,10853,99,0,7
34851,2014/03/31,2012/11/15,37,5,0.718823815,8247,37,2,3
34852,2014/03/31,2012/11/21,235,5,0.770932501,7689,235,2,3
34853,2014/03/31,2008/02/24,368,4,0.857690638,6911,368,4,0
34854,2014/03/31,2010/05/28,7,9,0.749722995,7906,7,4,5
34855,2014/03/31,2011/06/06,145,8,0.650589462,9110,145,2,6
34856,2014/03/31,2011/02/06,39,11,0.404581513,14648,39,2,9
34857,2014/03/31,2011/09/05,167,5,0.55660154,10646,167,3,2
34858,2014/03/31,2012/07/14,412,9,0.971519921,6099,412,9,0
34859,2014/03/31,2012/11/29,101,8,0.91720743,6460,101,1,7
34860,2014/03/31,2012/02/24,367,4,0.87987823,6734,367,4,0
34861,2014/03/31,2011/06/24,18,9,0.833693542,7107,18,5,4
34862,2014/03/31,2006/07/01,66,7,0.565463829,10478,66,5,2
34863,2014/03/31,2009/09/25,467,7,0.781011073,7586,467,7,0
34864,2014/03/31,2009/02/13,473,6,0.93130011,6361,473,6,0
34865,2014/03/31,2011/05/23,144,6,0.599200809,9885,144,5,1
34866,2014/03/31,2012/05/11,110,6,0.730091223,8112,110,5,1
34867,2014/03/31,2012/09/26,289,4,1.151000972,5145,289,3,1
34868,2014/03/31,2008/09/13,75,6,0.7437151470000001,7962,75,0,6
34869,2014/03/31,2006/03/07,66,6,0.759812652,7793,66,1,5
34870,2014/03/31,2007/07/03,84,7,0.533291002,11103,84,3,4
34871,2014/03/31,2011/09/11,615,3,0.85,6966,615,3,0
34872,2014/03/31,2011/12/08,384,3,1.3119875909999998,4513,384,3,0
34873,2014/03/31,2009/10/23,112,4,0.640498702,9244,112,1,3
34874,2014/03/31,2013/03/01,42,3,0.7466666670000001,7929,42,1,2
34875,2014/03/31,2008/05/28,165,16,0.886788496,6676,165,6,10
34876,2014/03/31,2007/02/22,231,6,0.7613607720000001,7775,231,5,1
34877,2014/03/31,2009/12/31,550,5,0.57,10385,550,5,0
34878,2014/03/31,2012/03/01,450,6,0.867409144,6824,450,6,0
34879,2014/03/31,2010/02/25,380,6,0.56332445,10507,380,6,0
34880,2014/03/31,2012/09/21,115,8,0.453510076,13051,115,5,3
34881,2014/03/31,2012/05/08,358,4,0.876900282,6749,358,2,2
34882,2014/03/31,2009/12/15,22,7,0.646722763,9151,22,3,4
34883,2014/03/31,2011/08/15,120,7,0.556448519,10635,120,2,5
34884,2014/03/31,2010/05/14,99,5,0.538910648,10979,99,2,3
34885,2014/03/31,2010/03/15,155,11,0.4089121570000001,14469,155,8,3
34886,2014/03/31,2006/05/15,373,6,0.63566133,9307,373,6,0
34887,2014/03/31,2007/12/02,178,8,0.7068992709999999,8369,178,7,1
34888,2014/03/31,2010/12/22,3,7,0.3955860920000001,14955,3,1,6
34889,2014/03/31,2012/12/05,12,8,0.6197978,9545,12,0,8
34890,2014/03/31,2009/07/15,121,5,0.791009493,7479,121,2,3
34891,2014/03/31,2010/09/23,128,6,0.436666667,13548,128,3,3
34892,2014/03/31,2011/01/15,3,8,0.575,10288,3,6,2
34893,2014/03/31,2009/07/01,174,5,0.828041713,7144,174,2,3
34894,2014/03/31,2007/01/07,66,6,0.5559530079999999,10640,66,3,3
34895,2014/03/31,2009/11/09,23,11,0.45,13145,23,5,6
34896,2014/03/31,2008/03/25,15,7,0.905714286,6531,15,1,6
34897,2014/03/31,2008/10/01,172,5,0.818,7230,172,2,3
34898,2014/03/31,2012/07/13,25,8,0.6227071710000001,9497,25,3,5
34899,2014/03/31,2005/10/03,269,4,0.791658635,7470,269,2,2
34900,2014/03/31,2008/04/07,181,8,0.396328664,14921,181,4,4
34901,2014/03/31,2010/03/12,438,6,0.843460277,7011,438,6,0
34902,2014/03/31,2012/07/01,73,9,0.709201247,8338,73,6,3
34903,2014/03/31,2012/09/25,149,6,0.7167551520000001,8250,149,2,4
34904,2014/03/31,2009/03/01,310,5,0.954803811,6193,310,3,2
34905,2014/03/31,2008/10/08,192,7,0.690137722,8568,192,5,2
34906,2014/03/31,2012/12/24,428,4,0.7666277709999999,7713,428,4,0
34907,2014/03/31,2011/02/18,370,3,0.667601897,8857,370,3,0
34908,2014/03/31,2007/11/29,85,4,0.635508383,9304,85,0,4
34909,2014/03/31,2009/11/14,57,5,0.6973098240000001,8479,57,3,2
34910,2014/03/31,2012/10/01,47,11,0.340146703,17382,47,2,9
34911,2014/03/31,2008/07/17,142,6,0.692924285,8532,142,0,6
34912,2014/03/31,2012/10/14,329,4,0.501169888,11796,329,2,2
34913,2014/03/31,2011/09/14,194,9,0.670199546,8820,194,4,5
34914,2014/03/31,2010/08/17,413,6,0.636007101,9294,413,6,0
34915,2014/03/31,2011/05/15,10,2,0.915,6460,10,0,2
34916,2014/03/31,2011/12/14,179,9,0.681541744,8672,179,8,1
34917,2014/03/31,2012/12/18,233,4,0.72697417,8130,233,2,2
34918,2014/03/31,2011/06/12,226,4,0.625625066,9447,226,0,4
34919,2014/03/31,2007/08/02,133,5,0.799626573,7391,133,2,3
34920,2014/03/31,2008/07/16,248,9,0.62328939,9482,248,6,3
34921,2014/03/31,2009/05/06,177,7,0.747142857,7910,177,1,6
34922,2014/03/31,2007/04/19,25,6,0.941666667,6276,25,2,4
34923,2014/03/31,2012/11/25,208,5,0.906953653,6516,208,1,4
34924,2014/03/31,2007/02/17,19,3,0.964608227,6126,19,2,1
34925,2014/03/31,2008/04/29,19,4,0.759311231,7782,19,0,4
34926,2014/03/31,2012/06/10,30,6,0.668119629,8844,30,4,2
34927,2014/03/31,2013/01/25,12,8,0.953642673,6196,12,4,4
34928,2014/03/31,2007/09/05,150,4,0.822415425,7183,150,0,4
34929,2014/03/31,2005/12/30,20,10,0.8169077579999999,7231,20,6,4
34930,2014/03/31,2011/09/11,21,6,0.801163705,7373,21,1,5
34931,2014/03/31,2011/11/07,9,10,0.7696351790000001,7675,9,6,4
34932,2014/03/31,2013/03/25,373,2,0.7105871029999999,8312,373,2,0
34933,2014/03/31,2011/12/19,197,4,0.778172596,7590,197,2,2
34934,2014/03/31,2006/08/01,38,6,0.760236839,7769,38,1,5
34935,2014/03/31,2012/10/13,211,8,0.554297513,10655,211,4,4
34936,2014/03/31,2007/07/25,185,10,0.706263605,8361,185,7,3
34937,2014/03/31,2008/04/13,23,7,0.52185506,11315,23,2,5
34938,2014/03/31,2011/06/07,381,10,0.6010128260000001,9824,381,10,0
34939,2014/03/31,2009/01/12,159,5,0.578618189,10204,159,0,5
34940,2014/03/31,2012/11/25,42,8,0.534067843,11055,42,3,5
34941,2014/03/31,2011/10/16,57,8,0.567302777,10407,57,2,6
34942,2014/03/31,2005/10/31,5,9,0.626938515,9417,5,6,3
34943,2014/03/31,2013/02/07,6,10,0.731095975,8075,6,3,7
34944,2014/03/31,2013/01/22,181,4,0.597045615,9887,181,2,2
34945,2014/03/31,2012/07/27,4,8,0.527937573,11181,4,4,4
34946,2014/03/31,2005/11/18,27,6,0.773432914,7632,27,1,5
34947,2014/03/31,2012/12/01,146,7,0.512604655,11514,146,4,3
34948,2014/03/31,2010/09/07,56,9,0.5056297120000001,11672,56,6,3
34949,2014/03/31,2007/02/23,14,5,0.7083173309999999,8332,14,0,5
34950,2014/03/31,2007/12/28,467,3,1.0,5901,467,3,0
34951,2014/03/31,2012/04/30,649,2,1.5,3934,649,2,0
34952,2014/03/31,2012/04/20,642,3,1.0,5901,642,3,0
34953,2014/03/31,2006/12/01,88,7,0.7298540509999999,8085,88,2,5
34954,2014/03/31,2007/09/08,192,9,0.614523016,9602,192,5,4
34955,2014/03/31,2010/04/17,25,5,0.6518161729999999,9052,25,4,1
34956,2014/03/31,2012/03/15,423,8,0.818648536,7207,423,8,0
34957,2014/03/31,2011/11/06,66,7,0.7354674640000001,8022,66,1,6
34958,2014/03/31,2007/10/03,321,8,0.339679889,17369,321,6,2
34959,2014/03/31,2007/06/28,30,4,0.665,8872,30,1,3
34960,2014/03/31,2007/05/08,300,5,0.632845956,9322,300,3,2
34961,2014/03/31,2011/12/02,139,11,0.458302517,12872,139,6,5
34962,2014/03/31,2012/10/24,89,9,0.705555556,8361,89,3,6
34963,2014/03/31,2013/02/25,271,5,0.463968853,12714,271,2,3
34964,2014/03/31,2012/10/20,15,5,0.728879278,8093,15,3,2
34965,2014/03/31,2007/06/25,4,4,0.71,8308,4,0,4
34966,2014/03/31,2007/06/28,474,7,0.643551555,9165,474,7,0
34967,2014/03/31,2011/04/02,423,6,0.727621515,8106,423,6,0
34968,2014/03/31,2012/06/24,260,10,0.8185357390000001,7205,260,7,3
34969,2014/03/31,2008/05/14,210,8,0.642034839,9185,210,6,2
34970,2014/03/31,2012/01/24,211,6,0.7306009170000001,8071,211,3,3
34971,2014/03/31,2009/08/11,101,9,0.719858381,8191,101,4,5
34972,2014/03/31,2011/01/06,85,7,0.644669801,9146,85,6,1
34973,2014/03/31,2006/03/26,101,7,0.7292738740000001,8084,101,0,7
34974,2014/03/31,2012/06/14,133,8,0.88880597,6633,133,6,2
34975,2014/03/31,2009/08/05,580,4,0.89012383,6622,580,4,0
34976,2014/03/31,2012/07/25,163,5,0.7044639659999999,8367,163,2,3
34977,2014/03/31,2012/08/11,91,13,0.783076923,7527,91,8,5
34978,2014/03/31,2012/05/11,683,2,1.2075804140000002,4881,683,2,0
34979,2014/03/31,2011/02/28,19,13,0.737136068,7996,19,4,9
34980,2014/03/31,2008/08/24,5,15,0.624375,9440,5,7,8
34981,2014/03/31,2011/10/29,517,6,0.535229749,11012,517,6,0
34982,2014/03/31,2011/06/26,256,6,0.8419357140000001,7000,256,4,2
34983,2014/03/31,2010/04/05,12,9,0.8402423720000001,7014,12,5,4
34984,2014/03/31,2011/11/20,85,10,0.505699331,11654,85,7,3
34985,2014/03/31,2012/07/09,263,12,0.6315861110000001,9331,263,7,5
34986,2014/03/31,2010/01/12,130,7,0.6409897760000001,9194,130,2,5
34987,2014/03/31,2009/11/11,338,5,0.746352584,7896,338,3,2
34988,2014/03/31,2011/03/02,46,7,0.7462542740000001,7897,46,0,7
34989,2014/03/31,2012/07/13,100,7,0.756789521,7787,100,1,6
34990,2014/03/31,2013/02/26,302,3,0.8562859629999999,6882,302,1,2
34991,2014/03/31,2010/12/06,160,8,0.74152007,7947,160,7,1
34992,2014/03/31,2010/02/02,3,9,0.559780564,10527,3,4,5
34993,2014/03/31,2008/09/15,29,12,0.507009724,11621,29,4,8
34994,2014/03/31,2006/11/01,92,6,0.797265223,7390,92,2,4
34995,2014/03/31,2012/08/14,69,6,0.77726781,7580,69,3,3
34996,2014/03/31,2009/04/09,537,5,0.650933598,9051,537,5,0
34997,2014/03/31,2012/10/30,143,8,0.475930204,12379,143,5,3
34998,2014/03/31,2012/08/20,80,5,0.7388937659999999,7973,80,3,2
34999,2014/03/31,2009/08/27,4,5,0.954667747,6170,4,1,4
35000,2014/03/31,2013/03/04,108,8,0.770762889,7642,108,2,6
35001,2014/03/31,2008/09/02,535,6,0.816666667,7212,535,6,0
35002,2014/03/31,2005/11/03,199,5,0.658292165,8947,199,2,3
35003,2014/03/31,2010/06/11,271,3,0.928242711,6345,271,1,2
35004,2014/03/31,2010/04/25,1,7,0.79008586,7454,1,0,7
35005,2014/03/31,2010/11/01,166,8,0.574053422,10258,166,4,4
35006,2014/03/31,2010/08/10,356,2,1.05,5608,356,1,1
35007,2014/03/31,2010/06/25,245,6,0.81508376,7223,245,3,3
35008,2014/03/31,2013/02/23,58,4,0.6325,9308,58,1,3
35009,2014/03/31,2011/03/10,14,8,0.7048479409999999,8352,14,4,4
35010,2014/03/31,2012/07/31,16,11,0.8177246840000001,7199,16,0,11
35011,2014/03/31,2012/11/24,107,6,0.8106251720000001,7262,107,4,2
35012,2014/03/31,2010/03/23,180,5,0.758081133,7765,180,3,2
35013,2014/03/31,2005/08/30,695,3,1.5,3924,695,3,0
35014,2014/03/31,2011/06/11,78,7,0.672839506,8748,78,1,6
35015,2014/03/31,2012/05/10,343,3,1.5,3924,343,1,2
35016,2014/03/31,2012/05/28,549,5,0.9,6540,549,5,0
35017,2014/03/31,2008/09/01,110,6,0.630867095,9330,110,2,4
35018,2014/03/31,2012/08/07,91,9,0.570195699,10322,91,6,3
35019,2014/03/31,2012/07/08,57,4,0.7448955829999999,7901,57,2,2
35020,2014/03/31,2006/01/29,481,7,0.931349897,6319,481,7,0
35021,2014/03/31,2012/12/05,11,12,0.807550432,7287,11,1,11
35022,2014/03/31,2010/09/19,174,8,0.434415326,13546,174,4,4
35023,2014/03/31,2012/01/16,522,4,1.26006424,4670,522,4,0
35024,2014/03/31,2007/09/07,443,4,0.849992778,6923,443,4,0
35025,2014/03/31,2009/12/15,210,6,0.418583725,14058,210,3,3
35026,2014/03/31,2009/11/07,447,7,0.690964068,8516,447,7,0
35027,2014/03/31,2011/03/01,149,7,0.681782155,8630,149,3,4
35028,2014/03/31,2010/04/24,42,9,0.50782755,11586,42,4,5
35029,2014/03/31,2009/09/23,489,7,0.654611704,8988,489,7,0
35030,2014/03/31,2013/01/26,37,5,0.414,14210,37,1,4
35031,2014/03/31,2012/03/20,108,4,0.817045833,7200,108,3,1
35032,2014/03/31,2013/02/07,409,4,0.822441275,7152,409,4,0
35033,2014/03/31,2008/05/16,407,2,0.7188156929999999,8182,407,2,0
35034,2014/03/31,2010/05/05,44,5,0.860725889,6833,44,2,3
35035,2014/03/31,2012/08/05,61,5,0.8786717470000001,6693,61,4,1
35036,2014/03/31,2012/08/05,61,5,0.8786717470000001,6693,61,4,1
35037,2014/03/31,2011/12/03,14,6,0.6639787739999999,8857,14,3,3
35038,2014/03/31,2004/11/28,72,8,0.570873702,10301,72,4,4
35039,2014/03/31,2005/09/09,624,5,0.781150372,7528,624,5,0
35040,2014/03/31,2011/11/28,191,5,0.694023368,8473,191,2,3
35041,2014/03/31,2012/01/25,142,6,0.631994841,9304,142,3,3
35042,2014/03/31,2005/08/23,469,4,1.05,5600,469,4,0
35043,2014/03/31,2009/11/14,124,6,0.7244006409999999,8117,124,3,3
35044,2014/03/31,2011/09/14,86,6,0.504846299,11646,86,3,3
35045,2014/03/31,2007/07/14,94,5,0.619342604,9492,94,4,1
35046,2014/03/31,2006/12/04,234,5,0.5894585379999999,9973,234,2,3
35047,2014/03/31,2006/10/01,3,6,0.679358604,8653,3,0,6
35048,2014/03/31,2013/03/05,109,6,0.8055872279999999,7297,109,1,5
35049,2014/03/31,2009/11/21,163,4,0.911035338,6452,163,2,2
35050,2014/03/31,2007/06/24,206,5,0.5660000000000001,10385,206,0,5
35051,2014/03/31,2012/11/19,134,8,0.5237346279999999,11222,134,1,7
35052,2014/03/31,2012/02/28,26,8,0.574767726,10225,26,3,5
35053,2014/03/31,2009/02/07,38,5,0.877816281,6695,38,3,2
35054,2014/03/31,2009/12/01,246,7,0.8502430559999999,6912,246,3,4
35055,2014/03/31,2009/12/21,114,6,0.606800207,9685,114,3,3
35056,2014/03/31,2012/12/28,254,7,0.6383595870000001,9205,254,3,4
35057,2014/03/31,2011/10/14,494,5,0.4,14689,494,5,0
35058,2014/03/31,2013/03/21,140,10,0.807,7280,140,1,9
35059,2014/03/31,2012/07/24,134,4,0.7147876870000001,8219,134,1,3
35060,2014/03/31,2013/01/26,70,6,0.606388315,9688,70,2,4
35061,2014/03/31,2007/12/24,186,5,0.708026998,8297,186,3,2
35062,2014/03/31,2005/12/03,104,9,0.807150316,7278,104,8,1
35063,2014/03/31,2008/08/10,42,6,0.610858985,9616,42,2,4
35064,2014/03/31,2007/07/10,164,7,0.676247985,8686,164,5,2
35065,2014/03/31,2010/12/03,12,7,0.6233110470000001,9423,12,0,7
35066,2014/03/31,2005/12/22,12,6,0.525630929,11174,12,2,4
35067,2014/03/31,2011/12/21,501,5,0.923337526,6361,501,5,0
35068,2014/03/31,2012/11/20,19,3,0.676666667,8679,19,2,1
35069,2014/03/31,2008/12/28,166,3,1.41,4165,166,0,3
35070,2014/03/31,2012/06/26,339,6,0.775247525,7575,339,4,2
35071,2014/03/31,2010/08/21,84,8,0.640672049,9166,84,5,3
35072,2014/03/31,2011/11/07,369,11,0.810650193,7244,369,11,0
35073,2014/03/31,2011/02/20,38,9,0.566920255,10358,38,2,7
35074,2014/03/31,2006/03/09,101,7,0.7235871840000001,8115,101,5,2
35075,2014/03/31,2012/11/16,397,4,0.9584476,6126,397,4,0
35076,2014/03/31,2013/02/27,132,5,0.853249528,6881,132,1,4
35077,2014/03/31,2011/07/03,48,5,0.837055888,7014,48,2,3
35078,2014/03/31,2007/10/12,16,6,0.872884329,6726,16,4,2
35079,2014/03/31,2012/11/27,76,9,0.823264619,7131,76,4,5
35080,2014/03/31,2006/09/27,56,6,0.607916537,9657,56,5,1
35081,2014/03/31,2012/05/17,285,11,0.593795266,9886,285,7,4
35082,2014/03/31,2008/07/09,45,5,0.8627586709999999,6804,45,4,1
35083,2014/03/31,2012/03/29,360,4,0.6084905660000001,9646,360,3,1
35084,2014/03/31,2011/07/20,112,7,0.738976328,7942,112,3,4
35085,2014/03/31,2008/10/30,78,3,0.74,7929,78,2,1
35086,2014/03/31,2011/01/15,252,6,0.546603317,10734,252,4,2
35087,2014/03/31,2013/03/20,183,6,0.511031269,11481,183,0,6
35088,2014/03/31,2008/03/02,46,5,0.878038013,6682,46,1,4
35089,2014/03/31,2011/04/07,51,6,0.642188047,9136,51,5,1
35090,2014/03/31,2010/06/07,273,8,0.956234719,6135,273,7,1
35091,2014/03/31,2006/10/22,265,5,0.8366257840000001,7012,265,3,2
35092,2014/03/31,2012/10/23,135,5,0.528489189,11100,135,2,3
35093,2014/03/31,2011/10/19,142,7,0.571320736,10267,142,2,5
35094,2014/03/31,2013/03/01,49,4,0.665233072,8817,49,0,4
35095,2014/03/31,2008/12/01,133,6,0.6235487989999999,9406,133,4,2
35096,2014/03/31,2009/09/09,107,8,0.907391304,6463,107,7,1
35097,2014/03/31,2008/05/03,16,7,0.7923,7400,16,3,4
35098,2014/03/31,2011/09/03,223,8,0.619261646,9467,223,5,3
35099,2014/03/31,2005/11/13,110,5,0.7456850270000001,7861,110,3,2
35100,2014/03/31,2007/09/01,117,5,0.596,9835,117,2,3
35101,2014/03/31,2008/07/31,72,9,0.727333085,8058,72,4,5
35102,2014/03/31,2010/04/22,334,17,0.662658299,8844,334,15,2
35103,2014/03/31,2010/05/14,39,7,0.833881616,7028,39,4,3
35104,2014/03/31,2012/04/01,611,6,0.7942802929999999,7378,611,6,0
35105,2014/03/31,2013/01/12,87,8,0.480418101,12198,87,5,3
35106,2014/03/31,2008/08/26,83,6,0.801961402,7306,83,0,6
35107,2014/03/31,2012/03/16,65,7,0.93,6300,65,6,1
35108,2014/03/31,2010/11/10,82,9,0.521192954,11241,82,2,7
35109,2014/03/31,2005/03/01,130,6,0.551329757,10626,130,2,4
35110,2014/03/31,2013/01/21,47,12,0.64433238,9092,47,1,11
35111,2014/03/31,2012/07/06,312,6,1.0,5858,312,5,1
35112,2014/03/31,2012/12/06,263,15,0.673333333,8700,263,7,8
35113,2014/03/31,2011/11/11,105,4,0.7589040029999999,7719,105,1,3
35114,2014/03/31,2012/10/29,4,7,0.783078877,7480,4,2,5
35115,2014/03/31,2012/08/28,109,6,0.812704315,7207,109,3,3
35116,2014/03/31,2008/08/10,78,2,1.41,4154,78,0,2
35117,2014/03/31,2010/04/16,137,2,1.41,4154,137,0,2
35118,2014/03/31,2008/09/01,222,6,0.636760165,9198,222,4,2
35119,2014/03/31,2012/07/10,215,4,0.8047210770000001,7278,215,0,4
35120,2014/03/31,2011/06/04,116,8,0.8340962829999999,7021,116,1,7
35121,2014/03/31,2012/09/11,100,6,0.452038753,12954,100,2,4
35122,2014/03/31,2006/10/24,233,4,0.8423751979999999,6951,233,0,4
35123,2014/03/31,2011/11/29,387,6,0.701383565,8348,387,6,0
35124,2014/03/31,2011/12/12,46,14,0.8545125509999999,6852,46,10,4
35125,2014/03/31,2011/09/28,41,8,0.631742555,9268,41,1,7
35126,2014/03/31,2010/01/20,429,6,0.466666667,12546,429,6,0
35127,2014/03/31,2008/02/27,52,9,0.593363738,9867,52,0,9
35128,2014/03/31,2011/08/14,208,9,0.752822425,7777,208,5,4
35129,2014/03/31,2006/04/15,280,4,0.7660690920000001,7642,280,3,1
35130,2014/03/31,2007/01/10,103,9,0.625633216,9357,103,6,3
35131,2014/03/31,2009/04/27,3,4,0.7673990559999999,7628,3,2,2
35132,2014/03/31,2007/09/06,12,4,0.6243871999999999,9375,12,2,2
35133,2014/03/31,2005/09/04,12,8,0.843791264,6937,12,6,2
35134,2014/03/31,2010/06/26,13,12,0.564062259,10376,13,2,10
35135,2014/03/31,2012/05/21,549,8,0.7875,7432,549,8,0
35136,2014/03/31,2008/11/10,230,4,0.8036029109999999,7283,230,3,1
35137,2014/03/31,2007/06/28,488,5,0.832977512,7026,488,5,0
35138,2014/03/31,2011/11/07,33,5,0.654044931,8947,33,0,5
35139,2014/03/31,2012/08/19,209,4,1.186685598,4930,209,3,1
35140,2014/03/31,2012/09/07,151,9,0.797942982,7331,151,6,3
35141,2014/03/31,2008/04/26,112,11,0.435114549,13444,112,1,10
35142,2014/03/31,2009/04/21,304,5,0.417227532,14020,304,3,2
35143,2014/03/31,2007/07/15,60,7,0.812635454,7198,60,2,5
35144,2014/03/31,2012/09/07,33,9,0.607509348,9628,33,7,2
35145,2014/03/31,2007/07/06,136,4,0.94658359,6179,136,1,3
35146,2014/03/31,2012/09/20,347,4,0.5858759889999999,9983,347,3,1
35147,2014/03/31,2010/11/23,92,7,0.668289338,8751,92,3,4
35148,2014/03/31,2010/02/04,531,3,0.625320787,9352,531,3,0
35149,2014/03/31,2011/11/29,27,4,0.696376087,8397,27,0,4
35150,2014/03/31,2011/10/16,85,6,0.6646192320000001,8798,85,4,2
35151,2014/03/31,2010/07/11,112,5,0.863393385,6772,112,3,2
35152,2014/03/31,2007/05/14,138,5,0.65560776,8918,138,4,1
35153,2014/03/31,2009/08/11,37,5,0.527378676,11086,37,2,3
35154,2014/03/31,2009/08/11,37,5,0.527378676,11086,37,2,3
35155,2014/03/31,2012/08/04,149,4,0.6062926479999999,9643,149,2,2
35156,2014/03/31,2005/07/12,122,9,0.624912881,9355,122,4,5
35157,2014/03/31,2012/05/28,230,5,0.8051721759999999,7260,230,4,1
35158,2014/03/31,2005/06/04,581,6,0.79334962,7368,581,6,0
35159,2014/03/31,2012/08/23,91,8,0.549917208,10629,91,1,7
35160,2014/03/31,2012/03/20,59,10,0.733933953,7964,59,5,5
35161,2014/03/31,2012/12/31,206,6,0.7016748709999999,8329,206,4,2
35162,2014/03/31,2005/10/18,231,7,0.680994057,8581,231,1,6
35163,2014/03/31,2010/12/14,4,7,0.888471948,6577,4,5,2
35164,2014/03/31,2009/07/14,295,8,0.813099082,7186,295,3,5
35165,2014/03/31,2009/08/29,26,8,0.4689702220000001,12459,26,6,2
35166,2014/03/31,2011/12/25,278,8,0.617251215,9466,278,7,1
35167,2014/03/31,2012/07/03,308,7,0.8542032159999999,6840,308,5,2
35168,2014/03/31,2012/11/09,172,9,0.776402658,7525,172,3,6
35169,2014/03/31,2006/11/01,261,4,0.71589266,8161,261,3,1
35170,2014/03/31,2012/07/10,190,4,0.503383595,11606,190,2,2
35171,2014/03/31,2011/04/29,424,7,0.574798308,10164,424,7,0
35172,2014/03/31,2011/06/16,1,11,0.530727653,11008,1,0,11
35173,2014/03/31,2013/02/13,3,6,0.761896192,7668,3,2,4
35174,2014/03/31,2008/04/28,102,6,0.662901396,8813,102,4,2
35175,2014/03/31,2010/12/23,292,5,0.687385267,8498,292,1,4
35176,2014/03/31,2011/04/20,128,5,0.676193563,8638,128,4,1
35177,2014/03/31,2012/05/07,649,5,0.601648295,9707,649,5,0
35178,2014/03/31,2009/11/25,37,3,0.730205051,7998,37,1,2
35179,2014/03/31,2007/07/04,215,8,0.713341883,8187,215,7,1
35180,2014/03/31,2011/06/07,482,6,0.8210459720000001,7113,482,6,0
35181,2014/03/31,2012/07/01,32,9,0.925141001,6312,32,3,6
35182,2014/03/31,2011/09/26,260,6,0.666815119,8757,260,5,1
35183,2014/03/31,2007/09/07,48,6,0.5649656510000001,10335,48,1,5
35184,2014/03/31,2007/10/16,10,6,0.852208437,6851,10,4,2
35185,2014/03/31,2013/03/04,387,2,0.8,7298,387,2,0
35186,2014/03/31,2009/03/11,100,8,0.498994786,11699,100,3,5
35187,2014/03/31,2011/07/27,97,7,0.808479224,7220,97,1,6
35188,2014/03/31,2008/04/18,144,8,0.84584553,6901,144,2,6
35189,2014/03/31,2009/09/16,469,4,0.8379270740000001,6966,469,4,0
35190,2014/03/31,2010/12/06,649,3,0.6826900579999999,8550,649,3,0
35191,2014/03/31,2005/02/02,401,4,0.834543895,6994,401,4,0
35192,2014/03/31,2007/10/12,19,7,0.401428571,14539,19,0,7
35193,2014/03/31,2012/10/28,42,7,0.7272993520000001,8024,42,1,6
35194,2014/03/31,2005/08/09,31,4,0.753540806,7744,31,0,4
35195,2014/03/31,2012/10/23,34,4,0.664925934,8776,34,0,4
35196,2014/03/31,2013/03/11,200,3,0.8944022070000001,6524,200,0,3
35197,2014/03/31,2010/10/19,89,7,0.778251301,7497,89,3,4
35198,2014/03/31,2007/06/16,116,6,0.624852736,9337,116,2,4
35199,2014/03/31,2011/05/24,189,6,0.508423529,11475,189,3,3
35200,2014/03/31,2012/03/05,194,7,0.842457762,6925,194,6,1
35201,2014/03/31,2010/05/19,24,7,0.611526205,9540,24,3,4
35202,2014/03/31,2010/12/20,144,5,0.677541231,8610,144,1,4
35203,2014/03/31,2007/09/03,25,6,0.559392922,10427,25,1,5
35204,2014/03/31,2007/11/22,163,4,0.7970794040000001,7317,163,2,2
35205,2014/03/31,2010/05/29,256,6,0.725373134,8040,256,1,5
35206,2014/03/31,2010/05/27,22,9,0.648054228,8999,22,3,6
35207,2014/03/31,2009/08/14,290,7,0.498640328,11694,290,2,5
35208,2014/03/31,2012/08/19,503,4,0.775,7524,503,4,0
35209,2014/03/31,2011/01/13,26,2,0.650839379,8959,26,0,2
35210,2014/03/31,2012/09/08,73,6,0.617479615,9443,73,1,5
35211,2014/03/31,2010/01/08,195,2,0.76,7672,195,0,2
35212,2014/03/31,2011/01/20,43,6,0.6667421379999999,8745,43,2,4
35213,2014/03/31,2009/01/17,24,4,0.7488543540000001,7786,24,2,2
35214,2014/03/31,2007/11/29,96,9,0.5687163479999999,10252,96,7,2
35215,2014/03/31,2008/03/26,1,6,0.5945441570000001,9806,1,4,2
35216,2014/03/31,2011/05/04,579,5,0.6731208870000001,8661,579,5,0
35217,2014/03/31,2007/05/03,381,4,1.334852301,4367,381,4,0
35218,2014/03/31,2008/04/18,243,6,0.864368327,6744,243,5,1
35219,2014/03/31,2007/06/03,152,5,0.69295768,8412,152,2,3
35220,2014/03/31,2008/06/20,121,7,0.558722323,10433,121,2,5
35221,2014/03/31,2009/09/17,410,7,0.579088019,10066,410,7,0
35222,2014/03/31,2012/10/30,7,9,0.724918542,8041,7,0,9
35223,2014/03/31,2008/04/21,101,9,0.6787782440000001,8586,101,1,8
35224,2014/03/31,2012/05/16,47,6,0.6084756729999999,9578,47,1,5
35225,2014/03/31,2007/03/25,95,9,0.8225391670000001,7085,95,4,5
35226,2014/03/31,2012/01/17,704,4,1.0,5827,704,4,0
35227,2014/03/31,2011/04/18,25,6,0.8218180540000001,7090,25,4,2
35228,2014/03/31,2010/04/28,420,5,0.645249169,9030,420,5,0
35229,2014/03/31,2011/11/12,113,4,0.789567692,7379,113,1,3
35230,2014/03/31,2012/06/20,374,3,0.683333333,8526,374,3,0
35231,2014/03/31,2011/10/07,72,8,0.656312944,8877,72,3,5
35232,2014/03/31,2011/11/15,83,7,0.7596361979999999,7669,83,5,2
35233,2014/03/31,2006/10/30,324,11,0.7148036809999999,8150,324,9,2
35234,2014/03/31,2005/09/09,69,6,0.864019579,6742,69,0,6
35235,2014/03/31,2011/03/18,48,2,0.875042812,6657,48,0,2
35236,2014/03/31,2007/10/26,136,4,0.55026547,10585,136,1,3
35237,2014/03/31,2008/05/11,32,7,0.837294422,6956,32,2,5
35238,2014/03/31,2009/02/26,623,2,0.72458323,8038,623,2,0
35239,2014/03/31,2010/11/11,39,11,0.446720871,13037,39,5,6
35240,2014/03/31,2006/04/20,12,7,0.7461242790000001,7805,12,0,7
35241,2014/03/31,2005/07/15,49,9,0.660860191,8812,49,3,6
35242,2014/03/31,2008/10/04,171,6,0.754131054,7722,171,2,4
35243,2014/03/31,2012/10/17,43,6,0.646177319,9012,43,3,3
35244,2014/03/31,2007/02/06,350,5,0.818498735,7114,350,4,1
35245,2014/03/31,2013/02/18,168,4,0.545,10684,168,2,2
35246,2014/03/31,2012/08/10,122,7,0.615251479,9464,122,1,6
35247,2014/03/31,2012/08/13,85,8,0.698381912,8337,85,3,5
35248,2014/03/31,2007/08/08,203,7,0.5182730999999999,11234,203,1,6
35249,2014/03/31,2012/09/09,560,6,0.926946346,6281,560,6,0
35250,2014/03/31,2010/12/01,246,5,0.845454545,6886,246,3,2
35251,2014/03/31,2010/06/30,101,4,1.029442971,5655,101,3,1
35252,2014/03/31,2011/05/09,63,8,0.600316593,9697,63,0,8
35253,2014/03/31,2009/09/22,171,6,0.8814748640000001,6604,171,1,5
35254,2014/03/31,2011/12/02,127,7,0.699138739,8325,127,5,2
35255,2014/03/31,2007/10/24,384,5,0.802647911,7251,384,5,0
35256,2014/03/31,2006/10/27,125,12,0.574120548,10137,125,4,8
35257,2014/03/31,2007/07/11,228,4,0.880559843,6609,228,3,1
35258,2014/03/31,2010/03/15,100,4,0.737959675,7886,100,1,3
35259,2014/03/31,2013/01/19,96,5,0.497673623,11692,96,0,5
35260,2014/03/31,2007/08/08,45,5,0.7111942309999999,8181,45,2,3
35261,2014/03/31,2006/03/15,576,6,0.66774934,8713,576,6,0
35262,2014/03/31,2011/09/27,395,5,0.708543417,8211,395,5,0
35263,2014/03/31,2007/05/21,671,8,0.673616258,8636,671,8,0
35264,2014/03/31,2012/10/14,522,4,0.731158874,7956,522,4,0
35265,2014/03/31,2010/08/14,112,3,0.93929275,6193,112,1,2
35266,2014/03/31,2011/06/10,137,5,0.596,9760,137,4,1
35267,2014/03/31,2012/10/14,153,3,0.65,8949,153,2,1
35268,2014/03/31,2007/04/07,489,9,0.580108706,10027,489,9,0
35269,2014/03/31,2009/03/07,83,6,0.6919605040000001,8406,83,0,6
35270,2014/03/31,2011/11/01,282,6,0.57057681,10194,282,2,4
35271,2014/03/31,2012/11/15,71,8,0.844277834,6889,71,6,2
35272,2014/03/31,2012/03/09,579,4,0.76982131,7555,579,4,0
35273,2014/03/31,2010/03/08,302,4,0.879596189,6612,302,3,1
35274,2014/03/31,2012/04/12,502,3,0.933333333,6231,502,3,0
35275,2014/03/31,2008/03/27,8,7,0.655636979,8870,8,4,3
35276,2014/03/31,2006/03/28,612,2,1.245427286,4669,612,2,0
35277,2014/03/31,2008/11/15,74,5,0.938105841,6198,74,4,1
35278,2014/03/31,2011/03/04,13,6,0.848291509,6854,13,4,2
35279,2014/03/31,2012/09/02,254,6,0.609449686,9540,254,3,3
35280,2014/03/31,2013/03/12,114,3,0.68256046,8518,114,1,2
35281,2014/03/31,2012/03/12,449,2,0.9,6460,449,2,0
35282,2014/03/31,2011/11/20,613,2,0.9,6460,613,2,0
35283,2014/03/31,2012/11/23,276,2,0.9,6460,276,0,2
35284,2014/03/31,2012/02/28,201,2,0.9,6460,201,0,2
35285,2014/03/31,2012/12/05,84,4,0.460159886,12634,84,0,4
35286,2014/03/31,2012/05/10,132,9,0.6655363479999999,8735,132,3,6
35287,2014/03/31,2012/06/29,485,6,0.711996326,8165,485,6,0
35288,2014/03/31,2012/02/15,135,5,0.711287323,8172,135,3,2
35289,2014/03/31,2010/11/25,493,2,0.477130192,12182,493,2,0
35290,2014/03/31,2010/10/03,104,6,0.50954677,11407,104,0,6
35291,2014/03/31,2011/07/28,33,6,0.545507274,10655,33,3,3
35292,2014/03/31,2011/10/25,35,8,0.558549875,10406,35,4,4
35293,2014/03/31,2012/07/14,618,3,0.5458024229999999,10649,618,3,0
35294,2014/03/31,2012/03/22,355,4,0.8850616720000001,6567,355,2,2
35295,2014/03/31,2010/02/13,118,5,0.664748942,8743,118,2,3
35296,2014/03/31,2007/02/12,50,6,0.861525348,6746,50,1,5
35297,2014/03/31,2012/11/09,155,5,1.109965623,5236,155,0,5
35298,2014/03/31,2011/08/11,516,7,0.808978285,7184,516,7,0
35299,2014/03/31,2011/06/27,42,6,0.926730984,6271,42,2,4
35300,2014/03/31,2010/04/28,272,5,0.757281731,7674,272,3,2
35301,2014/03/31,2012/07/27,539,4,0.879700272,6606,539,4,0
35302,2014/03/31,2012/10/07,213,8,0.437413624,13285,213,5,3
35303,2014/03/31,2012/10/12,21,8,0.8071829420000001,7199,21,0,8
35304,2014/03/31,2008/07/05,94,8,0.662210826,8775,94,5,3
35305,2014/03/31,2012/04/05,434,8,0.722364495,8044,434,8,0
35306,2014/03/31,2011/02/15,186,3,0.7500774590000001,7746,186,0,3
35307,2014/03/31,2007/02/27,165,4,0.939075481,6187,165,2,2
35308,2014/03/31,2006/08/24,195,5,0.810647412,7167,195,0,5
35309,2014/03/31,2009/09/21,81,9,0.890904769,6521,81,6,3
35310,2014/03/31,2013/03/12,219,6,0.783486177,7415,219,0,6
35311,2014/03/31,2010/11/18,604,5,0.5512382579999999,10539,604,5,0
35312,2014/03/31,2010/10/15,323,4,0.653809792,8885,323,3,1
35313,2014/03/31,2012/08/31,128,7,0.557051208,10428,128,3,4
35314,2014/03/31,2013/02/28,34,9,0.512294055,11338,34,2,7
35315,2014/03/31,2010/09/10,12,8,0.592531116,9802,12,1,7
35316,2014/03/31,2013/02/07,236,7,0.651908183,8909,236,2,5
35317,2014/03/31,2007/07/17,108,4,0.846738592,6859,108,0,4
35318,2014/03/31,2009/09/07,8,9,0.7031565559999999,8259,8,3,6
35319,2014/03/31,2005/09/07,532,6,0.7,8296,532,6,0
35320,2014/03/31,2010/12/29,159,4,0.694216378,8365,159,3,1
35321,2014/03/31,2008/11/10,199,5,0.8009655170000001,7250,199,2,3
35322,2014/03/31,2010/09/27,128,6,0.639308598,9083,128,5,1
35323,2014/03/31,2008/05/13,39,8,0.66248859,8764,39,6,2
35324,2014/03/31,2011/01/15,84,11,0.73120403,7940,84,2,9
35325,2014/03/31,2012/04/15,34,6,0.846557305,6858,34,5,1
35326,2014/03/31,2009/11/22,164,8,0.745588235,7786,164,5,3
35327,2014/03/31,2009/09/16,108,3,0.593333333,9783,108,0,3
35328,2014/03/31,2008/10/07,11,12,0.6184869470000001,9385,11,2,10
35329,2014/03/31,2011/01/24,14,6,0.522925225,11100,14,3,3
35330,2014/03/31,2010/05/08,11,5,0.5445313820000001,10659,11,2,3
35331,2014/03/31,2010/05/17,76,6,0.787826795,7367,76,0,6
35332,2014/03/31,2013/03/06,165,4,0.726645799,7987,165,1,3
35333,2014/03/31,2012/10/16,32,11,0.478688552,12124,32,2,9
35334,2014/03/31,2008/11/02,375,7,0.72155912,8043,375,7,0
35335,2014/03/31,2009/07/08,359,6,0.610190346,9509,359,5,1
35336,2014/03/31,2012/12/29,165,5,0.577854795,10041,165,1,4
35337,2014/03/31,2008/03/18,2,11,0.590735159,9821,2,4,7
35338,2014/03/31,2007/06/25,58,2,1.168246073,4966,58,0,2
35339,2014/03/31,2010/07/23,25,6,0.696444178,8330,25,4,2
35340,2014/03/31,2012/05/24,300,6,0.851501541,6813,300,5,1
35341,2014/03/31,2011/06/28,160,9,0.7806580540000001,7431,160,2,7
35342,2014/03/31,2007/07/19,34,3,0.666844465,8699,34,0,3
35343,2014/03/31,2013/01/25,93,6,0.7673015870000001,7560,93,0,6
35344,2014/03/31,2010/08/13,478,2,1.5,3867,478,2,0
35345,2014/03/31,2012/04/29,10,7,0.5369817610000001,10801,10,2,5
35346,2014/03/31,2011/11/28,163,9,0.398446689,14556,163,4,5
35347,2014/03/31,2006/01/25,525,4,0.703402475,8244,525,4,0
35348,2014/03/31,2012/01/17,200,7,0.6939073720000001,8356,200,4,3
35349,2014/03/31,2012/12/07,284,5,0.629144965,9216,284,4,1
35350,2014/03/31,2005/10/14,307,8,0.853245033,6795,307,7,1
35351,2014/03/31,2012/08/01,173,8,0.7985936640000001,7260,173,6,2
35352,2014/03/31,2012/09/22,80,6,0.631770731,9177,80,2,4
35353,2014/03/31,2009/12/14,89,7,0.82,7070,89,4,3
35354,2014/03/31,2012/08/18,45,8,0.795226337,7290,45,1,7
35355,2014/03/31,2012/02/15,95,6,0.8289432290000001,6993,95,2,4
35356,2014/03/31,2011/06/09,230,8,0.747969032,7750,230,4,4
35357,2014/03/31,2012/04/06,119,9,0.952267127,6087,119,8,1
35358,2014/03/31,2012/07/20,245,4,0.919257732,6305,245,3,1
35359,2014/03/31,2012/12/27,5,9,0.956064005,6062,5,0,9
35360,2014/03/31,2009/11/05,130,6,0.752306893,7703,130,2,4
35361,2014/03/31,2011/10/31,66,8,0.7806587629999999,7423,66,4,4
35362,2014/03/31,2011/09/11,64,12,0.801614555,7228,64,5,7
35363,2014/03/31,2008/01/10,275,5,0.577717619,10029,275,4,1
35364,2014/03/31,2012/07/26,206,6,0.655327452,8841,206,3,3
35365,2014/03/31,2012/03/02,72,8,0.914237021,6337,72,3,5
35366,2014/03/31,2010/03/07,137,10,0.569537947,10172,137,5,5
35367,2014/03/31,2012/05/28,671,2,1.05,5516,671,2,0
35368,2014/03/31,2011/05/21,497,5,0.671345775,8627,497,5,0
35369,2014/03/31,2009/01/08,67,3,1.01248951,5720,67,1,2
35370,2014/03/31,2009/07/19,194,5,0.55296314,10472,194,4,1
35371,2014/03/31,2010/06/21,382,9,0.7639182059999999,7580,382,9,0
35372,2014/03/31,2008/04/07,322,7,0.641665743,9023,322,6,1
35373,2014/03/31,2011/09/22,161,5,0.791576429,7314,161,2,3
35374,2014/03/31,2011/12/27,152,10,0.478424924,12101,152,2,8
35375,2014/03/31,2012/06/05,156,7,0.369411052,15672,156,5,2
35376,2014/03/31,2012/06/15,295,7,0.877901122,6594,295,0,7
35377,2014/03/31,2011/05/24,53,11,0.7577379240000001,7639,53,5,6
35378,2014/03/31,2006/04/04,452,7,0.895405322,6464,452,7,0
35379,2014/03/31,2013/02/10,127,5,0.431662812,13405,127,1,4
35380,2014/03/31,2010/05/27,200,5,0.7307943929999999,7918,200,3,2
35381,2014/03/31,2010/04/29,209,3,0.788192344,7341,209,0,3
35382,2014/03/31,2005/07/26,70,6,0.61213923,9452,70,3,3
35383,2014/03/31,2012/08/30,285,6,0.757992925,7633,285,5,1
35384,2014/03/31,2012/01/03,389,6,0.580833333,9960,389,6,0
35385,2014/03/31,2007/03/08,30,2,0.7,8264,30,0,2
35386,2014/03/31,2005/08/07,76,7,0.8857142859999999,6531,76,0,7
35387,2014/03/31,2012/03/21,37,9,0.5905789260000001,9794,37,6,3
35388,2014/03/31,2011/09/09,556,3,0.747583043,7737,556,3,0
35389,2014/03/31,2006/05/28,30,5,0.8,7230,30,0,5
35390,2014/03/31,2007/07/15,171,5,0.656297515,8813,171,2,3
35391,2014/03/31,2011/04/20,102,3,0.910420274,6353,102,1,2
35392,2014/03/31,2007/10/05,78,9,0.798741713,7240,78,3,6
35393,2014/03/31,2005/12/01,169,6,0.805624129,7178,169,1,5
35394,2014/03/31,2012/08/11,25,7,0.697213648,8294,25,2,5
35395,2014/03/31,2012/02/04,333,7,0.682990787,8466,333,5,2
35396,2014/03/31,2012/09/20,400,5,0.98,5900,400,5,0
35397,2014/03/31,2005/09/15,172,4,0.492250128,11746,172,0,4
35398,2014/03/31,2010/09/06,145,6,0.7786047140000001,7425,145,4,2
35399,2014/03/31,2009/02/10,595,5,0.935285552,6181,595,5,0
35400,2014/03/31,2007/12/15,470,6,0.754156336,7663,470,6,0
35401,2014/03/31,2010/08/23,274,7,0.481416431,12002,274,4,3
35402,2014/03/31,2013/01/13,40,7,0.7660527709999999,7542,40,3,4
35403,2014/03/31,2012/04/04,236,4,1.27877822,4518,236,1,3
35404,2014/03/31,2006/11/29,137,5,0.931835484,6200,137,2,3
35405,2014/03/31,2012/09/21,131,8,0.692869993,8338,131,4,4
35406,2014/03/31,2011/10/13,63,4,0.961988343,6005,63,2,2
35407,2014/03/31,2009/02/24,245,9,0.664125086,8698,245,7,2
35408,2014/03/31,2011/06/08,438,7,0.848772961,6805,438,7,0
35409,2014/03/31,2012/11/25,147,5,0.829866379,6960,147,2,3
35410,2014/03/31,2012/01/04,302,6,0.652488703,8852,302,3,3
35411,2014/03/31,2011/07/31,6,9,0.568199705,10165,6,1,8
35412,2014/03/31,2005/11/12,103,6,0.7193409740000001,8027,103,4,2
35413,2014/03/31,2010/10/27,410,6,0.6943362190000001,8316,410,6,0
35414,2014/03/31,2011/02/22,44,3,0.8180660240000001,7058,44,0,3
35415,2014/03/31,2012/07/04,416,4,0.5739314120000001,10060,416,4,0
35416,2014/03/31,2006/06/14,76,7,0.8222301340000001,7022,76,1,6
35417,2014/03/31,2007/10/30,4,9,0.619092859,9326,4,2,7
35418,2014/03/31,2009/03/10,11,6,0.571095064,10109,11,1,5
35419,2014/03/31,2013/02/06,70,8,0.632193386,9132,70,2,6
35420,2014/03/31,2010/01/24,23,5,0.596237348,9682,23,1,4
35421,2014/03/31,2006/02/01,27,8,0.564502249,10226,27,5,3
35422,2014/03/31,2012/10/31,32,5,0.766651614,7529,32,3,2
35423,2014/03/31,2011/04/24,260,10,0.624415837,9244,260,8,2
35424,2014/03/31,2011/11/07,480,6,0.632290754,9128,480,6,0
35425,2014/03/31,2010/02/17,95,3,0.682210402,8460,95,0,3
35426,2014/03/31,2011/10/21,44,4,0.821641515,7024,44,1,3
35427,2014/03/31,2007/10/10,143,8,0.854233274,6756,143,3,5
35428,2014/03/31,2012/06/26,32,5,0.727448632,7933,32,0,5
35429,2014/03/31,2010/06/07,82,6,0.4899201970000001,11779,82,2,4
35430,2014/03/31,2006/03/24,10,4,0.718175482,8035,10,1,3
35431,2014/03/31,2011/04/21,464,5,0.37,15595,464,5,0
35432,2014/03/31,2011/04/11,10,8,0.61423339,9392,10,3,5
35433,2014/03/31,2011/07/22,25,8,0.559976704,10302,25,0,8
35434,2014/03/31,2012/03/02,529,5,1.1225530259999998,5139,529,5,0
35435,2014/03/31,2013/02/27,46,8,0.7801731129999999,7394,46,1,7
35436,2014/03/31,2013/02/09,50,6,0.657524222,8773,50,1,5
35437,2014/03/31,2011/03/02,169,5,0.650401398,8869,169,3,2
35438,2014/03/31,2008/01/30,77,3,1.47,3924,77,2,1
35439,2014/03/31,2013/02/03,227,4,0.576010389,10011,227,3,1
35440,2014/03/31,2008/10/16,249,5,0.7448766309999999,7741,249,2,3
35441,2014/03/31,2010/08/26,351,5,0.8289360170000001,6955,351,3,2
35442,2014/03/31,2012/10/29,109,3,0.941571125,6123,109,1,2
35443,2014/03/31,2013/01/11,177,6,0.695259286,8292,177,1,5
35444,2014/03/31,2008/05/06,29,4,0.7055085059999999,8171,29,0,4
35445,2014/03/31,2008/11/08,138,4,0.81103982,7107,138,2,2
35446,2014/03/31,2010/10/07,48,5,0.94317624,6111,48,1,4
35447,2014/03/31,2012/01/19,76,7,0.626938975,9193,76,4,3
35448,2014/03/31,2006/05/12,229,6,0.470298678,12254,229,2,4
35449,2014/03/31,2009/12/28,354,4,0.871333535,6614,354,3,1
35450,2014/03/31,2008/11/09,149,11,0.44958964,12818,149,4,7
35451,2014/03/31,2005/03/01,64,8,0.685574063,8405,64,4,4
35452,2014/03/31,2012/08/19,136,5,0.771236782,7471,136,1,4
35453,2014/03/31,2007/07/17,75,8,0.631754386,9120,75,2,6
35454,2014/03/31,2012/09/13,37,10,0.5661196820000001,10177,37,4,6
35455,2014/03/31,2011/07/12,3,3,0.779883579,7387,3,1,2
35456,2014/03/31,2007/08/10,220,4,0.8304641779999999,6937,220,0,4
35457,2014/03/31,2007/07/05,4,5,0.7898930479999999,7293,4,0,5
35458,2014/03/31,2012/06/27,175,4,0.980313138,5876,175,3,1
35459,2014/03/31,2010/07/01,3,11,0.76703023,7509,3,0,11
35460,2014/03/31,2007/02/04,67,6,0.5348551260000001,10768,67,2,4
35461,2014/03/31,2007/06/14,5,5,0.749103682,7687,5,1,4
35462,2014/03/31,2012/11/05,135,10,0.343385414,16769,135,2,8
35463,2014/03/31,2013/02/07,195,6,0.8285868470000001,6949,195,2,4
35464,2014/03/31,2007/06/22,137,8,0.51853373,11103,137,5,3
35465,2014/03/31,2011/03/28,157,5,0.813968613,7073,157,3,2
35466,2014/03/31,2013/01/06,165,6,0.7766127070000001,7413,165,2,4
35467,2014/03/31,2006/03/13,249,5,0.576853707,9980,249,4,1
35468,2014/03/31,2010/04/13,133,5,0.784727372,7336,133,3,2
35469,2014/03/31,2007/05/13,346,2,1.103835091,5215,346,0,2
35470,2014/03/31,2011/08/09,15,4,1.376470588,4182,15,3,1
35471,2014/03/31,2008/10/10,163,5,0.980126,5873,163,3,2
35472,2014/03/31,2012/02/22,542,4,1.0,5756,542,4,0
35473,2014/03/31,2010/12/31,602,4,1.0,5756,602,4,0
35474,2014/03/31,2005/02/23,119,5,0.66812188,8615,119,0,5
35475,2014/03/31,2012/10/28,21,9,0.645372281,8918,21,3,6
35476,2014/03/31,2006/12/16,11,10,0.7707915890000001,7466,11,4,6
35477,2014/03/31,2008/09/03,2,5,0.795068399,7237,2,0,5
35478,2014/03/31,2011/11/06,30,4,0.8746822740000001,6578,30,0,4
35479,2014/03/31,2008/07/16,240,5,0.730496445,7876,240,3,2
35480,2014/03/31,2006/03/14,31,6,0.768237415,7489,31,0,6
35481,2014/03/31,2012/09/13,234,8,0.625492498,9198,234,7,1
35482,2014/03/31,2008/11/23,111,6,0.582425592,9878,111,1,5
35483,2014/03/31,2013/01/05,39,6,0.679451925,8466,39,3,3
35484,2014/03/31,2007/05/31,104,6,0.734796883,7828,104,0,6
35485,2014/03/31,2011/12/19,623,4,0.688420108,8355,623,4,0
35486,2014/03/31,2012/07/04,97,6,0.7374,7800,97,5,1
35487,2014/03/31,2012/10/22,66,4,1.29627451,4437,66,2,2
35488,2014/03/31,2007/10/16,164,7,0.586498062,9806,164,5,2
35489,2014/03/31,2011/06/29,163,6,0.694829044,8277,163,5,1
35490,2014/03/31,2011/02/26,173,7,0.7614285709999999,7553,173,4,3
35491,2014/03/31,2010/04/25,155,4,0.658203045,8737,155,1,3
35492,2014/03/31,2008/04/17,266,7,0.6364209829999999,9036,266,5,2
35493,2014/03/31,2011/03/01,102,4,0.632780896,9087,102,0,4
35494,2014/03/31,2007/05/23,107,3,0.8942146190000001,6430,107,0,3
35495,2014/03/31,2010/06/03,489,5,0.708427797,8116,489,5,0
35496,2014/03/31,2008/06/13,20,6,0.697231385,8246,20,2,4
35497,2014/03/31,2011/06/11,34,9,0.779782992,7373,34,8,1
35498,2014/03/31,2012/05/10,318,3,1.0,5749,318,2,1
35499,2014/03/31,2007/05/01,1,10,0.442119511,13003,1,1,9
35500,2014/03/31,2007/02/18,122,9,0.660400919,8705,122,8,1
35501,2014/03/31,2008/06/16,22,10,0.5979301020000001,9614,22,2,8
35502,2014/03/31,2012/04/24,329,5,0.772188634,7443,329,4,1
35503,2014/03/31,2008/09/13,198,3,0.822576213,6987,198,0,3
35504,2014/03/31,2012/03/31,121,5,0.528917725,10866,121,2,3
35505,2014/03/31,2008/04/13,233,6,0.815777147,7045,233,0,6
35506,2014/03/31,2011/01/26,72,4,0.722433995,7954,72,0,4
35507,2014/03/31,2008/05/30,24,7,0.79290465,7247,24,2,5
35508,2014/03/31,2009/10/12,567,5,0.637179772,9017,567,5,0
35509,2014/03/31,2009/08/20,123,5,0.811948841,7076,123,0,5
35510,2014/03/31,2010/08/22,115,8,0.7837061790000001,7331,115,3,5
35511,2014/03/31,2011/01/11,6,8,0.642942032,8936,6,1,7
35512,2014/03/31,2011/09/24,72,6,0.8064458170000001,7124,72,4,2
35513,2014/03/31,2010/06/11,76,7,0.8331718640000001,6895,76,2,5
35514,2014/03/31,2009/07/12,289,5,0.7237759859999999,7937,289,4,1
35515,2014/03/31,2006/03/22,14,3,0.596811429,9625,14,2,1
35516,2014/03/31,2012/02/15,240,4,0.7006684559999999,8198,240,0,4
35517,2014/03/31,2010/03/01,14,5,0.668200326,8596,14,3,2
35518,2014/03/31,2008/03/30,3,4,0.73,7868,3,0,4
35519,2014/03/31,2011/02/24,45,4,0.6813309609999999,8430,45,1,3
35520,2014/03/31,2008/06/04,61,9,0.608939779,9432,61,4,5
35521,2014/03/31,2008/07/09,217,8,0.842140762,6820,217,7,1
35522,2014/03/31,2010/03/08,13,6,0.972027759,5908,13,2,4
35523,2014/03/31,2012/11/27,47,4,0.543454477,10566,47,1,3
35524,2014/03/31,2010/10/11,80,7,0.7800692840000001,7361,80,4,3
35525,2014/03/31,2010/11/05,168,8,0.5406968639999999,10619,168,2,6
35526,2014/03/31,2009/11/04,193,8,0.737198254,7788,193,7,1
35527,2014/03/31,2005/09/19,98,4,0.738591277,7773,98,3,1
35528,2014/03/31,2012/11/10,350,3,0.6319242620000001,9084,350,2,1
35529,2014/03/31,2007/10/01,317,6,0.683333333,8400,317,4,2
35530,2014/03/31,2008/12/18,301,7,0.794541805,7224,301,4,3
35531,2014/03/31,2005/10/13,148,4,0.776731628,7389,148,0,4
35532,2014/03/31,2011/11/24,89,4,0.68041973,8434,89,0,4
35533,2014/03/31,2011/08/10,585,5,0.77547973,7400,585,5,0
35534,2014/03/31,2012/04/03,6,5,0.739748614,7757,6,3,2
35535,2014/03/31,2012/02/01,137,9,0.8889031759999999,6455,137,0,9
35536,2014/03/31,2009/01/10,171,7,0.604007159,9498,171,3,4
35537,2014/03/31,2008/08/09,211,3,0.583414014,9833,211,1,2
35538,2014/03/31,2012/11/14,132,6,0.8061663859999999,7116,132,1,5
35539,2014/03/31,2009/04/25,100,3,0.6266666670000001,9153,100,0,3
35540,2014/03/31,2011/08/16,96,7,0.578671308,9912,96,4,3
35541,2014/03/31,2008/02/25,60,3,0.823333333,6966,60,2,1
35542,2014/03/31,2009/07/08,227,5,0.812958605,7054,227,4,1
35543,2014/03/31,2012/11/15,463,4,0.8,7168,463,4,0
35544,2014/03/31,2013/02/02,226,4,0.8,7168,226,2,2
35545,2014/03/31,2010/08/18,230,7,0.621444673,9227,230,5,2
35546,2014/03/31,2008/09/17,222,8,0.5177307210000001,11074,222,5,3
35547,2014/03/31,2011/10/22,239,9,0.46603723,12302,239,3,6
35548,2014/03/31,2012/01/25,351,8,0.8100324999999999,7077,351,7,1
35549,2014/03/31,2011/08/14,37,13,0.513335124,11166,37,5,8
35550,2014/03/31,2011/11/24,104,5,0.710252788,8070,104,2,3
35551,2014/03/31,2010/11/10,231,11,0.8517164509999999,6729,231,8,3
35552,2014/03/31,2011/09/11,167,5,0.872591352,6568,167,2,3
35553,2014/03/31,2011/01/19,110,6,0.6636313110000001,8636,110,2,4
35554,2014/03/31,2013/01/23,48,10,0.631738507,9071,48,3,7
35555,2014/03/31,2005/01/01,214,5,0.603440396,9496,214,1,4
35556,2014/03/31,2010/03/23,38,7,0.757529085,7564,38,6,1
35557,2014/03/31,2010/10/14,78,4,0.7319228309999999,7827,78,0,4
35558,2014/03/31,2010/05/18,32,5,0.643361788,8903,32,3,2
35559,2014/03/31,2012/09/12,29,9,0.676313614,8469,29,4,5
35560,2014/03/31,2010/11/01,427,5,0.920844051,6220,427,5,0
35561,2014/03/31,2010/09/14,355,5,0.868445792,6595,355,4,1
35562,2014/03/31,2010/10/20,77,5,0.915342816,6257,77,0,5
35563,2014/03/31,2006/06/27,462,5,1.068118239,5362,462,5,0
35564,2014/03/31,2008/03/05,349,4,0.536537381,10674,349,2,2
35565,2014/03/31,2005/02/27,511,4,0.5773135079999999,9920,511,4,0
35566,2014/03/31,2012/10/08,12,5,0.569561412,10055,12,2,3
35567,2014/03/31,2012/02/22,381,3,0.819050343,6992,381,3,0
35568,2014/03/31,2006/11/09,32,5,0.751671042,7618,32,4,1
35569,2014/03/31,2009/01/24,31,6,0.635619449,9008,31,1,5
35570,2014/03/31,2012/04/18,103,4,0.673284337,8504,103,2,2
35571,2014/03/31,2012/07/07,11,13,0.23179838100000005,24700,11,6,7
35572,2014/03/31,2011/07/09,341,6,0.536821378,10665,341,4,2
35573,2014/03/31,2005/03/29,341,6,0.610992529,9370,341,4,2
35574,2014/03/31,2011/03/30,124,3,0.591293121,9682,124,0,3
35575,2014/03/31,2008/12/02,711,4,0.92171953,6211,711,4,0
35576,2014/03/31,2011/01/13,158,7,0.535810558,10684,158,2,5
35577,2014/03/31,2006/11/08,630,5,0.567468028,10087,630,5,0
35578,2014/03/31,2005/05/05,17,2,1.455,3934,17,1,1
35579,2014/03/31,2007/09/20,72,2,1.455,3934,72,1,1
35580,2014/03/31,2011/02/25,77,9,0.743451098,7699,77,3,6
35581,2014/03/31,2011/09/24,593,4,0.820734155,6974,593,4,0
35582,2014/03/31,2006/05/06,110,6,0.860396873,6652,110,4,2
35583,2014/03/31,2013/03/23,367,2,1.105252993,5178,367,2,0
35584,2014/03/31,2012/08/25,30,5,0.384003221,14903,30,1,4
35585,2014/03/31,2012/03/13,9,9,0.740516304,7728,9,2,7
35586,2014/03/31,2011/07/18,139,10,0.463436184,12348,139,2,8
35587,2014/03/31,2010/03/19,466,5,0.575125628,9950,466,5,0
35588,2014/03/31,2010/08/01,277,14,0.705675176,8109,277,9,5
35589,2014/03/31,2012/03/21,387,5,0.8122356279999999,7045,387,5,0
35590,2014/03/31,2009/02/10,180,3,0.78518732,7287,180,2,1
35591,2014/03/31,2011/10/08,411,5,0.891754988,6416,411,5,0
35592,2014/03/31,2012/03/03,461,5,0.753927254,7588,461,5,0
35593,2014/03/31,2005/05/24,126,5,0.8752723379999999,6536,126,4,1
35594,2014/03/31,2012/12/18,43,7,0.465509806,12289,43,3,4
35595,2014/03/31,2006/10/16,264,5,1.142664802,5006,264,3,2
35596,2014/03/31,2007/12/07,227,8,0.472408524,12107,227,6,2
35597,2014/03/31,2011/08/28,308,9,0.479039283,11939,308,7,2
35598,2014/03/31,2012/02/01,221,6,0.505631686,11311,221,4,2
35599,2014/03/31,2012/04/01,157,11,0.536129183,10667,157,7,4
35600,2014/03/31,2013/01/01,352,4,0.736413393,7765,352,2,2
35601,2014/03/31,2007/11/29,401,8,0.557685555,10253,401,8,0
35602,2014/03/31,2012/03/20,19,5,0.652338848,8765,19,2,3
35603,2014/03/31,2006/09/13,116,7,0.45187085,12652,116,1,6
35604,2014/03/31,2010/11/19,243,3,0.703878355,8122,243,0,3
35605,2014/03/31,2010/05/07,80,5,0.688017812,8309,80,1,4
35606,2014/03/31,2012/07/09,197,6,0.784290026,7289,197,4,2
35607,2014/03/31,2006/09/14,68,7,0.67881843,8421,68,2,5
35608,2014/03/31,2011/10/16,3,6,0.907770367,6297,3,1,5
35609,2014/03/31,2012/08/22,285,7,0.769122713,7432,285,5,2
35610,2014/03/31,2007/06/04,201,2,1.190566549,4801,201,0,2
35611,2014/03/31,2011/04/16,48,13,0.7182983540000001,7957,48,12,1
35612,2014/03/31,2012/11/14,413,5,1.0,5715,413,5,0
35613,2014/03/31,2011/12/06,18,10,0.700614272,8156,18,0,10
35614,2014/03/31,2012/05/08,193,5,1.287235864,4439,193,4,1
35615,2014/03/31,2012/04/07,394,8,0.379409031,15060,394,8,0
35616,2014/03/31,2011/10/23,53,5,0.805071157,7097,53,3,2
35617,2014/03/31,2013/01/23,3,8,0.898915985,6356,3,1,7
35618,2014/03/31,2012/09/23,374,8,0.4875,11720,374,8,0
35619,2014/03/31,2011/01/13,269,10,0.822670986,6945,269,8,2
35620,2014/03/31,2008/06/28,365,7,0.612758769,9323,365,6,1
35621,2014/03/31,2012/07/13,625,2,1.25,4570,625,2,0
35622,2014/03/31,2011/07/17,3,4,0.916908507,6230,3,2,2
35623,2014/03/31,2013/01/21,108,8,0.655285075,8717,108,1,7
35624,2014/03/31,2011/09/30,5,4,0.6875,8308,5,0,4
35625,2014/03/31,2012/09/19,84,6,0.581300763,9825,84,2,4
35626,2014/03/31,2007/09/09,594,5,0.7906812520000001,7222,594,5,0
35627,2014/03/31,2011/09/27,561,7,0.78276902,7295,561,7,0
35628,2014/03/31,2008/03/07,317,6,0.748401048,7630,317,5,1
35629,2014/03/31,2012/06/18,191,9,0.666298716,8570,191,4,5
35630,2014/03/31,2010/10/10,22,8,0.54114302,10551,22,3,5
35631,2014/03/31,2010/03/25,102,5,1.231566005,4636,102,2,3
35632,2014/03/31,2010/01/12,103,6,0.703222072,8119,103,1,5
35633,2014/03/31,2012/09/02,117,8,0.664933023,8585,117,4,4
35634,2014/03/31,2006/07/07,13,6,0.8436688840000001,6765,13,3,3
35635,2014/03/31,2010/09/14,138,4,0.872274186,6543,138,3,1
35636,2014/03/31,2012/02/15,84,5,0.491324036,11616,84,1,4
35637,2014/03/31,2007/02/22,565,13,0.704853649,8097,565,13,0
35638,2014/03/31,2010/10/21,347,4,1.017980735,5606,347,1,3
35639,2014/03/31,2011/08/02,42,4,0.7066233279999999,8076,42,0,4
35640,2014/03/31,2009/07/19,147,10,0.660486111,8640,147,9,1
35641,2014/03/31,2011/10/16,172,5,0.544,10490,172,1,4
35642,2014/03/31,2010/09/04,106,6,0.575,9924,106,1,5
35643,2014/03/31,2008/06/07,8,5,0.651181102,8763,8,1,4
35644,2014/03/31,2012/08/23,135,3,0.8837230909999999,6457,135,1,2
35645,2014/03/31,2012/10/14,217,2,0.92,6202,217,0,2
35646,2014/03/31,2010/04/29,6,7,0.7701214740000001,7409,6,2,5
35647,2014/03/31,2012/12/19,111,8,0.57897514,9855,111,3,5
35648,2014/03/31,2011/08/29,564,6,0.597220768,9553,564,6,0
35649,2014/03/31,2006/10/01,11,4,0.591622939,9643,11,3,1
35650,2014/03/31,2013/02/02,33,15,0.794,7185,33,2,13
35651,2014/03/31,2009/04/17,21,13,0.5399261710000001,10565,21,6,7
35652,2014/03/31,2011/08/19,288,8,0.884250504,6451,288,7,1
35653,2014/03/31,2009/02/28,377,5,0.58,9835,377,5,0
35654,2014/03/31,2012/09/16,549,3,0.7,8149,549,3,0
35655,2014/03/31,2005/01/01,441,3,0.966666667,5901,441,3,0
35656,2014/03/31,2010/04/17,83,8,0.558640682,10211,83,6,2
35657,2014/03/31,2009/02/22,137,7,0.966008467,5905,137,4,3
35658,2014/03/31,2007/09/23,392,5,0.692755647,8234,392,5,0
35659,2014/03/31,2010/01/08,34,8,0.685489725,8321,34,2,6
35660,2014/03/31,2008/11/26,193,4,0.8466186729999999,6737,193,1,3
35661,2014/03/31,2012/09/03,67,8,0.683549083,8343,67,4,4
35662,2014/03/31,2010/04/18,240,4,0.447447627,12745,240,2,2
35663,2014/03/31,2011/07/21,229,3,0.817373853,6976,229,2,1
35664,2014/03/31,2009/04/16,471,8,0.75697026,7532,471,8,0
35665,2014/03/31,2012/02/10,174,8,0.7079870859999999,8053,174,5,3
35666,2014/03/31,2012/05/29,134,4,0.7763044659999999,7344,134,3,1
35667,2014/03/31,2012/07/25,181,3,0.639575948,8914,181,2,1
35668,2014/03/31,2011/01/15,460,5,0.638545984,8927,460,5,0
35669,2014/03/31,2006/01/18,91,14,0.740344201,7699,91,8,6
35670,2014/03/31,2006/04/26,36,5,0.575392691,9906,36,4,1
35671,2014/03/31,2011/02/24,124,7,0.446937975,12753,124,5,2
35672,2014/03/31,2010/03/05,167,8,0.75013951,7598,167,4,4
35673,2014/03/31,2010/03/28,142,6,0.692699319,8228,142,1,5
35674,2014/03/31,2007/09/07,356,5,0.613834141,9285,356,4,1
35675,2014/03/31,2010/01/30,37,8,0.682611091,8349,37,0,8
35676,2014/03/31,2006/02/24,75,11,0.632102928,9016,75,5,6
35677,2014/03/31,2010/04/23,165,8,0.8005971620000001,7117,165,6,2
35678,2014/03/31,2012/06/13,653,4,0.6782797620000001,8400,653,4,0
35679,2014/03/31,2008/11/27,206,6,0.753244315,7564,206,4,2
35680,2014/03/31,2010/09/20,45,8,0.432211349,13182,45,3,5
35681,2014/03/31,2010/09/23,59,6,0.795483105,7162,59,0,6
35682,2014/03/31,2010/02/02,107,6,0.7570046509999999,7525,107,1,5
35683,2014/03/31,2011/07/06,108,7,0.732503858,7776,108,3,4
35684,2014/03/31,2006/04/20,277,7,0.694529935,8201,277,3,4
35685,2014/03/31,2011/04/14,164,5,0.7879745429999999,7228,164,3,2
35686,2014/03/31,2009/12/28,285,4,0.952852602,5977,285,2,2
35687,2014/03/31,2012/08/12,588,3,0.679744569,8378,588,3,0
35688,2014/03/31,2012/06/07,202,12,0.446498353,12754,202,7,5
35689,2014/03/31,2013/01/19,240,6,0.68066579,8366,240,4,2
35690,2014/03/31,2007/04/27,5,8,0.594890305,9572,5,0,8
35691,2014/03/31,2008/09/21,40,4,0.81130379,7018,40,3,1
35692,2014/03/31,2012/11/02,32,6,0.7102944109999999,8016,32,1,5
35693,2014/03/31,2011/11/18,217,8,0.76329937,7459,217,5,3
35694,2014/03/31,2012/08/31,30,5,0.513523363,11086,30,1,4
35695,2014/03/31,2011/02/28,12,10,0.877101695,6490,12,5,5
35696,2014/03/31,2006/10/21,29,7,0.5634884179999999,10102,29,3,4
35697,2014/03/31,2011/04/24,93,6,0.631139816,9019,93,5,1
35698,2014/03/31,2013/02/06,128,9,0.7485257759999999,7604,128,1,8
35699,2014/03/31,2011/07/07,290,7,0.525949543,10821,290,2,5
35700,2014/03/31,2011/12/15,33,10,0.54358678,10469,33,7,3
35701,2014/03/31,2006/04/05,385,6,0.6335021710000001,8983,385,6,0
35702,2014/03/31,2013/01/24,78,4,0.655758239,8678,78,0,4
35703,2014/03/31,2012/04/22,510,5,0.7207726409999999,7895,510,5,0
35704,2014/03/31,2010/09/05,57,7,0.536861672,10598,57,1,6
35705,2014/03/31,2010/11/17,201,4,0.817691865,6958,201,1,3
35706,2014/03/31,2005/04/05,342,7,0.553120747,10286,342,6,1
35707,2014/03/31,2011/10/26,618,3,0.816666667,6966,618,3,0
35708,2014/03/31,2013/01/15,400,3,0.816666667,6966,400,3,0
35709,2014/03/31,2011/04/25,10,2,0.595561721,9551,10,0,2
35710,2014/03/31,2011/09/06,308,7,0.815746451,6973,308,6,1
35711,2014/03/31,2011/07/19,65,5,0.623974331,9116,65,2,3
35712,2014/03/31,2008/01/23,3,5,0.892348604,6374,3,1,4
35713,2014/03/31,2010/12/19,106,4,0.685488731,8297,106,3,1
35714,2014/03/31,2009/01/13,148,3,0.946178672,6011,148,1,2
35715,2014/03/31,2008/04/26,88,5,0.572632904,9932,88,3,2
35716,2014/03/31,2009/08/21,11,8,0.833491133,6823,11,2,6
35717,2014/03/31,2011/02/22,1,4,0.822135319,6917,1,1,3
35718,2014/03/31,2012/06/15,45,4,0.642594643,8849,45,2,2
35719,2014/03/31,2006/03/30,359,5,0.522331435,10886,359,4,1
35720,2014/03/31,2010/01/09,79,2,0.5244875929999999,10841,79,1,1
35721,2014/03/31,2011/05/28,15,10,0.736712879,7718,15,0,10
35722,2014/03/31,2012/03/22,61,3,0.903333333,6294,61,0,3
35723,2014/03/31,2012/09/03,44,6,0.516392371,11010,44,3,3
35724,2014/03/31,2007/06/04,258,6,0.607027546,9366,258,4,2
35725,2014/03/31,2008/07/06,9,10,0.595131372,9553,9,2,8
35726,2014/03/31,2007/06/01,69,10,0.821570809,6920,69,3,7
35727,2014/03/31,2011/05/12,117,12,0.73,7788,117,4,8
35728,2014/03/31,2008/04/23,18,5,0.70720612,8039,18,1,4
35729,2014/03/31,2008/07/11,323,7,0.523788465,10854,323,5,2
35730,2014/03/31,2009/10/01,616,7,0.643122172,8840,616,7,0
35731,2014/03/31,2012/12/23,89,5,0.425359521,13365,89,2,3
35732,2014/03/31,2012/01/08,229,11,0.776436279,7321,229,8,3
35733,2014/03/31,2011/08/11,585,7,0.8444361909999999,6731,585,7,0
35734,2014/03/31,2006/08/03,198,5,0.641635809,8858,198,3,2
35735,2014/03/31,2012/02/13,34,9,0.590925348,9618,34,3,6
35736,2014/03/31,2008/01/28,280,4,0.6453895070000001,8806,280,2,2
35737,2014/03/31,2008/08/23,114,8,0.547205854,10386,114,4,4
35738,2014/03/31,2009/08/13,25,6,0.500846039,11347,25,2,4
35739,2014/03/31,2013/02/28,156,6,0.353262883,16087,156,1,5
35740,2014/03/31,2012/10/10,45,8,0.516884664,10994,45,2,6
35741,2014/03/31,2010/04/16,113,8,0.62124631,9147,113,3,5
35742,2014/03/31,2012/12/01,102,7,0.852455746,6666,102,1,6
35743,2014/03/31,2012/12/01,83,7,0.71866321,7907,83,0,7
35744,2014/03/31,2008/05/27,229,8,0.626870035,9064,229,4,4
35745,2014/03/31,2007/11/26,153,6,0.7784422520000001,7299,153,3,3
35746,2014/03/31,2005/10/18,291,3,0.947104517,5999,291,2,1
35747,2014/03/31,2013/03/25,142,3,0.686666667,8274,142,1,2
35748,2014/03/31,2008/07/10,35,4,0.740918101,7668,35,0,4
35749,2014/03/31,2010/10/17,70,6,0.7370711129999999,7706,70,2,4
35750,2014/03/31,2005/10/08,217,8,0.572490676,9921,217,4,4
35751,2014/03/31,2007/02/16,44,8,0.586438455,9684,44,6,2
35752,2014/03/31,2012/01/01,218,3,0.8236055109999999,6895,218,1,2
35753,2014/03/31,2011/06/26,201,5,0.8162823459999999,6956,201,1,4
35754,2014/03/31,2010/09/28,40,10,0.65270146,8699,40,5,5
35755,2014/03/31,2013/01/20,238,7,0.416808604,13621,238,1,6
35756,2014/03/31,2012/09/30,204,4,0.37,15344,204,2,2
35757,2014/03/31,2011/01/15,187,4,0.710945523,7985,187,2,2
35758,2014/03/31,2008/06/06,187,7,0.449424432,12631,187,5,2
35759,2014/03/31,2011/04/25,359,7,0.6785714290000001,8365,359,5,2
35760,2014/03/31,2009/12/11,47,8,0.848954532,6686,47,0,8
35761,2014/03/31,2012/07/20,383,3,1.058165548,5364,383,3,0
35762,2014/03/31,2012/08/22,66,5,0.774442625,7329,66,3,2
35763,2014/03/31,2013/03/19,38,7,0.621243433,9136,38,1,6
35764,2014/03/31,2007/12/28,357,4,0.7839964079999999,7239,357,2,2
35765,2014/03/31,2012/07/06,300,6,0.560497778,10125,300,5,1
35766,2014/03/31,2008/08/09,33,3,0.806549176,7036,33,2,1
35767,2014/03/31,2009/03/04,17,7,0.586541602,9675,17,1,6
35768,2014/03/31,2007/11/08,122,4,0.6514869679999999,8709,122,2,2
35769,2014/03/31,2006/12/14,353,7,0.681437665,8326,353,5,2
35770,2014/03/31,2008/03/15,445,7,0.816184722,6951,445,7,0
35771,2014/03/31,2008/08/05,124,7,0.644588115,8801,124,4,3
35772,2014/03/31,2010/03/05,345,5,0.78508165,7226,345,3,2
35773,2014/03/31,2012/04/14,695,4,0.580208653,9777,695,4,0
35774,2014/03/31,2012/12/02,278,10,0.459868666,12335,278,5,5
35775,2014/03/31,2010/06/20,10,6,0.749192973,7571,10,0,6
35776,2014/03/31,2010/08/29,119,7,0.7536539990000001,7526,119,2,5
35777,2014/03/31,2013/02/12,277,9,0.913333333,6210,277,6,3
35778,2014/03/31,2012/07/21,1,8,0.727330085,7798,1,3,5
35779,2014/03/31,2010/12/15,47,12,0.765384615,7410,47,4,8
35780,2014/03/31,2011/11/16,303,5,0.735518807,7710,303,3,2
35781,2014/03/31,2012/02/23,150,5,0.664719259,8531,150,4,1
35782,2014/03/31,2007/06/29,43,6,0.78107438,7260,43,4,2
35783,2014/03/31,2012/09/12,485,4,0.970128315,5845,485,4,0
35784,2014/03/31,2007/03/18,367,4,0.769382632,7370,367,4,0
35785,2014/03/31,2013/01/20,102,8,0.910293787,6229,102,1,7
35786,2014/03/31,2010/10/13,303,6,0.783358663,7238,303,4,2
35787,2014/03/31,2009/11/09,187,7,0.730468951,7762,187,3,4
35788,2014/03/31,2012/07/28,474,5,0.693953488,8170,474,5,0
35789,2014/03/31,2011/01/17,590,2,0.425,13340,590,2,0
35790,2014/03/31,2010/12/13,204,5,0.617845466,9176,204,0,5
35791,2014/03/31,2012/07/19,302,6,0.471763335,12017,302,4,2
35792,2014/03/31,2009/08/03,22,4,0.448751682,12633,22,2,2
35793,2014/03/31,2013/01/18,276,10,0.5104385020000001,11106,276,3,7
35794,2014/03/31,2011/04/10,137,7,0.641568583,8836,137,5,2
35795,2014/03/31,2012/07/24,351,6,0.826235243,6861,351,5,1
35796,2014/03/31,2012/12/20,414,4,1.5,3779,414,4,0
35797,2014/03/31,2011/03/09,24,10,0.979,5790,24,4,6
35798,2014/03/31,2006/08/06,262,8,0.681365549,8319,262,7,1
35799,2014/03/31,2011/10/20,36,8,0.561071075,10102,36,1,7
35800,2014/03/31,2010/12/29,183,3,0.973333333,5823,183,2,1
35801,2014/03/31,2011/10/27,81,4,0.564541289,10039,81,0,4
35802,2014/03/31,2005/01/18,63,7,0.725172105,7815,63,4,3
35803,2014/03/31,2007/09/07,26,8,0.725234195,7814,26,2,6
35804,2014/03/31,2007/05/14,125,8,0.518364435,10932,125,4,4
35805,2014/03/31,2011/09/05,377,4,0.787348895,7197,377,4,0
35806,2014/03/31,2013/02/07,76,9,0.621863477,9112,76,2,7
35807,2014/03/31,2010/05/25,2,11,0.8069481629999999,7022,2,7,4
35808,2014/03/31,2012/09/18,464,6,0.8463181479999999,6695,464,6,0
35809,2014/03/31,2008/12/10,84,11,0.539418317,10504,84,3,8
35810,2014/03/31,2008/04/02,40,7,0.492172516,11512,40,1,6
35811,2014/03/31,2011/08/30,42,9,0.736113565,7696,42,3,6
35812,2014/03/31,2006/12/11,5,5,0.8686016559999999,6522,5,4,1
35813,2014/03/31,2006/12/20,135,5,1.132996,5000,135,3,2
35814,2014/03/31,2009/12/26,44,5,0.5760000000000001,9835,44,2,3
35815,2014/03/31,2011/09/06,222,4,0.72,7868,222,2,2
35816,2014/03/31,2011/02/26,33,7,0.711771802,7958,33,0,7
35817,2014/03/31,2006/03/24,52,3,0.8169075440000001,6933,52,1,2
35818,2014/03/31,2009/10/25,131,6,0.957337728,5916,131,3,3
35819,2014/03/31,2010/10/28,478,5,0.59779924,9474,478,5,0
35820,2014/03/31,2008/02/22,396,7,0.593902055,9536,396,7,0
35821,2014/03/31,2010/01/21,61,6,0.522420664,10840,61,4,2
35822,2014/03/31,2012/12/14,4,6,0.754535643,7505,4,2,4
35823,2014/03/31,2011/11/30,278,8,0.740716808,7645,278,7,1
35824,2014/03/31,2008/03/12,113,6,0.663662682,8532,113,2,4
35825,2014/03/31,2012/01/09,32,4,0.888039523,6376,32,0,4
35826,2014/03/31,2012/08/10,160,6,0.809205374,6997,160,5,1
35827,2014/03/31,2012/08/16,143,7,0.513079293,11035,143,5,2
35828,2014/03/31,2012/08/11,104,7,0.606040039,9341,104,3,4
35829,2014/03/31,2007/07/27,583,4,0.839654405,6742,583,4,0
35830,2014/03/31,2013/01/22,217,11,0.553618582,10225,217,6,5
35831,2014/03/31,2007/09/11,26,5,0.610497196,9272,26,3,2
35832,2014/03/31,2012/04/26,55,5,0.690391511,8199,55,3,2
35833,2014/03/31,2012/12/20,402,2,1.21028437,4677,402,2,0
35834,2014/03/31,2010/03/23,146,9,0.6512978939999999,8691,146,6,3
35835,2014/03/31,2008/02/20,4,5,0.767922659,7370,4,0,5
35836,2014/03/31,2007/05/16,6,4,0.897521015,6305,6,0,4
35837,2014/03/31,2011/11/10,85,6,0.7228011240000001,7829,85,0,6
35838,2014/03/31,2013/02/14,6,2,0.87,6504,6,0,2
35839,2014/03/31,2012/10/04,451,4,0.441131987,12827,451,4,0
35840,2014/03/31,2008/06/26,262,8,0.77751546,7277,262,5,3
35841,2014/03/31,2010/02/10,128,3,0.6563503479999999,8620,128,1,2
35842,2014/03/31,2006/08/20,29,5,0.832079718,6799,29,1,4
35843,2014/03/31,2011/12/08,227,4,0.847259248,6677,227,2,2
35844,2014/03/31,2012/10/01,330,5,0.628496834,9001,330,3,2
35845,2014/03/31,2012/06/29,626,2,0.8,7070,626,2,0
35846,2014/03/31,2012/11/08,32,6,0.673333333,8400,32,3,3
35847,2014/03/31,2012/04/13,715,2,0.8,7070,715,2,0
35848,2014/03/31,2012/04/24,466,3,0.5166666670000001,10947,466,3,0
35849,2014/03/31,2012/07/03,634,2,0.775,7298,634,2,0
35850,2014/03/31,2013/02/27,7,6,0.788128484,7176,7,0,6
35851,2014/03/31,2006/04/28,297,2,0.995,5684,297,0,2
35852,2014/03/31,2008/09/19,555,5,0.846571856,6680,555,5,0
35853,2014/03/31,2013/02/27,189,5,0.6794353,8323,189,2,3
35854,2014/03/31,2009/01/11,64,9,0.506845926,11157,64,0,9
35855,2014/03/31,2012/05/02,5,5,0.71616768,7896,5,1,4
35856,2014/03/31,2012/10/16,13,11,0.475739525,11886,13,3,8
35857,2014/03/31,2006/09/19,107,7,0.6875668770000001,8224,107,4,3
35858,2014/03/31,2008/09/28,254,8,0.770148481,7341,254,7,1
35859,2014/03/31,2012/06/12,106,15,0.624,9060,106,11,4
35860,2014/03/31,2011/04/15,242,4,0.7451865520000001,7585,242,3,1
35861,2014/03/31,2010/02/26,95,8,0.598469928,9444,95,6,2
35862,2014/03/31,2010/11/12,61,5,0.903834959,6253,61,3,2
35863,2014/03/31,2011/06/11,92,6,0.748256322,7553,92,3,3
35864,2014/03/31,2006/02/18,138,13,0.599683786,9424,138,4,9
35865,2014/03/31,2010/06/01,72,8,0.7899426890000001,7154,72,2,6
35866,2014/03/31,2012/08/08,43,8,0.680122758,8309,43,4,4
35867,2014/03/31,2013/01/23,1,5,0.54289365,10409,1,1,4
35868,2014/03/31,2007/07/18,76,7,0.5766649660000001,9799,76,1,6
35869,2014/03/31,2005/10/25,419,5,0.746196513,7572,419,5,0
35870,2014/03/31,2012/08/05,276,5,0.723602715,7808,276,4,1
35871,2014/03/31,2013/03/12,289,4,0.7018186340000001,8050,289,1,3
35872,2014/03/31,2008/06/04,75,3,0.906666667,6231,75,0,3
35873,2014/03/31,2007/09/23,318,10,0.38614149,14630,318,6,4
35874,2014/03/31,2005/04/11,229,3,0.939634004,6011,229,1,2
35875,2014/03/31,2009/04/01,36,6,0.7183072620000001,7863,36,3,3
35876,2014/03/31,2008/07/19,4,4,0.7351243000000001,7683,4,0,4
35877,2014/03/31,2011/11/13,14,6,0.7963071070000001,7092,14,0,6
35878,2014/03/31,2008/03/13,63,7,0.604891269,9335,63,2,5
35879,2014/03/31,2008/06/24,559,2,0.514773452,10969,559,2,0
35880,2014/03/31,2006/12/18,236,6,0.506956366,11138,236,4,2
35881,2014/03/31,2011/07/15,170,5,0.664177156,8501,170,2,3
35882,2014/03/31,2012/08/21,177,9,0.658937908,8568,177,3,6
35883,2014/03/31,2008/01/20,637,7,0.76495935,7380,637,7,0
35884,2014/03/31,2007/10/19,412,4,0.926082677,6096,412,4,0
35885,2014/03/31,2010/09/28,166,5,0.574,9835,166,2,3
35886,2014/03/31,2009/06/25,404,3,0.948420699,5952,404,3,0
35887,2014/03/31,2009/03/27,212,8,0.65509342,8617,212,4,4
35888,2014/03/31,2011/05/23,167,4,0.665295851,8484,167,0,4
35889,2014/03/31,2007/03/24,192,3,0.5564097,10144,192,2,1
35890,2014/03/31,2011/04/23,83,8,0.8372852690000001,6741,83,5,3
35891,2014/03/31,2011/11/02,618,4,0.5,11288,618,4,0
35892,2014/03/31,2011/01/13,95,4,0.870024665,6487,95,1,3
35893,2014/03/31,2012/12/30,287,9,0.337428999,16725,287,3,6
35894,2014/03/31,2010/03/28,39,6,0.7043584620000001,8012,39,2,4
35895,2014/03/31,2008/10/29,34,5,0.804777524,7012,34,0,5
35896,2014/03/31,2012/07/12,494,4,0.75,7524,494,4,0
35897,2014/03/31,2010/04/20,35,7,0.726714746,7765,35,2,5
35898,2014/03/31,2012/11/15,50,9,0.584226548,9658,50,1,8
35899,2014/03/31,2012/11/19,277,4,0.6192722279999999,9110,277,1,3
35900,2014/03/31,2012/08/12,193,6,0.586116364,9625,193,0,6
35901,2014/03/31,2012/06/22,49,9,0.595697687,9467,49,7,2
35902,2014/03/31,2008/03/20,239,6,0.621528712,9073,239,1,5
35903,2014/03/31,2011/10/02,143,6,0.65649901,8589,143,3,3
35904,2014/03/31,2005/06/28,364,2,0.6493723370000001,8683,364,0,2
35905,2014/03/31,2011/09/17,40,3,0.921099494,6121,40,0,3
35906,2014/03/31,2008/03/31,232,4,0.591725441,9528,232,2,2
35907,2014/03/31,2011/11/04,84,5,0.786431859,7169,84,3,2
35908,2014/03/31,2011/09/19,115,4,0.5746284779999999,9811,115,2,2
35909,2014/03/31,2008/05/16,296,7,0.560107303,10065,296,4,3
35910,2014/03/31,2011/08/03,12,4,0.596366233,9453,12,0,4
35911,2014/03/31,2008/03/18,25,6,0.8209305370000001,6867,25,3,3
35912,2014/03/31,2012/05/19,233,9,0.907777778,6210,233,7,2
35913,2014/03/31,2007/06/22,40,9,0.72688717,7755,40,5,4
35914,2014/03/31,2011/03/16,234,4,0.52,10840,234,2,2
35915,2014/03/31,2009/08/28,317,4,0.784407181,7186,317,2,2
35916,2014/03/31,2009/07/20,403,7,0.724129513,7783,403,7,0
35917,2014/03/31,2011/08/12,57,8,0.6634078870000001,8495,57,5,3
35918,2014/03/31,2008/03/14,116,6,0.491095425,11475,116,3,3
35919,2014/03/31,2010/07/09,61,9,0.7081100779999999,7958,61,2,7
35920,2014/03/31,2012/10/02,448,7,0.80311431,7016,448,7,0
35921,2014/03/31,2010/12/08,117,6,0.68898875,8178,117,5,1
35922,2014/03/31,2013/02/13,196,5,0.875988806,6432,196,1,4
35923,2014/03/31,2008/11/19,130,5,0.737184352,7643,130,1,4
35924,2014/03/31,2012/11/25,225,7,0.585671518,9620,225,4,3
35925,2014/03/31,2006/04/20,1,8,0.6869166059999999,8202,1,3,5
35926,2014/03/31,2012/05/29,48,5,0.841158555,6698,48,2,3
35927,2014/03/31,2009/01/22,108,6,0.576194518,9778,108,3,3
35928,2014/03/31,2008/04/16,122,7,0.8288686190000001,6797,122,4,3
35929,2014/03/31,2011/03/01,450,5,0.859983209,6551,450,5,0
35930,2014/03/31,2010/06/08,13,7,0.6768496940000001,8323,13,1,6
35931,2014/03/31,2010/12/20,193,7,0.765854521,7355,193,5,2
35932,2014/03/31,2010/05/12,352,7,0.647345133,8701,352,6,1
35933,2014/03/31,2010/01/30,176,6,0.781517969,7207,176,3,3
35934,2014/03/31,2010/09/13,38,5,0.673166009,8367,38,3,2
35935,2014/03/31,2012/07/24,280,7,0.549299717,10253,280,5,2
35936,2014/03/31,2011/12/17,437,15,0.769378415,7320,437,15,0
35937,2014/03/31,2012/01/01,711,4,0.826746917,6812,711,4,0
35938,2014/03/31,2010/01/05,147,6,0.914540435,6158,147,2,4
35939,2014/03/31,2009/10/18,10,8,0.554265184,10159,10,7,1
35940,2014/03/31,2012/07/24,73,4,0.705758335,7978,73,0,4
35941,2014/03/31,2007/07/10,514,5,0.943115578,5970,514,5,0
35942,2014/03/31,2009/03/12,185,5,0.7422093329999999,7586,185,2,3
35943,2014/03/31,2009/12/20,50,5,0.8612176840000001,6537,50,1,4
35944,2014/03/31,2012/07/25,135,4,0.671635648,8382,135,0,4
35945,2014/03/31,2008/06/29,517,5,0.817068215,6890,517,5,0
35946,2014/03/31,2012/11/18,138,4,0.564993978,9964,138,1,3
35947,2014/03/31,2008/06/04,6,7,0.6970728079999999,8076,6,0,7
35948,2014/03/31,2009/08/26,17,5,0.844892691,6663,17,0,5
35949,2014/03/31,2010/10/20,151,6,0.6165410729999999,9130,151,4,2
35950,2014/03/31,2010/06/23,280,8,0.655599814,8586,280,5,3
35951,2014/03/31,2012/03/14,46,9,0.792023357,7107,46,4,5
35952,2014/03/31,2009/07/07,346,6,0.7940330090000001,7089,346,4,2
35953,2014/03/31,2006/07/03,71,7,0.6605680079999999,8521,71,2,5
35954,2014/03/31,2009/05/05,6,10,0.948054573,5937,6,5,5
35955,2014/03/31,2008/12/08,287,6,0.689640975,8161,287,5,1
35956,2014/03/31,2011/09/13,109,6,0.7024438340000001,8012,109,4,2
35957,2014/03/31,2008/11/04,101,10,0.501499733,11222,101,1,9
35958,2014/03/31,2012/05/22,304,6,0.933748133,6027,304,3,3
35959,2014/03/31,2013/03/19,103,5,0.859977078,6544,103,1,4
35960,2014/03/31,2012/08/06,111,3,0.635743335,8852,111,1,2
35961,2014/03/31,2011/12/01,239,5,0.396,14210,239,4,1
35962,2014/03/31,2008/05/21,193,3,0.709145558,7935,193,0,3
35963,2014/03/31,2008/10/11,256,4,0.70088565,8028,256,1,3
35964,2014/03/31,2010/08/16,263,6,0.882094701,6378,263,3,3
35965,2014/03/31,2012/03/04,156,6,0.812249495,6926,156,3,3
35966,2014/03/31,2012/04/10,181,4,0.638823529,8806,181,2,2
35967,2014/03/31,2012/11/07,36,6,0.619849036,9075,36,5,1
35968,2014/03/31,2008/05/07,3,4,0.856699665,6566,3,1,3
35969,2014/03/31,2008/04/26,335,8,0.67591925,8322,335,7,1
35970,2014/03/31,2013/03/09,13,8,0.641882917,8763,13,0,8
35971,2014/03/31,2009/10/06,77,5,0.710017672,7922,77,0,5
35972,2014/03/31,2011/10/11,25,3,0.602890223,9328,25,0,3
35973,2014/03/31,2011/06/21,28,10,0.731245774,7690,28,3,7
35974,2014/03/31,2008/06/22,189,6,0.515235477,10914,189,2,4
35975,2014/03/31,2010/08/08,210,9,0.522121634,10770,210,3,6
35976,2014/03/31,2013/01/21,193,4,0.7427912809999999,7570,193,1,3
35977,2014/03/31,2013/01/17,122,4,0.603800473,9312,122,3,1
35978,2014/03/31,2010/06/11,31,5,0.7056796790000001,7967,31,3,2
35979,2014/03/31,2012/05/22,53,2,0.87,6462,53,0,2
35980,2014/03/31,2010/05/01,44,6,0.401382979,14006,44,2,4
35981,2014/03/31,2009/04/14,122,5,0.567370811,9908,122,1,4
35982,2014/03/31,2008/06/19,617,4,1.0,5621,617,4,0
35983,2014/03/31,2009/10/26,380,5,0.76010142,7395,380,5,0
35984,2014/03/31,2008/04/01,69,13,0.648811035,8663,69,7,6
35985,2014/03/31,2012/01/16,459,5,0.594070394,9461,459,5,0
35986,2014/03/31,2007/04/12,273,6,0.835362663,6728,273,5,1
35987,2014/03/31,2009/03/10,236,7,0.79675645,7054,236,2,5
35988,2014/03/31,2012/10/02,135,6,0.6160506410000001,9123,135,1,5
35989,2014/03/31,2012/11/01,378,6,0.511485257,10988,378,6,0
35990,2014/03/31,2011/01/13,244,9,0.665419133,8446,244,6,3
35991,2014/03/31,2012/06/21,191,4,0.821388483,6842,191,3,1
35992,2014/03/31,2010/09/26,554,3,0.619545805,9071,554,3,0
35993,2014/03/31,2008/12/22,43,9,0.419825925,13385,43,4,5
35994,2014/03/31,2012/10/03,295,5,0.551420159,10189,295,2,3
35995,2014/03/31,2007/03/15,9,14,0.460714286,12194,9,6,8
35996,2014/03/31,2013/03/03,193,6,0.890991277,6305,193,1,5
35997,2014/03/31,2011/08/21,274,5,0.859238299,6538,274,2,3
35998,2014/03/31,2010/05/25,239,6,0.7206670940000001,7795,239,1,5
35999,2014/03/31,2013/03/10,8,9,0.6781192659999999,8284,8,0,9
36000,2014/03/31,2007/07/18,70,6,0.733344648,7660,70,1,5
36001,2014/03/31,2007/05/09,618,4,0.640625,8768,618,4,0
36002,2014/03/31,2012/01/15,402,7,0.7084825929999999,7928,402,7,0
36003,2014/03/31,2013/03/02,40,4,0.670250597,8380,40,0,4
36004,2014/03/31,2009/12/24,3,9,0.522222222,10755,3,3,6
36005,2014/03/31,2007/08/28,158,4,0.421812242,13315,158,2,2
36006,2014/03/31,2012/05/01,697,4,0.706084989,7954,697,4,0
36007,2014/03/31,2012/05/01,697,4,0.706084989,7954,697,4,0
36008,2014/03/31,2012/05/04,695,4,0.706084989,7954,695,4,0
36009,2014/03/31,2006/10/17,45,7,0.7564884159999999,7424,45,1,6
36010,2014/03/31,2009/11/15,330,4,0.593406593,9464,330,2,2
36011,2014/03/31,2012/06/25,584,3,0.393463182,14273,584,3,0
36012,2014/03/31,2011/09/16,339,8,0.782022003,7181,339,7,1
36013,2014/03/31,2012/07/04,220,9,0.829856657,6767,220,7,2
36014,2014/03/31,2007/10/22,250,4,0.627986802,8941,250,0,4
36015,2014/03/31,2011/09/22,448,4,1.116607001,5028,448,4,0
36016,2014/03/31,2011/04/23,84,13,0.7126812240000001,7877,84,7,6
36017,2014/03/31,2005/11/26,327,7,0.6799539729999999,8256,327,6,1
36018,2014/03/31,2012/06/16,5,5,0.614803943,9130,5,2,3
36019,2014/03/31,2007/10/29,322,5,0.795091373,7059,322,3,2
36020,2014/03/31,2012/06/10,190,7,0.801071938,7006,190,4,3
36021,2014/03/31,2008/11/24,203,7,0.684474936,8199,203,5,2
36022,2014/03/31,2007/10/01,100,4,0.76517862,7334,100,1,3
36023,2014/03/31,2008/10/18,317,8,0.750441294,7478,317,6,2
36024,2014/03/31,2009/12/10,30,11,0.58302026,9625,30,4,7
36025,2014/03/31,2007/12/05,250,4,0.7660819109999999,7325,250,1,3
36026,2014/03/31,2012/05/18,292,3,0.7,8016,292,1,2
36027,2014/03/31,2007/11/14,114,4,0.6937598909999999,8088,114,0,4
36028,2014/03/31,2008/12/10,405,3,0.8482237340000001,6615,405,3,0
36029,2014/03/31,2010/12/31,110,5,0.619966851,9050,110,2,3
36030,2014/03/31,2010/04/14,158,4,0.755735453,7424,158,3,1
36031,2014/03/31,2005/10/16,108,11,0.364051914,15410,108,4,7
36032,2014/03/31,2007/09/01,587,2,0.85,6600,587,2,0
36033,2014/03/31,2005/07/01,83,9,0.561345942,9993,83,4,5
36034,2014/03/31,2013/03/22,41,5,0.586075645,9571,41,0,5
36035,2014/03/31,2007/11/15,178,4,0.7003371209999999,8009,178,0,4
36036,2014/03/31,2009/10/19,166,6,0.527606998,10631,166,5,1
36037,2014/03/31,2007/02/20,148,9,0.70899507,7911,148,8,1
36038,2014/03/31,2008/12/16,524,6,0.712074657,7876,524,6,0
36039,2014/03/31,2011/06/13,417,4,0.675,8308,417,4,0
36040,2014/03/31,2008/04/23,625,4,0.75792106,7398,625,4,0
36041,2014/03/31,2008/09/11,161,4,0.557911443,10050,161,0,4
36042,2014/03/31,2005/07/15,41,6,0.461987475,12136,41,1,5
36043,2014/03/31,2008/03/17,536,5,0.62365406,8990,536,5,0
36044,2014/03/31,2011/07/08,6,4,0.925948803,6055,6,2,2
36045,2014/03/31,2011/05/23,36,4,0.73737209,7603,36,3,1
36046,2014/03/31,2012/01/12,352,5,0.940479785,5961,352,3,2
36047,2014/03/31,2012/06/10,43,5,0.6667697429999999,8408,43,1,4
36048,2014/03/31,2010/07/28,23,7,0.761983145,7357,23,6,1
36049,2014/03/31,2010/12/04,125,7,0.628463004,8920,125,4,3
36050,2014/03/31,2012/01/13,161,7,0.80331757,6978,161,5,2
36051,2014/03/31,2013/03/24,201,8,0.5341152929999999,10495,201,1,7
36052,2014/03/31,2012/06/02,16,7,0.6981205629999999,8029,16,1,6
36053,2014/03/31,2012/12/23,50,9,0.835347243,6710,50,4,5
36054,2014/03/31,2009/03/09,121,7,0.653434367,8578,121,6,1
36055,2014/03/31,2013/01/23,124,7,0.7887053190000001,7106,124,2,5
36056,2014/03/31,2011/02/22,566,2,0.748750835,7485,566,2,0
36057,2014/03/31,2012/06/06,626,4,0.5486587039999999,10214,626,4,0
36058,2014/03/31,2007/06/28,223,4,0.835254136,6709,223,2,2
36059,2014/03/31,2010/03/31,65,5,0.874060209,6411,65,3,2
36060,2014/03/31,2011/02/17,223,7,0.636805319,8799,223,3,4
36061,2014/03/31,2009/11/18,354,9,0.77060927,7271,354,7,2
36062,2014/03/31,2008/08/30,194,7,0.589442399,9505,194,2,5
36063,2014/03/31,2008/08/04,189,6,0.6410790710000001,8739,189,4,2
36064,2014/03/31,2008/11/07,492,5,0.785178697,7135,492,5,0
36065,2014/03/31,2012/07/21,121,6,0.5362617270000001,10446,121,0,6
36066,2014/03/31,2012/01/25,191,5,0.534,10490,191,4,1
36067,2014/03/31,2012/05/17,317,7,0.5626670020000001,9955,317,5,2
36068,2014/03/31,2012/03/13,95,4,0.665367071,8418,95,3,1
36069,2014/03/31,2009/07/17,181,5,0.519501901,10781,181,4,1
36070,2014/03/31,2008/08/10,248,9,0.849881639,6590,248,7,2
36071,2014/03/31,2011/07/04,159,7,0.60109048,9317,159,3,4
36072,2014/03/31,2009/12/09,346,8,0.5733592710000001,9767,346,7,1
36073,2014/03/31,2006/01/30,8,7,0.840651554,6661,8,0,7
36074,2014/03/31,2012/02/07,194,7,0.446797798,12532,194,6,1
36075,2014/03/31,2011/06/30,265,8,0.595914219,9396,265,4,4
36076,2014/03/31,2007/03/12,93,9,0.618919965,9046,93,2,7
36077,2014/03/31,2012/08/01,221,7,0.745083843,7514,221,6,1
36078,2014/03/31,2012/08/20,38,5,0.579567243,9659,38,3,2
36079,2014/03/31,2012/03/01,320,6,0.969582539,5773,320,5,1
36080,2014/03/31,2008/03/18,116,7,0.54384862,10292,116,1,6
36081,2014/03/31,2011/04/25,79,7,0.446157035,12545,79,5,2
36082,2014/03/31,2012/10/13,6,5,0.848184298,6598,6,1,4
36083,2014/03/31,2011/02/28,130,5,0.745276335,7509,130,2,3
36084,2014/03/31,2012/09/01,552,3,0.897098429,6238,552,3,0
36085,2014/03/31,2009/07/23,1,6,0.667064012,8389,1,4,2
36086,2014/03/31,2010/11/30,105,4,0.52050972,10751,105,2,2
36087,2014/03/31,2010/08/31,134,7,0.610179935,9170,134,3,4
36088,2014/03/31,2008/05/04,696,4,0.8300890209999999,6740,696,4,0
36089,2014/03/31,2007/09/22,110,4,0.7763502640000001,7206,110,2,2
36090,2014/03/31,2013/03/11,13,7,0.679083515,8238,13,3,4
36091,2014/03/31,2011/09/18,302,11,0.659844303,8478,302,10,1
36092,2014/03/31,2012/03/31,67,8,0.73568122,7604,67,3,5
36093,2014/03/31,2012/10/09,83,4,0.816165743,6854,83,3,1
36094,2014/03/31,2009/07/15,119,8,0.702132547,7967,119,1,7
36095,2014/03/31,2012/07/30,224,4,0.793843315,7046,224,0,4
36096,2014/03/31,2007/07/31,209,8,0.797337135,7015,209,2,6
36097,2014/03/31,2010/11/25,13,7,0.5753543870000001,9721,13,0,7
36098,2014/03/31,2013/02/28,274,2,1.391233831,4020,274,1,1
36099,2014/03/31,2011/02/21,73,4,0.749940995,7457,73,0,4
36100,2014/03/31,2004/11/10,253,8,0.601683882,9294,253,6,2
36101,2014/03/31,2004/11/23,20,9,0.564962619,9898,20,4,5
36102,2014/03/31,2013/03/18,217,5,0.8541286090000001,6547,217,1,4
36103,2014/03/31,2006/04/16,215,5,0.7220428720000001,7744,215,0,5
36104,2014/03/31,2012/01/18,49,8,0.6317139310000001,8851,49,2,6
36105,2014/03/31,2012/05/17,65,9,0.7715026909999999,7247,65,6,3
36106,2014/03/31,2009/08/11,123,6,0.742896625,7526,123,4,2
36107,2014/03/31,2011/09/22,112,4,0.956214506,5846,112,2,2
36108,2014/03/31,2011/11/02,558,8,0.6140667910000001,9103,558,8,0
36109,2014/03/31,2009/01/06,112,5,0.796209402,7020,112,4,1
36110,2014/03/31,2010/02/09,226,7,0.61509189,9087,226,4,3
36111,2014/03/31,2012/09/19,2,7,0.662228673,8440,2,0,7
36112,2014/03/31,2007/10/01,247,4,0.613779925,9106,247,2,2
36113,2014/03/31,2012/07/20,193,3,0.895280359,6242,193,2,1
36114,2014/03/31,2006/06/04,154,5,0.764986995,7305,154,1,4
36115,2014/03/31,2004/12/08,32,7,0.7396690929999999,7555,32,4,3
36116,2014/03/31,2011/06/13,136,6,0.629066757,8883,136,5,1
36117,2014/03/31,2013/01/03,162,9,0.7655555559999999,7299,162,3,6
36118,2014/03/31,2012/12/22,30,10,0.740197377,7549,30,2,8
36119,2014/03/31,2008/02/20,294,2,0.55875,10000,294,0,2
36120,2014/03/31,2008/03/03,13,4,0.630270728,8865,13,1,3
36121,2014/03/31,2012/04/30,46,8,0.667836481,8366,46,3,5
36122,2014/03/31,2007/10/31,30,6,0.585767456,9538,30,0,6
36123,2014/03/31,2006/11/06,231,3,0.874429488,6389,231,0,3
36124,2014/03/31,2013/03/17,57,4,0.7131788590000001,7833,57,2,2
36125,2014/03/31,2010/04/12,239,3,0.946666667,5901,239,1,2
36126,2014/03/31,2010/11/08,291,3,0.85713365,6517,291,0,3
36127,2014/03/31,2012/04/17,68,5,0.907358674,6156,68,3,2
36128,2014/03/31,2011/02/06,7,10,0.69808149,8001,7,7,3
36129,2014/03/31,2006/11/07,125,2,1.177552182,4743,125,0,2
36130,2014/03/31,2013/02/16,243,5,0.429908398,12991,243,2,3
36131,2014/03/31,2009/09/01,168,8,0.69689169,8014,168,5,3
36132,2014/03/31,2006/06/28,104,2,1.125887097,4960,104,0,2
36133,2014/03/31,2011/10/31,188,5,0.711055648,7853,188,2,3
36134,2014/03/31,2010/03/09,98,5,0.671359865,8317,98,1,4
36135,2014/03/31,2008/12/06,311,5,0.5993719129999999,9314,311,4,1
36136,2014/03/31,2012/05/30,213,7,0.484548216,11521,213,5,2
36137,2014/03/31,2012/08/16,480,6,1.0,5582,480,6,0
36138,2014/03/31,2011/11/07,28,3,1.012632438,5512,28,1,2
36139,2014/03/31,2012/01/11,163,6,0.876781338,6366,163,4,2
36140,2014/03/31,2012/06/05,158,8,0.615199515,9072,158,1,7
36141,2014/03/31,2006/07/18,9,5,0.849707674,6568,9,3,2
36142,2014/03/31,2010/07/23,287,5,0.472567533,11809,287,4,1
36143,2014/03/31,2010/03/01,16,15,0.465307263,11993,16,11,4
36144,2014/03/31,2011/08/01,124,3,0.934274234,5973,124,0,3
36145,2014/03/31,2011/12/26,5,10,0.712509258,7831,5,4,6
36146,2014/03/31,2012/01/19,82,7,0.7443303090000001,7496,82,5,2
36147,2014/03/31,2006/05/16,345,6,0.6909226009999999,8075,345,5,1
36148,2014/03/31,2011/05/28,79,7,0.594369273,9386,79,5,2
36149,2014/03/31,2012/04/15,128,8,0.61316368,9097,128,1,7
36150,2014/03/31,2006/11/14,191,6,0.6508296379999999,8570,191,4,2
36151,2014/03/31,2008/11/15,95,7,0.5611227360000001,9940,95,1,6
36152,2014/03/31,2013/01/06,71,4,0.4775,11680,71,1,3
36153,2014/03/31,2011/03/27,231,5,1.035682451,5385,231,2,3
36154,2014/03/31,2012/12/06,30,5,0.660441734,8444,30,2,3
36155,2014/03/31,2012/08/09,220,7,0.6225217679999999,8958,220,4,3
36156,2014/03/31,2010/08/24,213,5,0.978095071,5701,213,3,2
36157,2014/03/31,2011/06/08,36,8,0.392123769,14220,36,0,8
36158,2014/03/31,2011/10/18,432,5,0.620015568,8993,432,5,0
36159,2014/03/31,2013/03/17,15,6,0.794487033,7018,15,0,6
36160,2014/03/31,2011/10/18,401,6,0.634049812,8793,401,6,0
36161,2014/03/31,2011/09/04,158,5,0.75217274,7410,158,4,1
36162,2014/03/31,2008/01/18,106,4,1.304564607,4272,106,0,4
36163,2014/03/31,2012/08/10,443,3,0.8,6966,443,3,0
36164,2014/03/31,2012/11/26,464,3,0.8,6966,464,3,0
36165,2014/03/31,2012/12/31,446,3,0.8,6966,446,3,0
36166,2014/03/31,2012/10/25,339,3,0.8,6966,339,1,2
36167,2014/03/31,2012/06/22,473,3,0.8,6966,473,3,0
36168,2014/03/31,2012/08/22,449,3,0.8,6966,449,3,0
36169,2014/03/31,2010/12/14,3,8,0.5353636279999999,10409,3,4,4
36170,2014/03/31,2012/07/24,186,4,0.931245195,5983,186,2,2
36171,2014/03/31,2008/09/05,66,8,0.876297578,6358,66,4,4
36172,2014/03/31,2006/06/08,136,10,0.493211155,11295,136,5,5
36173,2014/03/31,2007/06/25,416,5,0.71696486,7769,416,5,0
36174,2014/03/31,2008/08/15,169,7,0.568470096,9798,169,4,3
36175,2014/03/31,2011/09/03,102,5,0.732806579,7600,102,2,3
36176,2014/03/31,2013/03/04,259,8,0.590970925,9424,259,3,5
36177,2014/03/31,2007/12/17,236,8,0.5563516479999999,10010,236,4,4
36178,2014/03/31,2009/02/23,183,5,0.570777903,9757,183,0,5
36179,2014/03/31,2010/07/14,262,6,0.627352709,8877,262,4,2
36180,2014/03/31,2012/04/09,383,8,0.461911082,12056,383,8,0
36181,2014/03/31,2011/08/01,34,7,0.63768667,8732,34,2,5
36182,2014/03/31,2010/05/15,28,4,0.7493997309999999,7430,28,2,2
36183,2014/03/31,2007/05/16,76,7,0.915643809,6081,76,2,5
36184,2014/03/31,2012/05/01,59,6,0.669705316,8314,59,3,3
36185,2014/03/31,2013/02/13,86,4,0.8374984959999999,6648,86,1,3
36186,2014/03/31,2008/04/19,174,7,0.8631922479999999,6450,174,4,3
36187,2014/03/31,2007/05/11,19,6,0.545814296,10199,19,0,6
36188,2014/03/31,2007/04/13,207,4,0.67,8308,207,2,2
36189,2014/03/31,2010/11/29,2,10,0.7213049109999999,7717,2,0,10
36190,2014/03/31,2007/02/19,152,8,0.82794437,6723,152,6,2
36191,2014/03/31,2011/09/27,181,4,0.952146767,5846,181,1,3
36192,2014/03/31,2012/09/05,273,6,0.764861894,7277,273,4,2
36193,2014/03/31,2009/08/08,113,5,1.040529071,5349,113,4,1
36194,2014/03/31,2013/03/10,108,4,0.725649283,7670,108,1,3
36195,2014/03/31,2010/07/15,146,8,0.625968957,8891,146,6,2
36196,2014/03/31,2009/12/01,120,9,0.441701722,12599,120,1,8
36197,2014/03/31,2007/01/14,75,15,0.603605597,9219,75,5,10
36198,2014/03/31,2007/07/12,508,9,0.575330852,9672,508,9,0
36199,2014/03/31,2007/12/26,10,9,0.6414249479999999,8674,10,7,2
36200,2014/03/31,2012/10/20,114,9,0.5216624470000001,10665,114,1,8
36201,2014/03/31,2005/07/06,9,11,0.548057143,10150,9,1,10
36202,2014/03/31,2012/07/24,466,3,0.635507826,8753,466,3,0
36203,2014/03/31,2010/12/07,153,6,0.8524521070000001,6525,153,3,3
36204,2014/03/31,2012/12/31,399,2,0.725,7672,399,2,0
36205,2014/03/31,2011/01/13,557,2,0.725,7672,557,2,0
36206,2014/03/31,2013/01/14,319,4,0.619376392,8980,319,3,1
36207,2014/03/31,2005/03/27,75,7,0.542580236,10251,75,5,2
36208,2014/03/31,2011/11/16,167,6,0.6604892529999999,8421,167,1,5
36209,2014/03/31,2005/03/07,151,9,0.489681254,11357,151,5,4
36210,2014/03/31,2012/07/05,155,10,0.587615173,9464,155,5,5
36211,2014/03/31,2011/01/04,95,11,0.59688097,9317,95,3,8
36212,2014/03/31,2008/03/03,554,5,0.6547986339999999,8492,554,5,0
36213,2014/03/31,2011/10/31,345,5,0.565530919,9832,345,3,2
36214,2014/03/31,2008/03/28,9,3,0.583959668,9521,9,0,3
36215,2014/03/31,2012/12/06,457,3,0.8833333329999999,6294,457,3,0
36216,2014/03/31,2008/12/20,401,4,0.6625,8392,401,4,0
36217,2014/03/31,2012/06/08,189,8,0.823146284,6754,189,4,4
36218,2014/03/31,2008/11/28,114,7,0.79507151,6992,114,2,5
36219,2014/03/31,2005/06/21,12,7,0.583200797,9532,12,3,4
36220,2014/03/31,2007/12/07,439,5,1.0,5559,439,5,0
36221,2014/03/31,2009/02/23,137,17,0.7917647059999999,7021,137,11,6
36222,2014/03/31,2010/10/10,131,5,0.75691585,7344,131,3,2
36223,2014/03/31,2011/07/12,20,8,0.5861092370000001,9484,20,5,3
36224,2014/03/31,2007/06/11,192,4,0.7416010670000001,7495,192,3,1
36225,2014/03/31,2010/08/08,611,4,0.745780223,7453,611,4,0
36226,2014/03/31,2007/09/30,34,3,0.7663265309999999,7252,34,2,1
36227,2014/03/31,2012/07/23,82,8,0.7270251179999999,7644,82,3,5
36228,2014/03/31,2009/07/03,182,7,0.65118233,8534,182,5,2
36229,2014/03/31,2007/12/24,537,3,0.600270066,9257,537,3,0
36230,2014/03/31,2013/02/18,42,4,0.612568625,9071,42,0,4
36231,2014/03/31,2012/09/20,426,5,0.82070901,6770,426,5,0
36232,2014/03/31,2012/08/19,536,4,1.0,5556,536,4,0
36233,2014/03/31,2006/02/07,371,5,0.7889378020000001,7042,371,5,0
36234,2014/03/31,2013/03/27,81,3,0.65839891,8438,81,1,2
36235,2014/03/31,2012/11/09,174,4,0.5905655360000001,9407,174,2,2
36236,2014/03/31,2009/02/14,71,7,0.644455916,8620,71,0,7
36237,2014/03/31,2007/02/22,25,7,0.6025065079999999,9220,25,0,7
36238,2014/03/31,2013/01/05,87,6,0.705856417,7870,87,3,3
36239,2014/03/31,2012/05/08,185,7,0.710687052,7816,185,2,5
36240,2014/03/31,2012/11/26,463,3,0.8856026790000001,6272,463,3,0
36241,2014/03/31,2009/09/15,4,9,0.656399196,8462,4,0,9
36242,2014/03/31,2011/10/27,1,7,0.76697045,7242,1,1,6
36243,2014/03/31,2009/03/11,76,4,1.487201393,3734,76,3,1
36244,2014/03/31,2013/01/18,98,12,0.711089768,7809,98,1,11
36245,2014/03/31,2006/06/06,201,4,0.96,5784,201,0,4
36246,2014/03/31,2009/09/05,21,16,0.426919114,13006,21,1,15
36247,2014/03/31,2012/09/05,70,8,0.520579411,10666,70,0,8
36248,2014/03/31,2012/09/04,347,5,0.718458851,7728,347,4,1
36249,2014/03/31,2011/04/09,240,6,0.829369585,6694,240,5,1
36250,2014/03/31,2005/10/07,438,4,0.670495169,8280,438,4,0
36251,2014/03/31,2008/08/20,28,8,0.656202128,8460,28,2,6
36252,2014/03/31,2012/07/10,49,5,0.619066577,8967,49,0,5
36253,2014/03/31,2012/12/18,138,5,0.7990744209999999,6947,138,2,3
36254,2014/03/31,2011/08/12,188,6,0.408920074,13575,188,1,5
36255,2014/03/31,2013/03/06,65,3,0.644260678,8616,65,0,3
36256,2014/03/31,2007/12/02,36,7,0.767436748,7233,36,3,4
36257,2014/03/31,2012/02/25,411,5,0.813900293,6820,411,5,0
36258,2014/03/31,2007/04/05,25,11,0.57148049,9713,25,6,5
36259,2014/03/31,2012/10/23,10,5,0.822691567,6747,10,1,4
36260,2014/03/31,2012/06/09,146,7,0.561550992,9884,146,3,4
36261,2014/03/31,2012/04/16,704,2,1.05,5286,704,2,0
36262,2014/03/31,2012/11/16,499,2,1.05,5286,499,2,0
36263,2014/03/31,2013/01/24,184,9,0.915570769,6062,184,2,7
36264,2014/03/31,2011/02/08,205,7,0.765328185,7252,205,1,6
36265,2014/03/31,2008/07/19,18,3,0.913423305,6076,18,0,3
36266,2014/03/31,2011/01/13,230,7,0.509904447,10884,230,5,2
36267,2014/03/31,2007/06/21,33,7,0.706423116,7856,33,3,4
36268,2014/03/31,2012/03/27,483,5,0.567855316,9773,483,5,0
36269,2014/03/31,2012/10/09,48,4,0.6766943059999999,8201,48,1,3
36270,2014/03/31,2008/02/07,90,5,0.713911477,7772,90,0,5
36271,2014/03/31,2010/06/16,402,4,0.65,8536,402,4,0
36272,2014/03/31,2012/05/30,144,6,1.047196526,5297,144,4,2
36273,2014/03/31,2005/07/02,13,2,1.41,3934,13,0,2
36274,2014/03/31,2008/06/26,198,2,1.41,3934,198,0,2
36275,2014/03/31,2008/03/24,23,3,0.824447087,6728,23,0,3
36276,2014/03/31,2006/03/15,677,7,0.6852792190000001,8094,677,7,0
36277,2014/03/31,2012/11/17,124,5,0.529737345,10470,124,3,2
36278,2014/03/31,2011/05/31,81,5,0.656604712,8447,81,2,3
36279,2014/03/31,2012/01/23,67,7,0.500700551,11077,67,4,3
36280,2014/03/31,2007/11/12,37,3,0.67,8278,37,0,3
36281,2014/03/31,2011/11/22,135,4,0.6731156690000001,8239,135,1,3
36282,2014/03/31,2012/11/12,186,6,1.26002045,4401,186,3,3
36283,2014/03/31,2011/10/01,48,8,0.6541524120000001,8477,48,3,5
36284,2014/03/31,2010/06/13,5,5,0.651429746,8512,5,1,4
36285,2014/03/31,2011/09/12,126,6,0.653721259,8481,126,5,1
36286,2014/03/31,2008/03/19,555,4,0.734999337,7543,555,4,0
36287,2014/03/31,2011/06/26,127,11,0.603780634,9181,127,1,10
36288,2014/03/31,2012/05/01,122,8,0.5480223470000001,10113,122,3,5
36289,2014/03/31,2012/08/04,596,2,0.938225834,5907,596,2,0
36290,2014/03/31,2011/07/23,321,4,0.4875,11368,321,3,1
36291,2014/03/31,2013/01/01,331,5,0.6637321829999999,8349,331,0,5
36292,2014/03/31,2007/05/10,6,4,0.600367281,9230,6,1,3
36293,2014/03/31,2012/10/23,108,3,0.90685761,6110,108,0,3
36294,2014/03/31,2008/01/25,22,9,0.7230601590000001,7663,22,1,8
36295,2014/03/31,2012/07/26,296,5,0.7404517509999999,7482,296,3,2
36296,2014/03/31,2009/02/07,39,6,0.926552935,5979,39,3,3
36297,2014/03/31,2012/10/29,77,11,0.463152746,11961,77,3,8
36298,2014/03/31,2011/09/15,2,6,0.499252884,11096,2,0,6
36299,2014/03/31,2009/03/20,404,6,0.7136755990000001,7762,404,6,0
36300,2014/03/31,2011/08/23,135,8,0.639149648,8667,135,4,4
36301,2014/03/31,2011/07/13,238,10,0.643967682,8602,238,8,2
36302,2014/03/31,2007/11/21,306,4,0.8989613759999999,6162,306,2,2
36303,2014/03/31,2013/03/30,166,6,0.632910525,8751,166,1,5
36304,2014/03/31,2011/11/28,28,6,0.87067285,6361,28,3,3
36305,2014/03/31,2011/05/08,198,6,0.7719291890000001,7174,198,5,1
36306,2014/03/31,2012/06/23,133,9,0.7087418409999999,7813,133,6,3
36307,2014/03/31,2009/11/11,72,5,0.641713988,8629,72,0,5
36308,2014/03/31,2010/10/01,45,9,0.773781442,7156,45,4,5
36309,2014/03/31,2011/12/15,40,11,0.852991835,6491,40,4,7
36310,2014/03/31,2012/08/05,8,5,0.7220461659999999,7668,8,3,2
36311,2014/03/31,2009/08/29,76,4,0.6794710359999999,8148,76,0,4
36312,2014/03/31,2007/05/15,18,5,0.7290833659999999,7593,18,0,5
36313,2014/03/31,2011/03/17,511,7,0.630544481,8779,511,7,0
36314,2014/03/31,2008/09/23,2,6,0.805917298,6868,2,2,4
36315,2014/03/31,2011/09/11,367,4,0.684237854,8089,367,4,0
36316,2014/03/31,2012/11/02,24,8,0.490087665,11293,24,1,7
36317,2014/03/31,2006/12/22,264,6,0.83767822,6607,264,4,2
36318,2014/03/31,2007/09/02,191,9,0.6847884190000001,8082,191,5,4
36319,2014/03/31,2011/08/31,66,7,0.674362661,8206,66,0,7
36320,2014/03/31,2013/03/27,58,6,0.680486965,8132,58,2,4
36321,2014/03/31,2008/12/22,383,7,0.567052675,9758,383,7,0
36322,2014/03/31,2011/01/25,387,10,0.8235302870000001,6719,387,10,0
36323,2014/03/31,2013/03/19,33,6,0.5468442379999999,10118,33,1,5
36324,2014/03/31,2005/08/03,192,6,0.7362528279999999,7515,192,5,1
36325,2014/03/31,2012/03/15,131,6,0.510586064,10835,131,3,3
36326,2014/03/31,2008/09/06,572,8,0.8239722970000001,6714,572,8,0
36327,2014/03/31,2010/09/30,307,6,0.475,11646,307,5,1
36328,2014/03/31,2006/12/06,6,11,0.495454545,11165,6,1,10
36329,2014/03/31,2011/11/11,164,5,0.865394243,6392,164,3,2
36330,2014/03/31,2009/07/23,27,9,0.55857013,9903,27,5,4
36331,2014/03/31,2012/03/30,176,9,0.721365415,7668,176,4,5
36332,2014/03/31,2012/10/14,122,8,0.585539911,9446,122,4,4
36333,2014/03/31,2010/12/09,175,6,0.7887976040000001,7011,175,5,1
36334,2014/03/31,2011/06/22,371,3,1.0,5530,371,3,0
36335,2014/03/31,2010/02/06,161,7,0.733328912,7540,161,3,4
36336,2014/03/31,2012/07/17,13,8,0.702758007,7868,13,3,5
36337,2014/03/31,2010/11/19,16,3,1.145001035,4829,16,0,3
36338,2014/03/31,2012/11/18,168,5,0.722810825,7649,168,2,3
36339,2014/03/31,2011/07/12,54,9,0.596093801,9275,54,5,4
36340,2014/03/31,2012/06/24,96,6,0.5396954310000001,10244,96,4,2
36341,2014/03/31,2007/11/05,116,8,0.534991291,10334,116,6,2
36342,2014/03/31,2010/09/20,18,5,0.799115351,6918,18,2,3
36343,2014/03/31,2012/04/17,2,6,0.756492405,7307,2,1,5
36344,2014/03/31,2010/05/19,145,10,0.685949367,8058,145,5,5
36345,2014/03/31,2008/04/28,133,9,0.594427834,9298,133,5,4
36346,2014/03/31,2007/09/04,5,9,0.89,6210,5,7,2
36347,2014/03/31,2013/01/11,67,6,0.630836662,8761,67,1,5
36348,2014/03/31,2012/12/22,146,8,0.5469863420000001,10104,146,3,5
36349,2014/03/31,2012/09/16,243,6,0.870554505,6348,243,3,3
36350,2014/03/31,2010/09/14,192,16,0.83625,6608,192,12,4
36351,2014/03/31,2008/11/20,20,6,0.583312573,9473,20,3,3
36352,2014/03/31,2011/02/04,26,11,0.818490594,6751,26,8,3
36353,2014/03/31,2010/01/18,44,3,0.856666667,6450,44,2,1
36354,2014/03/31,2011/05/08,6,3,1.117280081,4945,6,0,3
36355,2014/03/31,2009/07/22,247,7,0.966025529,5719,247,6,1
36356,2014/03/31,2012/06/23,116,8,0.76943454,7180,116,5,3
36357,2014/03/31,2012/03/06,364,7,0.535305233,10320,364,6,1
36358,2014/03/31,2012/07/21,527,3,0.6,9207,527,3,0
36359,2014/03/31,2012/12/23,216,7,0.80856411,6832,216,2,5
36360,2014/03/31,2012/08/03,343,5,0.60672232,9104,343,1,4
36361,2014/03/31,2010/06/09,2,6,0.489013723,11295,2,2,4
36362,2014/03/31,2010/03/27,343,5,0.979482178,5639,343,4,1
36363,2014/03/31,2013/03/15,109,10,0.645795813,8551,109,4,6
36364,2014/03/31,2004/12/06,37,10,0.590415909,9353,37,5,5
36365,2014/03/31,2012/08/25,56,11,0.5470279370000001,10094,56,8,3
36366,2014/03/31,2013/03/20,75,5,0.7089022979999999,7789,75,2,3
36367,2014/03/31,2005/09/30,137,9,0.71646639,7706,137,7,2
36368,2014/03/31,2008/06/23,434,4,0.623912306,8849,434,4,0
36369,2014/03/31,2010/04/13,426,7,0.67178754,8218,426,7,0
36370,2014/03/31,2012/07/02,72,6,0.753256925,7329,72,1,5
36371,2014/03/31,2010/04/19,131,4,0.705307948,7826,131,1,3
36372,2014/03/31,2010/06/18,233,7,0.722657764,7638,233,2,5
36373,2014/03/31,2005/02/16,535,6,0.6082203860000001,9075,535,6,0
36374,2014/03/31,2013/03/22,173,10,0.642173357,8595,173,1,9
36375,2014/03/31,2005/07/15,102,5,0.6492742029999999,8501,102,3,2
36376,2014/03/31,2011/07/10,401,7,0.905859183,6093,401,7,0
36377,2014/03/31,2011/03/29,12,5,0.744444295,7414,12,2,3
36378,2014/03/31,2011/12/02,656,4,0.6199955070000001,8902,656,4,0
36379,2014/03/31,2007/08/30,66,7,0.91996166,5999,66,5,2
36380,2014/03/31,2005/01/28,39,8,0.55212006,9995,39,5,3
36381,2014/03/31,2008/10/18,550,4,0.8607549520000001,6411,550,4,0
36382,2014/03/31,2012/12/29,32,7,0.581172319,9494,32,1,6
36383,2014/03/31,2007/03/16,116,7,0.708017452,7793,116,1,6
36384,2014/03/31,2009/08/26,190,5,0.620170863,8896,190,2,3
36385,2014/03/31,2012/12/19,67,6,0.710176365,7768,67,5,1
36386,2014/03/31,2011/11/30,236,6,0.71316225,7735,236,5,1
36387,2014/03/31,2013/02/08,117,5,0.430860803,12802,117,2,3
36388,2014/03/31,2007/08/02,372,5,0.7330187429999999,7523,372,5,0
36389,2014/03/31,2005/03/24,13,6,0.8292315790000001,6650,13,4,2
36390,2014/03/31,2007/03/04,6,7,0.595823879,9255,6,2,5
36391,2014/03/31,2012/03/20,216,7,0.8442857140000001,6531,216,3,4
36392,2014/03/31,2010/04/26,47,4,0.650199292,8480,47,0,4
36393,2014/03/31,2010/08/23,33,6,0.532264916,10358,33,0,6
36394,2014/03/31,2008/01/01,146,4,0.796352737,6923,146,0,4
36395,2014/03/31,2011/10/03,118,7,0.7138124840000001,7722,118,5,2
36396,2014/03/31,2006/12/15,159,4,1.239437823,4447,159,1,3
36397,2014/03/31,2008/02/06,478,3,0.616689046,8937,478,3,0
36398,2014/03/31,2008/02/02,43,7,0.670424574,8220,43,0,7
36399,2014/03/31,2011/01/18,135,7,0.7170383859999999,7685,135,3,4
36400,2014/03/31,2010/09/19,209,8,0.763725572,7215,209,7,1
36401,2014/03/31,2011/02/03,48,3,0.754655527,7301,48,1,2
36402,2014/03/31,2008/03/13,60,15,0.405552448,13585,60,11,4
36403,2014/03/31,2009/07/16,8,8,0.533796144,10321,8,5,3
36404,2014/03/31,2012/02/14,7,7,0.803567678,6856,7,4,3
36405,2014/03/31,2008/05/18,39,7,0.715109698,7703,39,0,7
36406,2014/03/31,2012/03/20,602,4,0.9,6120,602,4,0
36407,2014/03/31,2007/04/11,361,3,0.933333333,5901,361,2,1
36408,2014/03/31,2012/03/24,607,4,0.7,7868,607,4,0
36409,2014/03/31,2005/12/07,209,4,0.7,7868,209,0,4
36410,2014/03/31,2006/11/15,21,4,0.7,7868,21,2,2
36411,2014/03/31,2010/11/16,10,3,1.182897337,4656,10,2,1
36412,2014/03/31,2012/11/09,294,4,0.670533301,8213,294,2,2
36413,2014/03/31,2013/01/18,185,3,1.399440915,3935,185,2,1
36414,2014/03/31,2007/07/18,35,6,0.638320389,8627,35,4,2
36415,2014/03/31,2011/08/11,350,6,0.8833333329999999,6234,350,4,2
36416,2014/03/31,2012/12/09,16,4,0.61043459,9020,16,1,3
36417,2014/03/31,2011/02/03,345,3,0.7459829290000001,7381,345,2,1
36418,2014/03/31,2011/11/09,202,8,0.666173019,8265,202,5,3
36419,2014/03/31,2012/07/25,173,7,0.688917668,7992,173,4,3
36420,2014/03/31,2007/06/21,83,7,0.576747329,9546,83,5,2
36421,2014/03/31,2008/12/06,348,3,0.6985471390000001,7881,348,1,2
36422,2014/03/31,2012/01/15,72,4,0.924137989,5957,72,2,2
36423,2014/03/31,2009/06/30,172,6,0.63218305,8708,172,4,2
36424,2014/03/31,2012/03/28,703,5,0.648509661,8488,703,5,0
36425,2014/03/31,2010/12/16,225,3,0.8667044559999999,6351,225,2,1
36426,2014/03/31,2012/10/02,492,5,0.53,10385,492,5,0
36427,2014/03/31,2005/09/09,168,4,0.772371597,7126,168,0,4
36428,2014/03/31,2012/07/25,32,7,0.813708413,6763,32,4,3
36429,2014/03/31,2010/11/25,225,4,1.283344216,4288,225,3,1
36430,2014/03/31,2011/04/30,104,7,0.7925421290000001,6943,104,4,3
36431,2014/03/31,2010/04/14,25,7,0.518183445,10619,25,0,7
36432,2014/03/31,2012/05/12,86,6,0.622566191,8838,86,3,3
36433,2014/03/31,2012/06/23,18,9,0.967481976,5687,18,5,4
36434,2014/03/31,2008/02/11,401,2,1.0,5502,401,2,0
36435,2014/03/31,2011/02/03,584,4,0.8399389309999999,6550,584,4,0
36436,2014/03/31,2011/01/13,500,7,0.721981627,7620,500,7,0
36437,2014/03/31,2012/04/29,584,8,0.707679444,7774,584,8,0
36438,2014/03/31,2012/06/19,93,8,0.419512734,13114,93,2,6
36439,2014/03/31,2008/05/25,242,4,0.971463888,5663,242,2,2
36440,2014/03/31,2006/09/26,39,3,0.809587932,6795,39,0,3
36441,2014/03/31,2010/10/28,132,6,0.912295191,6030,132,4,2
36442,2014/03/31,2012/11/04,235,3,1.423203105,3865,235,0,3
36443,2014/03/31,2009/08/18,385,8,0.7952291459999999,6917,385,8,0
36444,2014/03/31,2010/12/20,19,6,0.773147315,7114,19,4,2
36445,2014/03/31,2012/06/11,258,5,0.628857633,8745,258,1,4
36446,2014/03/31,2012/02/01,443,3,0.711791354,7726,443,3,0
36447,2014/03/31,2006/04/30,174,9,0.7113442879999999,7729,174,5,4
36448,2014/03/31,2012/09/30,77,4,0.537825066,10221,77,1,3
36449,2014/03/31,2012/05/02,5,10,0.509530873,10786,5,7,3
36450,2014/03/31,2008/03/01,81,7,0.715128172,7685,81,3,4
36451,2014/03/31,2008/09/01,93,7,0.703943897,7807,93,3,4
36452,2014/03/31,2006/11/15,123,3,0.7227314570000001,7604,123,2,1
36453,2014/03/31,2012/03/16,250,5,0.69631779,7892,250,4,1
36454,2014/03/31,2012/10/24,109,7,0.7245767409999999,7584,109,1,6
36455,2014/03/31,2010/08/03,252,7,0.8194378170000001,6706,252,5,2
36456,2014/03/31,2012/11/08,108,6,0.7059121270000001,7784,108,0,6
36457,2014/03/31,2009/11/07,2,9,0.657690927,8354,2,5,4
36458,2014/03/31,2012/01/16,36,6,0.830306786,6617,36,4,2
36459,2014/03/31,2011/09/15,614,7,0.535125658,10266,614,7,0
36460,2014/03/31,2011/08/29,440,5,0.84,6540,440,5,0
36461,2014/03/31,2010/09/04,253,7,0.463813745,11844,253,3,4
36462,2014/03/31,2010/12/13,466,7,0.7841947459999999,7004,466,7,0
36463,2014/03/31,2010/07/28,4,8,0.552569675,9939,4,0,8
36464,2014/03/31,2012/06/30,339,2,0.75,7322,339,1,1
36465,2014/03/31,2004/12/15,348,2,0.75,7322,348,0,2
36466,2014/03/31,2009/09/07,164,7,0.780136383,7039,164,6,1
36467,2014/03/31,2007/04/22,338,2,0.85,6460,338,0,2
36468,2014/03/31,2011/12/07,682,2,0.85,6460,682,2,0
36469,2014/03/31,2012/08/30,576,2,0.85,6460,576,2,0
36470,2014/03/31,2013/01/13,416,2,0.85,6460,416,2,0
36471,2014/03/31,2012/07/04,623,2,0.85,6460,623,2,0
36472,2014/03/31,2013/02/14,174,2,0.85,6460,174,0,2
36473,2014/03/31,2011/03/06,516,2,0.85,6460,516,2,0
36474,2014/03/31,2012/12/08,401,2,0.85,6460,401,2,0
36475,2014/03/31,2011/05/30,39,6,0.7617799670000001,7208,39,3,3
36476,2014/03/31,2005/03/18,565,6,0.848470097,6471,565,6,0
36477,2014/03/31,2008/05/29,157,8,0.757904473,7244,157,1,7
36478,2014/03/31,2011/06/14,595,3,1.361145549,4033,595,3,0
36479,2014/03/31,2007/08/10,658,3,0.5340305479999999,10279,658,3,0
36480,2014/03/31,2012/02/05,44,8,0.72944186,7525,44,0,8
36481,2014/03/31,2006/10/01,485,7,0.825492555,6649,485,7,0
36482,2014/03/31,2012/09/03,66,3,0.730547125,7512,66,0,3
36483,2014/03/31,2008/10/31,234,3,0.415262202,13215,234,0,3
36484,2014/03/31,2010/11/17,116,8,0.686809762,7990,116,4,4
36485,2014/03/31,2005/06/28,313,6,0.5885349639999999,9324,313,5,1
36486,2014/03/31,2011/12/18,442,5,0.912691284,6012,442,5,0
36487,2014/03/31,2010/01/10,361,6,0.8322539059999999,6593,361,5,1
36488,2014/03/31,2010/09/14,565,4,1.0162900540000002,5399,565,4,0
36489,2014/03/31,2008/08/21,48,5,0.588920137,9316,48,0,5
36490,2014/03/31,2007/01/09,36,7,0.545992237,10048,36,4,3
36491,2014/03/31,2006/06/09,550,4,0.89967197,6097,550,4,0
36492,2014/03/31,2008/05/13,143,5,0.667870449,8213,143,3,2
36493,2014/03/31,2011/08/20,96,8,0.535915975,10235,96,3,5
36494,2014/03/31,2013/01/22,230,3,0.82048018,6685,230,1,2
36495,2014/03/31,2013/03/27,1,8,0.628709308,8724,1,0,8
36496,2014/03/31,2008/12/05,606,2,1.1,4986,606,2,0
36497,2014/03/31,2006/04/21,191,5,0.624527442,8782,191,4,1
36498,2014/03/31,2013/02/07,49,5,0.72269996,7589,49,0,5
36499,2014/03/31,2006/02/24,10,7,0.636907444,8611,10,4,3
36500,2014/03/31,2008/01/05,154,11,0.825454545,6644,154,7,4
36501,2014/03/31,2008/09/06,338,5,0.732999198,7482,338,3,2
36502,2014/03/31,2012/06/08,1,9,0.7007974440000001,7825,1,1,8
36503,2014/03/31,2012/01/07,8,5,0.872057888,6288,8,0,5
36504,2014/03/31,2009/10/08,1,4,0.854712393,6415,1,1,3
36505,2014/03/31,2008/05/29,226,10,0.649167653,8446,226,6,4
36506,2014/03/31,2012/09/20,139,8,0.713351548,7686,139,6,2
36507,2014/03/31,2005/02/09,46,10,0.379406961,14451,46,2,8
36508,2014/03/31,2012/09/25,51,12,0.554196907,9893,51,7,5
36509,2014/03/31,2008/03/03,276,5,0.762529903,7190,276,3,2
36510,2014/03/31,2007/03/03,96,5,0.79203265,6922,96,2,3
36511,2014/03/31,2011/08/23,630,4,0.801930954,6836,630,4,0
36512,2014/03/31,2013/03/03,93,8,0.533795891,10269,93,1,7
36513,2014/03/31,2006/12/27,340,5,0.8316740020000001,6589,340,4,1
36514,2014/03/31,2006/03/07,107,3,0.7023558059999999,7802,107,0,3
36515,2014/03/31,2008/10/29,49,6,0.615625211,8901,49,3,3
36516,2014/03/31,2011/08/14,574,6,0.739094955,7414,574,6,0
36517,2014/03/31,2006/07/21,156,5,0.721495918,7594,156,2,3
36518,2014/03/31,2009/01/18,468,2,0.672175193,8151,468,2,0
36519,2014/03/31,2011/11/10,161,2,0.735,7454,161,1,1
36520,2014/03/31,2010/05/16,62,5,0.679178031,8066,62,4,1
36521,2014/03/31,2011/03/16,16,7,0.7985714290000001,6860,16,0,7
36522,2014/03/31,2008/03/08,109,8,0.563883685,9715,109,0,8
36523,2014/03/31,2009/04/29,104,7,0.7033923990000001,7788,104,5,2
36524,2014/03/31,2012/03/14,139,6,0.652341312,8397,139,5,1
36525,2014/03/31,2012/03/27,585,4,0.5125,10688,585,4,0
36526,2014/03/31,2008/04/19,512,2,1.053983067,5197,512,2,0
36527,2014/03/31,2011/03/28,22,8,0.723163454,7574,22,4,4
36528,2014/03/31,2011/09/27,45,4,0.664784561,8239,45,2,2
36529,2014/03/31,2009/07/15,77,11,0.7011111109999999,7812,77,4,7
36530,2014/03/31,2009/05/01,184,3,0.7172682029999999,7636,184,1,2
36531,2014/03/31,2010/04/11,178,5,0.81942699,6684,178,1,4
36532,2014/03/31,2010/04/22,16,8,0.794320522,6895,16,3,5
36533,2014/03/31,2011/01/19,75,3,1.138305965,4811,75,0,3
36534,2014/03/31,2007/04/08,2,6,0.986666667,5550,2,0,6
36535,2014/03/31,2010/10/19,159,7,0.980236305,5586,159,5,2
36536,2014/03/31,2011/12/09,1,13,0.409751553,13363,1,3,10
36537,2014/03/31,2006/04/06,570,3,0.649436603,8431,570,3,0
36538,2014/03/31,2009/01/08,22,5,0.6740477659999999,8123,22,1,4
36539,2014/03/31,2008/03/02,36,2,1.41,3883,36,0,2
36540,2014/03/31,2009/11/13,33,7,0.7247332190000001,7553,33,2,5
36541,2014/03/31,2009/10/10,278,10,0.7008822020000001,7810,278,7,3
36542,2014/03/31,2008/01/29,12,2,0.75,7298,12,0,2
36543,2014/03/31,2011/01/27,341,3,0.5,10947,341,2,1
36544,2014/03/31,2010/02/14,51,7,0.598916612,9138,51,6,1
36545,2014/03/31,2012/07/01,435,2,1.5,3648,435,2,0
36546,2014/03/31,2008/11/20,96,5,0.803819597,6807,96,3,2
36547,2014/03/31,2012/10/24,152,6,0.623899658,8770,152,2,4
36548,2014/03/31,2008/02/11,590,3,1.023092745,5348,590,3,0
36549,2014/03/31,2010/05/12,551,6,0.878955823,6225,551,6,0
36550,2014/03/31,2005/12/04,347,5,0.7795953259999999,7018,347,4,1
36551,2014/03/31,2011/04/12,32,7,0.88155817,6206,32,3,4
36552,2014/03/31,2012/11/01,26,8,0.744952342,7344,26,5,3
36553,2014/03/31,2012/04/22,42,6,0.5295518339999999,10331,42,3,3
36554,2014/03/31,2012/10/01,258,7,0.510331157,10720,258,3,4
36555,2014/03/31,2011/08/01,139,3,0.77,7104,139,0,3
36556,2014/03/31,2007/10/14,88,4,0.512059539,10682,88,0,4
36557,2014/03/31,2006/07/06,615,4,0.88981617,6147,615,4,0
36558,2014/03/31,2009/11/06,62,4,0.806094326,6785,62,3,1
36559,2014/03/31,2010/06/28,47,5,0.635213705,8610,47,0,5
36560,2014/03/31,2012/06/08,29,6,0.418960472,13054,29,1,5
36561,2014/03/31,2008/06/22,199,4,0.8129924190000001,6727,199,3,1
36562,2014/03/31,2012/09/06,143,9,0.5128403979999999,10664,143,6,3
36563,2014/03/31,2012/06/26,6,7,0.75690519,7225,6,3,4
36564,2014/03/31,2013/01/08,158,5,0.725277188,7540,158,2,3
36565,2014/03/31,2011/12/12,13,7,0.715943964,7638,13,0,7
36566,2014/03/31,2012/10/08,122,7,0.549061151,9959,122,2,5
36567,2014/03/31,2011/05/09,119,7,0.723675225,7556,119,3,4
36568,2014/03/31,2007/09/29,325,5,0.914806759,5977,325,4,1
36569,2014/03/31,2006/03/19,159,6,0.56655544,9650,159,5,1
36570,2014/03/31,2011/06/03,192,6,0.8904071659999999,6140,192,4,2
36571,2014/03/31,2008/12/02,68,4,0.665,8220,68,0,4
36572,2014/03/31,2012/03/16,242,6,0.603785485,9053,242,3,3
36573,2014/03/31,2009/03/20,72,6,0.558895706,9780,72,1,5
36574,2014/03/31,2012/04/01,565,4,0.7,7808,565,4,0
36575,2014/03/31,2011/10/31,250,6,0.56506617,9672,250,4,2
36576,2014/03/31,2012/10/25,35,14,0.63193802,8648,35,3,11
36577,2014/03/31,2010/08/26,353,7,0.7115494790000001,7680,353,6,1
36578,2014/03/31,2012/04/18,15,3,0.5852265179999999,9337,15,2,1
36579,2014/03/31,2011/04/14,149,5,0.7118321609999999,7674,149,1,4
36580,2014/03/31,2009/10/06,144,3,0.8766666670000001,6231,144,0,3
36581,2014/03/31,2007/10/07,218,6,0.871033328,6271,218,4,2
36582,2014/03/31,2008/07/03,49,3,0.971702544,5621,49,1,2
36583,2014/03/31,2010/12/23,201,7,0.553380952,9870,201,4,3
36584,2014/03/31,2008/08/09,264,7,0.5760219360000001,9482,264,3,4
36585,2014/03/31,2010/09/22,678,4,0.55,9930,678,4,0
36586,2014/03/31,2005/02/01,223,4,0.951119819,5742,223,2,2
36587,2014/03/31,2005/09/19,341,9,0.6812476609999999,8015,341,8,1
36588,2014/03/31,2011/09/02,243,6,0.654995202,8336,243,3,3
36589,2014/03/31,2010/12/20,343,7,0.6489006420000001,8414,343,5,2
36590,2014/03/31,2008/03/11,507,6,0.604740806,9028,507,6,0
36591,2014/03/31,2008/06/22,155,8,0.496229776,11002,155,4,4
36592,2014/03/31,2011/02/27,104,6,0.669460454,8155,104,2,4
36593,2014/03/31,2005/11/13,8,8,0.609571189,8955,8,0,8
36594,2014/03/31,2008/04/14,50,2,0.875,6238,50,0,2
36595,2014/03/31,2010/06/25,372,4,0.630053099,8663,372,4,0
36596,2014/03/31,2013/02/28,377,3,0.783333333,6966,377,3,0
36597,2014/03/31,2012/02/28,447,3,0.783333333,6966,447,3,0
36598,2014/03/31,2012/06/27,400,9,0.694444444,7857,400,9,0
36599,2014/03/31,2005/08/25,36,11,0.83992303,6496,36,0,11
36600,2014/03/31,2009/01/24,63,5,0.782879897,6969,63,2,3
36601,2014/03/31,2011/08/28,409,5,0.576905996,9457,409,5,0
36602,2014/03/31,2011/09/21,6,7,0.656054119,8315,6,0,7
36603,2014/03/31,2010/12/30,413,10,0.615,8870,413,10,0
36604,2014/03/31,2007/04/26,348,8,0.690331562,7902,348,7,1
36605,2014/03/31,2008/01/20,312,10,0.551278423,9895,312,9,1
36606,2014/03/31,2012/04/06,714,3,0.8666666670000001,6294,714,3,0
36607,2014/03/31,2008/04/09,23,8,0.504599445,10810,23,1,7
36608,2014/03/31,2006/04/12,4,9,0.784388841,6954,4,6,3
36609,2014/03/31,2011/12/26,277,7,0.95912256,5687,277,5,2
36610,2014/03/31,2009/01/19,27,7,0.6681710160000001,8163,27,0,7
36611,2014/03/31,2007/11/29,209,6,0.9,6060,209,1,5
36612,2014/03/31,2010/01/19,252,7,0.678080318,8043,252,6,1
36613,2014/03/31,2012/01/06,115,11,0.637360916,8556,115,4,7
36614,2014/03/31,2011/09/05,171,6,0.701908869,7769,171,3,3
36615,2014/03/31,2013/03/13,137,7,0.732900538,7440,137,0,7
36616,2014/03/31,2011/04/10,161,6,0.7480683220000001,7289,161,4,2
36617,2014/03/31,2013/02/08,133,3,0.680571714,8011,133,1,2
36618,2014/03/31,2012/01/05,574,4,0.798608263,6826,574,4,0
36619,2014/03/31,2007/10/25,44,6,0.894492944,6094,44,4,2
36620,2014/03/31,2012/10/20,306,6,0.637612586,8549,306,3,3
36621,2014/03/31,2006/11/21,26,3,1.316586957,4140,26,1,2
36622,2014/03/31,2011/11/13,5,9,0.530266563,10279,5,6,3
36623,2014/03/31,2007/07/29,367,3,0.8182104790000001,6661,367,3,0
36624,2014/03/31,2004/12/31,94,7,0.620053482,8788,94,3,4
36625,2014/03/31,2007/07/19,219,5,0.653594818,8337,219,0,5
36626,2014/03/31,2011/10/06,158,4,0.65129333,8366,158,2,2
36627,2014/03/31,2011/09/10,297,3,0.5860600189999999,9297,297,2,1
36628,2014/03/31,2008/03/11,10,6,0.6246142379999999,8723,10,1,5
36629,2014/03/31,2005/03/09,93,4,0.64045727,8507,93,1,3
36630,2014/03/31,2012/02/19,19,10,0.624592457,8723,19,7,3
36631,2014/03/31,2012/06/10,277,5,0.5530585729999999,9851,277,3,2
36632,2014/03/31,2007/03/21,194,5,0.736731575,7395,194,3,2
36633,2014/03/31,2005/10/24,210,10,0.480592802,11336,210,6,4
36634,2014/03/31,2006/05/09,24,7,0.5646098039999999,9649,24,2,5
36635,2014/03/31,2008/10/30,167,8,0.663780919,8207,167,6,2
36636,2014/03/31,2011/08/18,597,4,0.800823287,6802,597,4,0
36637,2014/03/31,2008/03/08,200,2,0.71,7672,200,0,2
36638,2014/03/31,2009/10/26,241,2,0.71,7672,241,0,2
36639,2014/03/31,2006/08/17,247,3,0.903333333,6030,247,2,1
36640,2014/03/31,2010/02/25,204,7,0.717137591,7595,204,5,2
36641,2014/03/31,2007/09/07,289,3,0.515430113,10567,289,0,3
36642,2014/03/31,2008/06/19,14,5,0.568086993,9587,14,0,5
36643,2014/03/31,2007/10/10,121,6,0.977701975,5570,121,4,2
36644,2014/03/31,2012/06/26,49,8,0.63674696,8552,49,5,3
36645,2014/03/31,2012/08/07,593,3,1.0,5445,593,3,0
36646,2014/03/31,2010/07/12,169,6,0.529748005,10278,169,1,5
36647,2014/03/31,2012/06/05,69,8,0.792985727,6866,69,0,8
36648,2014/03/31,2006/11/12,11,12,0.544985986,9990,11,4,8
36649,2014/03/31,2008/09/27,118,7,0.640121105,8505,118,3,4
36650,2014/03/31,2012/01/06,220,5,0.518540813,10499,220,4,1
36651,2014/03/31,2007/10/19,165,6,0.7094448059999999,7673,165,3,3
36652,2014/03/31,2007/09/13,129,4,0.608419405,8946,129,1,3
36653,2014/03/31,2009/01/28,39,5,0.554133578,9822,39,1,4
36654,2014/03/31,2009/12/08,435,3,0.8397623820000001,6481,435,3,0
36655,2014/03/31,2012/04/07,285,5,0.778819405,6988,285,3,2
36656,2014/03/31,2013/03/25,227,4,1.455,3740,227,1,3
36657,2014/03/31,2006/04/13,538,3,0.70455134,7723,538,3,0
36658,2014/03/31,2013/02/17,380,3,1.5,3627,380,3,0
36659,2014/03/31,2011/11/23,88,7,0.645373665,8430,88,4,3
36660,2014/03/31,2009/12/14,307,5,0.769803311,7067,307,4,1
36661,2014/03/31,2008/01/08,319,3,0.8542949120000001,6368,319,1,2
36662,2014/03/31,2011/07/11,126,9,0.63367152,8585,126,0,9
36663,2014/03/31,2011/10/22,349,6,0.7750391790000001,7019,349,5,1
36664,2014/03/31,2012/12/05,356,7,0.838068094,6491,356,6,1
36665,2014/03/31,2012/09/24,6,4,0.764239955,7118,6,2,2
36666,2014/03/31,2011/01/24,65,4,0.632703269,8597,65,1,3
36667,2014/03/31,2011/01/07,174,6,0.721298236,7541,174,2,4
36668,2014/03/31,2009/09/10,210,5,0.793652415,6853,210,3,2
36669,2014/03/31,2011/08/23,49,4,0.855455403,6357,49,1,3
36670,2014/03/31,2013/03/12,50,5,0.8678483640000001,6265,50,1,4
36671,2014/03/31,2007/07/07,360,6,0.71072549,7650,360,3,3
36672,2014/03/31,2012/02/04,114,2,0.745,7298,114,0,2
36673,2014/03/31,2012/04/28,684,3,0.8680664220000001,6263,684,3,0
36674,2014/03/31,2009/01/28,38,11,0.493480984,11017,38,4,7
36675,2014/03/31,2012/04/05,258,4,0.6846964740000001,7940,258,2,2
36676,2014/03/31,2010/01/26,79,6,0.65091954,8352,79,4,2
36677,2014/03/31,2006/04/28,11,4,1.140176174,4768,11,2,2
36678,2014/03/31,2010/03/21,10,9,0.494101981,11002,10,3,6
36679,2014/03/31,2006/11/20,106,7,0.858750395,6330,106,3,4
36680,2014/03/31,2011/01/13,1,11,0.54395777,9993,1,0,11
36681,2014/03/31,2012/12/08,214,4,0.733640167,7409,214,2,2
36682,2014/03/31,2010/10/12,156,7,0.555517171,9784,156,2,5
36683,2014/03/31,2011/09/01,189,7,0.627416301,8662,189,3,4
36684,2014/03/31,2010/11/21,36,8,0.7239443190000001,7507,36,6,2
36685,2014/03/31,2006/12/10,36,6,0.607177338,8949,36,0,6
36686,2014/03/31,2013/01/05,3,8,0.55646866,9764,3,4,4
36687,2014/03/31,2010/01/16,67,5,0.846936867,6415,67,0,5
36688,2014/03/31,2013/01/11,90,8,0.493733188,11004,90,1,7
36689,2014/03/31,2011/02/01,122,6,0.610447191,8900,122,0,6
36690,2014/03/31,2011/04/08,76,3,1.457499329,3727,76,0,3
36691,2014/03/31,2013/01/31,98,6,0.461743899,11761,98,0,6
36692,2014/03/31,2009/01/15,58,4,0.6825,7956,58,0,4
36693,2014/03/31,2012/10/23,46,3,0.649751077,8356,46,0,3
36694,2014/03/31,2013/02/07,223,9,0.513261486,10578,223,2,7
36695,2014/03/31,2009/10/09,137,5,0.6879067409999999,7892,137,0,5
36696,2014/03/31,2011/10/30,108,6,0.750681692,7232,108,3,3
36697,2014/03/31,2012/09/11,126,5,0.552,9835,126,3,2
36698,2014/03/31,2007/12/04,50,7,0.93955694,5778,50,4,3
36699,2014/03/31,2010/10/04,75,8,0.6955843159999999,7804,75,2,6
36700,2014/03/31,2008/06/25,574,4,0.772917557,7023,574,4,0
36701,2014/03/31,2011/03/24,537,5,0.83,6540,537,5,0
36702,2014/03/31,2010/11/21,189,3,1.066986436,5087,189,2,1
36703,2014/03/31,2012/12/20,2,5,0.54902671,9884,2,1,4
36704,2014/03/31,2009/10/03,243,8,0.598819245,9062,243,6,2
36705,2014/03/31,2007/05/24,23,5,0.556247053,9755,23,0,5
36706,2014/03/31,2005/02/14,57,4,0.670823442,8088,57,0,4
36707,2014/03/31,2012/07/05,354,8,0.61875,8768,354,7,1
36708,2014/03/31,2012/10/16,236,2,0.795,6824,236,0,2
36709,2014/03/31,2008/12/16,193,3,0.479024283,11325,193,2,1
36710,2014/03/31,2006/07/17,556,3,0.760841515,7130,556,3,0
36711,2014/03/31,2012/06/06,154,5,0.521006531,10412,154,3,2
36712,2014/03/31,2008/09/27,280,6,0.606247206,8948,280,4,2
36713,2014/03/31,2010/01/30,46,3,0.807943104,6714,46,2,1
36714,2014/03/31,2008/12/16,1,6,0.569705913,9521,1,0,6
36715,2014/03/31,2011/03/31,219,9,0.667499385,8126,219,7,2
36716,2014/03/31,2012/09/04,75,11,0.41370376,13111,75,3,8
36717,2014/03/31,2011/04/06,600,9,0.765028209,7090,600,9,0
36718,2014/03/31,2005/01/29,169,5,0.7097553000000001,7642,169,1,4
36719,2014/03/31,2009/08/16,144,6,0.639276199,8483,144,0,6
36720,2014/03/31,2012/01/22,2,10,0.621248711,8729,2,8,2
36721,2014/03/31,2012/07/20,169,4,0.767349653,7067,169,0,4
36722,2014/03/31,2010/12/28,96,8,0.7023118770000001,7721,96,1,7
36723,2014/03/31,2006/03/13,17,7,0.545893486,9933,17,1,6
36724,2014/03/31,2012/08/20,241,3,0.982660384,5518,241,2,1
36725,2014/03/31,2012/09/10,9,12,0.6310696,8592,9,3,9
36726,2014/03/31,2012/07/07,367,7,0.426832244,12703,367,7,0
36727,2014/03/31,2012/02/17,19,6,0.58935,9200,19,1,5
36728,2014/03/31,2009/08/06,676,5,1.0,5422,676,5,0
36729,2014/03/31,2011/03/22,118,6,0.73803975,7346,118,4,2
36730,2014/03/31,2010/02/10,492,4,0.558399423,9709,492,4,0
36731,2014/03/31,2012/04/21,161,5,0.647343284,8375,161,1,4
36732,2014/03/31,2013/01/17,433,2,1.0,5420,433,2,0
36733,2014/03/31,2005/03/15,431,2,1.0,5420,431,2,0
36734,2014/03/31,2013/02/16,404,2,1.0,5420,404,2,0
36735,2014/03/31,2005/05/21,434,2,1.0,5420,434,2,0
36736,2014/03/31,2013/01/29,425,2,1.0,5420,425,2,0
36737,2014/03/31,2011/07/23,501,2,1.0,5420,501,2,0
36738,2014/03/31,2006/11/01,416,2,1.0,5420,416,2,0
36739,2014/03/31,2013/01/26,428,2,1.0,5420,428,2,0
36740,2014/03/31,2013/01/31,421,2,1.0,5420,421,2,0
36741,2014/03/31,2008/04/21,223,6,0.8789977290000001,6166,223,2,4
36742,2014/03/31,2011/11/08,368,6,0.632767075,8565,368,6,0
36743,2014/03/31,2005/05/11,65,5,0.7205584359999999,7521,65,2,3
36744,2014/03/31,2009/02/09,129,6,0.761426163,7117,129,3,3
36745,2014/03/31,2012/03/29,640,3,0.7333333329999999,7389,640,3,0
36746,2014/03/31,2008/05/19,601,6,0.59610011,9090,601,6,0
36747,2014/03/31,2011/09/27,10,7,0.677603802,7996,10,3,4
36748,2014/03/31,2008/11/01,33,14,0.603598172,8974,33,6,8
36749,2014/03/31,2008/03/11,95,8,0.5344479529999999,10135,95,5,3
36750,2014/03/31,2012/07/23,49,6,0.5699116160000001,9504,49,3,3
36751,2014/03/31,2008/03/06,6,4,0.79400088,6821,6,1,3
36752,2014/03/31,2012/12/27,221,5,0.949290096,5705,221,3,2
36753,2014/03/31,2010/03/08,16,6,0.740194095,7316,16,4,2
36754,2014/03/31,2009/10/28,375,4,0.8332051079999999,6499,375,4,0
36755,2014/03/31,2012/07/28,582,4,0.809705399,6687,582,4,0
36756,2014/03/31,2010/11/07,236,9,0.661343594,8187,236,7,2
36757,2014/03/31,2008/03/26,259,5,0.538455495,10055,259,3,2
36758,2014/03/31,2008/07/03,160,6,0.691457216,7830,160,4,2
36759,2014/03/31,2007/09/22,401,3,0.798054245,6784,401,3,0
36760,2014/03/31,2010/11/09,156,8,0.6641241410000001,8152,156,6,2
36761,2014/03/31,2005/09/19,261,6,0.702628164,7705,261,2,4
36762,2014/03/31,2012/02/22,149,5,0.730676205,7409,149,0,5
36763,2014/03/31,2008/11/19,274,9,0.614491997,8809,274,8,1
36764,2014/03/31,2012/05/09,162,7,0.701907664,7711,162,4,3
36765,2014/03/31,2008/10/25,230,3,0.8325473,6501,230,2,1
36766,2014/03/31,2007/07/18,25,5,0.772,7010,25,2,3
36767,2014/03/31,2008/11/01,383,6,0.7800778429999999,6937,383,6,0
36768,2014/03/31,2012/08/05,107,4,0.775919128,6974,107,1,3
36769,2014/03/31,2012/09/03,17,8,0.698372483,7748,17,2,6
36770,2014/03/31,2008/03/20,192,6,0.7028773709999999,7698,192,2,4
36771,2014/03/31,2012/06/02,667,3,0.7782220940000001,6952,667,3,0
36772,2014/03/31,2012/03/10,147,4,0.8219690059999999,6582,147,3,1
36773,2014/03/31,2010/05/09,437,4,0.6751778359999999,8013,437,4,0
36774,2014/03/31,2010/03/31,209,6,0.406405229,13311,209,5,1
36775,2014/03/31,2010/03/12,40,5,0.898442119,6021,40,1,4
36776,2014/03/31,2009/08/01,362,3,0.916666667,5901,362,2,1
36777,2014/03/31,2012/04/20,135,6,0.583941488,9263,135,3,3
36778,2014/03/31,2008/11/17,38,5,0.7996525720000001,6764,38,2,3
36779,2014/03/31,2012/11/23,174,9,0.473369518,11423,174,2,7
36780,2014/03/31,2013/01/15,337,5,0.52796875,10240,337,2,3
36781,2014/03/31,2011/12/28,91,3,0.824976347,6553,91,0,3
36782,2014/03/31,2012/03/01,83,7,0.646257023,8365,83,5,2
36783,2014/03/31,2011/04/28,153,8,0.8175665459999999,6612,153,5,3
36784,2014/03/31,2006/08/19,72,4,0.49,11032,72,2,2
36785,2014/03/31,2011/01/14,29,5,0.643680638,8398,29,1,4
36786,2014/03/31,2011/11/01,259,5,0.58769465,9196,259,1,4
36787,2014/03/31,2009/08/08,125,7,0.4971428570000001,10871,125,4,3
36788,2014/03/31,2010/06/02,533,5,0.602799777,8965,533,5,0
36789,2014/03/31,2011/02/23,208,4,0.970168761,5570,208,3,1
36790,2014/03/31,2012/01/26,43,5,0.5655416010000001,9555,43,3,2
36791,2014/03/31,2005/03/24,180,6,0.5323982660000001,10149,180,1,5
36792,2014/03/31,2011/07/25,505,5,0.775948003,6962,505,5,0
36793,2014/03/31,2012/08/08,596,2,0.925,5840,596,2,0
36794,2014/03/31,2013/01/05,179,4,0.896718127,6024,179,0,4
36795,2014/03/31,2011/06/16,143,3,0.7039106070000001,7674,143,0,3
36796,2014/03/31,2012/06/29,57,6,0.765332294,7057,57,4,2
36797,2014/03/31,2005/06/08,13,11,0.45313533,11919,13,8,3
36798,2014/03/31,2011/05/16,597,3,0.8666666670000001,6231,597,3,0
36799,2014/03/31,2010/07/27,89,5,0.52,10385,89,0,5
36800,2014/03/31,2013/01/16,4,6,0.662508895,8151,4,0,6
36801,2014/03/31,2011/07/10,470,3,0.515222784,10481,470,3,0
36802,2014/03/31,2012/04/01,456,2,0.95,5684,456,2,0
36803,2014/03/31,2011/09/26,290,2,0.95,5684,290,0,2
36804,2014/03/31,2011/05/10,6,6,0.596013909,9059,6,2,4
36805,2014/03/31,2007/12/11,562,7,0.610285973,8847,562,7,0
36806,2014/03/31,2011/09/22,306,3,0.917576067,5883,306,1,2
36807,2014/03/31,2005/02/01,205,4,0.578678032,9327,205,0,4
36808,2014/03/31,2010/10/31,65,5,0.8393219279999999,6430,65,2,3
36809,2014/03/31,2008/05/23,210,8,0.5886529229999999,9168,210,6,2
36810,2014/03/31,2011/05/18,73,12,0.433420355,12449,73,2,10
36811,2014/03/31,2012/04/16,396,4,0.614743079,8777,396,4,0
36812,2014/03/31,2012/03/01,573,5,0.7526154279999999,7169,573,5,0
36813,2014/03/31,2013/01/24,83,5,0.468841575,11507,83,2,3
36814,2014/03/31,2009/10/21,363,5,0.6,8991,363,4,1
36815,2014/03/31,2012/02/28,176,8,0.6825,7904,176,4,4
36816,2014/03/31,2010/11/19,230,8,0.577985642,9333,230,6,2
36817,2014/03/31,2012/06/25,24,7,0.622881062,8660,24,6,1
36818,2014/03/31,2012/05/30,169,2,0.835,6460,169,0,2
36819,2014/03/31,2011/08/19,201,4,0.5964985620000001,9042,201,0,4
36820,2014/03/31,2011/02/02,281,6,0.89,6060,281,4,2
36821,2014/03/31,2009/11/20,45,7,0.762857143,7070,45,0,7
36822,2014/03/31,2005/11/26,124,10,0.7494941629999999,7196,124,5,5
36823,2014/03/31,2012/10/18,337,5,1.073507166,5024,337,4,1
36824,2014/03/31,2011/10/17,134,8,0.5270905,10232,134,4,4
36825,2014/03/31,2013/03/07,191,8,0.460433706,11713,191,2,6
36826,2014/03/31,2009/08/17,305,5,0.732271863,7364,305,3,2
36827,2014/03/31,2006/09/21,88,6,0.6397437420000001,8429,88,3,3
36828,2014/03/31,2012/04/30,411,6,0.776245321,6946,411,6,0
36829,2014/03/31,2008/10/14,84,7,0.639651163,8428,84,4,3
36830,2014/03/31,2012/05/07,131,9,0.680424135,7922,131,7,2
36831,2014/03/31,2011/10/04,43,3,0.6366666670000001,8466,43,1,2
36832,2014/03/31,2011/01/26,44,2,0.77,7000,44,0,2
36833,2014/03/31,2009/07/15,182,5,0.731036213,7373,182,0,5
36834,2014/03/31,2012/12/28,40,5,0.5479999999999999,9835,40,3,2
36835,2014/03/31,2009/01/07,107,5,0.609386024,8844,107,1,4
36836,2014/03/31,2011/09/28,615,6,0.709893295,7591,615,6,0
36837,2014/03/31,2012/08/31,397,4,0.725835129,7424,397,4,0
36838,2014/03/31,2011/03/03,320,8,0.816911765,6596,320,7,1
36839,2014/03/31,2012/06/18,44,9,0.543926913,9906,44,4,5
36840,2014/03/31,2010/03/20,23,7,0.717735447,7507,23,4,3
36841,2014/03/31,2008/06/06,170,5,0.605600764,8897,170,2,3
36842,2014/03/31,2008/04/16,11,9,0.766965125,7025,11,3,6
36843,2014/03/31,2012/05/10,30,8,0.6884996809999999,7825,30,3,5
36844,2014/03/31,2012/09/28,25,6,0.446945412,12054,25,1,5
36845,2014/03/31,2008/03/01,411,3,0.881310322,6113,411,3,0
36846,2014/03/31,2005/04/13,516,2,0.75,7183,516,2,0
36847,2014/03/31,2012/12/11,318,4,0.978405376,5506,318,1,3
36848,2014/03/31,2009/09/23,507,5,0.55740894,9664,507,5,0
36849,2014/03/31,2007/02/15,135,7,0.630319448,8546,135,4,3
36850,2014/03/31,2012/12/23,35,6,0.603250084,8929,35,4,2
36851,2014/03/31,2012/11/13,7,6,0.82536776,6526,7,0,6
36852,2014/03/31,2012/05/23,7,9,0.476979277,11292,7,7,2
36853,2014/03/31,2010/03/20,238,7,0.68062808,7913,238,4,3
36854,2014/03/31,2010/08/16,432,9,0.7528166059999999,7154,432,9,0
36855,2014/03/31,2010/02/21,266,5,0.941682112,5719,266,3,2
36856,2014/03/31,2010/11/25,312,5,0.780613132,6899,312,4,1
36857,2014/03/31,2008/05/08,125,4,0.651033607,8272,125,1,3
36858,2014/03/31,2009/06/20,540,3,0.509094347,10578,540,3,0
36859,2014/03/31,2012/05/24,625,3,1.0,5385,625,3,0
36860,2014/03/31,2010/04/06,207,26,0.553837293,9723,207,22,4
36861,2014/03/31,2013/01/13,195,6,0.720192591,7477,195,3,3
36862,2014/03/31,2008/03/17,3,5,0.872448153,6172,3,0,5
36863,2014/03/31,2008/03/27,393,3,0.848652482,6345,393,3,0
36864,2014/03/31,2012/01/17,248,9,0.689542835,7809,248,1,8
36865,2014/03/31,2006/10/01,258,8,0.750133742,7178,258,5,3
36866,2014/03/31,2012/05/28,18,7,0.632686251,8510,18,4,3
36867,2014/03/31,2011/12/13,18,8,0.768488438,7006,18,1,7
36868,2014/03/31,2008/09/06,99,4,0.636839366,8454,99,0,4
36869,2014/03/31,2011/10/10,200,5,0.760932862,7075,200,4,1
36870,2014/03/31,2013/01/05,43,9,0.348918639,15425,43,2,7
36871,2014/03/31,2009/09/29,95,11,0.440240491,12225,95,1,10
36872,2014/03/31,2006/07/16,167,6,0.671551036,8014,167,2,4
36873,2014/03/31,2009/08/08,32,10,0.7893018479999999,6818,32,7,3
36874,2014/03/31,2010/08/10,162,5,0.860992,6250,162,1,4
36875,2014/03/31,2010/04/25,405,5,0.912618725,5896,405,5,0
36876,2014/03/31,2012/03/15,9,7,0.5646065060000001,9530,9,2,5
36877,2014/03/31,2012/11/13,69,8,0.709538441,7583,69,2,6
36878,2014/03/31,2006/05/17,17,16,0.826736325,6508,17,6,10
36879,2014/03/31,2008/05/28,13,7,0.652953883,8240,13,3,4
36880,2014/03/31,2011/02/13,134,6,0.619628009,8683,134,4,2
36881,2014/03/31,2012/05/15,35,6,0.687241952,7828,35,1,5
36882,2014/03/31,2010/11/03,293,5,0.578709122,9296,293,4,1
36883,2014/03/31,2006/04/08,261,7,0.638742579,8422,261,6,1
36884,2014/03/31,2008/11/22,20,3,0.8633333329999999,6231,20,0,3
36885,2014/03/31,2012/06/13,83,6,0.382166809,14076,83,0,6
36886,2014/03/31,2011/09/01,128,3,0.717493664,7497,128,1,2
36887,2014/03/31,2011/05/26,418,5,0.863176055,6231,418,5,0
36888,2014/03/31,2013/02/06,30,6,0.651606494,8254,30,0,6
36889,2014/03/31,2010/04/09,499,7,0.7964973340000001,6752,499,7,0
36890,2014/03/31,2011/04/26,62,7,0.802516042,6701,62,1,6
36891,2014/03/31,2009/01/20,31,8,0.530534728,10136,31,1,7
36892,2014/03/31,2010/10/22,161,3,0.969433928,5547,161,1,2
36893,2014/03/31,2013/03/22,137,3,1.137584091,4727,137,1,2
36894,2014/03/31,2008/08/29,61,6,0.569969257,9433,61,2,4
36895,2014/03/31,2012/08/04,597,3,0.693875839,7748,597,3,0
36896,2014/03/31,2011/10/01,66,7,0.873668129,6153,66,5,2
36897,2014/03/31,2012/02/28,16,14,0.639040656,8412,16,4,10
36898,2014/03/31,2009/05/07,454,11,0.809090909,6644,454,11,0
36899,2014/03/31,2012/12/27,316,3,0.520166441,10334,316,0,3
36900,2014/03/31,2010/07/30,83,8,0.664436341,8090,83,6,2
36901,2014/03/31,2012/04/01,273,4,0.5354377929999999,10039,273,3,1
36902,2014/03/31,2007/09/09,174,4,0.812215171,6618,174,0,4
36903,2014/03/31,2011/10/07,195,6,0.903429148,5949,195,5,1
36904,2014/03/31,2010/06/04,13,9,0.598653075,8976,13,1,8
36905,2014/03/31,2012/07/05,429,7,0.686533793,7827,429,7,0
36906,2014/03/31,2010/05/13,352,4,0.66538271,8074,352,3,1
36907,2014/03/31,2011/10/17,1,8,0.85321474,6296,1,5,3
36908,2014/03/31,2008/09/30,80,7,0.724511735,7414,80,2,5
36909,2014/03/31,2007/10/07,262,6,0.869545087,6177,262,5,1
36910,2014/03/31,2012/12/07,263,6,0.501781577,10704,263,4,2
36911,2014/03/31,2008/03/26,2,6,0.563459924,9532,2,4,2
36912,2014/03/31,2012/04/21,267,8,0.5328924389999999,10078,267,6,2
36913,2014/03/31,2013/01/09,68,4,0.6575,8168,68,1,3
36914,2014/03/31,2012/05/02,177,2,0.7,7672,177,0,2
36915,2014/03/31,2011/08/22,576,2,0.7,7672,576,2,0
36916,2014/03/31,2009/12/08,543,2,0.7,7672,543,2,0
36917,2014/03/31,2010/06/19,179,2,0.7,7672,179,0,2
36918,2014/03/31,2006/04/04,558,4,0.7233297409999999,7424,558,4,0
36919,2014/03/31,2009/11/13,5,5,0.8733127340000001,6149,5,3,2
36920,2014/03/31,2007/01/13,164,4,0.809787362,6631,164,1,3
36921,2014/03/31,2007/10/10,1,5,0.556729912,9645,1,1,4
36922,2014/03/31,2012/12/16,132,7,0.7350650240000001,7305,132,0,7
36923,2014/03/31,2011/06/28,319,6,0.592071893,9069,319,4,2
36924,2014/03/31,2012/01/21,50,6,0.842929356,6370,50,1,5
36925,2014/03/31,2013/01/21,199,3,0.827116007,6491,199,1,2
36926,2014/03/31,2012/06/27,344,5,0.7330420540000001,7324,344,3,2
36927,2014/03/31,2006/07/12,140,5,0.788195566,6811,140,1,4
36928,2014/03/31,2012/05/17,4,6,0.546289814,9827,4,5,1
36929,2014/03/31,2012/10/18,199,8,0.73875172,7266,199,5,3
36930,2014/03/31,2007/01/09,16,5,0.5656655070000001,9489,16,2,3
36931,2014/03/31,2007/04/11,20,4,0.563811975,9520,20,0,4
36932,2014/03/31,2012/10/01,172,5,0.797521545,6730,172,3,2
36933,2014/03/31,2008/05/09,115,8,0.806640613,6653,115,3,5
36934,2014/03/31,2011/06/24,500,6,0.840485513,6385,500,6,0
36935,2014/03/31,2008/07/13,2,9,0.663574873,8087,2,3,6
36936,2014/03/31,2009/03/21,43,4,0.6328529310000001,8479,43,3,1
36937,2014/03/31,2005/03/05,61,3,0.6309173229999999,8503,61,0,3
36938,2014/03/31,2007/12/06,80,12,0.522588407,10265,80,5,7
36939,2014/03/31,2011/06/08,338,6,0.62424648,8593,338,5,1
36940,2014/03/31,2007/06/10,262,7,0.632029225,8486,262,0,7
36941,2014/03/31,2011/04/09,212,5,0.8540127390000001,6280,212,2,3
36942,2014/03/31,2005/01/16,109,6,0.620504454,8643,109,3,3
36943,2014/03/31,2012/08/16,575,3,0.967177638,5545,575,3,0
36944,2014/03/31,2012/06/09,203,7,0.586862552,9138,203,2,5
36945,2014/03/31,2012/07/06,165,6,0.537016824,9986,165,2,4
36946,2014/03/31,2010/10/26,682,3,0.792917344,6763,682,3,0
36947,2014/03/31,2007/08/16,136,6,0.510932825,10495,136,2,4
36948,2014/03/31,2008/12/02,32,7,0.653902439,8200,32,3,4
36949,2014/03/31,2007/04/05,215,10,0.6567160710000001,8164,215,7,3
36950,2014/03/31,2005/12/20,164,6,0.8590177859999999,6241,164,3,3
36951,2014/03/31,2012/02/21,36,4,0.7125,7524,36,2,2
36952,2014/03/31,2012/05/29,379,6,0.665111663,8060,379,6,0
36953,2014/03/31,2008/08/02,451,5,0.652275493,8218,451,5,0
36954,2014/03/31,2008/06/28,340,5,0.441144762,12151,340,1,4
36955,2014/03/31,2012/02/03,192,9,0.600716127,8923,192,6,3
36956,2014/03/31,2010/01/19,625,5,0.8170807929999999,6560,625,5,0
36957,2014/03/31,2008/04/30,454,5,0.65070414,8237,454,5,0
36958,2014/03/31,2005/02/26,193,8,0.896938912,5975,193,1,7
36959,2014/03/31,2008/10/23,80,8,0.497265473,10777,80,3,5
36960,2014/03/31,2007/07/25,11,8,0.593053342,9036,11,3,5
36961,2014/03/31,2011/10/15,65,8,0.505294672,10605,65,3,5
36962,2014/03/31,2008/10/28,432,7,0.64755287,8275,432,7,0
36963,2014/03/31,2012/09/27,289,5,0.869579682,6162,289,2,3
36964,2014/03/31,2009/04/13,143,6,0.7877576829999999,6801,143,3,3
36965,2014/03/31,2012/12/20,221,7,0.907528375,5903,221,5,2
36966,2014/03/31,2008/05/22,211,4,0.778626453,6880,211,0,4
36967,2014/03/31,2012/03/24,68,10,0.7133022640000001,7510,68,3,7
36968,2014/03/31,2011/06/03,257,3,0.568387097,9424,257,0,3
36969,2014/03/31,2009/11/21,286,6,0.79,6780,286,4,2
36970,2014/03/31,2008/06/08,619,3,1.246891735,4295,619,3,0
36971,2014/03/31,2006/03/01,123,4,0.810039328,6611,123,0,4
36972,2014/03/31,2005/05/07,10,9,0.623185151,8593,10,2,7
36973,2014/03/31,2010/12/13,20,7,0.762922069,7019,20,3,4
36974,2014/03/31,2012/04/24,518,3,0.661037037,8100,518,3,0
36975,2014/03/31,2011/11/02,72,5,0.794413947,6740,72,3,2
36976,2014/03/31,2012/04/04,594,4,0.637322938,8401,594,4,0
36977,2014/03/31,2008/02/08,26,9,0.794373887,6740,26,0,9
36978,2014/03/31,2013/01/19,9,6,0.593567627,9020,9,4,2
36979,2014/03/31,2011/04/26,125,8,0.717517759,7461,125,5,3
36980,2014/03/31,2009/04/27,37,4,0.683615119,7831,37,2,2
36981,2014/03/31,2012/10/19,340,3,0.948741581,5642,340,1,2
36982,2014/03/31,2012/07/16,25,8,0.682312301,7845,25,5,3
36983,2014/03/31,2012/09/20,438,7,0.777421932,6885,438,7,0
36984,2014/03/31,2011/11/23,435,4,0.427311193,12526,435,4,0
36985,2014/03/31,2013/03/19,30,11,0.524825456,10198,30,0,11
36986,2014/03/31,2013/02/14,4,16,0.5568782520000001,9610,4,5,11
36987,2014/03/31,2009/07/13,34,5,0.751898272,7117,34,1,4
36988,2014/03/31,2006/10/17,125,6,0.731939808,7310,125,2,4
36989,2014/03/31,2010/10/31,175,6,0.728944142,7340,175,5,1
36990,2014/03/31,2011/06/17,34,6,0.696666667,7680,34,2,4
36991,2014/03/31,2012/01/24,568,4,0.925,5784,568,4,0
36992,2014/03/31,2011/05/26,95,3,0.7085233740000001,7551,95,0,3
36993,2014/03/31,2011/11/19,145,10,0.74240494,7206,145,3,7
36994,2014/03/31,2011/07/04,161,5,0.747387173,7157,161,2,3
36995,2014/03/31,2012/07/17,24,7,0.500656121,10684,24,2,5
36996,2014/03/31,2012/03/03,65,9,0.614372846,8706,65,4,5
36997,2014/03/31,2005/07/15,33,7,0.607449177,8805,33,2,5
36998,2014/03/31,2012/10/25,142,5,0.901922428,5930,142,2,3
36999,2014/03/31,2010/07/03,193,4,0.720915341,7418,193,2,2
37000,2014/03/31,2011/12/25,407,3,0.610167751,8763,407,3,0
37001,2014/03/31,2012/07/28,509,8,0.95090715,5622,509,8,0
37002,2014/03/31,2011/08/12,170,4,0.600738285,8899,170,0,4
37003,2014/03/31,2012/06/26,340,8,0.531295965,10062,340,7,1
37004,2014/03/31,2013/03/27,8,7,0.530334425,10077,8,0,7
37005,2014/03/31,2012/04/15,204,5,0.766400402,6973,204,4,1
37006,2014/03/31,2009/01/16,17,6,0.829959621,6439,17,0,6
37007,2014/03/31,2006/04/05,652,5,0.6928173209999999,7713,652,5,0
37008,2014/03/31,2013/01/07,73,9,0.572658879,9331,73,2,7
37009,2014/03/31,2007/05/13,105,6,0.550019559,9714,105,2,4
37010,2014/03/31,2010/07/13,133,4,0.7888011220000001,6773,133,1,3
37011,2014/03/31,2008/11/06,34,6,0.768041978,6956,34,2,4
37012,2014/03/31,2011/07/09,69,5,0.5947862389999999,8982,69,1,4
37013,2014/03/31,2013/02/25,6,8,0.670789804,7964,6,0,8
37014,2014/03/31,2008/12/03,24,2,0.669255826,7982,24,1,1
37015,2014/03/31,2009/08/12,35,10,0.567772109,9408,35,3,7
37016,2014/03/31,2011/12/07,446,8,0.453480771,11779,446,8,0
37017,2014/03/31,2011/12/09,74,5,0.837328735,6379,74,2,3
37018,2014/03/31,2006/01/24,554,3,1.0,5341,554,3,0
37019,2014/03/31,2012/04/11,171,5,0.840040893,6358,171,1,4
37020,2014/03/31,2011/09/29,45,6,0.689496514,7746,45,3,3
37021,2014/03/31,2007/05/20,5,29,0.7769595579999999,6874,5,9,20
37022,2014/03/31,2012/10/09,444,3,0.7666666670000001,6966,444,3,0
37023,2014/03/31,2012/10/06,432,3,0.7666666670000001,6966,432,3,0
37024,2014/03/31,2012/01/31,80,9,0.379490514,14073,80,2,7
37025,2014/03/31,2008/03/15,178,7,0.564179168,9466,178,4,3
37026,2014/03/31,2006/12/27,412,6,0.737115252,7245,412,6,0
37027,2014/03/31,2009/04/18,254,6,0.540567871,9879,254,3,3
37028,2014/03/31,2012/08/02,607,2,1.5,3560,607,2,0
37029,2014/03/31,2010/08/06,43,8,0.670660638,7962,43,5,3
37030,2014/03/31,2009/11/11,162,4,0.79046336,6755,162,0,4
37031,2014/03/31,2012/09/16,548,4,0.7662672220000001,6968,548,4,0
37032,2014/03/31,2012/01/24,40,10,0.848582327,6292,40,5,5
37033,2014/03/31,2011/05/17,276,5,0.702640168,7598,276,3,2
37034,2014/03/31,2007/08/16,166,10,0.6991317440000001,7636,166,7,3
37035,2014/03/31,2010/09/13,14,7,0.484732589,11013,14,0,7
37036,2014/03/31,2006/11/12,337,5,0.824432432,6475,337,4,1
37037,2014/03/31,2012/01/20,165,3,0.856666667,6231,165,1,2
37038,2014/03/31,2005/08/24,11,3,0.856666667,6231,11,0,3
37039,2014/03/31,2006/02/01,161,7,0.42792592,12473,161,5,2
37040,2014/03/31,2008/10/24,45,5,0.6299067629999999,8473,45,2,3
37041,2014/03/31,2009/11/17,91,5,0.655736577,8139,91,3,2
37042,2014/03/31,2008/09/28,262,7,0.526366506,10139,262,3,4
37043,2014/03/31,2007/09/26,98,8,0.46617051,11448,98,3,5
37044,2014/03/31,2010/08/03,417,5,0.633353116,8425,417,5,0
37045,2014/03/31,2008/09/10,617,2,0.4,13340,617,2,0
37046,2014/03/31,2012/12/16,39,7,0.6643276889999999,8032,39,4,3
37047,2014/03/31,2005/09/24,515,6,0.560012594,9528,515,6,0
37048,2014/03/31,2009/02/19,103,7,0.592136278,9011,103,2,5
37049,2014/03/31,2012/07/28,113,7,0.8504144090000001,6274,113,2,5
37050,2014/03/31,2005/08/26,133,6,0.680789843,7837,133,2,4
37051,2014/03/31,2011/09/02,647,4,0.698141848,7642,647,4,0
37052,2014/03/31,2010/04/05,40,6,0.75354096,7080,40,2,4
37053,2014/03/31,2004/12/01,429,4,0.625,8536,429,4,0
37054,2014/03/31,2012/09/07,371,2,1.0,5335,371,2,0
37055,2014/03/31,2011/03/17,48,4,0.815,6546,48,0,4
37056,2014/03/31,2012/10/24,59,7,0.71609396,7450,59,4,3
37057,2014/03/31,2006/07/24,28,8,0.6394330579999999,8343,28,4,4
37058,2014/03/31,2005/05/06,84,8,0.573875861,9296,84,0,8
37059,2014/03/31,2010/11/25,53,4,0.84596099,6306,53,0,4
37060,2014/03/31,2008/04/20,533,6,0.7856606270000001,6789,533,6,0
37061,2014/03/31,2012/05/29,131,4,0.686145632,7773,131,2,2
37062,2014/03/31,2007/03/13,78,10,0.882804171,6041,78,7,3
37063,2014/03/31,2012/01/17,574,3,1.309354284,4073,574,3,0
37064,2014/03/31,2008/03/09,45,10,0.501745554,10627,45,4,6
37065,2014/03/31,2011/09/09,13,6,0.736145244,7243,13,1,5
37066,2014/03/31,2008/11/13,145,8,0.713004814,7478,145,7,1
37067,2014/03/31,2007/12/14,318,4,1.076418332,4953,318,2,2
37068,2014/03/31,2007/02/08,32,7,0.621881488,8573,32,5,2
37069,2014/03/31,2011/08/23,52,12,0.7958157929999999,6699,52,7,5
37070,2014/03/31,2006/07/26,58,7,0.6825915490000001,7810,58,5,2
37071,2014/03/31,2008/06/21,485,5,0.600337838,8880,485,5,0
37072,2014/03/31,2011/11/22,662,4,0.823170167,6476,662,4,0
37073,2014/03/31,2007/01/15,8,6,0.6942693409999999,7678,8,0,6
37074,2014/03/31,2010/03/09,69,3,0.903333333,5901,69,0,3
37075,2014/03/31,2012/08/13,64,6,0.598872037,8901,64,3,3
37076,2014/03/31,2012/08/15,130,8,0.491606566,10843,130,2,6
37077,2014/03/31,2008/11/01,38,10,0.7560808509999999,7050,38,3,7
37078,2014/03/31,2011/04/10,601,4,0.773628447,6890,601,4,0
37079,2014/03/31,2010/10/01,406,6,0.588912827,9051,406,6,0
37080,2014/03/31,2010/05/12,32,3,0.886727666,6011,32,0,3
37081,2014/03/31,2011/07/09,90,4,0.477631508,11159,90,2,2
37082,2014/03/31,2007/01/21,680,3,1.5,3553,680,3,0
37083,2014/03/31,2006/12/09,284,6,0.711540721,7490,284,2,4
37084,2014/03/31,2004/11/04,30,7,0.595919714,8943,30,3,4
37085,2014/03/31,2010/11/05,59,10,0.458110548,11633,59,3,7
37086,2014/03/31,2008/01/11,14,10,0.877945634,6070,14,0,10
37087,2014/03/31,2009/10/03,10,5,0.508,10490,10,2,3
37088,2014/03/31,2012/09/04,337,9,0.6190404279999999,8608,337,8,1
37089,2014/03/31,2007/07/13,49,3,0.63201874,8431,49,0,3
37090,2014/03/31,2007/04/04,7,11,0.422694749,12606,7,4,7
37091,2014/03/31,2005/02/08,120,7,0.703869732,7569,120,5,2
37092,2014/03/31,2011/11/16,315,3,0.605031804,8804,315,2,1
37093,2014/03/31,2011/12/18,12,8,0.6632598679999999,8031,12,4,4
37094,2014/03/31,2012/04/05,69,5,0.825448629,6453,69,1,4
37095,2014/03/31,2009/06/18,485,6,0.838407052,6353,485,6,0
37096,2014/03/31,2006/11/25,107,11,0.501386614,10623,107,10,1
37097,2014/03/31,2011/07/14,23,7,0.507203124,10501,23,1,6
37098,2014/03/31,2009/12/16,166,7,0.7245055090000001,7351,166,5,2
37099,2014/03/31,2008/02/23,46,4,0.6985532529999999,7624,46,0,4
37100,2014/03/31,2009/11/27,9,6,0.581666667,9156,9,0,6
37101,2014/03/31,2011/09/07,73,7,0.332364726,16023,73,4,3
37102,2014/03/31,2011/05/15,91,6,0.661155947,8054,91,4,2
37103,2014/03/31,2006/11/24,69,4,0.861216238,6183,69,2,2
37104,2014/03/31,2012/04/17,47,7,0.773934593,6880,47,3,4
37105,2014/03/31,2007/07/31,440,5,0.890384615,5980,440,5,0
37106,2014/03/31,2009/07/11,208,5,0.948421803,5614,208,3,2
37107,2014/03/31,2009/04/30,175,5,0.74,7195,175,1,4
37108,2014/03/31,2006/12/10,324,5,0.502278517,10599,324,4,1
37109,2014/03/31,2005/04/23,174,8,0.6048392229999999,8801,174,5,3
37110,2014/03/31,2006/07/10,6,6,0.623568416,8536,6,0,6
37111,2014/03/31,2011/09/29,22,8,0.665204349,8001,22,5,3
37112,2014/03/31,2008/06/29,463,5,0.8593896329999999,6193,463,5,0
37113,2014/03/31,2012/07/29,255,4,0.961872402,5533,255,2,2
37114,2014/03/31,2012/10/02,526,4,1.5,3548,526,4,0
37115,2014/03/31,2010/12/13,55,6,0.530485447,10032,55,2,4
37116,2014/03/31,2011/05/01,88,13,0.706923077,7527,88,9,4
37117,2014/03/31,2012/01/14,319,5,1.057543232,5031,319,4,1
37118,2014/03/31,2008/07/22,66,7,0.721206452,7377,66,5,2
37119,2014/03/31,2013/03/10,41,7,0.772701525,6885,41,2,5
37120,2014/03/31,2012/01/05,129,5,0.912807138,5828,129,0,5
37121,2014/03/31,2010/10/01,548,2,1.3885930569999998,3831,548,2,0
37122,2014/03/31,2012/08/24,36,9,0.378191966,14065,36,4,5
37123,2014/03/31,2012/02/21,78,7,0.497586529,10690,78,4,3
37124,2014/03/31,2011/11/01,165,5,0.86969915,6116,165,4,1
37125,2014/03/31,2010/03/12,8,6,0.539490769,9858,8,2,4
37126,2014/03/31,2013/03/12,66,2,0.895,5942,66,0,2
37127,2014/03/31,2013/01/18,131,4,0.5731235179999999,9278,131,0,4
37128,2014/03/31,2012/03/19,35,3,0.889792503,5976,35,2,1
37129,2014/03/31,2008/05/28,69,3,0.763333333,6966,69,0,3
37130,2014/03/31,2010/07/06,76,3,0.668680835,7952,76,1,2
37131,2014/03/31,2011/11/17,210,5,0.463536745,11471,210,4,1
37132,2014/03/31,2006/06/20,154,4,0.7624290220000001,6974,154,2,2
37133,2014/03/31,2011/02/09,49,2,0.725,7334,49,0,2
37134,2014/03/31,2011/09/26,164,5,0.7236354970000001,7347,164,2,3
37135,2014/03/31,2011/05/19,279,7,0.803333837,6617,279,5,2
37136,2014/03/31,2012/07/16,164,5,0.7069344329999999,7519,164,3,2
37137,2014/03/31,2011/09/18,41,2,0.6113837129999999,8694,41,0,2
37138,2014/03/31,2012/08/25,64,10,0.918,5790,64,2,8
37139,2014/03/31,2010/04/19,126,6,0.660019868,8053,126,4,2
37140,2014/03/31,2008/09/14,62,2,0.647393423,8210,62,0,2
37141,2014/03/31,2006/09/01,140,5,0.7609047959999999,6985,140,4,1
37142,2014/03/31,2012/08/14,159,9,0.7175172129999999,7407,159,2,7
37143,2014/03/31,2009/10/15,195,6,0.785715553,6764,195,3,3
37144,2014/03/31,2013/02/22,59,2,0.935,5684,59,1,1
37145,2014/03/31,2012/07/21,460,6,0.542406614,9798,460,6,0
37146,2014/03/31,2008/04/16,70,6,0.48613337,10932,70,0,6
37147,2014/03/31,2012/06/12,578,4,0.632716123,8398,578,4,0
37148,2014/03/31,2011/04/08,162,6,0.43831367,12121,162,4,2
37149,2014/03/31,2012/10/24,23,8,0.627015225,8473,23,4,4
37150,2014/03/31,2013/03/17,63,6,0.68398867,7767,63,0,6
37151,2014/03/31,2008/10/11,430,8,0.740080802,7178,430,8,0
37152,2014/03/31,2005/06/10,710,3,0.7901234570000001,6723,710,3,0
37153,2014/03/31,2011/11/16,94,9,0.77975778,6812,94,6,3
37154,2014/03/31,2010/01/16,32,4,0.854498069,6216,32,1,3
37155,2014/03/31,2005/06/02,10,15,0.448580236,11840,10,10,5
37156,2014/03/31,2009/02/14,28,4,0.675,7868,28,0,4
37157,2014/03/31,2012/02/20,329,6,0.567029682,9366,329,5,1
37158,2014/03/31,2012/10/06,128,9,0.5059255029999999,10497,128,6,3
37159,2014/03/31,2012/08/22,123,9,0.639484586,8304,123,4,5
37160,2014/03/31,2008/02/19,112,4,0.5325,9972,112,0,4
37161,2014/03/31,2011/08/15,33,7,0.729543831,7278,33,5,2
37162,2014/03/31,2009/03/23,585,6,0.7725916759999999,6872,585,6,0
37163,2014/03/31,2012/10/19,189,6,0.905217391,5865,189,5,1
37164,2014/03/31,2010/11/15,120,5,0.810300672,6552,120,1,4
37165,2014/03/31,2008/05/25,60,5,0.6914365720000001,7678,60,2,3
37166,2014/03/31,2010/04/25,161,6,0.8448169959999999,6284,161,4,2
37167,2014/03/31,2012/10/08,71,6,0.566773436,9366,71,3,3
37168,2014/03/31,2010/04/05,525,6,0.621795923,8536,525,6,0
37169,2014/03/31,2013/03/27,195,5,0.777885095,6823,195,2,3
37170,2014/03/31,2012/04/15,176,5,0.710413599,7471,176,1,4
37171,2014/03/31,2007/04/04,244,5,0.515780369,10290,244,3,2
37172,2014/03/31,2012/10/12,4,6,0.706981484,7507,4,4,2
37173,2014/03/31,2007/12/27,143,8,0.3991006170000001,13298,143,4,4
37174,2014/03/31,2010/08/08,1,4,0.72821213,7288,1,2,2
37175,2014/03/31,2005/02/01,33,4,0.782057177,6786,33,1,3
37176,2014/03/31,2012/12/21,202,8,0.470354547,11282,202,1,7
37177,2014/03/31,2011/07/28,228,3,0.762396552,6960,228,2,1
37178,2014/03/31,2009/01/24,159,6,0.531187306,9989,159,3,3
37179,2014/03/31,2011/11/29,139,8,0.82983422,6394,139,4,4
37180,2014/03/31,2009/03/22,72,5,0.901223034,5887,72,1,4
37181,2014/03/31,2009/01/08,223,5,0.848440748,6253,223,3,2
37182,2014/03/31,2012/09/18,202,4,0.7578185709999999,7000,202,1,3
37183,2014/03/31,2011/10/18,613,5,0.530310907,10003,613,5,0
37184,2014/03/31,2012/04/28,36,20,0.484,10960,36,12,8
37185,2014/03/31,2008/01/16,123,10,0.530151924,10005,123,4,6
37186,2014/03/31,2012/09/14,61,6,0.834771797,6354,61,5,1
37187,2014/03/31,2012/10/06,296,7,0.681258831,7785,296,3,4
37188,2014/03/31,2008/10/19,258,5,0.689938858,7687,258,4,1
37189,2014/03/31,2006/03/23,380,3,1.14272786,4641,380,3,0
37190,2014/03/31,2011/03/04,595,5,1.05915718,5007,595,5,0
37191,2014/03/31,2012/11/22,18,7,0.668787993,7929,18,2,5
37192,2014/03/31,2009/06/09,15,7,0.444932036,11918,15,3,4
37193,2014/03/31,2010/11/18,606,2,0.85,6238,606,2,0
37194,2014/03/31,2011/06/24,651,3,0.875367344,6057,651,3,0
37195,2014/03/31,2012/08/15,579,2,1.0,5302,579,2,0
37196,2014/03/31,2011/06/17,624,2,1.0,5302,624,2,0
37197,2014/03/31,2013/01/11,33,9,0.441636818,12005,33,2,7
37198,2014/03/31,2010/06/07,74,5,0.8859291440000001,5984,74,4,1
37199,2014/03/31,2009/10/04,402,4,0.821636702,6452,402,4,0
37200,2014/03/31,2012/02/20,12,6,0.825199253,6424,12,3,3
37201,2014/03/31,2012/08/27,154,4,0.570386312,9293,154,3,1
37202,2014/03/31,2012/08/24,257,6,0.87323888,6070,257,4,2
37203,2014/03/31,2012/06/17,102,4,0.799963779,6626,102,1,3
37204,2014/03/31,2011/11/24,65,5,0.880046488,6023,65,4,1
37205,2014/03/31,2010/06/20,131,7,0.694586555,7631,131,2,5
37206,2014/03/31,2011/06/11,647,4,0.739810162,7164,647,4,0
37207,2014/03/31,2011/11/01,664,3,0.731807512,7242,664,3,0
37208,2014/03/31,2012/03/07,346,6,0.471775127,11233,346,5,1
37209,2014/03/31,2013/01/01,30,6,0.62484141,8481,30,1,5
37210,2014/03/31,2010/12/13,379,5,0.582201714,9102,379,5,0
37211,2014/03/31,2012/02/10,17,6,0.524048066,10111,17,2,4
37212,2014/03/31,2011/05/31,424,3,1.0,5298,424,3,0
37213,2014/03/31,2007/10/15,172,7,0.700924848,7558,172,3,4
37214,2014/03/31,2008/08/07,541,4,0.641266191,8261,541,4,0
37215,2014/03/31,2010/10/21,28,7,0.8842029709999999,5991,28,4,3
37216,2014/03/31,2009/08/28,102,3,0.909862567,5821,102,0,3
37217,2014/03/31,2009/06/06,437,4,0.669629536,7909,437,4,0
37218,2014/03/31,2005/06/24,27,7,0.7561493429999999,7004,27,4,3
37219,2014/03/31,2013/01/18,285,7,0.8417930379999999,6291,285,2,5
37220,2014/03/31,2009/09/16,35,7,0.7907870370000001,6696,35,1,6
37221,2014/03/31,2012/07/18,301,7,0.500953733,10569,301,3,4
37222,2014/03/31,2011/12/29,51,6,0.449971953,11766,51,0,6
37223,2014/03/31,2010/04/07,36,7,0.374062036,14153,36,3,4
37224,2014/03/31,2012/06/16,81,7,0.610042637,8678,81,2,5
37225,2014/03/31,2007/07/13,452,5,0.603981746,8765,452,5,0
37226,2014/03/31,2010/10/25,526,4,0.586093888,9032,526,4,0
37227,2014/03/31,2012/07/26,261,2,1.455,3638,261,1,1
37228,2014/03/31,2007/06/30,5,4,0.632482973,8369,5,2,2
37229,2014/03/31,2010/04/22,563,4,0.66547649,7954,563,4,0
37230,2014/03/31,2012/11/26,149,4,0.840675032,6296,149,3,1
37231,2014/03/31,2011/09/30,334,4,0.6444836820000001,8212,334,3,1
37232,2014/03/31,2008/10/22,142,6,0.6034606610000001,8770,142,0,6
37233,2014/03/31,2007/07/15,37,6,0.58303658,9076,37,1,5
37234,2014/03/31,2011/10/06,269,11,0.411309755,12865,269,7,4
37235,2014/03/31,2009/11/14,303,7,0.5737233,9223,303,6,1
37236,2014/03/31,2012/08/02,66,6,0.653104172,8102,66,3,3
37237,2014/03/31,2011/11/16,151,5,0.6338560129999999,8348,151,2,3
37238,2014/03/31,2011/07/23,59,4,0.861481602,6142,59,1,3
37239,2014/03/31,2011/09/23,26,8,0.6934390559999999,7630,26,2,6
37240,2014/03/31,2007/04/27,54,5,0.787558797,6718,54,1,4
37241,2014/03/31,2012/03/31,263,5,0.591808725,8940,263,3,2
37242,2014/03/31,2006/06/09,83,6,0.557849009,9484,83,3,3
37243,2014/03/31,2006/03/21,30,8,0.777794766,6802,30,3,5
37244,2014/03/31,2012/07/27,176,5,0.599619177,8823,176,1,4
37245,2014/03/31,2006/12/01,135,6,0.772867787,6845,135,5,1
37246,2014/03/31,2006/08/18,280,4,0.7662485520000001,6904,280,3,1
37247,2014/03/31,2012/11/22,1,6,0.6951590009999999,7610,1,2,4
37248,2014/03/31,2005/08/09,223,6,0.887901981,5958,223,2,4
37249,2014/03/31,2011/07/28,431,3,1.270413064,4164,431,3,0
37250,2014/03/31,2009/07/02,25,10,0.5014674379999999,10549,25,0,10
37251,2014/03/31,2011/06/23,526,5,0.5157127539999999,10256,526,5,0
37252,2014/03/31,2012/05/04,403,4,0.5516374629999999,9588,403,4,0
37253,2014/03/31,2012/12/25,49,4,0.414374804,12764,49,1,3
37254,2014/03/31,2008/04/14,470,4,0.782743821,6757,470,4,0
37255,2014/03/31,2012/11/16,222,5,0.6739785909999999,7847,222,1,4
37256,2014/03/31,2011/07/09,8,5,0.593695555,8908,8,0,5
37257,2014/03/31,2012/12/10,66,5,0.8589475390000001,6157,66,1,4
37258,2014/03/31,2013/01/22,8,4,0.877329131,6028,8,3,1
37259,2014/03/31,2011/07/16,2,10,0.794,6660,2,4,6
37260,2014/03/31,2012/01/20,96,6,0.719806698,7346,96,3,3
37261,2014/03/31,2011/05/24,395,6,0.5673516470000001,9319,395,6,0
37262,2014/03/31,2010/08/13,22,6,0.590329388,8956,22,1,5
37263,2014/03/31,2011/10/24,374,5,0.729810878,7244,374,5,0
37264,2014/03/31,2007/10/30,126,6,0.826113455,6399,126,4,2
37265,2014/03/31,2012/08/26,52,3,0.62,8526,52,1,2
37266,2014/03/31,2006/08/07,113,2,0.93,5684,113,0,2
37267,2014/03/31,2006/02/23,94,11,0.605396862,8731,94,9,2
37268,2014/03/31,2011/08/07,373,10,0.889772727,5940,373,10,0
37269,2014/03/31,2007/06/05,254,4,0.560686618,9423,254,2,2
37270,2014/03/31,2005/07/31,112,3,0.8503621440000001,6213,112,2,1
37271,2014/03/31,2004/11/30,78,5,0.852680762,6196,78,1,4
37272,2014/03/31,2012/07/10,361,6,0.7988507490000001,6613,361,4,2
37273,2014/03/31,2012/04/01,526,4,0.469072989,11262,526,4,0
37274,2014/03/31,2007/11/20,558,6,0.876755187,6025,558,6,0
37275,2014/03/31,2013/02/27,394,3,0.764539007,6909,394,3,0
37276,2014/03/31,2012/08/29,432,5,1.0,5282,432,5,0
37277,2014/03/31,2009/07/07,160,7,0.454439473,11623,160,2,5
37278,2014/03/31,2011/01/19,203,6,0.534260571,9886,203,5,1
37279,2014/03/31,2009/09/03,37,7,0.772141813,6840,37,1,6
37280,2014/03/31,2008/09/25,470,2,0.951188761,5552,470,2,0
37281,2014/03/31,2011/07/08,331,4,0.7191474870000001,7343,331,2,2
37282,2014/03/31,2013/02/24,48,4,0.85,6212,48,1,3
37283,2014/03/31,2008/04/20,154,9,0.7655162409999999,6896,154,5,4
37284,2014/03/31,2012/12/04,294,3,0.632133876,8351,294,1,2
37285,2014/03/31,2011/07/02,190,3,0.63,8379,190,1,2
37286,2014/03/31,2013/03/25,10,3,0.63,8379,10,0,3
37287,2014/03/31,2008/07/02,274,8,0.428733756,12312,274,4,4
37288,2014/03/31,2007/11/15,68,5,0.85391037,6181,68,1,4
37289,2014/03/31,2008/02/24,31,7,0.515859642,10231,31,2,5
37290,2014/03/31,2009/12/14,509,4,0.774992658,6810,509,4,0
37291,2014/03/31,2006/10/22,197,6,0.902522661,5847,197,4,2
37292,2014/03/31,2005/04/12,114,7,0.480768039,10976,114,4,3
37293,2014/03/31,2012/10/31,291,5,0.6130777270000001,8607,291,1,4
37294,2014/03/31,2010/09/21,266,3,0.8896138929999999,5931,266,2,1
37295,2014/03/31,2012/10/17,2,6,0.81762746,6453,2,2,4
37296,2014/03/31,2007/08/12,2,3,0.7684241190000001,6866,2,1,2
37297,2014/03/31,2007/08/25,102,4,0.8992653829999999,5867,102,2,2
37298,2014/03/31,2012/09/02,7,9,0.636717355,8286,7,2,7
37299,2014/03/31,2012/07/05,49,9,0.692959412,7613,49,4,5
37300,2014/03/31,2009/10/17,94,6,0.735739191,7170,94,2,4
37301,2014/03/31,2008/06/30,377,3,0.8,6594,377,3,0
37302,2014/03/31,2012/06/13,386,7,0.530694165,9940,386,7,0
37303,2014/03/31,2012/08/20,550,3,0.966666667,5457,550,3,0
37304,2014/03/31,2005/10/10,453,6,0.500517225,10537,453,6,0
37305,2014/03/31,2009/09/27,222,9,0.601537584,8767,222,5,4
37306,2014/03/31,2012/10/26,216,7,0.555817875,9488,216,2,5
37307,2014/03/31,2012/12/18,61,7,0.834166403,6322,61,3,4
37308,2014/03/31,2013/02/09,88,5,0.5636878670000001,9355,88,2,3
37309,2014/03/31,2007/12/29,146,7,0.419682426,12564,146,4,3
37310,2014/03/31,2010/12/14,86,7,0.421566323,12507,86,5,2
37311,2014/03/31,2006/03/30,79,3,1.010044061,5220,79,0,3
37312,2014/03/31,2012/07/26,143,9,0.6529027860000001,8075,143,2,7
37313,2014/03/31,2011/09/07,17,4,0.67,7868,17,1,3
37314,2014/03/31,2013/01/15,24,4,0.67,7868,24,0,4
37315,2014/03/31,2007/12/29,109,6,0.566384442,9307,109,1,5
37316,2014/03/31,2010/11/29,11,5,0.8059999999999999,6540,11,0,5
37317,2014/03/31,2011/02/16,265,4,0.817478288,6448,265,1,3
37318,2014/03/31,2007/05/17,84,7,0.681176014,7738,84,3,4
37319,2014/03/31,2009/07/28,356,8,0.760343335,6932,356,7,1
37320,2014/03/31,2010/11/17,319,4,0.675,7808,319,0,4
37321,2014/03/31,2010/03/11,232,3,1.38252361,3812,232,1,2
37322,2014/03/31,2010/11/01,124,9,0.49,10755,124,5,4
37323,2014/03/31,2013/02/11,24,5,0.547319277,9628,24,0,5
37324,2014/03/31,2012/08/24,275,6,0.558306845,9438,275,5,1
37325,2014/03/31,2010/10/30,348,6,0.614890886,8569,348,4,2
37326,2014/03/31,2011/12/05,37,6,0.965,5460,37,3,3
37327,2014/03/31,2011/04/02,391,10,0.91,5790,391,10,0
37328,2014/03/31,2011/11/10,35,7,0.5139859529999999,10251,35,1,6
37329,2014/03/31,2012/08/25,458,5,0.715543936,7363,458,5,0
37330,2014/03/31,2011/04/30,4,7,0.955134155,5516,4,6,1
37331,2014/03/31,2010/04/06,413,6,0.853401912,6173,413,6,0
37332,2014/03/31,2008/05/05,452,3,0.74040759,7115,452,3,0
37333,2014/03/31,2009/10/29,199,4,0.731032473,7206,199,2,2
37334,2014/03/31,2008/04/11,579,5,0.848413593,6209,579,5,0
37335,2014/03/31,2011/04/08,210,5,0.7691822429999999,6848,210,4,1
37336,2014/03/31,2012/05/29,5,4,0.723884002,7276,5,0,4
37337,2014/03/31,2011/10/20,21,6,0.584417443,9012,21,3,3
37338,2014/03/31,2007/11/24,216,5,0.682708063,7714,216,4,1
37339,2014/03/31,2011/12/06,335,8,0.6984217509999999,7540,335,7,1
37340,2014/03/31,2009/06/23,491,8,0.8510748340000001,6187,491,8,0
37341,2014/03/31,2011/11/07,34,5,0.929302859,5666,34,4,1
37342,2014/03/31,2012/03/21,116,6,0.718830034,7325,116,0,6
37343,2014/03/31,2010/12/17,614,5,0.761865143,6911,614,5,0
37344,2014/03/31,2011/10/24,22,8,0.6033253120000001,8727,22,1,7
37345,2014/03/31,2011/07/28,198,7,0.737697912,7137,198,6,1
37346,2014/03/31,2010/06/08,59,4,0.8075,6520,59,0,4
37347,2014/03/31,2013/03/01,8,2,0.815,6460,8,1,1
37348,2014/03/31,2010/06/30,381,6,0.575,9156,381,6,0
37349,2014/03/31,2012/07/17,203,15,0.7480065359999999,7038,203,11,4
37350,2014/03/31,2010/11/19,176,4,0.65484513,8039,176,3,1
37351,2014/03/31,2010/03/03,233,7,0.663336694,7936,233,6,1
37352,2014/03/31,2011/12/15,123,6,0.56134158,9377,123,3,3
37353,2014/03/31,2011/11/07,131,3,0.6159134,8545,131,0,3
37354,2014/03/31,2011/11/05,159,4,0.909093108,5789,159,2,2
37355,2014/03/31,2012/08/21,52,7,0.384755429,13677,52,3,4
37356,2014/03/31,2011/04/26,166,7,0.698557016,7533,166,6,1
37357,2014/03/31,2012/03/26,244,3,0.678028605,7761,244,1,2
37358,2014/03/31,2012/08/21,282,8,0.564020795,9329,282,5,3
37359,2014/03/31,2013/02/10,74,6,0.623068451,8444,74,2,4
37360,2014/03/31,2009/08/12,662,4,0.740436312,7105,662,4,0
37361,2014/03/31,2011/01/20,385,5,0.933209154,5637,385,5,0
37362,2014/03/31,2005/12/05,379,6,0.900154004,5844,379,6,0
37363,2014/03/31,2012/11/23,220,5,0.633464595,8304,220,0,5
37364,2014/03/31,2012/09/16,109,4,0.867688882,6062,109,2,2
37365,2014/03/31,2007/07/01,131,5,0.6986226590000001,7529,131,0,5
37366,2014/03/31,2010/03/27,203,7,0.589054765,8929,203,3,4
37367,2014/03/31,2012/03/19,162,9,0.502059947,10476,162,3,6
37368,2014/03/31,2012/04/28,87,11,0.89286927,5890,87,5,6
37369,2014/03/31,2012/08/14,64,10,0.5128191129999999,10255,64,1,9
37370,2014/03/31,2012/10/09,293,6,0.67,7848,293,4,2
37371,2014/03/31,2012/12/27,166,4,0.555,9472,166,3,1
37372,2014/03/31,2012/04/30,25,3,0.593803231,8853,25,2,1
37373,2014/03/31,2008/11/15,340,8,0.558531662,9412,340,7,1
37374,2014/03/31,2012/04/01,61,4,0.817797138,6428,61,0,4
37375,2014/03/31,2007/07/11,55,5,0.8118548259999999,6475,55,0,5
37376,2014/03/31,2012/12/13,424,4,0.75,7009,424,4,0
37377,2014/03/31,2006/01/04,51,3,1.033318262,5087,51,0,3
37378,2014/03/31,2011/08/01,37,10,0.382,13760,37,1,9
37379,2014/03/31,2012/10/30,407,5,0.6437959329999999,8164,407,5,0
37380,2014/03/31,2012/10/25,26,7,0.663913593,7916,26,5,2
37381,2014/03/31,2011/01/30,425,8,0.637059037,8249,425,8,0
37382,2014/03/31,2009/07/06,46,7,0.774725048,6783,46,2,5
37383,2014/03/31,2012/08/14,32,5,0.61449655,8551,32,4,1
37384,2014/03/31,2006/05/15,107,3,0.961973636,5462,107,2,1
37385,2014/03/31,2009/06/16,545,5,0.687302107,7643,545,5,0
37386,2014/03/31,2012/11/21,138,6,0.6480690929999999,8105,138,2,4
37387,2014/03/31,2013/03/25,236,3,0.481514763,10906,236,1,2
37388,2014/03/31,2007/09/29,284,3,0.65,8079,284,0,3
37389,2014/03/31,2006/05/28,110,5,0.595158109,8823,110,4,1
37390,2014/03/31,2012/06/17,223,7,0.5381235910000001,9758,223,3,4
37391,2014/03/31,2005/02/25,604,4,0.919936931,5708,604,4,0
37392,2014/03/31,2008/11/19,22,6,0.668220921,7858,22,3,3
37393,2014/03/31,2012/09/10,262,8,0.78622342,6678,262,0,8
37394,2014/03/31,2011/05/31,31,4,0.529846589,9908,31,1,3
37395,2014/03/31,2006/06/07,136,6,0.681161282,7707,136,4,2
37396,2014/03/31,2013/01/20,27,4,0.615,8536,27,2,2
37397,2014/03/31,2005/01/04,230,4,0.615,8536,230,0,4
37398,2014/03/31,2012/08/08,207,5,0.952553076,5511,207,3,2
37399,2014/03/31,2007/04/08,257,6,0.780093625,6729,257,2,4
37400,2014/03/31,2012/01/02,10,11,0.739732244,7096,10,2,9
37401,2014/03/31,2009/10/21,25,5,0.6810808359999999,7707,25,4,1
37402,2014/03/31,2011/02/21,293,4,0.705430108,7440,293,0,4
37403,2014/03/31,2010/02/02,152,8,0.813271347,6453,152,5,3
37404,2014/03/31,2012/08/24,231,6,0.5130817360000001,10228,231,5,1
37405,2014/03/31,2012/06/11,98,5,0.755566595,6945,98,2,3
37406,2014/03/31,2012/09/09,14,8,0.758751988,6915,14,2,6
37407,2014/03/31,2012/09/27,284,5,0.549624974,9546,284,3,2
37408,2014/03/31,2005/10/01,39,4,1.41,3721,39,0,4
37409,2014/03/31,2011/04/06,418,10,0.834781225,6285,418,10,0
37410,2014/03/31,2006/03/20,183,7,0.679062783,7725,183,2,5
37411,2014/03/31,2010/12/13,5,5,0.707619048,7413,5,1,4
37412,2014/03/31,2013/03/08,156,7,0.86758518,6046,156,0,7
37413,2014/03/31,2011/01/07,359,6,0.6001373000000001,8740,359,5,1
37414,2014/03/31,2007/01/11,187,13,0.500018112,10490,187,9,4
37415,2014/03/31,2012/12/31,324,5,0.5,10490,324,4,1
37416,2014/03/31,2013/03/12,4,6,0.531390071,9870,4,1,5
37417,2014/03/31,2012/01/18,271,10,0.988048229,5308,271,6,4
37418,2014/03/31,2012/02/03,227,6,0.6903027509999999,7597,227,3,3
37419,2014/03/31,2011/12/28,325,3,0.848899142,6177,325,1,2
37420,2014/03/31,2007/02/15,489,4,0.8162515570000001,6424,489,4,0
37421,2014/03/31,2012/01/22,301,5,0.633591107,8276,301,2,3
37422,2014/03/31,2006/11/15,80,7,0.881851665,5946,80,3,4
37423,2014/03/31,2009/11/07,74,6,0.5666573,9253,74,2,4
37424,2014/03/31,2012/12/31,59,5,0.519694717,10089,59,1,4
37425,2014/03/31,2010/09/25,246,5,0.634,8270,246,4,1
37426,2014/03/31,2012/09/18,75,8,0.811510602,6461,75,3,5
37427,2014/03/31,2013/02/20,395,3,0.67494207,7768,395,3,0
37428,2014/03/31,2011/08/18,146,5,0.635898836,8244,146,3,2
37429,2014/03/31,2011/12/29,55,3,1.026666667,5106,55,2,1
37430,2014/03/31,2009/01/20,11,3,0.857905074,6110,11,0,3
37431,2014/03/31,2007/08/03,225,6,0.58228308,9001,225,2,4
37432,2014/03/31,2011/08/19,431,3,1.312546957,3993,431,3,0
37433,2014/03/31,2012/08/23,115,6,0.841728514,6225,115,3,3
37434,2014/03/31,2011/01/19,61,5,0.8324785509999999,6294,61,3,2
37435,2014/03/31,2012/08/27,16,8,0.627180991,8354,16,3,5
37436,2014/03/31,2009/04/29,12,6,0.645400345,8118,12,1,5
37437,2014/03/31,2012/01/20,132,9,0.480748761,10898,132,3,6
37438,2014/03/31,2011/09/07,48,5,0.785837708,6667,48,1,4
37439,2014/03/31,2004/12/15,387,6,0.656219466,7983,387,6,0
37440,2014/03/31,2013/01/04,28,5,0.516066397,10151,28,2,3
37441,2014/03/31,2011/12/21,290,5,0.56874362,9209,290,3,2
37442,2014/03/31,2012/05/31,80,5,0.963833272,5434,80,3,2
37443,2014/03/31,2011/08/24,525,4,0.8649710979999999,6055,525,4,0
37444,2014/03/31,2006/06/16,49,6,0.776351912,6746,49,3,3
37445,2014/03/31,2011/02/01,270,5,0.5690935770000001,9201,270,3,2
37446,2014/03/31,2011/03/23,85,7,0.7851267059999999,6669,85,0,7
37447,2014/03/31,2012/10/12,13,6,0.6233333329999999,8400,13,2,4
37448,2014/03/31,2011/04/18,99,8,0.65873663,7947,99,6,2
37449,2014/03/31,2006/10/28,48,9,0.590917711,8859,48,4,5
37450,2014/03/31,2008/01/10,109,3,0.84,6231,109,1,2
37451,2014/03/31,2011/09/20,120,9,0.744731076,7028,120,3,6
37452,2014/03/31,2012/12/08,3,4,0.64735436,8085,3,0,4
37453,2014/03/31,2008/08/17,226,4,0.8658014890000001,6045,226,2,2
37454,2014/03/31,2012/11/27,49,5,0.887796438,5895,49,0,5
37455,2014/03/31,2012/04/19,46,5,0.564442407,9272,46,4,1
37456,2014/03/31,2006/11/22,295,6,0.599207694,8734,295,3,3
37457,2014/03/31,2012/10/09,173,4,0.6817743620000001,7676,173,1,3
37458,2014/03/31,2012/10/18,36,5,0.561017367,9328,36,0,5
37459,2014/03/31,2013/03/02,13,5,0.7279371259999999,7189,13,0,5
37460,2014/03/31,2010/10/29,281,5,0.6144311379999999,8517,281,4,1
37461,2014/03/31,2012/08/03,404,3,0.819336152,6387,404,3,0
37462,2014/03/31,2008/04/06,560,8,0.60416811,8661,560,8,0
37463,2014/03/31,2012/09/24,105,4,0.6086831079999999,8596,105,1,3
37464,2014/03/31,2013/01/27,5,7,0.871597535,6003,5,5,2
37465,2014/03/31,2012/10/17,522,4,1.0,5232,522,4,0
37466,2014/03/31,2008/03/10,257,5,0.7781082690000001,6724,257,2,3
37467,2014/03/31,2010/04/30,111,8,0.670934975,7797,111,4,4
37468,2014/03/31,2007/12/06,40,5,0.930483814,5622,40,2,3
37469,2014/03/31,2010/07/13,222,4,0.809395018,6463,222,1,3
37470,2014/03/31,2012/04/27,442,3,0.8822482709999999,5929,442,3,0
37471,2014/03/31,2012/12/11,80,6,0.71361528,7330,80,0,6
37472,2014/03/31,2006/04/22,164,3,0.970794358,5388,164,2,1
37473,2014/03/31,2010/07/15,354,7,1.0,5230,354,5,2
37474,2014/03/31,2012/10/20,80,5,0.544877058,9598,80,3,2
37475,2014/03/31,2007/02/20,25,6,0.680903646,7680,25,5,1
37476,2014/03/31,2011/03/22,41,8,0.70628309,7404,41,4,4
37477,2014/03/31,2010/03/31,109,2,0.92,5684,109,0,2
37478,2014/03/31,2011/12/11,197,2,0.92,5684,197,0,2
37479,2014/03/31,2011/04/12,186,6,0.625897774,8354,186,5,1
37480,2014/03/31,2009/02/07,206,7,0.680057232,7688,206,0,7
37481,2014/03/31,2012/06/29,108,7,0.7738454709999999,6756,108,3,4
37482,2014/03/31,2008/02/07,4,12,0.401843966,13010,4,8,4
37483,2014/03/31,2011/01/03,356,7,0.649062578,8054,356,6,1
37484,2014/03/31,2006/09/25,570,3,1.153165674,4533,570,3,0
37485,2014/03/31,2012/05/25,26,7,0.6769783709999999,7721,26,1,6
37486,2014/03/31,2008/11/01,1,10,0.69643038,7505,1,2,8
37487,2014/03/31,2007/06/25,31,6,0.688615283,7590,31,4,2
37488,2014/03/31,2007/02/01,76,2,1.08402821,4821,76,1,1
37489,2014/03/31,2008/08/01,352,5,0.8260512170000001,6326,352,4,1
37490,2014/03/31,2011/06/14,108,7,0.51986668,10051,108,1,6
37491,2014/03/31,2012/01/22,411,4,0.735369458,7105,411,4,0
37492,2014/03/31,2011/06/08,382,7,0.8,6531,382,7,0
37493,2014/03/31,2010/02/07,235,6,0.7090147920000001,7369,235,3,3
37494,2014/03/31,2012/05/11,94,8,0.495042638,10554,94,6,2
37495,2014/03/31,2010/03/24,10,8,0.5290026329999999,9876,10,2,6
37496,2014/03/31,2008/02/20,7,4,0.686758249,7607,7,1,3
37497,2014/03/31,2013/03/11,176,5,0.498,10490,176,1,4
37498,2014/03/31,2011/04/17,83,7,0.6581768929999999,7937,83,3,4
37499,2014/03/31,2009/01/05,84,9,0.7269798190000001,7185,84,5,4
37500,2014/03/31,2009/12/22,131,8,0.806908698,6473,131,3,5
37501,2014/03/31,2006/11/01,56,5,0.643307058,8119,56,0,5
37502,2014/03/31,2009/11/12,19,3,0.691772185,7550,19,0,3
37503,2014/03/31,2013/02/07,194,5,0.4476992970000001,11666,194,1,4
37504,2014/03/31,2008/11/07,50,4,0.8560252420000001,6101,50,0,4
37505,2014/03/31,2007/08/16,219,8,0.619084874,8436,219,2,6
37506,2014/03/31,2012/06/10,100,7,0.7205408390000001,7248,100,0,7
37507,2014/03/31,2005/09/23,107,3,0.7025184990000001,7433,107,0,3
37508,2014/03/31,2010/08/30,23,6,0.582086957,8970,23,3,3
37509,2014/03/31,2009/07/05,526,4,0.5362777320000001,9736,526,4,0
37510,2014/03/31,2007/10/18,160,3,0.777177731,6718,160,0,3
37511,2014/03/31,2008/04/08,553,9,0.607293242,8597,553,9,0
37512,2014/03/31,2010/11/18,68,6,0.829612268,6293,68,2,4
37513,2014/03/31,2010/10/26,558,4,0.8769863929999999,5953,558,4,0
37514,2014/03/31,2012/08/24,45,5,0.574,9095,45,2,3
37515,2014/03/31,2010/10/07,218,6,0.6971006940000001,7488,218,2,4
37516,2014/03/31,2007/10/05,18,5,0.7251292029999999,7198,18,1,4
37517,2014/03/31,2012/11/24,354,5,0.770171167,6777,354,3,2
37518,2014/03/31,2008/04/09,364,5,0.6100935129999999,8555,364,4,1
37519,2014/03/31,2007/11/15,197,6,0.641898905,8131,197,5,1
37520,2014/03/31,2008/06/01,307,8,0.626554622,8330,307,7,1
37521,2014/03/31,2006/03/24,378,10,0.831291813,6278,378,10,0
37522,2014/03/31,2012/01/13,16,6,0.581103563,8980,16,4,2
37523,2014/03/31,2010/12/24,26,9,0.893333333,5841,26,2,7
37524,2014/03/31,2012/08/09,15,9,0.6795051440000001,7679,15,5,4
37525,2014/03/31,2008/05/22,542,2,0.8,6522,542,2,0
37526,2014/03/31,2007/06/28,136,9,0.484971184,10758,136,3,6
37527,2014/03/31,2010/07/07,414,5,0.894598765,5832,414,5,0
37528,2014/03/31,2012/09/03,95,8,0.5995334410000001,8702,95,0,8
37529,2014/03/31,2010/10/24,343,4,0.972376514,5365,343,3,1
37530,2014/03/31,2012/04/01,235,6,0.723333333,7212,235,2,4
37531,2014/03/31,2012/10/01,358,4,0.645858611,8077,358,2,2
37532,2014/03/31,2007/07/08,274,5,0.7042527340000001,7407,274,1,4
37533,2014/03/31,2009/08/01,58,4,1.056998987,4935,58,0,4
37534,2014/03/31,2010/12/27,73,3,0.815528455,6396,73,0,3
37535,2014/03/31,2011/04/02,205,3,0.853633388,6110,205,1,2
37536,2014/03/31,2011/10/12,78,6,0.509438367,10238,78,1,5
37537,2014/03/31,2012/07/19,256,4,0.777265276,6710,256,3,1
37538,2014/03/31,2012/04/29,692,4,0.7589202559999999,6872,692,4,0
37539,2014/03/31,2009/02/25,130,7,0.727054231,7173,130,2,5
37540,2014/03/31,2011/03/06,134,8,0.8931152590000001,5839,134,7,1
37541,2014/03/31,2007/07/09,16,7,0.61440674,8487,16,1,6
37542,2014/03/31,2007/08/23,86,3,0.977906977,5332,86,2,1
37543,2014/03/31,2006/11/12,84,5,0.486282063,10721,84,1,4
37544,2014/03/31,2005/12/03,135,8,0.555261476,9389,135,3,5
37545,2014/03/31,2012/02/11,264,8,0.853170213,6110,264,6,2
37546,2014/03/31,2012/08/20,119,2,0.615,8476,119,1,1
37547,2014/03/31,2011/08/21,393,5,0.611532145,8524,393,5,0
37548,2014/03/31,2007/04/23,25,6,0.952335526,5472,25,3,3
37549,2014/03/31,2010/03/10,11,7,0.728594799,7152,11,3,4
37550,2014/03/31,2010/05/26,130,7,0.6964127240000001,7482,130,3,4
37551,2014/03/31,2011/08/17,18,6,0.586415307,8885,18,4,2
37552,2014/03/31,2008/02/24,37,6,0.611521127,8520,37,3,3
37553,2014/03/31,2008/05/07,499,8,0.749338415,6953,499,8,0
37554,2014/03/31,2007/02/27,448,4,0.7296778709999999,7140,448,4,0
37555,2014/03/31,2012/03/15,524,3,0.650012477,8015,524,3,0
37556,2014/03/31,2011/02/22,159,13,0.66030545,7890,159,8,5
37557,2014/03/31,2010/06/17,105,5,0.983134554,5299,105,2,3
37558,2014/03/31,2007/04/28,551,4,0.676220145,7704,551,4,0
37559,2014/03/31,2010/02/10,189,7,0.724539638,7190,189,4,3
37560,2014/03/31,2008/10/28,109,6,0.8257077190000001,6309,109,5,1
37561,2014/03/31,2011/08/04,41,9,0.688692491,7564,41,4,5
37562,2014/03/31,2011/04/23,625,3,0.904069767,5762,625,3,0
37563,2014/03/31,2013/02/26,218,3,0.74,7038,218,1,2
37564,2014/03/31,2012/09/25,333,7,0.81630094,6380,333,5,2
37565,2014/03/31,2012/11/03,425,4,1.0,5208,425,4,0
37566,2014/03/31,2010/08/24,510,3,0.666666667,7812,510,3,0
37567,2014/03/31,2008/04/23,35,4,0.8162147340000001,6380,35,2,2
37568,2014/03/31,2007/07/12,22,7,0.725947302,7173,22,2,5
37569,2014/03/31,2012/03/09,355,7,0.607012942,8577,355,6,1
37570,2014/03/31,2012/09/20,197,5,0.66338685,7848,197,4,1
37571,2014/03/31,2006/06/22,69,6,0.946397019,5501,69,0,6
37572,2014/03/31,2012/07/10,145,5,0.69118428,7532,145,0,5
37573,2014/03/31,2007/11/24,430,7,0.652337093,7980,430,7,0
37574,2014/03/31,2006/01/28,65,9,0.478751954,10873,65,7,2
37575,2014/03/31,2010/11/13,365,6,0.6722717290000001,7743,365,5,1
37576,2014/03/31,2012/03/20,368,8,0.89375,5824,368,8,0
37577,2014/03/31,2011/10/14,14,10,0.859151535,6058,14,5,5
37578,2014/03/31,2012/05/24,115,7,0.654344984,7954,115,4,3
37579,2014/03/31,2007/12/18,89,8,0.636642202,8175,89,3,5
37580,2014/03/31,2010/12/20,14,8,0.76593819,6795,14,3,5
37581,2014/03/31,2012/11/20,28,6,0.5523241010000001,9423,28,0,6
37582,2014/03/31,2011/01/14,174,9,0.639275273,8141,174,3,6
37583,2014/03/31,2010/05/02,245,5,0.859062397,6058,245,4,1
37584,2014/03/31,2010/05/22,421,9,0.940046965,5536,421,9,0
37585,2014/03/31,2011/11/25,231,10,0.688539296,7558,231,9,1
37586,2014/03/31,2011/10/25,10,6,0.6925578920000001,7514,10,2,4
37587,2014/03/31,2011/01/02,67,4,0.538357128,9666,67,3,1
37588,2014/03/31,2006/03/13,40,4,0.530962343,9799,40,2,2
37589,2014/03/31,2011/07/25,125,7,0.75211797,6917,125,6,1
37590,2014/03/31,2010/09/15,71,4,0.662701911,7850,71,2,2
37591,2014/03/31,2012/08/22,202,4,0.85,6120,202,0,4
37592,2014/03/31,2009/11/07,654,6,1.0,5202,654,6,0
37593,2014/03/31,2012/04/05,5,9,0.78,6669,5,0,9
37594,2014/03/31,2012/04/12,155,6,0.7649411759999999,6800,155,4,2
37595,2014/03/31,2012/12/14,311,4,0.8,6502,311,2,2
37596,2014/03/31,2013/01/27,96,5,0.954653084,5448,96,1,4
37597,2014/03/31,2012/05/29,21,15,0.438091146,11871,21,7,8
37598,2014/03/31,2006/11/15,80,4,0.7429,7000,80,1,3
37599,2014/03/31,2012/12/19,80,6,0.758717537,6854,80,2,4
37600,2014/03/31,2012/02/03,48,7,0.8336165440000001,6238,48,3,4
37601,2014/03/31,2010/08/02,68,3,0.528455285,9840,68,2,1
37602,2014/03/31,2011/09/07,549,3,0.85,6117,549,3,0
37603,2014/03/31,2012/06/11,106,3,1.046244717,4969,106,0,3
37604,2014/03/31,2006/03/24,4,9,0.552222222,9414,4,2,7
37605,2014/03/31,2008/06/11,222,4,0.632734907,8216,222,3,1
37606,2014/03/31,2005/04/04,165,5,0.742523925,7001,165,2,3
37607,2014/03/31,2012/12/21,6,7,0.6289534179999999,8265,6,0,7
37608,2014/03/31,2012/06/26,112,6,0.796872605,6523,112,3,3
37609,2014/03/31,2013/03/12,18,7,0.647552012,8027,18,1,6
37610,2014/03/31,2009/06/26,13,7,0.7869371690000001,6605,13,4,3
37611,2014/03/31,2010/11/07,341,7,0.49648486,10469,341,6,1
37612,2014/03/31,2006/10/15,380,5,0.485702271,10701,380,5,0
37613,2014/03/31,2010/05/12,144,6,0.819539505,6341,144,4,2
37614,2014/03/31,2012/07/13,286,5,0.8636851729999999,6016,286,3,2
37615,2014/03/31,2013/01/29,16,7,0.58579434,8869,16,1,6
37616,2014/03/31,2010/11/25,12,6,0.654199723,7941,12,0,6
37617,2014/03/31,2010/10/07,437,6,0.73085256,7108,437,6,0
37618,2014/03/31,2011/11/03,320,4,0.893634956,5813,320,2,2
37619,2014/03/31,2012/02/07,574,6,0.5745023220000001,9042,574,6,0
37620,2014/03/31,2007/10/19,362,6,0.812910798,6390,362,5,1
37621,2014/03/31,2009/09/28,135,7,0.70402277,7378,135,1,6
37622,2014/03/31,2008/10/27,120,5,0.741769494,7002,120,3,2
37623,2014/03/31,2012/10/08,87,9,0.465975774,11145,87,3,6
37624,2014/03/31,2012/03/20,76,7,0.6055457089999999,8576,76,6,1
37625,2014/03/31,2005/07/08,178,3,0.611732831,8489,178,1,2
37626,2014/03/31,2009/04/14,192,9,0.611431767,8493,192,2,7
37627,2014/03/31,2009/04/09,292,4,0.66,7868,292,2,2
37628,2014/03/31,2012/10/21,1,8,0.489418473,10610,1,2,6
37629,2014/03/31,2012/02/08,486,4,0.625,8308,486,4,0
37630,2014/03/31,2012/01/02,461,6,0.593026045,8754,461,6,0
37631,2014/03/31,2011/07/31,259,4,0.610888549,8497,259,2,2
37632,2014/03/31,2011/04/17,90,6,0.7407165290000001,7006,90,3,3
37633,2014/03/31,2007/10/08,3,4,0.5575,9308,3,0,4
37634,2014/03/31,2010/11/18,448,7,0.646307137,8029,448,7,0
37635,2014/03/31,2006/09/01,96,6,0.689041296,7531,96,2,4
37636,2014/03/31,2007/12/19,164,4,0.6768084,7667,164,0,4
37637,2014/03/31,2010/09/15,235,7,0.67524987,7684,235,5,2
37638,2014/03/31,2012/10/16,9,3,1.088162752,4768,9,0,3
37639,2014/03/31,2011/11/02,397,3,0.982742944,5279,397,3,0
37640,2014/03/31,2009/01/08,112,5,0.656829577,7898,112,1,4
37641,2014/03/31,2007/09/02,72,9,0.486636961,10660,72,7,2
37642,2014/03/31,2011/02/28,416,3,0.627650048,8264,416,3,0
37643,2014/03/31,2010/12/11,181,8,0.7883462529999999,6579,181,7,1
37644,2014/03/31,2011/01/13,249,5,0.7746997309999999,6694,249,3,2
37645,2014/03/31,2013/03/25,135,3,0.536461825,9666,135,1,2
37646,2014/03/31,2009/03/26,32,6,0.625050627,8296,32,0,6
37647,2014/03/31,2010/03/04,144,6,0.76603191,6769,144,3,3
37648,2014/03/31,2012/09/27,135,7,0.503176128,10305,135,0,7
37649,2014/03/31,2008/06/06,266,5,0.6808022579999999,7616,266,2,3
37650,2014/03/31,2010/01/04,374,5,0.66,7855,374,5,0
37651,2014/03/31,2012/03/03,485,8,0.722939618,7171,485,8,0
37652,2014/03/31,2013/03/19,341,4,0.798429077,6493,341,2,2
37653,2014/03/31,2012/11/18,356,4,0.805484773,6436,356,2,2
37654,2014/03/31,2007/02/22,673,5,0.812133793,6383,673,5,0
37655,2014/03/31,2006/02/21,12,5,0.475167293,10909,12,2,3
37656,2014/03/31,2004/12/23,84,9,0.51599104,10045,84,5,4
37657,2014/03/31,2013/01/27,76,3,0.91,5694,76,0,3
37658,2014/03/31,2006/10/01,164,5,0.919272534,5636,164,3,2
37659,2014/03/31,2008/08/23,462,5,0.8032325579999999,6450,462,5,0
37660,2014/03/31,2012/03/24,488,4,1.0,5180,488,4,0
37661,2014/03/31,2009/10/09,7,7,0.555832171,9319,7,3,4
37662,2014/03/31,2012/12/05,268,2,1.455,3560,268,0,2
37663,2014/03/31,2013/01/01,23,7,0.652835896,7934,23,0,7
37664,2014/03/31,2007/09/04,20,5,0.5446204000000001,9510,20,2,3
37665,2014/03/31,2004/12/18,12,24,0.6922186579999999,7482,12,10,14
37666,2014/03/31,2010/11/21,531,5,0.727081286,7123,531,5,0
37667,2014/03/31,2006/08/20,122,7,0.716311203,7230,122,0,7
37668,2014/03/31,2008/12/05,22,5,0.8366219709999999,6190,22,2,3
37669,2014/03/31,2011/03/20,20,2,0.8165562909999999,6342,20,1,1
37670,2014/03/31,2006/05/24,282,8,0.625415459,8280,282,7,1
37671,2014/03/31,2012/11/13,27,8,0.767260335,6749,27,5,3
37672,2014/03/31,2011/08/29,127,4,0.457424028,11320,127,2,2
37673,2014/03/31,2011/10/25,253,5,0.7794505490000001,6643,253,1,4
37674,2014/03/31,2013/03/07,151,5,0.626240929,8268,151,2,3
37675,2014/03/31,2011/01/15,206,3,1.337437355,3871,206,1,2
37676,2014/03/31,2005/04/07,197,3,0.7497624909999999,6905,197,1,2
37677,2014/03/31,2010/05/26,534,3,0.8629354890000001,5999,534,3,0
37678,2014/03/31,2004/12/07,390,2,1.5,3451,390,2,0
37679,2014/03/31,2012/09/19,42,5,0.719056813,7199,42,0,5
37680,2014/03/31,2012/11/21,141,10,0.558124865,9274,141,5,5
37681,2014/03/31,2010/08/08,433,4,0.658524173,7860,433,4,0
37682,2014/03/31,2007/09/18,63,4,0.898423885,5761,63,0,4
37683,2014/03/31,2012/04/01,49,7,0.482351351,10730,49,4,3
37684,2014/03/31,2007/01/09,22,7,0.766737778,6750,22,0,7
37685,2014/03/31,2009/11/12,60,3,0.914715447,5658,60,2,1
37686,2014/03/31,2010/12/28,229,7,0.993106889,5211,229,6,1
37687,2014/03/31,2008/09/01,2,6,1.06214535,4871,2,1,5
37688,2014/03/31,2012/11/19,37,4,0.7493757240000001,6904,37,0,4
37689,2014/03/31,2008/07/19,137,6,0.958369767,5398,137,3,3
37690,2014/03/31,2011/06/22,677,3,0.8766666670000001,5901,677,3,0
37691,2014/03/31,2012/09/06,46,7,0.761203649,6796,46,2,5
37692,2014/03/31,2012/08/07,256,5,0.676630477,7645,256,2,3
37693,2014/03/31,2011/12/24,1,3,0.907815023,5698,1,0,3
37694,2014/03/31,2011/05/13,10,4,0.738885714,7000,10,0,4
37695,2014/03/31,2006/06/19,365,7,0.5400083520000001,9578,365,6,1
37696,2014/03/31,2008/01/10,178,4,0.821343497,6297,178,3,1
37697,2014/03/31,2009/02/25,224,4,0.6666537770000001,7758,224,2,2
37698,2014/03/31,2008/01/07,82,3,0.83,6231,82,0,3
37699,2014/03/31,2007/07/20,390,2,0.7,7388,390,2,0
37700,2014/03/31,2012/12/28,10,8,1.26349377,4093,10,2,6
37701,2014/03/31,2007/01/27,59,7,0.678437418,7622,59,2,5
37702,2014/03/31,2012/07/25,29,5,0.764899408,6760,29,2,3
37703,2014/03/31,2009/02/20,102,4,0.798049082,6479,102,0,4
37704,2014/03/31,2010/02/04,63,7,0.716724425,7214,63,3,4
37705,2014/03/31,2008/01/25,137,5,0.671243833,7702,137,3,2
37706,2014/03/31,2011/11/10,103,10,0.69671159,7420,103,7,3
37707,2014/03/31,2011/02/15,48,2,0.87,5942,48,0,2
37708,2014/03/31,2011/07/13,306,5,0.5592276070000001,9244,306,4,1
37709,2014/03/31,2010/07/08,2,8,0.7257209040000001,7123,2,3,5
37710,2014/03/31,2010/12/13,352,6,0.573516032,9013,352,4,2
37711,2014/03/31,2010/01/07,225,3,0.8635131970000001,5986,225,0,3
37712,2014/03/31,2007/02/12,86,38,0.7392105259999999,6992,86,19,19
37713,2014/03/31,2007/04/01,244,7,0.558150108,9260,244,2,5
37714,2014/03/31,2011/09/28,200,10,0.6770277709999999,7634,200,4,6
37715,2014/03/31,2013/03/27,30,8,0.417314276,12384,30,1,7
37716,2014/03/31,2012/07/31,604,2,0.8,6460,604,2,0
37717,2014/03/31,2012/02/10,412,2,0.8,6460,412,2,0
37718,2014/03/31,2012/07/31,604,2,0.8,6460,604,2,0
37719,2014/03/31,2011/07/08,32,7,0.621428571,8316,32,4,3
37720,2014/03/31,2012/03/01,17,9,0.551422474,9371,17,2,7
37721,2014/03/31,2011/01/29,173,5,0.510225141,10127,173,4,1
37722,2014/03/31,2006/03/24,159,5,0.88223873,5856,159,3,2
37723,2014/03/31,2010/11/17,89,4,0.913897046,5653,89,0,4
37724,2014/03/31,2011/10/20,25,5,0.8764992359999999,5893,25,4,1
37725,2014/03/31,2012/04/22,423,3,0.820622815,6294,423,3,0
37726,2014/03/31,2012/03/23,293,7,0.486479231,10617,293,6,1
37727,2014/03/31,2006/11/30,547,4,0.590262857,8750,547,4,0
37728,2014/03/31,2012/06/13,430,3,0.8716624470000001,5925,430,3,0
37729,2014/03/31,2010/04/22,168,4,0.759275213,6802,168,1,3
37730,2014/03/31,2006/03/23,78,7,0.608403629,8488,78,0,7
37731,2014/03/31,2011/11/01,210,9,0.934811731,5524,210,6,3
37732,2014/03/31,2011/11/08,75,7,0.529457603,9753,75,1,6
37733,2014/03/31,2009/02/25,66,2,0.616339222,8378,66,0,2
37734,2014/03/31,2012/12/22,130,9,0.609632822,8470,130,2,7
37735,2014/03/31,2011/11/05,32,8,0.64517306,8003,32,2,6
37736,2014/03/31,2009/08/03,12,6,0.5878298989999999,8783,12,1,5
37737,2014/03/31,2012/08/17,69,10,0.728764822,7084,69,5,5
37738,2014/03/31,2008/10/09,264,7,0.587413518,8788,264,5,2
37739,2014/03/31,2012/06/30,83,8,0.618443752,8347,83,5,3
37740,2014/03/31,2013/01/17,287,4,0.610700509,8451,287,3,1
37741,2014/03/31,2013/02/08,134,6,0.570846145,9041,134,1,5
37742,2014/03/31,2007/09/13,261,4,0.827190255,6239,261,3,1
37743,2014/03/31,2008/08/16,366,7,0.5030954470000001,10257,366,6,1
37744,2014/03/31,2005/08/09,129,8,0.723830832,7129,129,6,2
37745,2014/03/31,2006/02/28,61,6,0.480158243,10743,61,4,2
37746,2014/03/31,2011/07/09,237,4,0.7517723359999999,6861,237,2,2
37747,2014/03/31,2008/09/18,148,8,0.6274066420000001,8221,148,6,2
37748,2014/03/31,2008/07/23,299,6,0.7181634640000001,7182,299,5,1
37749,2014/03/31,2012/11/21,341,5,0.628151261,8211,341,2,3
37750,2014/03/31,2010/02/20,416,5,0.68512221,7528,416,5,0
37751,2014/03/31,2012/09/27,268,4,0.640211075,8054,268,3,1
37752,2014/03/31,2012/11/01,359,4,0.481779107,10702,359,2,2
37753,2014/03/31,2012/03/24,142,3,0.56,9207,142,2,1
37754,2014/03/31,2012/10/23,172,7,0.941761052,5474,172,2,5
37755,2014/03/31,2009/05/30,9,3,0.643333333,8013,9,0,3
37756,2014/03/31,2012/11/20,76,7,0.457442315,11268,76,2,5
37757,2014/03/31,2009/11/24,447,6,0.501942929,10268,447,6,0
37758,2014/03/31,2012/08/09,3,7,0.544616929,9463,3,0,7
37759,2014/03/31,2012/07/23,290,5,0.8292164120000001,6215,290,4,1
37760,2014/03/31,2012/09/26,144,3,0.8733333329999999,5901,144,0,3
37761,2014/03/31,2006/04/23,12,5,0.744818615,6919,12,3,2
37762,2014/03/31,2013/02/12,93,6,0.737114862,6991,93,0,6
37763,2014/03/31,2011/11/24,328,11,0.804928917,6401,328,7,4
37764,2014/03/31,2009/02/18,60,10,0.604447443,8524,60,4,6
37765,2014/03/31,2013/03/06,91,9,0.454770942,11329,91,0,9
37766,2014/03/31,2007/03/05,566,6,0.929301948,5544,566,6,0
37767,2014/03/31,2011/11/20,86,8,0.750323332,6866,86,2,6
37768,2014/03/31,2007/11/08,11,9,0.46584102,11058,11,1,8
37769,2014/03/31,2012/11/13,126,11,0.483636278,10651,126,3,8
37770,2014/03/31,2013/02/04,90,4,0.8691040999999999,5927,90,0,4
37771,2014/03/31,2009/08/22,117,9,0.441902883,11656,117,4,5
37772,2014/03/31,2012/12/05,76,6,0.695679363,7404,76,2,4
37773,2014/03/31,2012/05/08,93,2,0.6172330739999999,8345,93,0,2
37774,2014/03/31,2009/11/12,21,8,0.761275495,6766,21,4,4
37775,2014/03/31,2010/01/07,537,5,0.985402717,5227,537,5,0
37776,2014/03/31,2013/03/24,67,4,0.629266952,8185,67,0,4
37777,2014/03/31,2007/05/31,151,4,0.555121793,9278,151,2,2
37778,2014/03/31,2008/10/07,19,7,0.5914343129999999,8708,19,4,3
37779,2014/03/31,2012/06/05,50,5,0.6883440259999999,7482,50,3,2
37780,2014/03/31,2006/08/28,101,5,0.8746705159999999,5888,101,2,3
37781,2014/03/31,2008/02/01,9,7,0.556917919,9247,9,5,2
37782,2014/03/31,2011/02/28,89,5,0.655079506,7861,89,0,5
37783,2014/03/31,2011/05/12,380,4,0.6311902429999999,8158,380,4,0
37784,2014/03/31,2008/07/19,2,6,0.901002625,5715,2,3,3
37785,2014/03/31,2009/02/12,435,2,0.95,5420,435,2,0
37786,2014/03/31,2007/04/15,498,3,0.7393739229999999,6964,498,3,0
37787,2014/03/31,2010/04/01,142,5,0.963067714,5346,142,2,3
37788,2014/03/31,2012/04/03,9,8,0.662265535,7773,9,2,6
37789,2014/03/31,2010/10/30,563,3,0.735911365,6995,563,3,0
37790,2014/03/31,2009/10/08,16,6,0.69920663,7361,16,1,5
37791,2014/03/31,2012/12/31,26,7,0.7054900620000001,7295,26,2,5
37792,2014/03/31,2011/07/23,13,8,0.646048205,7966,13,1,7
37793,2014/03/31,2012/02/17,80,2,0.825,6238,80,0,2
37794,2014/03/31,2007/08/27,154,6,0.640947932,8028,154,0,6
37795,2014/03/31,2006/01/15,123,7,0.545675045,9429,123,2,5
37796,2014/03/31,2011/04/12,295,6,0.586859815,8767,295,3,3
37797,2014/03/31,2007/02/08,84,3,0.585705829,8784,84,0,3
37798,2014/03/31,2012/10/06,57,5,0.511640975,10055,57,3,2
37799,2014/03/31,2007/03/01,267,4,0.7225,7120,267,2,2
37800,2014/03/31,2012/12/28,240,4,0.4525,11368,240,2,2
37801,2014/03/31,2008/02/09,8,8,0.6470763620000001,7949,8,4,4
37802,2014/03/31,2009/07/04,338,5,0.740299367,6948,338,4,1
37803,2014/03/31,2012/11/20,12,5,0.8545489279999999,6019,12,1,4
37804,2014/03/31,2009/05/06,44,8,0.8059291759999999,6382,44,0,8
37805,2014/03/31,2012/06/15,292,5,0.488479438,10529,292,3,2
37806,2014/03/31,2011/05/25,42,4,0.960386555,5355,42,2,2
37807,2014/03/31,2012/10/06,108,12,0.4781117520000001,10756,108,9,3
37808,2014/03/31,2012/12/06,1,9,0.599421844,8579,1,2,7
37809,2014/03/31,2006/05/31,201,7,0.52922499,9716,201,5,2
37810,2014/03/31,2011/05/31,224,6,0.6460522679999999,7959,224,3,3
37811,2014/03/31,2010/11/08,48,7,0.611330401,8411,48,5,2
37812,2014/03/31,2008/09/26,71,5,0.636607651,8077,71,2,3
37813,2014/03/31,2012/12/04,20,10,0.683790902,7518,20,3,7
37814,2014/03/31,2005/10/10,220,2,0.67,7672,220,0,2
37815,2014/03/31,2012/11/17,15,8,0.43068298,11933,15,2,6
37816,2014/03/31,2008/08/04,42,8,0.356281198,14424,42,6,2
37817,2014/03/31,2007/12/07,28,7,0.6604884320000001,7780,28,4,3
37818,2014/03/31,2012/01/28,295,11,0.5766864970000001,8909,295,9,2
37819,2014/03/31,2008/08/12,597,5,0.512162297,10031,597,5,0
37820,2014/03/31,2010/05/27,109,9,0.498303424,10309,109,6,3
37821,2014/03/31,2006/12/20,633,3,0.677843758,7578,633,3,0
37822,2014/03/31,2012/01/24,32,7,0.754394184,6809,32,2,5
37823,2014/03/31,2012/07/18,216,7,0.937499544,5479,216,3,4
37824,2014/03/31,2011/08/17,5,6,0.800924828,6412,5,4,2
37825,2014/03/31,2012/05/17,157,8,0.624487413,8223,157,5,3
37826,2014/03/31,2012/12/17,246,4,0.462433357,11104,246,2,2
37827,2014/03/31,2012/05/30,2,10,0.7391276809999999,6947,2,2,8
37828,2014/03/31,2011/03/27,116,3,0.840327332,6110,116,1,2
37829,2014/03/31,2012/10/27,12,3,0.87,5901,12,0,3
37830,2014/03/31,2009/11/09,109,2,0.69,7440,109,0,2
37831,2014/03/31,2012/10/05,23,6,0.617313612,8316,23,2,4
37832,2014/03/31,2012/08/11,135,5,0.667609572,7689,135,0,5
37833,2014/03/31,2006/06/01,145,6,0.784164375,6546,145,3,3
37834,2014/03/31,2012/03/22,312,5,0.84325612,6087,312,4,1
37835,2014/03/31,2011/04/01,366,7,0.688497653,7455,366,6,1
37836,2014/03/31,2012/12/14,36,4,0.795,6456,36,0,4
37837,2014/03/31,2011/01/14,250,4,0.871050755,5891,250,3,1
37838,2014/03/31,2011/11/17,242,4,0.743649275,6900,242,2,2
37839,2014/03/31,2013/02/01,177,6,0.605506254,8474,177,2,4
37840,2014/03/31,2012/07/27,103,6,0.701916553,7310,103,3,3
37841,2014/03/31,2009/12/09,75,5,0.6520371079999999,7869,75,1,4
37842,2014/03/31,2005/10/08,72,2,0.86,5966,72,0,2
37843,2014/03/31,2008/04/01,21,8,0.558649826,9184,21,4,4
37844,2014/03/31,2012/09/17,44,6,0.679731055,7548,44,3,3
37845,2014/03/31,2007/10/29,108,8,0.797297591,6435,108,7,1
37846,2014/03/31,2010/06/08,58,8,0.628255971,8165,58,6,2
37847,2014/03/31,2010/02/22,276,4,0.562955443,9112,276,3,1
37848,2014/03/31,2012/11/24,312,8,0.522043558,9826,312,6,2
37849,2014/03/31,2011/03/13,211,2,0.707660044,7248,211,0,2
37850,2014/03/31,2010/08/08,47,5,0.854974162,5999,47,1,4
37851,2014/03/31,2009/02/25,12,5,0.625775988,8196,12,1,4
37852,2014/03/31,2010/12/30,16,6,0.602887034,8507,16,5,1
37853,2014/03/31,2008/12/01,254,3,0.983867997,5212,254,2,1
37854,2014/03/31,2011/04/13,122,8,0.7548697190000001,6793,122,6,2
37855,2014/03/31,2012/10/10,23,14,0.631428571,8120,23,4,10
37856,2014/03/31,2013/03/28,143,6,0.82681503,6201,143,1,5
37857,2014/03/31,2011/01/13,137,4,0.6944345120000001,7383,137,0,4
37858,2014/03/31,2006/08/22,7,6,0.860784083,5956,7,2,4
37859,2014/03/31,2013/03/04,82,9,0.489529221,10472,82,1,8
37860,2014/03/31,2005/07/19,280,5,0.551482677,9294,280,1,4
37861,2014/03/31,2013/03/04,358,2,0.7,7322,358,1,1
37862,2014/03/31,2008/11/17,638,2,0.7,7322,638,2,0
37863,2014/03/31,2009/05/02,192,10,0.762133829,6725,192,8,2
37864,2014/03/31,2008/04/12,133,10,0.469102975,10925,133,6,4
37865,2014/03/31,2009/10/14,55,5,0.534982775,9579,55,0,5
37866,2014/03/31,2009/10/29,50,8,0.636138085,8053,50,3,5
37867,2014/03/31,2013/01/09,334,5,0.76,6740,334,3,2
37868,2014/03/31,2012/10/25,328,3,0.726421784,7051,328,2,1
37869,2014/03/31,2005/01/15,446,3,0.8,6402,446,3,0
37870,2014/03/31,2009/09/27,74,6,0.5639482379999999,9080,74,1,5
37871,2014/03/31,2010/02/24,311,5,0.7061508759999999,7251,311,4,1
37872,2014/03/31,2010/10/11,194,5,0.861812826,5941,194,3,2
37873,2014/03/31,2011/03/28,30,6,0.6021310129999999,8503,30,4,2
37874,2014/03/31,2012/02/09,286,8,0.61125,8376,286,6,2
37875,2014/03/31,2012/12/06,314,5,0.646577419,7918,314,2,3
37876,2014/03/31,2006/08/26,331,4,0.85,6023,331,3,1
37877,2014/03/31,2013/01/23,26,10,0.644583228,7942,26,1,9
37878,2014/03/31,2007/07/03,62,5,0.635687321,8053,62,0,5
37879,2014/03/31,2008/03/07,287,4,0.683632479,7488,287,2,2
37880,2014/03/31,2006/03/16,22,6,0.5970932,8573,22,1,5
37881,2014/03/31,2011/01/14,396,6,0.618027047,8282,396,6,0
37882,2014/03/31,2009/07/10,575,4,0.50832754,10069,575,4,0
37883,2014/03/31,2010/05/27,512,4,0.568683333,9000,512,4,0
37884,2014/03/31,2012/12/20,67,6,0.6750969529999999,7581,67,1,5
37885,2014/03/31,2013/03/09,16,6,0.983956931,5201,16,1,5
37886,2014/03/31,2011/05/17,8,7,0.7091934590000001,7216,8,3,4
37887,2014/03/31,2011/12/20,366,3,0.7912478740000001,6467,366,2,1
37888,2014/03/31,2012/08/18,6,5,0.929685683,5504,6,1,4
37889,2014/03/31,2009/03/21,279,5,0.726423907,7044,279,4,1
37890,2014/03/31,2008/10/10,237,7,0.5952349929999999,8596,237,4,3
37891,2014/03/31,2005/11/04,74,3,0.782262997,6540,74,0,3
37892,2014/03/31,2012/04/06,703,2,0.9,5684,703,2,0
37893,2014/03/31,2008/08/28,510,2,0.9,5684,510,2,0
37894,2014/03/31,2008/09/12,679,2,0.9,5684,679,2,0
37895,2014/03/31,2009/10/31,524,4,0.736905791,6942,524,4,0
37896,2014/03/31,2011/09/18,589,2,0.9,5684,589,2,0
37897,2014/03/31,2010/09/07,163,5,0.8621152870000001,5933,163,0,5
37898,2014/03/31,2011/11/21,1,7,0.617866634,8278,1,4,3
37899,2014/03/31,2005/06/30,473,5,0.665084525,7690,473,5,0
37900,2014/03/31,2011/02/25,197,5,0.825710365,6194,197,2,3
37901,2014/03/31,2010/09/15,24,6,0.72124242,7091,24,1,5
37902,2014/03/31,2009/11/18,147,4,0.65,7868,147,2,2
37903,2014/03/31,2010/09/05,345,5,0.634110353,8065,345,3,2
37904,2014/03/31,2013/03/01,13,7,0.6377625339999999,8018,13,0,7
37905,2014/03/31,2013/03/20,251,6,0.913333333,5598,251,0,6
37906,2014/03/31,2011/11/07,100,5,0.464615594,11004,100,4,1
37907,2014/03/31,2005/03/02,239,5,0.755064245,6771,239,4,1
37908,2014/03/31,2011/05/17,546,7,0.839190742,6092,546,7,0
37909,2014/03/31,2012/12/15,58,6,0.615346094,8307,58,3,3
37910,2014/03/31,2011/08/17,146,7,0.500556208,10212,146,3,4
37911,2014/03/31,2010/08/09,401,4,0.8813017240000001,5800,401,4,0
37912,2014/03/31,2011/08/10,464,4,0.7830116420000001,6528,464,4,0
37913,2014/03/31,2011/12/15,475,7,0.961075592,5318,475,7,0
37914,2014/03/31,2011/08/18,156,6,0.833763458,6130,156,4,2
37915,2014/03/31,2011/09/27,68,8,0.631058155,8099,68,4,4
37916,2014/03/31,2009/06/19,511,3,0.433127119,11800,511,3,0
37917,2014/03/31,2011/04/26,306,4,0.701166141,7289,306,0,4
37918,2014/03/31,2011/09/30,329,7,0.619566008,8249,329,4,3
37919,2014/03/31,2011/01/04,6,9,0.562222222,9090,6,5,4
37920,2014/03/31,2013/02/10,23,5,0.764119318,6688,23,2,3
37921,2014/03/31,2011/07/12,247,10,0.585893144,8722,247,6,4
37922,2014/03/31,2012/05/23,557,7,0.9,5677,557,7,0
37923,2014/03/31,2006/10/05,176,9,0.511923848,9980,176,8,1
37924,2014/03/31,2007/08/02,46,3,0.763333333,6693,46,1,2
37925,2014/03/31,2006/04/24,56,7,0.5516650470000001,9261,56,3,4
37926,2014/03/31,2008/05/16,271,4,0.95206858,5366,271,2,2
37927,2014/03/31,2011/03/29,32,8,0.46333031,11026,32,3,5
37928,2014/03/31,2013/02/27,169,7,0.605501956,8437,169,0,7
37929,2014/03/31,2011/10/08,222,4,0.870437894,5869,222,1,3
37930,2014/03/31,2012/08/23,32,6,0.717784179,7117,32,2,4
37931,2014/03/31,2011/01/02,545,3,0.7333333329999999,6966,545,3,0
37932,2014/03/31,2013/03/15,30,7,0.396227118,12892,30,0,7
37933,2014/03/31,2006/12/27,185,3,0.991381988,5152,185,2,1
37934,2014/03/31,2006/03/01,209,7,0.64819901,7879,209,0,7
37935,2014/03/31,2012/09/19,16,14,0.657776919,7764,16,5,9
37936,2014/03/31,2010/09/29,312,7,0.645600506,7910,312,5,2
37937,2014/03/31,2008/02/12,722,4,0.742037198,6882,722,4,0
37938,2014/03/31,2011/05/27,557,5,0.64966285,7860,557,5,0
37939,2014/03/31,2011/05/02,32,6,0.380113154,13433,32,2,4
37940,2014/03/31,2012/02/25,231,9,0.6810457520000001,7497,231,5,4
37941,2014/03/31,2009/07/08,132,10,0.49027271,10414,132,4,6
37942,2014/03/31,2009/12/04,25,7,0.5855,8720,25,0,7
37943,2014/03/31,2011/08/15,135,4,0.924207096,5524,135,2,2
37944,2014/03/31,2007/10/07,19,6,0.790867545,6455,19,0,6
37945,2014/03/31,2012/03/10,89,8,0.617556255,8266,89,6,2
37946,2014/03/31,2005/08/07,160,7,0.679837507,7508,160,4,3
37947,2014/03/31,2012/09/06,148,7,0.583002856,8755,148,2,5
37948,2014/03/31,2012/05/01,58,4,0.68472498,7454,58,3,1
37949,2014/03/31,2007/06/11,27,7,0.6690090439999999,7629,27,1,6
37950,2014/03/31,2008/08/05,465,6,0.846781151,6027,465,6,0
37951,2014/03/31,2011/11/21,358,5,0.649376511,7859,358,4,1
37952,2014/03/31,2012/04/29,144,4,0.6375203,8005,144,3,1
37953,2014/03/31,2010/02/12,157,5,0.578376969,8823,157,2,3
37954,2014/03/31,2012/01/28,196,3,0.989679922,5155,196,2,1
37955,2014/03/31,2010/04/26,58,5,0.6729099059999999,7581,58,1,4
37956,2014/03/31,2012/07/16,343,4,0.975,5232,343,2,2
37957,2014/03/31,2005/06/17,316,9,0.758649412,6723,316,8,1
37958,2014/03/31,2007/01/09,140,4,0.621547837,8205,140,0,4
37959,2014/03/31,2008/01/06,392,6,0.827319922,6164,392,6,0
37960,2014/03/31,2012/09/15,112,7,0.567115214,8992,112,2,5
37961,2014/03/31,2008/10/25,222,8,0.567677319,8981,222,5,3
37962,2014/03/31,2011/07/12,36,5,0.706520233,7216,36,1,4
37963,2014/03/31,2008/08/25,48,7,0.6885494329999999,7404,48,2,5
37964,2014/03/31,2011/08/04,28,7,0.6930070690000001,7356,28,6,1
37965,2014/03/31,2011/08/03,32,9,0.533013384,9564,32,2,7
37966,2014/03/31,2007/05/27,296,3,0.797107115,6395,296,2,1
37967,2014/03/31,2011/11/03,1,16,0.6813743320000001,7480,1,5,11
37968,2014/03/31,2006/04/17,162,4,0.8240339529999999,6185,162,0,4
37969,2014/03/31,2007/07/13,15,6,0.783372272,6506,15,3,3
37970,2014/03/31,2007/05/01,22,4,0.7181708000000001,7096,22,2,2
37971,2014/03/31,2011/08/11,61,6,0.805004739,6330,61,2,4
37972,2014/03/31,2010/06/25,108,6,0.855304684,5957,108,0,6
37973,2014/03/31,2008/07/03,11,5,0.762374682,6683,11,2,3
37974,2014/03/31,2005/07/30,77,4,0.728152065,6997,77,0,4
37975,2014/03/31,2013/01/17,1,7,0.593450606,8584,1,0,7
37976,2014/03/31,2012/09/25,551,3,0.810824578,6282,551,3,0
37977,2014/03/31,2010/06/30,319,6,0.739767611,6885,319,4,2
37978,2014/03/31,2013/01/05,120,10,0.666118232,7646,120,5,5
37979,2014/03/31,2011/11/27,216,6,0.651948285,7812,216,5,1
37980,2014/03/31,2009/11/05,76,6,0.59991754,8489,76,2,4
37981,2014/03/31,2012/11/16,499,3,0.8407627540000001,6057,499,3,0
37982,2014/03/31,2005/08/12,144,5,0.674633015,7548,144,0,5
37983,2014/03/31,2006/01/15,114,6,0.700220022,7272,114,3,3
37984,2014/03/31,2012/04/29,481,9,0.477480308,10664,481,9,0
37985,2014/03/31,2012/02/04,98,15,0.708666667,7185,98,7,8
37986,2014/03/31,2009/04/21,579,5,0.937458564,5430,579,5,0
37987,2014/03/31,2012/07/11,119,6,0.757200238,6722,119,5,1
37988,2014/03/31,2005/08/13,299,2,1.331035565,3824,299,1,1
37989,2014/03/31,2009/09/05,93,9,0.633676544,8032,93,5,4
37990,2014/03/31,2012/10/06,76,11,0.68160841,7467,76,4,7
37991,2014/03/31,2012/09/19,333,3,0.8873931999999999,5735,333,2,1
37992,2014/03/31,2011/03/04,76,15,0.8926666670000001,5700,76,14,1
37993,2014/03/31,2009/06/26,33,8,0.577795821,8806,33,2,6
37994,2014/03/31,2007/09/22,156,4,0.629376546,8084,156,1,3
37995,2014/03/31,2012/07/27,72,4,0.661164392,7695,72,2,2
37996,2014/03/31,2008/05/16,37,9,0.5705573620000001,8917,37,4,5
37997,2014/03/31,2012/05/29,66,3,0.571003367,8910,66,1,2
37998,2014/03/31,2011/08/05,47,4,0.7063676759999999,7202,47,1,3
37999,2014/03/31,2007/04/13,537,4,0.8943037970000001,5688,537,4,0
38000,2014/03/31,2009/08/08,114,7,0.7133235170000001,7131,114,4,3
38001,2014/03/31,2007/02/01,12,10,0.544,9350,12,4,6
38002,2014/03/31,2013/01/04,348,7,0.907142857,5607,348,4,3
38003,2014/03/31,2010/09/29,163,6,0.727752182,6989,163,1,5
38004,2014/03/31,2012/06/20,648,2,0.840972222,6048,648,2,0
38005,2014/03/31,2009/07/17,68,5,0.799710692,6360,68,2,3
38006,2014/03/31,2013/02/01,75,5,0.83944206,6058,75,1,4
38007,2014/03/31,2008/06/13,452,4,0.825,6164,452,4,0
38008,2014/03/31,2011/08/03,200,4,0.843250415,6030,200,1,3
38009,2014/03/31,2013/03/19,222,5,0.8426466690000001,6034,222,0,5
38010,2014/03/31,2006/03/13,18,5,0.590663336,8608,18,0,5
38011,2014/03/31,2008/11/07,74,12,0.6697734160000001,7591,74,10,2
38012,2014/03/31,2012/11/02,11,3,0.543333333,9357,11,0,3
38013,2014/03/31,2008/05/27,74,7,0.563807253,9017,74,3,4
38014,2014/03/31,2005/08/12,429,8,0.728226615,6981,429,8,0
38015,2014/03/31,2012/06/05,140,5,0.826727923,6149,140,3,2
38016,2014/03/31,2012/10/01,543,4,0.689781517,7369,543,4,0
38017,2014/03/31,2012/01/01,234,4,0.719655954,7063,234,0,4
38018,2014/03/31,2012/10/16,252,4,0.567922905,8950,252,2,2
38019,2014/03/31,2013/01/30,38,9,0.7580223709999999,6705,38,3,6
38020,2014/03/31,2013/03/02,38,3,0.849832776,5980,38,0,3
38021,2014/03/31,2010/09/03,196,4,0.94770608,5362,196,3,1
38022,2014/03/31,2012/09/20,41,4,0.8459157509999999,6006,41,0,4
38023,2014/03/31,2008/09/16,218,5,0.873656062,5815,218,2,3
38024,2014/03/31,2012/11/11,7,12,0.74034538,6862,7,4,8
38025,2014/03/31,2009/10/27,81,9,0.76520711,6639,81,0,9
38026,2014/03/31,2008/09/11,6,3,0.794084727,6397,6,0,3
38027,2014/03/31,2009/02/03,580,3,0.6,8466,580,3,0
38028,2014/03/31,2008/11/14,29,6,0.625643552,8119,29,2,4
38029,2014/03/31,2009/10/28,31,12,0.669234519,7590,31,1,11
38030,2014/03/31,2012/09/15,304,5,0.547700604,9272,304,4,1
38031,2014/03/31,2010/12/06,218,4,0.659148494,7704,218,0,4
38032,2014/03/31,2008/06/04,505,4,0.934984349,5431,505,4,0
38033,2014/03/31,2010/08/29,236,5,0.7428734459999999,6835,236,3,2
38034,2014/03/31,2012/08/31,199,5,0.683632692,7427,199,2,3
38035,2014/03/31,2012/08/31,199,5,0.683632692,7427,199,2,3
38036,2014/03/31,2006/10/04,247,2,1.21,4196,247,1,1
38037,2014/03/31,2011/05/11,49,9,0.628382025,8078,49,3,6
38038,2014/03/31,2013/01/07,107,6,0.659960993,7691,107,1,5
38039,2014/03/31,2012/03/14,146,4,0.7063234070000001,7186,146,1,3
38040,2014/03/31,2009/09/20,64,10,0.722403928,7026,64,5,5
38041,2014/03/31,2010/06/26,491,6,0.720126277,7048,491,6,0
38042,2014/03/31,2011/03/31,403,4,0.835173605,6077,403,4,0
38043,2014/03/31,2012/08/07,20,5,0.680050918,7463,20,2,3
38044,2014/03/31,2012/10/20,315,4,0.65,7808,315,2,2
38045,2014/03/31,2013/03/26,140,11,0.5436507770000001,9335,140,0,11
38046,2014/03/31,2008/07/15,175,6,0.43,11802,175,5,1
38047,2014/03/31,2012/10/29,43,6,0.636158957,7977,43,0,6
38048,2014/03/31,2012/12/01,110,8,0.609079232,8330,110,0,8
38049,2014/03/31,2008/10/20,91,8,0.466496874,10876,91,0,8
38050,2014/03/31,2011/01/15,58,10,0.464046465,10933,58,2,8
38051,2014/03/31,2009/09/28,317,3,0.7108378870000001,7137,317,1,2
38052,2014/03/31,2011/11/19,461,6,0.728807471,6960,461,6,0
38053,2014/03/31,2012/02/01,31,8,0.936192322,5418,31,4,4
38054,2014/03/31,2009/08/23,495,4,0.799613747,6343,495,4,0
38055,2014/03/31,2009/11/13,527,3,0.784994583,6461,527,3,0
38056,2014/03/31,2009/11/13,527,3,0.784994583,6461,527,3,0
38057,2014/03/31,2012/08/26,575,6,0.950843645,5334,575,6,0
38058,2014/03/31,2008/07/05,21,8,0.502126733,10100,21,5,3
38059,2014/03/31,2011/06/08,347,7,0.488249735,10387,347,6,1
38060,2014/03/31,2010/06/26,359,7,0.8033185490000001,6313,359,5,2
38061,2014/03/31,2011/01/25,61,4,0.866486671,5852,61,2,2
38062,2014/03/31,2010/12/12,9,8,0.667665262,7594,9,2,6
38063,2014/03/31,2010/08/30,79,7,0.604303933,8390,79,3,4
38064,2014/03/31,2006/09/10,123,3,0.632881039,8011,123,1,2
38065,2014/03/31,2011/02/21,80,5,0.591968936,8563,80,1,4
38066,2014/03/31,2011/04/25,102,10,0.8027637,6314,102,7,3
38067,2014/03/31,2011/09/26,56,7,0.431922454,11735,56,2,5
38068,2014/03/31,2007/04/20,339,3,1.5,3379,339,1,2
38069,2014/03/31,2005/06/29,386,5,0.913335736,5549,386,5,0
38070,2014/03/31,2013/02/12,11,3,0.6233333329999999,8130,11,2,1
38071,2014/03/31,2012/09/01,263,6,0.7572624029999999,6692,263,4,2
38072,2014/03/31,2008/11/12,305,3,1.478701488,3427,305,0,3
38073,2014/03/31,2008/08/10,554,5,0.7582448,6683,554,5,0
38074,2014/03/31,2012/04/11,396,4,0.851487145,5951,396,4,0
38075,2014/03/31,2010/07/25,190,4,0.561665004,9021,190,1,3
38076,2014/03/31,2008/05/10,5,6,0.807313576,6276,5,0,6
38077,2014/03/31,2007/10/21,32,8,0.592797473,8547,32,4,4
38078,2014/03/31,2011/09/24,629,5,0.55536556,9123,629,5,0
38079,2014/03/31,2005/10/20,9,7,0.649989736,7794,9,0,7
38080,2014/03/31,2009/12/18,249,4,0.6794768609999999,7455,249,3,1
38081,2014/03/31,2010/11/04,20,9,0.585562493,8649,20,4,5
38082,2014/03/31,2012/05/08,68,8,0.705698955,7175,68,4,4
38083,2014/03/31,2008/03/20,149,3,0.889704797,5691,149,0,3
38084,2014/03/31,2012/07/28,68,6,0.798875039,6338,68,1,5
38085,2014/03/31,2007/11/26,475,6,0.656967692,7707,475,6,0
38086,2014/03/31,2012/07/16,18,9,0.5453339079999999,9284,18,1,8
38087,2014/03/31,2012/06/01,279,3,0.588908922,8597,279,2,1
38088,2014/03/31,2010/10/09,147,3,1.107538832,4571,147,0,3
38089,2014/03/31,2006/09/26,257,7,0.61986776,8167,257,5,2
38090,2014/03/31,2012/11/25,154,5,0.62934361,8044,154,3,2
38091,2014/03/31,2012/04/13,203,4,0.445259917,11369,203,2,2
38092,2014/03/31,2006/12/12,65,5,0.774,6540,65,4,1
38093,2014/03/31,2009/07/25,680,5,0.84959718,5958,680,5,0
38094,2014/03/31,2007/05/29,47,8,0.485578473,10424,47,5,3
38095,2014/03/31,2007/12/24,7,8,0.565746227,8945,7,6,2
38096,2014/03/31,2006/04/02,36,6,0.701666667,7212,36,2,4
38097,2014/03/31,2013/01/12,66,10,0.836003635,6053,66,2,8
38098,2014/03/31,2012/12/04,234,9,0.620035535,8161,234,5,4
38099,2014/03/31,2005/11/22,19,6,0.59216852,8545,19,0,6
38100,2014/03/31,2007/04/01,1,3,0.478336169,10578,1,1,2
38101,2014/03/31,2008/11/18,78,7,0.6300149420000001,8031,78,3,4
38102,2014/03/31,2006/10/08,97,5,0.490959728,10305,97,3,2
38103,2014/03/31,2005/10/18,215,4,0.985458796,5133,215,2,2
38104,2014/03/31,2010/09/20,155,14,0.681926655,7417,155,10,4
38105,2014/03/31,2007/11/02,84,7,0.504398125,10027,84,2,5
38106,2014/03/31,2012/09/01,209,5,0.912064923,5545,209,4,1
38107,2014/03/31,2006/08/20,505,6,0.848238846,5962,505,6,0
38108,2014/03/31,2012/06/05,164,6,0.617983625,8183,164,4,2
38109,2014/03/31,2012/03/28,227,4,0.7506011579999999,6737,227,2,2
38110,2014/03/31,2007/09/14,128,8,0.736839114,6862,128,2,6
38111,2014/03/31,2009/10/08,17,3,0.856666667,5901,17,0,3
38112,2014/03/31,2007/11/30,259,3,0.856666667,5901,259,1,2
38113,2014/03/31,2007/10/28,326,3,0.871263575,5801,326,2,1
38114,2014/03/31,2007/05/21,137,5,0.5498433420000001,9192,137,1,4
38115,2014/03/31,2006/06/14,122,5,0.62416821,8097,122,1,4
38116,2014/03/31,2007/08/10,13,5,0.982654093,5143,13,4,1
38117,2014/03/31,2011/07/18,38,3,0.823333333,6138,38,0,3
38118,2014/03/31,2010/10/27,277,3,0.808801216,6248,277,2,1
38119,2014/03/31,2010/07/12,94,5,0.656360566,7699,94,3,2
38120,2014/03/31,2012/12/26,72,10,0.463373682,10905,72,1,9
38121,2014/03/31,2013/01/11,239,8,0.674630174,7490,239,6,2
38122,2014/03/31,2011/08/01,70,4,0.6753140870000001,7482,70,0,4
38123,2014/03/31,2006/11/01,241,5,0.737610219,6850,241,2,3
38124,2014/03/31,2006/07/04,82,6,0.658405004,7674,82,5,1
38125,2014/03/31,2012/07/12,66,4,0.4760473,10613,66,2,2
38126,2014/03/31,2011/09/03,452,10,0.718553549,7031,452,10,0
38127,2014/03/31,2011/07/31,513,4,0.658399583,7673,513,4,0
38128,2014/03/31,2007/03/01,18,6,0.7643758509999999,6609,18,2,4
38129,2014/03/31,2011/09/06,508,4,0.89886121,5620,508,4,0
38130,2014/03/31,2012/08/12,88,12,0.724219355,6975,88,5,7
38131,2014/03/31,2010/02/24,220,7,0.779618768,6479,220,3,4
38132,2014/03/31,2012/04/25,1,7,0.454925696,11103,1,3,4
38133,2014/03/31,2013/01/23,92,5,0.631846385,7994,92,1,4
38134,2014/03/31,2012/03/13,126,7,0.717346968,7041,126,1,6
38135,2014/03/31,2010/04/13,123,3,0.510541797,9893,123,0,3
38136,2014/03/31,2010/11/10,574,7,0.648952711,7782,574,7,0
38137,2014/03/31,2008/01/13,297,5,0.932378139,5416,297,4,1
38138,2014/03/31,2012/12/06,417,3,0.829010015,6091,417,3,0
38139,2014/03/31,2012/08/30,272,4,0.757101514,6669,272,3,1
38140,2014/03/31,2005/09/15,215,9,0.5980090020000001,8443,215,6,3
38141,2014/03/31,2011/09/30,232,7,0.709551651,7115,232,5,2
38142,2014/03/31,2012/03/13,468,4,0.7011666670000001,7200,468,4,0
38143,2014/03/31,2010/01/20,399,2,0.8,6310,399,2,0
38144,2014/03/31,2008/03/11,175,5,0.857336957,5888,175,3,2
38145,2014/03/31,2012/09/22,10,4,0.910692766,5543,10,0,4
38146,2014/03/31,2011/06/05,191,7,0.724212339,6970,191,6,1
38147,2014/03/31,2012/10/24,7,6,0.901666667,5598,7,3,3
38148,2014/03/31,2007/07/05,37,10,0.808206565,6245,37,6,4
38149,2014/03/31,2010/04/30,17,3,0.81,6231,17,2,1
38150,2014/03/31,2012/03/15,122,3,0.794674854,6351,122,2,1
38151,2014/03/31,2008/06/23,179,5,0.7513651929999999,6717,179,0,5
38152,2014/03/31,2006/11/04,18,4,0.8280393770000001,6095,18,0,4
38153,2014/03/31,2012/09/11,47,3,0.816373342,6182,47,0,3
38154,2014/03/31,2013/01/11,311,7,0.671001197,7521,311,4,3
38155,2014/03/31,2012/12/07,116,6,0.509274397,9909,116,1,5
38156,2014/03/31,2011/01/15,209,8,0.850272957,5935,209,6,2
38157,2014/03/31,2006/07/02,1,3,0.7416460909999999,6804,1,1,2
38158,2014/03/31,2011/02/20,40,8,0.341438528,14779,40,4,4
38159,2014/03/31,2012/06/29,75,4,0.7599216870000001,6640,75,1,3
38160,2014/03/31,2012/11/13,87,5,0.939802534,5368,87,2,3
38161,2014/03/31,2006/06/01,21,8,0.6,8408,21,5,3
38162,2014/03/31,2008/03/07,35,5,0.918723366,5491,35,2,3
38163,2014/03/31,2011/07/29,165,8,0.62125,8120,165,6,2
38164,2014/03/31,2006/06/22,217,5,0.7972024659999999,6327,217,2,3
38165,2014/03/31,2010/07/18,69,4,0.705170582,7152,69,0,4
38166,2014/03/31,2012/12/26,225,5,0.794924338,6344,225,0,5
38167,2014/03/31,2012/09/22,1,5,0.71556407,7047,1,4,1
38168,2014/03/31,2012/10/05,45,6,0.409660383,12308,45,4,2
38169,2014/03/31,2011/05/20,19,5,0.6749678709999999,7470,19,3,2
38170,2014/03/31,2008/11/07,634,2,1.0,5042,634,2,0
38171,2014/03/31,2008/04/14,7,6,0.575950423,8754,7,1,5
38172,2014/03/31,2012/08/28,191,8,0.350756279,14373,191,2,6
38173,2014/03/31,2011/06/14,99,8,0.55858615,9025,99,0,8
38174,2014/03/31,2009/09/08,520,4,1.0,5041,520,4,0
38175,2014/03/31,2012/02/19,102,7,0.865381974,5825,102,6,1
38176,2014/03/31,2008/01/28,1,4,0.6713931809999999,7508,1,3,1
38177,2014/03/31,2011/12/01,160,5,0.870335003,5791,160,2,3
38178,2014/03/31,2009/03/31,317,4,0.565471783,8913,317,3,1
38179,2014/03/31,2008/11/02,26,8,0.520003095,9692,26,2,6
38180,2014/03/31,2006/06/26,2,5,0.582439616,8653,2,0,5
38181,2014/03/31,2010/01/16,109,3,0.963070896,5233,109,0,3
38182,2014/03/31,2012/09/08,270,5,0.651659123,7733,270,4,1
38183,2014/03/31,2012/02/20,120,9,0.516357209,9759,120,5,4
38184,2014/03/31,2011/11/08,377,6,0.6426348679999999,7841,377,6,0
38185,2014/03/31,2012/11/05,36,7,0.681651786,7392,36,3,4
38186,2014/03/31,2007/09/03,191,8,0.5161094039999999,9762,191,6,2
38187,2014/03/31,2011/12/25,236,4,0.96,5248,236,1,3
38188,2014/03/31,2010/11/08,479,4,0.667448331,7548,479,4,0
38189,2014/03/31,2012/02/17,1,6,0.55286655,9112,1,2,4
38190,2014/03/31,2011/09/13,116,6,0.656456867,7674,116,4,2
38191,2014/03/31,2012/08/04,104,4,0.861417579,5848,104,2,2
38192,2014/03/31,2012/09/04,185,6,0.985399061,5112,185,1,5
38193,2014/03/31,2005/07/20,520,2,1.5,3358,520,2,0
38194,2014/03/31,2009/03/04,34,9,0.6078843829999999,8286,34,4,5
38195,2014/03/31,2005/04/21,203,8,0.448988233,11218,203,5,3
38196,2014/03/31,2007/11/01,116,9,0.657266084,7663,116,4,5
38197,2014/03/31,2005/07/19,5,6,0.584833953,8612,5,3,3
38198,2014/03/31,2007/09/01,177,4,0.59,8536,177,0,4
38199,2014/03/31,2012/09/09,558,3,0.647160113,7782,558,3,0
38200,2014/03/31,2012/09/09,558,3,0.647160113,7782,558,3,0
38201,2014/03/31,2009/03/04,195,3,0.7136290209999999,7057,195,1,2
38202,2014/03/31,2008/06/26,587,3,1.0,5036,587,3,0
38203,2014/03/31,2006/06/10,352,5,0.77,6540,352,4,1
38204,2014/03/31,2012/07/21,4,6,0.430023057,11710,4,1,5
38205,2014/03/31,2005/05/19,79,3,0.8533333329999999,5901,79,1,2
38206,2014/03/31,2010/06/01,37,4,0.64,7868,37,0,4
38207,2014/03/31,2012/10/16,280,5,0.774279563,6503,280,2,3
38208,2014/03/31,2009/09/30,199,7,0.5505762710000001,9145,199,5,2
38209,2014/03/31,2010/09/25,83,7,0.68362797,7365,83,4,3
38210,2014/03/31,2007/07/26,81,5,1.065768417,4724,81,3,2
38211,2014/03/31,2012/09/13,142,5,0.88794709,5670,142,1,4
38212,2014/03/31,2010/07/15,154,6,0.7324967259999999,6873,154,4,2
38213,2014/03/31,2007/11/19,186,5,0.6769181120000001,7437,186,2,3
38214,2014/03/31,2012/12/01,200,4,0.587965429,8562,200,2,2
38215,2014/03/31,2012/07/24,177,5,0.753573353,6680,177,0,5
38216,2014/03/31,2011/02/24,348,5,0.747061443,6738,348,4,1
38217,2014/03/31,2005/09/23,172,6,0.509156383,9886,172,4,2
38218,2014/03/31,2008/04/27,378,7,0.63147033,7971,378,7,0
38219,2014/03/31,2012/07/22,4,9,0.830665126,6059,4,5,4
38220,2014/03/31,2011/11/01,346,4,0.562438534,8948,346,1,3
38221,2014/03/31,2004/11/10,43,7,0.71274607,7061,43,0,7
38222,2014/03/31,2005/11/22,127,6,0.707330991,7115,127,2,4
38223,2014/03/31,2007/01/10,269,7,0.768440983,6549,269,5,2
38224,2014/03/31,2012/06/26,103,9,0.5848768010000001,8604,103,4,5
38225,2014/03/31,2011/11/08,150,5,0.719899857,6990,150,0,5
38226,2014/03/31,2013/02/16,23,4,1.15097667,4372,23,1,3
38227,2014/03/31,2011/04/15,411,8,0.448005698,11232,411,8,0
38228,2014/03/31,2013/03/18,19,4,0.74,6800,19,0,4
38229,2014/03/31,2012/08/17,83,7,0.596692755,8433,83,4,3
38230,2014/03/31,2012/08/14,137,3,0.807299856,6233,137,1,2
38231,2014/03/31,2010/10/16,39,6,0.723900158,6951,39,2,4
38232,2014/03/31,2008/10/18,4,4,0.615504587,8175,4,0,4
38233,2014/03/31,2008/10/25,5,3,0.729843342,6894,5,2,1
38234,2014/03/31,2013/02/22,195,5,0.6625572820000001,7594,195,1,4
38235,2014/03/31,2006/04/03,72,5,0.8640494590000001,5823,72,0,5
38236,2014/03/31,2005/09/09,239,6,0.7484900329999999,6722,239,5,1
38237,2014/03/31,2012/09/01,542,6,0.964251486,5217,542,6,0
38238,2014/03/31,2010/11/01,340,8,0.546415381,9206,340,7,1
38239,2014/03/31,2008/09/12,1,4,0.6470217420000001,7773,1,0,4
38240,2014/03/31,2008/06/16,231,5,0.80325028,6261,231,1,4
38241,2014/03/31,2010/09/22,464,4,0.8679841220000001,5794,464,4,0
38242,2014/03/31,2012/11/07,243,5,0.743600473,6763,243,3,2
38243,2014/03/31,2011/05/09,67,7,0.479405091,10489,67,0,7
38244,2014/03/31,2012/06/29,33,5,0.944123169,5326,33,2,3
38245,2014/03/31,2009/10/10,262,6,0.8289317509999999,6066,262,2,4
38246,2014/03/31,2009/09/11,255,6,0.742605228,6771,255,4,2
38247,2014/03/31,2012/09/12,333,6,0.676786916,7429,333,4,2
38248,2014/03/31,2007/07/29,111,8,0.6275287070000001,8012,111,3,5
38249,2014/03/31,2005/12/04,105,7,0.601688607,8356,105,3,4
38250,2014/03/31,2012/12/04,179,6,0.446666667,11256,179,2,4
38251,2014/03/31,2012/02/04,340,6,0.6530787220000001,7698,340,4,2
38252,2014/03/31,2010/07/22,130,7,0.775114092,6486,130,4,3
38253,2014/03/31,2012/10/14,351,6,0.950784944,5287,351,4,2
38254,2014/03/31,2013/01/13,340,4,0.614962075,8174,340,1,3
38255,2014/03/31,2010/10/21,557,3,0.651964981,7710,557,3,0
38256,2014/03/31,2006/11/30,62,3,0.7660768179999999,6561,62,0,3
38257,2014/03/31,2013/02/17,401,2,0.85,5913,401,2,0
38258,2014/03/31,2008/11/29,166,5,0.5682609679999999,8844,166,4,1
38259,2014/03/31,2010/03/24,4,7,0.610047342,8238,4,2,5
38260,2014/03/31,2012/07/23,216,7,0.883017044,5691,216,6,1
38261,2014/03/31,2011/03/06,61,3,0.878479021,5720,61,0,3
38262,2014/03/31,2011/11/03,151,7,0.6891619809999999,7291,151,4,3
38263,2014/03/31,2009/09/15,443,4,0.812714332,6182,443,4,0
38264,2014/03/31,2012/11/09,446,4,0.590786689,8504,446,4,0
38265,2014/03/31,2012/10/12,360,2,0.819425869,6131,360,0,2
38266,2014/03/31,2010/01/19,168,8,0.656712418,7650,168,4,4
38267,2014/03/31,2011/08/05,389,5,0.553016292,9084,389,5,0
38268,2014/03/31,2011/11/26,347,4,0.6004661729999999,8366,347,0,4
38269,2014/03/31,2012/06/15,167,6,0.609985426,8234,167,3,3
38270,2014/03/31,2010/12/13,90,4,0.666480892,7536,90,1,3
38271,2014/03/31,2008/08/27,268,3,0.8340807170000001,6021,268,2,1
38272,2014/03/31,2009/07/27,28,6,0.482119816,10416,28,1,5
38273,2014/03/31,2010/08/19,235,6,0.7289547040000001,6888,235,4,2
38274,2014/03/31,2013/02/01,375,6,0.505583526,9931,375,6,0
38275,2014/03/31,2005/12/27,204,6,0.6881441890000001,7296,204,5,1
38276,2014/03/31,2009/07/11,288,7,0.558427141,8990,288,5,2
38277,2014/03/31,2012/11/27,107,8,0.63828862,7865,107,1,7
38278,2014/03/31,2011/07/15,165,6,0.601786142,8342,165,5,1
38279,2014/03/31,2012/08/24,252,3,0.89676313,5598,252,2,1
38280,2014/03/31,2008/12/17,490,8,0.539768817,9300,490,8,0
38281,2014/03/31,2007/04/08,440,4,0.5625,8924,440,4,0
38282,2014/03/31,2012/07/23,367,9,0.7234721820000001,6938,367,9,0
38283,2014/03/31,2006/03/26,85,3,0.800133907,6273,85,0,3
38284,2014/03/31,2006/06/08,59,7,0.7275257279999999,6899,59,6,1
38285,2014/03/31,2010/02/01,97,9,0.8890770590000001,5645,97,6,3
38286,2014/03/31,2011/10/04,308,7,0.7117359240000001,7051,308,4,3
38287,2014/03/31,2012/08/22,175,5,0.807834836,6212,175,2,3
38288,2014/03/31,2012/04/24,5,8,0.552727473,9078,5,0,8
38289,2014/03/31,2007/09/26,409,4,0.833211558,6022,409,4,0
38290,2014/03/31,2013/03/30,23,4,0.973151668,5156,23,0,4
38291,2014/03/31,2012/03/16,20,4,0.8900106440000001,5637,20,2,2
38292,2014/03/31,2008/02/23,249,5,0.8165234379999999,6144,249,4,1
38293,2014/03/31,2010/05/24,429,6,0.614134427,8168,429,6,0
38294,2014/03/31,2012/03/27,9,7,0.699584379,7170,9,1,6
38295,2014/03/31,2008/08/05,56,7,0.676457181,7415,56,0,7
38296,2014/03/31,2011/08/28,625,4,0.6375,7868,625,4,0
38297,2014/03/31,2010/04/07,61,7,0.455733236,11006,61,3,4
38298,2014/03/31,2010/12/31,346,5,0.779303915,6436,346,4,1
38299,2014/03/31,2007/02/18,302,10,0.554627889,9043,302,8,2
38300,2014/03/31,2007/10/16,96,4,1.116207434,4493,96,3,1
38301,2014/03/31,2012/06/29,128,4,0.72136939,6952,128,1,3
38302,2014/03/31,2005/11/02,401,3,0.783333333,6402,401,3,0
38303,2014/03/31,2012/10/28,294,4,0.5875,8536,294,2,2
38304,2014/03/31,2011/08/01,154,4,0.71628196,7001,154,0,4
38305,2014/03/31,2006/05/30,226,6,0.70448862,7118,226,4,2
38306,2014/03/31,2009/09/10,162,8,0.461740331,10860,162,6,2
38307,2014/03/31,2009/07/03,13,7,0.5986723970000001,8376,13,1,6
38308,2014/03/31,2011/10/12,39,5,0.523497599,9578,39,3,2
38309,2014/03/31,2010/03/25,132,9,0.519075474,9659,132,8,1
38310,2014/03/31,2012/09/10,448,4,0.4625,10840,448,4,0
38311,2014/03/31,2008/03/28,41,3,0.6166666670000001,8130,41,1,2
38312,2014/03/31,2008/11/06,209,7,0.968024715,5179,209,4,3
38313,2014/03/31,2011/09/13,74,7,0.682278171,7348,74,4,3
38314,2014/03/31,2011/08/09,11,3,0.7588147140000001,6606,11,1,2
38315,2014/03/31,2008/06/05,140,4,0.832639535,6020,140,3,1
38316,2014/03/31,2006/06/09,25,7,0.566835558,8842,25,0,7
38317,2014/03/31,2011/04/08,79,5,0.845740803,5926,79,0,5
38318,2014/03/31,2012/11/01,113,6,0.732043529,6846,113,1,5
38319,2014/03/31,2011/10/31,179,5,0.694275423,7218,179,0,5
38320,2014/03/31,2012/03/08,137,6,0.5047995160000001,9926,137,4,2
38321,2014/03/31,2012/07/10,216,6,0.72155962,6944,216,4,2
38322,2014/03/31,2012/11/11,188,5,0.715159863,7006,188,4,1
38323,2014/03/31,2008/11/03,104,5,0.549145112,9124,104,3,2
38324,2014/03/31,2012/09/06,12,5,0.681208702,7355,12,2,3
38325,2014/03/31,2011/11/23,191,8,0.6293254620000001,7961,191,7,1
38326,2014/03/31,2010/01/08,115,15,0.809076227,6192,115,8,7
38327,2014/03/31,2008/07/22,31,8,0.420797984,11905,31,2,6
38328,2014/03/31,2011/09/16,198,3,0.751579895,6665,198,0,3
38329,2014/03/31,2012/11/18,50,3,0.88243129,5676,50,0,3
38330,2014/03/31,2010/12/05,204,5,0.506211846,9894,204,4,1
38331,2014/03/31,2011/09/14,44,5,0.6859999999999999,7300,44,2,3
38332,2014/03/31,2008/03/15,105,8,0.45305347,11053,105,0,8
38333,2014/03/31,2012/10/30,169,6,0.7619567859999999,6572,169,4,2
38334,2014/03/31,2005/09/17,104,4,0.766126071,6536,104,2,2
38335,2014/03/31,2011/12/08,12,6,0.8195155479999999,6110,12,3,3
38336,2014/03/31,2006/04/27,67,4,0.657887268,7611,67,2,2
38337,2014/03/31,2008/03/22,39,7,0.502210632,9970,39,4,3
38338,2014/03/31,2012/12/05,143,8,0.551458471,9078,143,1,7
38339,2014/03/31,2010/11/17,162,5,0.641971018,7798,162,2,3
38340,2014/03/31,2011/10/08,6,7,0.8274363640000001,6050,6,5,2
38341,2014/03/31,2009/12/01,144,5,0.463460791,10801,144,2,3
38342,2014/03/31,2011/08/17,261,5,0.731683964,6841,261,3,2
38343,2014/03/31,2011/12/16,195,7,0.682361282,7335,195,5,2
38344,2014/03/31,2010/01/07,92,8,0.5138418889999999,9740,92,4,4
38345,2014/03/31,2006/12/01,11,7,0.909383972,5503,11,3,4
38346,2014/03/31,2013/01/01,131,8,0.482477825,10372,131,3,5
38347,2014/03/31,2006/10/24,111,5,0.575859609,8690,111,2,3
38348,2014/03/31,2012/08/31,9,4,1.41,3549,9,0,4
38349,2014/03/31,2011/09/15,212,9,0.7052840029999999,7095,212,6,3
38350,2014/03/31,2005/11/21,413,3,0.800335893,6252,413,3,0
38351,2014/03/31,2013/01/18,5,7,0.682103613,7335,5,1,6
38352,2014/03/31,2010/12/20,25,5,0.595619717,8399,25,2,3
38353,2014/03/31,2008/07/19,34,7,0.735746433,6799,34,2,5
38354,2014/03/31,2009/10/05,289,7,0.440696035,11350,289,1,6
38355,2014/03/31,2011/02/05,218,4,0.6981853709999999,7164,218,1,3
38356,2014/03/31,2013/03/08,142,4,0.6940169279999999,7207,142,2,2
38357,2014/03/31,2012/01/01,31,4,0.39,12824,31,2,2
38358,2014/03/31,2010/02/26,135,6,0.799955214,6252,135,0,6
38359,2014/03/31,2010/09/25,178,9,0.62630933,7985,178,6,3
38360,2014/03/31,2009/08/11,443,5,0.782514473,6391,443,5,0
38361,2014/03/31,2008/06/24,93,7,0.693772198,7208,93,3,4
38362,2014/03/31,2012/05/16,342,5,0.927239014,5393,342,4,1
38363,2014/03/31,2012/10/24,193,7,0.844818381,5919,193,1,6
38364,2014/03/31,2011/03/29,262,6,0.696136712,7183,262,4,2
38365,2014/03/31,2010/01/10,9,6,0.693333333,7212,9,2,4
38366,2014/03/31,2012/11/15,224,5,0.8831190390000001,5662,224,3,2
38367,2014/03/31,2012/09/21,133,10,0.55916909,8942,133,7,3
38368,2014/03/31,2012/03/18,105,5,0.481702312,10380,105,0,5
38369,2014/03/31,2010/10/13,381,4,0.5945415629999999,8409,381,4,0
38370,2014/03/31,2011/11/12,257,6,0.74115493,6745,257,4,2
38371,2014/03/31,2008/03/16,196,5,0.87641129,5704,196,2,3
38372,2014/03/31,2009/02/09,658,4,0.613750767,8145,658,4,0
38373,2014/03/31,2012/04/05,152,9,0.515327835,9700,152,2,7
38374,2014/03/31,2012/09/07,569,3,0.862799931,5793,569,3,0
38375,2014/03/31,2013/03/12,11,6,0.7039230879999999,7099,11,2,4
38376,2014/03/31,2013/02/04,146,6,0.5103063729999999,9792,146,1,5
38377,2014/03/31,2006/09/20,21,5,0.7629596820000001,6548,21,0,5
38378,2014/03/31,2011/10/14,286,6,0.64053212,7799,286,4,2
38379,2014/03/31,2010/01/28,56,8,0.527198945,9475,56,5,3
38380,2014/03/31,2008/03/30,349,5,0.8735571879999999,5718,349,2,3
38381,2014/03/31,2009/09/03,95,9,0.6464957929999999,7725,95,5,4
38382,2014/03/31,2006/11/07,166,7,0.80265188,6222,166,4,3
38383,2014/03/31,2013/01/19,419,2,0.6251032670000001,7989,419,2,0
38384,2014/03/31,2012/02/05,83,5,0.603005676,8281,83,4,1
38385,2014/03/31,2006/08/03,355,8,0.716927495,6965,355,5,3
38386,2014/03/31,2011/01/13,234,4,0.946040167,5278,234,1,3
38387,2014/03/31,2013/03/01,107,2,0.855,5840,107,0,2
38388,2014/03/31,2007/12/01,208,3,1.286567895,3881,208,2,1
38389,2014/03/31,2011/02/23,23,5,0.652502614,7652,23,0,5
38390,2014/03/31,2008/08/27,212,8,0.576535797,8660,212,4,4
38391,2014/03/31,2004/12/16,197,3,0.693711269,7197,197,2,1
38392,2014/03/31,2010/01/20,70,7,0.541949631,9212,70,6,1
38393,2014/03/31,2008/04/23,396,3,0.716666667,6966,396,3,0
38394,2014/03/31,2006/05/28,243,6,0.665810883,7498,243,3,3
38395,2014/03/31,2009/10/15,188,12,0.665951174,7496,188,9,3
38396,2014/03/31,2011/01/05,43,5,0.571646816,8732,43,1,4
38397,2014/03/31,2007/05/18,98,5,0.912482633,5470,98,4,1
38398,2014/03/31,2011/01/27,202,2,0.939747693,5311,202,1,1
38399,2014/03/31,2011/08/20,517,4,0.564170246,8846,517,4,0
38400,2014/03/31,2011/01/18,166,7,0.732941695,6809,166,5,2
38401,2014/03/31,2013/03/26,96,6,0.798190979,6252,96,1,5
38402,2014/03/31,2009/04/06,13,4,0.693798665,7192,13,2,2
38403,2014/03/31,2012/02/03,570,6,0.4294801170000001,11618,570,6,0
38404,2014/03/31,2012/05/23,196,2,1.445833092,3451,196,1,1
38405,2014/03/31,2011/10/14,8,5,0.849996593,5870,8,3,2
38406,2014/03/31,2008/07/15,285,7,0.907823872,5496,285,3,4
38407,2014/03/31,2010/10/04,358,5,0.76416756,6529,358,4,1
38408,2014/03/31,2010/07/03,346,4,1.0,4989,346,3,1
38409,2014/03/31,2012/05/12,34,4,0.4254579570000001,11726,34,1,3
38410,2014/03/31,2008/09/04,424,5,0.612862408,8140,424,5,0
38411,2014/03/31,2012/05/22,211,3,0.606624103,8223,211,0,3
38412,2014/03/31,2008/03/18,23,7,0.514983481,9686,23,5,2
38413,2014/03/31,2008/07/07,126,5,0.669723416,7448,126,3,2
38414,2014/03/31,2012/06/18,530,3,0.902896452,5524,530,3,0
38415,2014/03/31,2008/06/11,409,6,0.732178509,6812,409,6,0
38416,2014/03/31,2006/04/21,216,4,0.939734313,5307,216,3,1
38417,2014/03/31,2008/04/10,190,2,0.65,7672,190,0,2
38418,2014/03/31,2012/08/28,400,2,0.65,7672,400,2,0
38419,2014/03/31,2011/07/06,402,2,0.65,7672,402,2,0
38420,2014/03/31,2012/10/18,121,4,0.913960777,5456,121,2,2
38421,2014/03/31,2008/07/13,100,2,0.92,5420,100,0,2
38422,2014/03/31,2012/05/17,509,7,0.5786642679999999,8617,509,7,0
38423,2014/03/31,2012/11/15,502,2,1.0,4986,502,2,0
38424,2014/03/31,2008/06/04,709,2,1.0,4986,709,2,0
38425,2014/03/31,2012/10/02,76,6,0.496731095,10037,76,0,6
38426,2014/03/31,2010/05/06,115,6,0.650418787,7665,115,2,4
38427,2014/03/31,2011/11/14,137,7,0.700892732,7113,137,5,2
38428,2014/03/31,2012/09/05,170,5,0.7886916629999999,6321,170,2,3
38429,2014/03/31,2011/12/16,132,6,0.434844731,11464,132,1,5
38430,2014/03/31,2011/06/22,131,6,0.649994784,7669,131,3,3
38431,2014/03/31,2010/10/19,699,3,0.8,6231,699,3,0
38432,2014/03/31,2005/02/06,614,4,0.6,8308,614,4,0
38433,2014/03/31,2012/11/01,501,2,1.2,4154,501,2,0
38434,2014/03/31,2008/01/04,535,3,0.8,6231,535,3,0
38435,2014/03/31,2011/03/08,12,3,0.6036170989999999,8258,12,2,1
38436,2014/03/31,2009/01/06,233,6,0.708951785,7031,233,5,1
38437,2014/03/31,2013/02/12,285,4,0.682357612,7304,285,1,3
38438,2014/03/31,2012/11/06,25,6,0.635,7848,25,0,6
38439,2014/03/31,2012/04/07,203,8,0.559822492,8901,203,4,4
38440,2014/03/31,2006/01/14,44,8,0.6749932270000001,7382,44,3,5
38441,2014/03/31,2009/08/04,262,7,0.5312004260000001,9380,262,4,3
38442,2014/03/31,2012/01/12,29,11,0.651387109,7649,29,6,5
38443,2014/03/31,2010/11/04,104,6,0.595051953,8373,104,3,3
38444,2014/03/31,2007/08/14,9,7,0.506702604,9832,9,0,7
38445,2014/03/31,2011/02/07,398,4,0.8274916940000001,6020,398,4,0
38446,2014/03/31,2012/06/12,592,6,1.050463939,4742,592,6,0
38447,2014/03/31,2010/12/29,7,9,0.689962599,7219,7,3,6
38448,2014/03/31,2009/10/05,26,6,0.510841026,9750,26,2,4
38449,2014/03/31,2008/09/06,95,3,0.86059098,5787,95,0,3
38450,2014/03/31,2011/01/06,112,8,0.927749627,5368,112,7,1
38451,2014/03/31,2010/10/06,140,4,0.86760453,5740,140,0,4
38452,2014/03/31,2012/08/11,269,5,0.473197453,10524,269,4,1
38453,2014/03/31,2006/04/20,216,6,0.542693984,9176,216,1,5
38454,2014/03/31,2008/01/08,650,3,0.926782058,5373,650,3,0
38455,2014/03/31,2012/06/09,593,3,0.615704217,8087,593,3,0
38456,2014/03/31,2007/06/22,21,3,0.924629526,5385,21,0,3
38457,2014/03/31,2011/06/30,199,4,0.5113156,9737,199,2,2
38458,2014/03/31,2010/03/25,300,5,0.640407769,7774,300,2,3
38459,2014/03/31,2009/03/12,361,12,0.528840025,9414,361,10,2
38460,2014/03/31,2011/01/04,238,6,0.62572901,7956,238,3,3
38461,2014/03/31,2011/12/29,48,8,0.720439942,6910,48,4,4
38462,2014/03/31,2008/09/15,19,6,0.612401279,8129,19,0,6
38463,2014/03/31,2012/08/08,165,5,0.767616037,6485,165,1,4
38464,2014/03/31,2012/08/23,414,4,0.6375,7808,414,4,0
38465,2014/03/31,2012/01/13,434,5,0.759731339,6551,434,5,0
38466,2014/03/31,2012/05/29,142,6,0.470587179,10576,142,3,3
38467,2014/03/31,2013/01/29,177,5,0.506,9835,177,2,3
38468,2014/03/31,2012/12/05,112,6,0.713253547,6977,112,3,3
38469,2014/03/31,2013/01/24,30,9,0.509039484,9776,30,0,9
38470,2014/03/31,2005/11/24,215,5,0.631912381,7875,215,4,1
38471,2014/03/31,2010/02/12,684,4,0.977258445,5092,684,4,0
38472,2014/03/31,2012/08/23,28,11,0.518181818,9603,28,5,6
38473,2014/03/31,2013/03/18,327,3,0.7395808559999999,6728,327,2,1
38474,2014/03/31,2011/12/03,123,5,0.62081243,8013,123,0,5
38475,2014/03/31,2005/10/08,338,5,0.7049603170000001,7056,338,3,2
38476,2014/03/31,2006/03/25,143,4,0.699586498,7110,143,0,4
38477,2014/03/31,2008/02/12,37,6,0.544431918,9136,37,2,4
38478,2014/03/31,2012/04/27,400,4,0.926872903,5366,400,4,0
38479,2014/03/31,2008/01/18,582,3,0.583333333,8526,582,3,0
38480,2014/03/31,2013/02/24,9,5,0.406997299,12219,9,0,5
38481,2014/03/31,2006/03/31,472,9,0.571609195,8700,472,9,0
38482,2014/03/31,2011/07/23,569,5,0.711409156,6990,569,5,0
38483,2014/03/31,2010/12/01,110,7,0.7458662070000001,6667,110,1,6
38484,2014/03/31,2012/05/23,640,4,0.8125,6120,640,4,0
38485,2014/03/31,2008/11/06,20,6,0.6711771059999999,7408,20,2,4
38486,2014/03/31,2009/07/16,151,5,0.669176312,7430,151,0,5
38487,2014/03/31,2011/04/28,81,6,0.807916802,6154,81,0,6
38488,2014/03/31,2005/12/01,115,7,0.737748924,6739,115,4,3
38489,2014/03/31,2008/02/08,486,6,0.911885547,5452,486,6,0
38490,2014/03/31,2007/05/30,191,5,0.8946427929999999,5557,191,2,3
38491,2014/03/31,2010/11/12,322,5,0.736831184,6747,322,4,1
38492,2014/03/31,2010/01/19,51,11,0.696363636,7139,51,7,4
38493,2014/03/31,2007/03/10,162,7,0.710760761,6993,162,5,2
38494,2014/03/31,2011/07/25,573,5,0.804516025,6178,573,5,0
38495,2014/03/31,2010/09/13,144,7,0.531529412,9350,144,3,4
38496,2014/03/31,2005/06/17,36,6,0.681056599,7297,36,1,5
38497,2014/03/31,2006/08/04,38,4,0.535827043,9274,38,3,1
38498,2014/03/31,2011/06/07,39,6,0.6201996999999999,8012,39,0,6
38499,2014/03/31,2013/01/10,10,4,0.43751783,11357,10,1,3
38500,2014/03/31,2008/04/23,206,6,0.6112918310000001,8128,206,4,2
38501,2014/03/31,2008/09/01,90,5,0.5943964589999999,8359,90,3,2
38502,2014/03/31,2011/10/10,458,5,0.54886213,9052,458,5,0
38503,2014/03/31,2012/08/13,9,8,0.635207774,7821,9,2,6
38504,2014/03/31,2013/02/15,113,5,0.7753909790000001,6407,113,1,4
38505,2014/03/31,2005/08/18,138,5,0.473172683,10499,138,3,2
38506,2014/03/31,2011/08/09,192,5,0.6957535009999999,7140,192,3,2
38507,2014/03/31,2008/07/10,203,5,0.603972036,8225,203,4,1
38508,2014/03/31,2011/09/26,130,6,0.557773411,8906,130,2,4
38509,2014/03/31,2008/08/21,419,6,0.654274236,7592,419,6,0
38510,2014/03/31,2011/07/23,4,4,0.7862023109999999,6317,4,2,2
38511,2014/03/31,2013/03/16,343,4,0.824161965,6026,343,1,3
38512,2014/03/31,2012/02/09,166,7,0.54312664,9144,166,2,5
38513,2014/03/31,2008/09/09,112,7,0.539398284,9207,112,3,4
38514,2014/03/31,2012/12/31,14,9,0.60164284,8254,14,2,7
38515,2014/03/31,2012/11/20,124,5,0.655914674,7571,124,0,5
38516,2014/03/31,2005/12/20,474,3,0.7,7094,474,3,0
38517,2014/03/31,2005/09/02,194,6,0.512358646,9692,194,5,1
38518,2014/03/31,2012/10/23,303,4,0.8669134079999999,5728,303,1,3
38519,2014/03/31,2011/06/11,620,6,0.961207898,5166,620,6,0
38520,2014/03/31,2012/09/15,79,6,0.510384457,9728,79,0,6
38521,2014/03/31,2006/01/04,233,7,0.6473621070000001,7669,233,0,7
38522,2014/03/31,2011/03/13,287,4,1.038681733,4779,287,2,2
38523,2014/03/31,2011/01/30,437,4,0.75,6618,437,4,0
38524,2014/03/31,2013/02/27,68,5,0.789195421,6289,68,0,5
38525,2014/03/31,2010/08/26,616,4,0.972995491,5101,616,4,0
38526,2014/03/31,2012/07/20,582,3,0.649777429,7638,582,3,0
38527,2014/03/31,2007/11/19,25,11,0.517352236,9593,25,5,6
38528,2014/03/31,2012/06/19,26,5,0.613967586,8083,26,3,2
38529,2014/03/31,2007/03/06,21,6,0.5486379220000001,9045,21,0,6
38530,2014/03/31,2011/02/03,200,10,0.745862017,6653,200,3,7
38531,2014/03/31,2012/07/22,612,2,1.5,3308,612,2,0
38532,2014/03/31,2011/10/17,249,6,0.699875864,7089,249,4,2
38533,2014/03/31,2012/12/08,337,4,0.460754086,10768,337,0,4
38534,2014/03/31,2013/03/18,124,3,1.033148688,4802,124,0,3
38535,2014/03/31,2009/07/28,103,8,0.481504416,10303,103,4,4
38536,2014/03/31,2010/01/02,146,7,0.726771169,6826,146,4,3
38537,2014/03/31,2012/02/11,598,3,0.682178218,7272,598,3,0
38538,2014/03/31,2008/05/01,72,7,0.542067534,9151,72,2,5
38539,2014/03/31,2010/12/13,199,6,0.691916585,7169,199,3,3
38540,2014/03/31,2010/11/17,557,4,0.531463624,9333,557,4,0
38541,2014/03/31,2013/01/17,434,2,1.0,4960,434,2,0
38542,2014/03/31,2008/01/21,448,5,0.657388999,7545,448,5,0
38543,2014/03/31,2007/07/19,2,4,0.635876923,7800,2,0,4
38544,2014/03/31,2013/02/25,6,7,0.808799739,6132,6,0,7
38545,2014/03/31,2005/07/10,497,5,1.069779983,4636,497,5,0
38546,2014/03/31,2009/12/10,22,6,0.7296513170000001,6797,22,1,5
38547,2014/03/31,2011/07/07,319,13,0.390338449,12705,319,12,1
38548,2014/03/31,2013/01/22,298,4,0.6553912239999999,7566,298,2,2
38549,2014/03/31,2010/09/06,432,3,0.8889655790000001,5578,432,3,0
38550,2014/03/31,2013/02/06,230,3,0.666655015,7438,230,0,3
38551,2014/03/31,2012/10/13,86,5,0.7011170809999999,7072,86,3,2
38552,2014/03/31,2013/01/23,85,3,0.783795447,6326,85,1,2
38553,2014/03/31,2012/08/04,459,5,0.7073762309999999,7009,459,5,0
38554,2014/03/31,2011/11/25,283,7,0.6959792220000001,7123,283,6,1
38555,2014/03/31,2011/03/14,368,4,1.0,4957,368,4,0
38556,2014/03/31,2011/09/06,406,4,0.938273708,5283,406,4,0
38557,2014/03/31,2013/02/11,123,5,0.674496462,7348,123,1,4
38558,2014/03/31,2011/02/02,97,4,0.583278399,8495,97,1,3
38559,2014/03/31,2012/04/06,9,4,0.853846949,5802,9,2,2
38560,2014/03/31,2012/09/15,86,6,0.4355076920000001,11375,86,1,5
38561,2014/03/31,2009/03/31,436,5,0.688683442,7193,436,5,0
38562,2014/03/31,2012/01/25,58,4,0.456201879,10858,58,0,4
38563,2014/03/31,2011/06/12,91,8,0.510514327,9702,91,7,1
38564,2014/03/31,2010/03/12,20,6,0.779357986,6355,20,0,6
38565,2014/03/31,2011/12/25,319,6,0.47227043,10487,319,4,2
38566,2014/03/31,2012/04/27,512,12,0.612711864,8083,512,12,0
38567,2014/03/31,2005/06/19,300,5,0.593993522,8336,300,3,2
38568,2014/03/31,2011/01/15,3,8,0.48125,10288,3,1,7
38569,2014/03/31,2012/06/13,123,9,0.550365718,8996,123,1,8
38570,2014/03/31,2008/01/09,69,25,0.7492433409999999,6608,69,14,11
38571,2014/03/31,2008/01/21,169,9,0.629568922,7864,169,8,1
38572,2014/03/31,2008/10/08,12,6,0.7666274390000001,6458,12,3,3
38573,2014/03/31,2011/01/14,471,4,1.02558525,4827,471,4,0
38574,2014/03/31,2009/12/03,10,8,0.473788285,10448,10,4,4
38575,2014/03/31,2007/05/29,475,3,0.7333333329999999,6750,475,3,0
38576,2014/03/31,2011/12/05,553,6,0.572835648,8640,553,6,0
38577,2014/03/31,2010/07/08,44,6,0.8851439809999999,5591,44,5,1
38578,2014/03/31,2012/04/26,535,5,0.910469181,5435,535,5,0
38579,2014/03/31,2012/08/22,55,5,0.482884747,10247,55,2,3
38580,2014/03/31,2011/04/21,46,7,0.629676763,7858,46,0,7
38581,2014/03/31,2007/07/10,182,5,0.5619364,8805,182,1,4
38582,2014/03/31,2012/07/23,45,5,0.604422184,8186,45,3,2
38583,2014/03/31,2012/07/15,336,3,0.6333333329999999,7812,336,2,1
38584,2014/03/31,2013/02/16,367,3,0.483333333,10236,367,3,0
38585,2014/03/31,2011/05/28,71,6,0.50196347,9855,71,2,4
38586,2014/03/31,2012/09/07,84,3,0.952230991,5195,84,2,1
38587,2014/03/31,2010/02/26,88,6,0.61236816,8078,88,0,6
38588,2014/03/31,2010/09/18,324,6,0.6932585840000001,7135,324,5,1
38589,2014/03/31,2011/03/03,88,6,0.762325832,6488,88,5,1
38590,2014/03/31,2009/09/14,173,4,0.633102036,7811,173,3,1
38591,2014/03/31,2012/03/12,30,7,0.429221422,11521,30,0,7
38592,2014/03/31,2011/08/21,568,2,0.9,5494,568,2,0
38593,2014/03/31,2006/03/16,76,4,0.757246133,6529,76,0,4
38594,2014/03/31,2009/03/12,74,8,0.499853387,9890,74,1,7
38595,2014/03/31,2010/10/01,180,3,0.67273816,7348,180,0,3
38596,2014/03/31,2011/02/28,272,7,0.871805996,5670,272,6,1
38597,2014/03/31,2007/08/09,173,5,0.532234306,9287,173,2,3
38598,2014/03/31,2006/11/10,33,7,0.910941762,5426,33,5,2
38599,2014/03/31,2013/02/03,409,3,0.45,10983,409,3,0
38600,2014/03/31,2012/09/03,65,2,0.765,6460,65,1,1
38601,2014/03/31,2012/01/23,372,6,0.950894747,5197,372,6,0
38602,2014/03/31,2013/03/16,203,6,0.59387814,8321,203,0,6
38603,2014/03/31,2012/05/15,2,13,0.35517286,13913,2,7,6
38604,2014/03/31,2011/07/20,224,4,0.691088112,7150,224,3,1
38605,2014/03/31,2012/10/17,165,6,0.75393195,6554,165,2,4
38606,2014/03/31,2010/02/05,24,5,0.739344606,6683,24,4,1
38607,2014/03/31,2009/03/01,9,4,0.590948451,8361,9,2,2
38608,2014/03/31,2012/10/26,196,6,0.579026134,8533,196,3,3
38609,2014/03/31,2008/05/16,310,6,0.784238095,6300,310,4,2
38610,2014/03/31,2013/01/09,42,5,0.941553269,5247,42,0,5
38611,2014/03/31,2012/12/25,200,3,0.6318879510000001,7818,200,1,2
38612,2014/03/31,2007/03/14,141,4,0.5905558879999999,8365,141,2,2
38613,2014/03/31,2008/03/22,614,2,1.0,4940,614,2,0
38614,2014/03/31,2010/12/20,12,8,0.670259159,7370,12,3,5
38615,2014/03/31,2011/01/14,76,5,0.703964657,7017,76,2,3
38616,2014/03/31,2012/07/05,158,4,0.486564224,10152,158,1,3
38617,2014/03/31,2013/02/12,45,4,0.768177294,6430,45,2,2
38618,2014/03/31,2009/10/17,555,3,0.7838914459999999,6301,555,3,0
38619,2014/03/31,2010/10/17,77,5,0.571325622,8645,77,3,2
38620,2014/03/31,2009/12/11,127,4,0.808363339,6110,127,2,2
38621,2014/03/31,2009/11/02,282,6,0.7937817420000001,6222,282,4,2
38622,2014/03/31,2013/01/12,123,8,0.529912017,9320,123,4,4
38623,2014/03/31,2010/10/04,714,2,0.875,5644,714,2,0
38624,2014/03/31,2009/08/27,634,2,0.8262506270000001,5977,634,2,0
38625,2014/03/31,2011/02/04,49,8,0.6113406779999999,8078,49,3,5
38626,2014/03/31,2008/12/08,77,4,0.5621675770000001,8784,77,2,2
38627,2014/03/31,2011/07/04,649,5,0.8770870340000001,5630,649,5,0
38628,2014/03/31,2010/04/18,31,5,0.502,9835,31,3,2
38629,2014/03/31,2009/12/11,233,7,0.598585112,8248,233,5,2
38630,2014/03/31,2012/09/18,40,7,0.439658888,11228,40,1,6
38631,2014/03/31,2007/09/05,207,6,0.811721756,6081,207,2,4
38632,2014/03/31,2013/03/15,191,5,0.683749827,7219,191,0,5
38633,2014/03/31,2012/03/29,702,2,0.945555556,5220,702,2,0
38634,2014/03/31,2012/07/20,436,4,0.489754912,10078,436,4,0
38635,2014/03/31,2011/01/27,23,5,0.4320000000000001,11425,23,3,2
38636,2014/03/31,2012/05/02,688,5,0.584832326,8439,688,5,0
38637,2014/03/31,2010/11/29,448,7,0.834610181,5913,448,7,0
38638,2014/03/31,2010/05/29,42,2,1.41,3500,42,0,2
38639,2014/03/31,2011/06/11,275,6,0.6380527539999999,7734,275,4,2
38640,2014/03/31,2012/05/12,652,5,0.560055612,8811,652,5,0
38641,2014/03/31,2009/12/23,117,4,0.884012899,5582,117,3,1
38642,2014/03/31,2011/12/18,4,7,0.7177439999999999,6875,4,4,3
38643,2014/03/31,2009/10/24,174,10,0.60625384,8139,174,6,4
38644,2014/03/31,2010/10/09,119,4,0.7579827929999999,6509,119,2,2
38645,2014/03/31,2011/05/07,203,4,0.795876754,6199,203,3,1
38646,2014/03/31,2010/08/02,71,4,0.7214916640000001,6838,71,0,4
38647,2014/03/31,2008/07/09,51,5,0.724335634,6811,51,1,4
38648,2014/03/31,2007/08/01,659,5,0.72946917,6763,659,5,0
38649,2014/03/31,2013/03/01,346,4,0.7125,6924,346,2,2
38650,2014/03/31,2012/04/10,585,4,0.775683962,6360,585,4,0
38651,2014/03/31,2005/07/25,31,4,0.922117757,5350,31,0,4
38652,2014/03/31,2007/09/09,342,6,0.902212875,5468,342,5,1
38653,2014/03/31,2009/08/26,25,4,0.634157347,7779,25,0,4
38654,2014/03/31,2005/05/14,47,5,0.8225679509999999,5997,47,1,4
38655,2014/03/31,2010/09/05,192,6,0.550535714,8960,192,4,2
38656,2014/03/31,2011/03/05,241,4,1.217940741,4050,241,3,1
38657,2014/03/31,2012/04/16,285,4,0.7090856809999999,6956,285,2,2
38658,2014/03/31,2012/03/01,243,5,0.579120582,8517,243,3,2
38659,2014/03/31,2012/11/04,275,6,0.455218274,10835,275,2,4
38660,2014/03/31,2006/08/20,99,4,0.52,9485,99,3,1
38661,2014/03/31,2012/02/27,64,6,0.8531482440000001,5781,64,3,3
38662,2014/03/31,2008/02/20,3,4,0.719358226,6856,3,0,4
38663,2014/03/31,2009/01/11,97,8,0.549390665,8977,97,7,1
38664,2014/03/31,2011/07/03,475,3,0.881438785,5595,475,3,0
38665,2014/03/31,2006/08/13,217,9,0.5509596689999999,8951,217,7,2
38666,2014/03/31,2008/10/28,56,6,0.889792494,5542,56,2,4
38667,2014/03/31,2011/07/11,67,4,0.7044600000000001,7000,67,1,3
38668,2014/03/31,2010/01/17,284,8,0.43259321,11399,284,4,4
38669,2014/03/31,2008/02/01,190,5,0.57578468,8564,190,1,4
38670,2014/03/31,2006/11/14,160,4,0.827968094,5955,160,0,4
38671,2014/03/31,2006/05/07,238,3,0.783333333,6294,238,0,3
38672,2014/03/31,2012/03/21,357,5,0.32546378800000003,15147,357,3,2
38673,2014/03/31,2010/06/27,206,6,0.6703209139999999,7354,206,4,2
38674,2014/03/31,2012/11/14,43,6,0.581699316,8474,43,2,4
38675,2014/03/31,2011/04/08,197,9,0.672031633,7334,197,6,3
38676,2014/03/31,2008/09/15,20,7,0.524155057,9403,20,5,2
38677,2014/03/31,2010/07/23,620,3,0.854472954,5768,620,3,0
38678,2014/03/31,2013/03/16,105,5,0.6161865470000001,7998,105,0,5
38679,2014/03/31,2013/02/28,154,5,0.7578837279999999,6502,154,1,4
38680,2014/03/31,2011/04/17,284,4,0.626380625,7866,284,0,4
38681,2014/03/31,2011/04/17,161,2,0.675,7298,161,0,2
38682,2014/03/31,2008/05/24,589,3,0.760654725,6476,589,3,0
38683,2014/03/31,2009/07/26,660,3,0.724518312,6799,660,3,0
38684,2014/03/31,2013/02/14,157,6,0.5970990420000001,8249,157,2,4
38685,2014/03/31,2007/05/11,11,7,0.335145988,14693,11,2,5
38686,2014/03/31,2007/02/07,63,9,0.732823757,6718,63,7,2
38687,2014/03/31,2012/12/25,221,5,0.6329454870000001,7778,221,0,5
38688,2014/03/31,2011/12/31,80,5,0.747614275,6585,80,3,2
38689,2014/03/31,2011/10/08,446,4,0.608491965,8090,446,4,0
38690,2014/03/31,2005/09/20,37,7,0.710126947,6932,37,4,3
38691,2014/03/31,2009/01/12,127,7,0.391182548,12583,127,0,7
38692,2014/03/31,2012/10/18,403,5,0.664713032,7405,403,5,0
38693,2014/03/31,2012/05/25,56,6,0.756973239,6502,56,5,1
38694,2014/03/31,2009/10/01,61,3,0.531198187,9264,61,0,3
38695,2014/03/31,2011/01/04,149,8,0.478131558,10292,149,6,2
38696,2014/03/31,2005/08/16,334,5,0.629177854,7821,334,2,3
38697,2014/03/31,2007/07/30,189,5,0.561398745,8765,189,2,3
38698,2014/03/31,2013/03/17,185,5,0.5101555210000001,9645,185,2,3
38699,2014/03/31,2012/08/18,78,5,0.6844922090000001,7188,78,1,4
38700,2014/03/31,2012/02/18,346,6,0.460161803,10692,346,5,1
38701,2014/03/31,2008/08/31,230,2,0.775,6348,230,0,2
38702,2014/03/31,2006/04/07,122,3,0.5253694999999999,9364,122,1,2
38703,2014/03/31,2010/11/15,308,8,0.6118843279999999,8040,308,6,2
38704,2014/03/31,2008/03/16,577,5,0.913386558,5386,577,5,0
38705,2014/03/31,2012/01/16,600,3,0.626755001,7849,600,3,0
38706,2014/03/31,2012/08/01,191,6,0.753898851,6525,191,1,5
38707,2014/03/31,2009/11/28,520,2,0.85,5786,520,2,0
38708,2014/03/31,2012/12/01,210,4,0.771188647,6377,210,1,3
38709,2014/03/31,2012/12/16,116,4,0.87502847,5620,116,2,2
38710,2014/03/31,2010/05/16,5,7,0.847279462,5804,5,3,4
38711,2014/03/31,2013/01/01,256,4,0.7703650320000001,6383,256,0,4
38712,2014/03/31,2011/10/08,128,6,0.511881116,9606,128,3,3
38713,2014/03/31,2012/07/05,501,8,0.601455657,8175,501,8,0
38714,2014/03/31,2006/09/01,148,3,1.157652461,4247,148,0,3
38715,2014/03/31,2009/12/10,217,2,0.58,8476,217,0,2
38716,2014/03/31,2011/11/30,304,5,0.422983135,11622,304,4,1
38717,2014/03/31,2012/11/16,116,7,0.826618463,5947,116,5,2
38718,2014/03/31,2011/07/06,517,4,1.074737648,4574,517,4,0
38719,2014/03/31,2012/06/18,240,5,0.879338104,5590,240,4,1
38720,2014/03/31,2013/03/15,5,8,0.382145856,12862,5,0,8
38721,2014/03/31,2012/09/16,12,6,0.5121717379999999,9596,12,2,4
38722,2014/03/31,2010/06/04,165,4,0.707978969,6942,165,2,2
38723,2014/03/31,2008/11/17,21,5,0.760544723,6462,21,1,4
38724,2014/03/31,2011/11/01,147,3,0.762949853,6441,147,0,3
38725,2014/03/31,2008/05/11,580,7,0.8503374290000001,5779,580,7,0
38726,2014/03/31,2012/07/27,353,4,0.75,6552,353,2,2
38727,2014/03/31,2008/05/19,256,10,0.629348105,7808,256,8,2
38728,2014/03/31,2010/03/23,219,2,0.822124812,5977,219,0,2
38729,2014/03/31,2006/09/29,289,6,0.7760170559999999,6332,289,4,2
38730,2014/03/31,2010/02/15,58,8,0.569045744,8635,58,2,6
38731,2014/03/31,2009/07/23,42,5,0.677369727,7254,42,2,3
38732,2014/03/31,2010/06/10,2,10,0.659899275,7446,2,5,5
38733,2014/03/31,2012/06/17,440,6,0.739516857,6644,440,6,0
38734,2014/03/31,2007/12/04,470,5,0.778505784,6311,470,5,0
38735,2014/03/31,2010/05/11,56,6,0.795890167,6173,56,2,4
38736,2014/03/31,2012/05/10,9,6,0.6753656859999999,7274,9,1,5
38737,2014/03/31,2007/02/20,336,2,1.5,3275,336,1,1
38738,2014/03/31,2008/06/06,433,2,1.5,3275,433,2,0
38739,2014/03/31,2012/03/27,49,11,0.8806651129999999,5578,49,7,4
38740,2014/03/31,2013/01/28,248,6,0.718221962,6839,248,2,4
38741,2014/03/31,2007/03/29,47,5,0.4638017,10590,47,3,2
38742,2014/03/31,2013/02/16,112,4,0.592596525,8288,112,2,2
38743,2014/03/31,2012/12/05,203,6,0.607454545,8085,203,1,5
38744,2014/03/31,2011/12/04,300,5,0.883952484,5556,300,3,2
38745,2014/03/31,2012/07/26,109,5,0.774333018,6342,109,4,1
38746,2014/03/31,2008/10/08,90,7,0.76028797,6459,90,3,4
38747,2014/03/31,2006/11/28,362,3,0.826544353,5941,362,2,1
38748,2014/03/31,2011/09/11,4,6,0.832686112,5897,4,3,3
38749,2014/03/31,2008/03/20,5,3,0.58,8466,5,0,3
38750,2014/03/31,2012/03/27,34,3,0.58,8466,34,0,3
38751,2014/03/31,2005/06/02,49,6,0.680923717,7210,49,0,6
38752,2014/03/31,2012/02/08,250,5,0.650397456,7548,250,1,4
38753,2014/03/31,2007/12/05,127,5,0.654748566,7497,127,2,3
38754,2014/03/31,2012/08/31,256,2,0.650153663,7549,256,1,1
38755,2014/03/31,2006/06/16,198,5,0.513405168,9559,198,4,1
38756,2014/03/31,2012/09/12,64,10,0.544444198,9014,64,5,5
38757,2014/03/31,2007/09/19,664,9,0.6449730579999999,7609,664,9,0
38758,2014/03/31,2008/02/13,217,5,0.7884816840000001,6224,217,0,5
38759,2014/03/31,2012/10/30,40,7,0.584562239,8395,40,1,6
38760,2014/03/31,2013/01/25,135,7,0.662888018,7403,135,2,5
38761,2014/03/31,2007/11/08,61,5,0.661366577,7420,61,1,4
38762,2014/03/31,2010/08/23,100,4,0.7005438970000001,7005,100,2,2
38763,2014/03/31,2008/09/14,27,6,0.417730484,11747,27,1,5
38764,2014/03/31,2011/12/05,48,6,0.520535752,9426,48,2,4
38765,2014/03/31,2010/03/16,256,6,0.7449703870000001,6585,256,5,1
38766,2014/03/31,2008/05/09,232,5,0.6447752370000001,7608,232,0,5
38767,2014/03/31,2012/08/29,20,7,0.7542857140000001,6503,20,4,3
38768,2014/03/31,2007/03/02,121,2,0.905,5420,121,0,2
38769,2014/03/31,2011/03/24,9,6,0.713228152,6877,9,4,2
38770,2014/03/31,2009/07/27,4,10,0.410168088,11958,4,4,6
38771,2014/03/31,2012/04/04,269,7,0.506200846,9689,269,6,1
38772,2014/03/31,2009/07/20,9,8,0.465971496,10525,9,0,8
38773,2014/03/31,2007/03/08,633,3,0.795748824,6163,633,3,0
38774,2014/03/31,2005/08/15,382,6,0.887262529,5527,382,6,0
38775,2014/03/31,2006/04/22,398,5,0.7934466020000001,6180,398,5,0
38776,2014/03/31,2007/02/25,111,9,0.821873952,5966,111,4,5
38777,2014/03/31,2013/02/01,120,5,0.7976248579999999,6147,120,0,5
38778,2014/03/31,2011/09/11,593,3,1.0,4903,593,3,0
38779,2014/03/31,2010/06/20,339,5,0.525399207,9331,339,2,3
38780,2014/03/31,2006/01/19,46,5,0.7190363740000001,6818,46,0,5
38781,2014/03/31,2013/02/09,118,6,0.628101217,7805,118,1,5
38782,2014/03/31,2010/11/22,540,4,0.805984873,6082,540,4,0
38783,2014/03/31,2010/01/13,74,5,0.696481955,7038,74,1,4
38784,2014/03/31,2008/12/09,455,6,0.696674247,7036,455,6,0
38785,2014/03/31,2013/02/06,57,3,0.96,5106,57,2,1
38786,2014/03/31,2008/04/05,378,6,0.616184789,7955,378,6,0
38787,2014/03/31,2006/11/05,173,3,0.786666667,6231,173,0,3
38788,2014/03/31,2012/07/01,82,5,0.417458479,11741,82,3,2
38789,2014/03/31,2009/08/14,33,4,0.856083843,5725,33,2,2
38790,2014/03/31,2011/05/05,131,8,0.963041855,5089,131,4,4
38791,2014/03/31,2012/07/25,140,8,0.604590993,8105,140,1,7
38792,2014/03/31,2006/06/21,14,4,0.979028971,5005,14,2,2
38793,2014/03/31,2013/01/02,235,6,0.756111111,6480,235,2,4
38794,2014/03/31,2012/11/11,5,3,0.647143046,7571,5,1,2
38795,2014/03/31,2011/10/01,49,4,0.798746332,6134,49,0,4
38796,2014/03/31,2009/06/27,244,6,0.794314202,6168,244,2,4
38797,2014/03/31,2007/03/01,534,5,0.709089593,6909,534,5,0
38798,2014/03/31,2013/03/16,159,4,0.591826749,8277,159,1,3
38799,2014/03/31,2012/10/07,154,3,0.526272698,9307,154,1,2
38800,2014/03/31,2010/10/19,4,5,0.601051663,8149,4,1,4
38801,2014/03/31,2007/01/18,662,4,0.662774019,7390,662,4,0
38802,2014/03/31,2011/09/19,75,3,0.83,5901,75,0,3
38803,2014/03/31,2013/01/22,102,4,0.6225,7868,102,2,2
38804,2014/03/31,2011/11/07,82,4,0.6970936520000001,7026,82,1,3
38805,2014/03/31,2012/07/19,162,9,0.462839728,10582,162,6,3
38806,2014/03/31,2010/07/09,243,9,0.71455421,6853,243,8,1
38807,2014/03/31,2009/03/11,104,4,0.7913332259999999,6188,104,3,1
38808,2014/03/31,2012/08/14,4,5,0.842646705,5811,4,3,2
38809,2014/03/31,2007/11/11,14,5,0.668748976,7322,14,0,5
38810,2014/03/31,2010/03/02,82,6,0.7827354120000001,6255,82,4,2
38811,2014/03/31,2010/11/17,508,9,0.944444444,5184,508,9,0
38812,2014/03/31,2011/10/05,150,6,0.452742741,10814,150,5,1
38813,2014/03/31,2005/09/25,3,6,0.653608812,7490,3,1,5
38814,2014/03/31,2009/08/04,330,4,0.880942955,5557,330,3,1
38815,2014/03/31,2010/09/27,412,4,0.70112432,6982,412,4,0
38816,2014/03/31,2008/02/09,42,6,0.7706234259999999,6352,42,3,3
38817,2014/03/31,2006/11/01,38,8,0.286506877,17085,38,2,6
38818,2014/03/31,2013/02/10,190,4,0.534031202,9166,190,0,4
38819,2014/03/31,2013/02/25,48,5,0.651991475,7507,48,0,5
38820,2014/03/31,2007/09/21,568,4,0.7525757340000001,6503,568,4,0
38821,2014/03/31,2013/01/10,6,9,0.532252556,9194,6,4,5
38822,2014/03/31,2007/02/23,20,8,0.61581928,7946,20,1,7
38823,2014/03/31,2008/04/21,5,4,0.973138425,5028,5,2,2
38824,2014/03/31,2012/12/27,177,7,0.334285714,14637,177,2,5
38825,2014/03/31,2006/05/17,423,6,0.660221293,7411,423,6,0
38826,2014/03/31,2012/10/09,44,7,0.652984119,7493,44,1,6
38827,2014/03/31,2007/11/04,514,5,0.520618282,9397,514,5,0
38828,2014/03/31,2010/12/03,127,2,0.82,5966,127,0,2
38829,2014/03/31,2013/01/23,5,8,0.790952304,6185,5,4,4
38830,2014/03/31,2007/05/21,461,5,0.936985252,5221,461,5,0
38831,2014/03/31,2008/11/24,70,7,0.550510916,8886,70,3,4
38832,2014/03/31,2012/04/10,99,6,0.757229102,6460,99,4,2
38833,2014/03/31,2013/03/09,344,2,0.75,6522,344,1,1
38834,2014/03/31,2012/05/22,222,5,0.6716890959999999,7282,222,4,1
38835,2014/03/31,2012/03/31,658,6,0.862797672,5669,658,6,0
38836,2014/03/31,2012/01/05,187,6,0.813113882,6015,187,3,3
38837,2014/03/31,2005/09/15,232,8,0.516775148,9464,232,5,3
38838,2014/03/31,2012/06/08,27,6,0.674650297,7249,27,0,6
38839,2014/03/31,2011/09/03,211,4,0.7505386740000001,6516,211,2,2
38840,2014/03/31,2008/04/16,385,2,0.98419199,4969,385,2,0
38841,2014/03/31,2006/04/20,207,5,0.797524462,6132,207,2,3
38842,2014/03/31,2013/01/13,379,4,0.491309153,9953,379,4,0
38843,2014/03/31,2011/08/19,558,3,0.747706422,6540,558,3,0
38844,2014/03/31,2010/06/13,687,2,0.925,5286,687,2,0
38845,2014/03/31,2006/03/31,161,8,0.465603276,10501,161,4,4
38846,2014/03/31,2012/07/08,126,3,1.009481726,4843,126,1,2
38847,2014/03/31,2010/03/09,187,3,0.55846356,8754,187,0,3
38848,2014/03/31,2010/08/25,44,14,0.7905206990000001,6184,44,10,4
38849,2014/03/31,2010/11/17,297,8,0.6028675379999999,8108,297,7,1
38850,2014/03/31,2005/11/11,21,5,0.678974858,7199,21,2,3
38851,2014/03/31,2007/12/04,14,4,1.126168203,4340,14,1,3
38852,2014/03/31,2007/01/04,12,8,0.769790518,6349,12,0,8
38853,2014/03/31,2012/07/25,29,8,0.5752224579999999,8496,29,2,6
38854,2014/03/31,2009/01/16,60,4,0.864644374,5652,60,3,1
38855,2014/03/31,2013/02/27,43,3,0.763333333,6402,43,1,2
38856,2014/03/31,2009/08/14,203,6,0.679414627,7192,203,4,2
38857,2014/03/31,2007/12/12,146,9,0.408451893,11963,146,1,8
38858,2014/03/31,2011/05/22,42,6,0.595154689,8210,42,1,5
38859,2014/03/31,2007/04/26,466,6,0.617167761,7916,466,6,0
38860,2014/03/31,2012/08/25,244,8,0.638074713,7656,244,7,1
38861,2014/03/31,2006/04/07,289,3,0.948175466,5152,289,2,1
38862,2014/03/31,2009/10/03,426,5,0.972526379,5023,426,5,0
38863,2014/03/31,2005/09/24,169,9,0.532712105,9170,169,6,3
38864,2014/03/31,2010/01/26,47,4,0.550294018,8877,47,1,3
38865,2014/03/31,2013/01/19,211,3,0.5902416629999999,8276,211,1,2
38866,2014/03/31,2009/12/17,609,4,0.565543592,8637,609,4,0
38867,2014/03/31,2008/09/09,414,7,0.654765416,7460,414,7,0
38868,2014/03/31,2012/07/18,594,4,0.8872116259999999,5505,594,4,0
38869,2014/03/31,2011/07/13,50,4,0.7225773040000001,6759,50,2,2
38870,2014/03/31,2006/11/14,115,4,0.65212979,7489,115,3,1
38871,2014/03/31,2010/07/23,74,7,0.940412093,5193,74,0,7
38872,2014/03/31,2008/10/13,614,5,0.78942774,6186,614,5,0
38873,2014/03/31,2013/02/28,70,4,0.97124105,5028,70,2,2
38874,2014/03/31,2012/08/06,221,7,0.6844078490000001,7135,221,3,4
38875,2014/03/31,2007/11/10,182,4,0.8153974620000001,5988,182,3,1
38876,2014/03/31,2012/02/10,283,7,0.7325626409999999,6665,283,4,3
38877,2014/03/31,2010/11/29,171,6,0.628527291,7768,171,3,3
38878,2014/03/31,2009/11/06,557,6,0.83129576,5873,557,6,0
38879,2014/03/31,2008/02/20,125,3,0.854544022,5713,125,0,3
38880,2014/03/31,2006/07/13,268,5,0.612338184,7972,268,3,2
38881,2014/03/31,2011/03/16,120,6,0.449532185,10859,120,2,4
38882,2014/03/31,2012/04/12,13,6,0.620177868,7871,13,0,6
38883,2014/03/31,2010/06/13,30,6,0.593021504,8231,30,1,5
38884,2014/03/31,2012/05/13,188,6,0.7245531470000001,6736,188,5,1
38885,2014/03/31,2012/09/14,15,8,0.94,5192,15,1,7
38886,2014/03/31,2011/04/15,13,10,0.5555510020000001,8784,13,6,4
38887,2014/03/31,2009/01/28,45,7,0.530006517,9207,45,2,5
38888,2014/03/31,2006/06/13,40,6,0.494953849,9859,40,2,4
38889,2014/03/31,2010/09/10,40,5,0.6035922810000001,8084,40,0,5
38890,2014/03/31,2010/09/30,537,4,0.775,6296,537,4,0
38891,2014/03/31,2010/06/01,491,5,0.512477681,9521,491,5,0
38892,2014/03/31,2011/10/31,69,6,0.581592562,8389,69,1,5
38893,2014/03/31,2008/07/20,76,4,0.9325,5232,76,0,4
38894,2014/03/31,2008/06/07,2,7,0.434351852,11232,2,3,4
38895,2014/03/31,2010/06/24,580,3,0.826666667,5901,580,3,0
38896,2014/03/31,2005/12/13,74,7,0.821650665,5937,74,4,3
38897,2014/03/31,2008/04/04,521,2,0.9,5420,521,2,0
38898,2014/03/31,2007/09/27,626,2,1.369071008,3563,626,2,0
38899,2014/03/31,2007/11/03,578,2,1.369071008,3563,578,2,0
38900,2014/03/31,2007/12/31,30,2,0.9,5420,30,0,2
38901,2014/03/31,2009/03/20,258,7,0.535686361,9106,258,4,3
38902,2014/03/31,2008/07/26,218,2,0.92,5302,218,0,2
38903,2014/03/31,2012/01/21,145,6,0.412033283,11838,145,4,2
38904,2014/03/31,2008/03/04,74,4,0.515031154,9469,74,3,1
38905,2014/03/31,2012/02/04,18,9,0.522693462,9330,18,3,6
38906,2014/03/31,2011/07/11,9,6,0.8006074540000001,6091,9,4,2
38907,2014/03/31,2006/12/16,221,6,0.554796313,8788,221,3,3
38908,2014/03/31,2012/06/24,110,8,0.7856647859999999,6205,110,0,8
38909,2014/03/31,2005/08/28,14,4,0.8354498709999999,5835,14,0,4
38910,2014/03/31,2007/03/01,221,7,0.578852868,8421,221,5,2
38911,2014/03/31,2012/07/01,44,4,0.486198504,10025,44,0,4
38912,2014/03/31,2010/05/11,37,5,0.492016959,9906,37,3,2
38913,2014/03/31,2012/01/12,382,2,0.575,8476,382,2,0
38914,2014/03/31,2011/10/30,467,3,0.75,6498,467,3,0
38915,2014/03/31,2012/10/17,520,4,0.971411483,5016,520,4,0
38916,2014/03/31,2009/04/15,12,8,0.520058704,9369,12,1,7
38917,2014/03/31,2012/11/13,80,6,0.718429667,6782,80,2,4
38918,2014/03/31,2006/07/29,61,8,0.7109805920000001,6853,61,3,5
38919,2014/03/31,2011/07/08,34,3,0.759865876,6412,34,2,1
38920,2014/03/31,2007/03/16,340,2,1.5,3248,340,0,2
38921,2014/03/31,2009/11/06,666,5,0.8199966340000001,5941,666,5,0
38922,2014/03/31,2012/10/14,145,11,0.472405935,10312,145,4,7
38923,2014/03/31,2013/01/15,1,3,0.608762809,8002,1,0,3
38924,2014/03/31,2007/08/06,88,10,0.403838501,12062,88,6,4
38925,2014/03/31,2007/06/09,192,11,0.393780419,12369,192,7,4
38926,2014/03/31,2011/10/10,104,4,0.652782842,7460,104,2,2
38927,2014/03/31,2012/09/24,458,10,0.524520681,9284,458,10,0
38928,2014/03/31,2006/05/29,156,8,0.510547285,9538,156,4,4
38929,2014/03/31,2008/12/04,1,9,0.542134269,8982,1,8,1
38930,2014/03/31,2011/08/19,329,3,0.8271445559999999,5887,329,1,2
38931,2014/03/31,2012/11/25,67,4,0.963796516,5052,67,1,3
38932,2014/03/31,2004/12/01,40,4,0.817054875,5959,40,0,4
38933,2014/03/31,2011/04/06,44,7,0.5559860679999999,8757,44,1,6
38934,2014/03/31,2009/07/24,146,2,1.41,3453,146,0,2
38935,2014/03/31,2007/09/28,315,6,0.700194161,6953,315,4,2
38936,2014/03/31,2012/07/27,35,4,0.636971085,7643,35,2,2
38937,2014/03/31,2013/01/05,40,14,0.389332214,12504,40,7,7
38938,2014/03/31,2006/06/25,176,7,0.512632687,9496,176,4,3
38939,2014/03/31,2011/09/30,540,6,0.636480126,7648,540,6,0
38940,2014/03/31,2006/06/23,17,4,0.58,8392,17,0,4
38941,2014/03/31,2011/07/27,23,6,0.7869571540000001,6185,23,4,2
38942,2014/03/31,2011/12/15,162,4,0.785371954,6197,162,1,3
38943,2014/03/31,2011/07/29,33,3,0.8791166909999999,5536,33,1,2
38944,2014/03/31,2012/06/08,153,5,0.694300185,7009,153,2,3
38945,2014/03/31,2012/05/15,282,5,0.69359179,7016,282,3,2
38946,2014/03/31,2006/06/22,158,4,0.688779901,7065,158,2,2
38947,2014/03/31,2011/10/06,80,6,0.831938793,5849,80,5,1
38948,2014/03/31,2013/02/03,38,5,0.844306785,5763,38,0,5
38949,2014/03/31,2010/01/29,70,6,0.585031862,8317,70,3,3
38950,2014/03/31,2009/06/04,47,6,0.561381101,8667,47,0,6
38951,2014/03/31,2005/11/25,238,5,0.65,7485,238,4,1
38952,2014/03/31,2012/10/15,312,5,0.65,7485,312,2,3
38953,2014/03/31,2011/08/13,590,3,1.019488684,4772,590,3,0
38954,2014/03/31,2011/01/20,39,5,0.6791456090000001,7163,39,3,2
38955,2014/03/31,2006/03/09,34,3,0.447019575,10881,34,2,1
38956,2014/03/31,2007/04/15,156,5,0.492040465,9885,156,3,2
38957,2014/03/31,2010/09/17,251,5,0.862438376,5639,251,4,1
38958,2014/03/31,2007/05/11,42,7,0.817843929,5946,42,1,6
38959,2014/03/31,2008/03/10,152,3,1.049784111,4632,152,0,3
38960,2014/03/31,2007/11/09,26,9,0.511709114,9502,26,0,9
38961,2014/03/31,2012/05/18,202,4,0.637247706,7630,202,3,1
38962,2014/03/31,2011/01/24,323,6,0.55105973,8823,323,5,1
38963,2014/03/31,2012/01/07,14,6,0.419243705,11596,14,4,2
38964,2014/03/31,2009/11/18,56,7,0.624552929,7784,56,1,6
38965,2014/03/31,2008/02/10,58,5,0.807932525,6017,58,4,1
38966,2014/03/31,2012/04/30,694,3,0.7051349,6894,694,3,0
38967,2014/03/31,2008/04/27,12,6,0.728580635,6672,12,5,1
38968,2014/03/31,2009/04/20,266,9,0.7443040879999999,6531,266,6,3
38969,2014/03/31,2007/07/27,16,2,0.686550847,7080,16,0,2
38970,2014/03/31,2012/03/12,213,6,0.652274557,7452,213,2,4
38971,2014/03/31,2012/07/28,122,6,0.8348694609999999,5822,122,1,5
38972,2014/03/31,2007/08/08,9,8,0.556767468,8730,9,1,7
38973,2014/03/31,2008/09/14,127,9,0.50889331,9551,127,3,6
38974,2014/03/31,2012/09/24,90,3,0.78,6231,90,1,2
38975,2014/03/31,2011/02/20,437,2,0.8274987229999999,5873,437,2,0
38976,2014/03/31,2012/04/24,23,4,0.407429362,11927,23,3,1
38977,2014/03/31,2011/02/03,69,7,0.755832944,6429,69,3,4
38978,2014/03/31,2012/04/11,85,8,0.70875,6856,85,1,7
38979,2014/03/31,2012/09/19,498,3,1.0,4859,498,3,0
38980,2014/03/31,2013/03/25,188,3,1.4463054480000002,3359,188,1,2
38981,2014/03/31,2012/12/26,259,6,0.640561709,7584,259,0,6
38982,2014/03/31,2009/08/04,11,3,0.914817326,5310,11,0,3
38983,2014/03/31,2011/08/20,601,6,0.887881557,5471,601,6,0
38984,2014/03/31,2008/03/03,131,8,0.961460808,5052,131,4,4
38985,2014/03/31,2011/12/12,27,7,0.553574196,8774,27,4,3
38986,2014/03/31,2011/05/22,250,5,0.8830909090000001,5500,250,3,2
38987,2014/03/31,2012/08/19,245,2,0.94656792,5131,245,1,1
38988,2014/03/31,2010/09/12,224,9,0.552719927,8787,224,0,9
38989,2014/03/31,2010/03/25,91,6,0.8708194370000001,5577,91,5,1
38990,2014/03/31,2009/07/08,20,7,0.6887689690000001,7051,20,6,1
38991,2014/03/31,2005/09/09,323,6,0.769163763,6314,323,4,2
38992,2014/03/31,2011/08/01,187,4,0.586315345,8283,187,0,4
38993,2014/03/31,2013/01/15,103,3,0.616809348,7873,103,1,2
38994,2014/03/31,2012/10/15,98,9,0.652578954,7441,98,3,6
38995,2014/03/31,2011/04/20,136,6,0.470653291,10317,136,1,5
38996,2014/03/31,2012/07/09,565,3,0.8661434179999999,5606,565,3,0
38997,2014/03/31,2010/10/26,564,4,0.603755285,8042,564,4,0
38998,2014/03/31,2007/11/01,57,6,0.515031293,9427,57,3,3
38999,2014/03/31,2010/02/25,82,8,0.633588673,7663,82,6,2
39000,2014/03/31,2008/08/14,568,3,0.8669017859999999,5600,568,3,0
39001,2014/03/31,2009/01/05,158,5,0.7522640629999999,6453,158,1,4
39002,2014/03/31,2012/08/21,540,6,0.94220691,5152,540,6,0
39003,2014/03/31,2006/09/29,253,6,0.682215039,7115,253,5,1
39004,2014/03/31,2012/01/22,527,5,0.657710027,7380,527,5,0
39005,2014/03/31,2011/08/10,194,7,0.61886268,7843,194,2,5
39006,2014/03/31,2012/04/16,397,3,0.561866173,8638,397,3,0
39007,2014/03/31,2009/11/11,217,3,0.8162237170000001,5945,217,0,3
39008,2014/03/31,2013/01/20,167,2,0.634689339,7645,167,0,2
39009,2014/03/31,2012/01/28,357,4,0.7963148390000001,6092,357,1,3
39010,2014/03/31,2005/05/22,44,6,0.588299782,8246,44,4,2
39011,2014/03/31,2007/12/03,119,2,0.895,5420,119,0,2
39012,2014/03/31,2006/08/10,103,2,0.895,5420,103,0,2
39013,2014/03/31,2010/10/12,80,2,0.895,5420,80,0,2
39014,2014/03/31,2007/04/12,67,2,0.895,5420,67,0,2
39015,2014/03/31,2007/11/24,105,2,0.895,5420,105,0,2
39016,2014/03/31,2010/03/01,115,2,0.895,5420,115,0,2
39017,2014/03/31,2011/02/01,14,6,0.742746899,6531,14,5,1
39018,2014/03/31,2007/03/08,58,5,0.753060084,6441,58,0,5
39019,2014/03/31,2012/10/08,316,5,0.643945831,7532,316,4,1
39020,2014/03/31,2010/08/09,402,5,0.750681009,6461,402,5,0
39021,2014/03/31,2008/05/06,218,4,0.6961518590000001,6967,218,0,4
39022,2014/03/31,2012/02/21,683,3,1.167268351,4155,683,3,0
39023,2014/03/31,2011/07/06,8,6,0.541333854,8959,8,3,3
39024,2014/03/31,2012/11/23,103,4,0.59,8220,103,0,4
39025,2014/03/31,2007/05/16,90,9,0.711211321,6819,90,7,2
39026,2014/03/31,2007/01/04,187,5,0.601950341,8055,187,1,4
39027,2014/03/31,2013/02/28,38,5,0.622021809,7795,38,0,5
39028,2014/03/31,2005/08/04,69,7,0.922525214,5255,69,1,6
39029,2014/03/31,2008/10/25,145,4,0.628441794,7714,145,2,2
39030,2014/03/31,2008/10/09,97,5,0.63377435,7649,97,2,3
39031,2014/03/31,2005/06/27,3,3,0.676958525,7161,3,2,1
39032,2014/03/31,2010/09/13,697,2,1.25,3878,697,2,0
39033,2014/03/31,2009/11/11,25,5,0.6939770940000001,6985,25,3,2
39034,2014/03/31,2011/08/15,255,5,0.646122367,7502,255,4,1
39035,2014/03/31,2005/05/29,500,4,0.819945864,5911,500,4,0
39036,2014/03/31,2007/07/25,94,6,0.742374387,6528,94,0,6
39037,2014/03/31,2007/11/01,2,8,0.551605009,8785,2,3,5
39038,2014/03/31,2009/12/09,575,2,0.75,6460,575,2,0
39039,2014/03/31,2010/12/28,624,2,0.75,6460,624,2,0
39040,2014/03/31,2012/07/16,583,2,0.75,6460,583,2,0
39041,2014/03/31,2012/04/29,697,2,0.75,6460,697,2,0
39042,2014/03/31,2011/05/24,23,10,0.4560754970000001,10623,23,7,3
39043,2014/03/31,2012/05/29,339,8,0.571977568,8470,339,6,2
39044,2014/03/31,2012/01/17,103,4,0.848301523,5711,103,2,2
39045,2014/03/31,2012/07/03,36,6,0.5662782,8555,36,4,2
39046,2014/03/31,2009/03/31,11,9,0.642325643,7542,11,7,2
39047,2014/03/31,2012/05/17,186,3,0.706666667,6855,186,1,2
39048,2014/03/31,2012/07/25,394,6,0.708734455,6835,394,6,0
39049,2014/03/31,2010/08/26,3,7,0.6973740279999999,6946,3,0,7
39050,2014/03/31,2013/03/05,38,5,0.369338824,13113,38,0,5
39051,2014/03/31,2007/02/21,98,6,0.446565237,10845,98,5,1
39052,2014/03/31,2012/05/12,15,4,0.774252598,6255,15,2,2
39053,2014/03/31,2012/09/11,246,3,0.906518158,5342,246,2,1
39054,2014/03/31,2008/10/14,151,6,0.480986293,10068,151,3,3
39055,2014/03/31,2009/11/26,177,8,0.88919574,5446,177,5,3
39056,2014/03/31,2008/09/10,260,3,0.751179026,6446,260,2,1
39057,2014/03/31,2012/10/24,11,8,0.475685234,10179,11,3,5
39058,2014/03/31,2012/01/10,64,7,0.550570844,8794,64,0,7
39059,2014/03/31,2011/12/07,173,5,0.520924352,9293,173,0,5
39060,2014/03/31,2011/01/21,3,4,0.67136061,7210,3,0,4
39061,2014/03/31,2013/03/30,61,5,0.612443376,7903,61,1,4
39062,2014/03/31,2011/10/31,153,5,0.893837488,5415,153,3,2
39063,2014/03/31,2010/01/12,562,4,0.67534887,7166,562,4,0
39064,2014/03/31,2012/03/08,204,5,0.6080248770000001,7959,204,4,1
39065,2014/03/31,2010/01/01,156,2,0.92,5260,156,0,2
39066,2014/03/31,2011/11/19,138,5,0.5291525420000001,9145,138,3,2
39067,2014/03/31,2010/11/19,113,3,0.908916228,5324,113,0,3
39068,2014/03/31,2011/03/13,79,5,0.657298289,7362,79,3,2
39069,2014/03/31,2007/09/11,5,3,0.82,5901,5,0,3
39070,2014/03/31,2006/10/31,134,3,0.82,5901,134,0,3
39071,2014/03/31,2012/07/10,451,7,0.5687294310000001,8508,451,7,0
39072,2014/03/31,2008/01/23,427,3,0.924808869,5232,427,3,0
39073,2014/03/31,2006/06/07,97,8,0.572939017,8445,97,1,7
39074,2014/03/31,2012/03/13,141,3,0.790359418,6121,141,2,1
39075,2014/03/31,2006/08/30,239,6,0.6117946120000001,7907,239,4,2
39076,2014/03/31,2011/12/08,24,6,0.667935653,7242,24,5,1
39077,2014/03/31,2011/06/20,569,3,0.901602982,5365,569,3,0
39078,2014/03/31,2005/06/11,3,8,0.675350461,7162,3,4,4
39079,2014/03/31,2013/02/06,2,6,0.719980649,6718,2,2,4
39080,2014/03/31,2007/09/17,217,5,0.600141457,8059,217,2,3
39081,2014/03/31,2012/01/21,427,4,0.404457267,11958,427,4,0
39082,2014/03/31,2007/06/11,267,7,0.614276642,7873,267,3,4
39083,2014/03/31,2012/08/06,330,4,0.7363124240000001,6568,330,1,3
39084,2014/03/31,2012/09/19,102,10,0.492571807,9818,102,6,4
39085,2014/03/31,2012/12/03,402,4,0.603594608,8012,402,4,0
39086,2014/03/31,2009/12/22,557,2,0.8709113829999999,5552,557,2,0
39087,2014/03/31,2006/12/16,33,3,1.483067485,3260,33,2,1
39088,2014/03/31,2009/04/19,89,3,0.507242682,9531,89,0,3
39089,2014/03/31,2011/09/08,662,5,0.66,7325,662,5,0
39090,2014/03/31,2008/06/06,325,5,0.525633359,9197,325,4,1
39091,2014/03/31,2011/06/09,32,5,0.78591286,6151,32,0,5
39092,2014/03/31,2009/09/09,8,5,0.672437057,7189,8,2,3
39093,2014/03/31,2009/10/01,69,2,0.7076679840000001,6831,69,1,1
39094,2014/03/31,2011/03/14,34,5,0.585085936,8262,34,2,3
39095,2014/03/31,2008/11/04,246,7,0.582543987,8298,246,5,2
39096,2014/03/31,2010/10/15,2,7,0.573040901,8435,2,2,5
39097,2014/03/31,2011/07/12,49,2,0.63,7672,49,0,2
39098,2014/03/31,2013/02/28,31,3,0.936666667,5160,31,1,2
39099,2014/03/31,2012/07/20,125,10,0.542507858,8908,125,6,4
39100,2014/03/31,2012/12/05,60,10,0.665707398,7259,60,3,7
39101,2014/03/31,2006/05/03,91,6,0.658596156,7337,91,0,6
39102,2014/03/31,2011/06/20,22,4,0.6481982829999999,7454,22,0,4
39103,2014/03/31,2013/01/29,425,2,0.85,5684,425,2,0
39104,2014/03/31,2012/10/08,496,2,0.85,5684,496,2,0
39105,2014/03/31,2012/08/28,437,2,0.85,5684,437,2,0
39106,2014/03/31,2008/03/20,132,2,0.85,5684,132,0,2
39107,2014/03/31,2012/04/10,696,2,0.85,5684,696,2,0
39108,2014/03/31,2006/06/25,570,8,0.533085071,9063,570,8,0
39109,2014/03/31,2013/03/26,317,5,0.645099479,7489,317,2,3
39110,2014/03/31,2012/11/13,235,4,0.656721044,7356,235,2,2
39111,2014/03/31,2012/10/20,78,2,0.7512286159999999,6430,78,1,1
39112,2014/03/31,2010/03/27,273,4,0.5847627120000001,8260,273,2,2
39113,2014/03/31,2010/09/13,446,2,1.5,3220,446,2,0
39114,2014/03/31,2011/05/28,233,3,0.708719002,6815,233,1,2
39115,2014/03/31,2008/05/07,177,4,0.669916771,7209,177,2,2
39116,2014/03/31,2008/12/20,113,4,0.754656978,6399,113,0,4
39117,2014/03/31,2012/10/02,227,6,0.7016797440000001,6882,227,2,4
39118,2014/03/31,2010/10/10,171,3,0.7303342909999999,6611,171,0,3
39119,2014/03/31,2011/08/23,152,2,1.0407156709999998,4639,152,0,2
39120,2014/03/31,2011/01/14,34,3,0.931988417,5180,34,2,1
39121,2014/03/31,2013/01/25,16,6,0.6,8046,16,3,3
39122,2014/03/31,2012/08/29,189,6,0.499751553,9660,189,4,2
39123,2014/03/31,2012/05/24,361,4,0.568330586,8494,361,3,1
39124,2014/03/31,2012/08/17,10,6,0.668793295,7218,10,4,2
39125,2014/03/31,2007/09/29,44,9,0.566625191,8519,44,2,7
39126,2014/03/31,2012/08/31,31,6,0.441202925,10940,31,3,3
39127,2014/03/31,2009/04/05,614,5,0.924636015,5220,614,5,0
39128,2014/03/31,2013/02/02,207,5,0.78105195,6179,207,1,4
39129,2014/03/31,2006/04/05,464,3,0.594511519,8117,464,3,0
39130,2014/03/31,2011/12/19,85,4,0.685642228,7038,85,0,4
39131,2014/03/31,2012/09/16,497,4,0.7071815920000001,6823,497,4,0
39132,2014/03/31,2008/06/30,330,5,0.7175936940000001,6724,330,4,1
39133,2014/03/31,2008/04/03,252,4,0.739819074,6522,252,2,2
39134,2014/03/31,2006/12/06,229,6,0.74633256,6465,229,4,2
39135,2014/03/31,2011/10/19,103,5,0.475861525,10139,103,3,2
39136,2014/03/31,2006/05/27,214,6,0.549706016,8776,214,3,3
39137,2014/03/31,2009/10/16,109,6,0.7080343509999999,6812,109,0,6
39138,2014/03/31,2010/07/20,194,6,0.460565317,10472,194,1,5
39139,2014/03/31,2005/10/15,18,6,0.924628067,5216,18,2,4
39140,2014/03/31,2012/07/11,34,4,0.749914477,6431,34,2,2
39141,2014/03/31,2013/01/10,38,4,0.7362809159999999,6550,38,0,4
39142,2014/03/31,2006/12/11,319,6,0.6070682279999999,7944,319,4,2
39143,2014/03/31,2007/01/01,311,6,0.630804447,7645,311,5,1
39144,2014/03/31,2009/11/02,297,6,0.743180767,6489,297,5,1
39145,2014/03/31,2012/06/24,27,6,0.754561102,6391,27,3,3
39146,2014/03/31,2009/09/05,83,7,0.604730374,7974,83,0,7
39147,2014/03/31,2009/11/13,116,8,0.92875,5192,116,3,5
39148,2014/03/31,2012/05/10,14,8,0.552670487,8725,14,6,2
39149,2014/03/31,2010/03/17,2,7,0.620998068,7765,2,1,6
39150,2014/03/31,2007/07/23,109,7,0.589807951,8175,109,3,4
39151,2014/03/31,2012/04/20,701,4,0.468025626,10302,701,4,0
39152,2014/03/31,2008/12/05,240,5,0.725645695,6644,240,4,1
39153,2014/03/31,2011/01/10,372,4,0.527115679,9146,372,4,0
39154,2014/03/31,2012/11/05,491,4,0.527115679,9146,491,4,0
39155,2014/03/31,2012/01/02,469,5,0.632650919,7620,469,5,0
39156,2014/03/31,2012/08/19,233,2,0.79,6102,233,1,1
39157,2014/03/31,2008/10/27,320,3,0.663158619,7269,320,0,3
39158,2014/03/31,2006/03/29,56,7,0.543569415,8867,56,1,6
39159,2014/03/31,2006/04/08,287,4,0.733320146,6572,287,1,3
39160,2014/03/31,2012/11/22,37,4,0.63011114,7648,37,2,2
39161,2014/03/31,2007/12/29,90,7,0.659310345,7308,90,3,4
39162,2014/03/31,2012/06/16,104,6,0.571553974,8430,104,2,4
39163,2014/03/31,2007/08/17,253,5,0.6790852709999999,7095,253,3,2
39164,2014/03/31,2008/09/16,279,7,0.801805625,6009,279,2,5
39165,2014/03/31,2012/02/22,289,4,0.722344828,6670,289,1,3
39166,2014/03/31,2008/01/20,688,2,1.0,4818,688,2,0
39167,2014/03/31,2012/11/17,499,2,1.0,4818,499,2,0
39168,2014/03/31,2009/10/09,630,2,1.0,4818,630,2,0
39169,2014/03/31,2011/02/05,107,6,0.795,6060,107,2,4
39170,2014/03/31,2010/07/16,139,5,0.800410435,6018,139,2,3
39171,2014/03/31,2012/03/21,73,2,0.7369553240000001,6536,73,0,2
39172,2014/03/31,2010/08/13,180,2,0.66,7298,180,0,2
39173,2014/03/31,2008/03/31,148,5,0.53431329,9014,148,3,2
39174,2014/03/31,2012/04/07,593,5,0.434311869,11088,593,5,0
39175,2014/03/31,2010/12/20,236,7,0.683560477,7044,236,5,2
39176,2014/03/31,2008/06/09,334,5,0.800216055,6017,334,4,1
39177,2014/03/31,2006/09/30,95,8,0.559329693,8608,95,2,6
39178,2014/03/31,2011/08/03,2,7,0.6782053809999999,7099,2,2,5
39179,2014/03/31,2013/03/18,3,15,0.553333333,8700,3,0,15
39180,2014/03/31,2010/06/19,27,2,0.70992479,6781,27,0,2
39181,2014/03/31,2011/05/28,355,6,0.8496028940000001,5666,355,5,1
39182,2014/03/31,2010/04/28,145,6,0.553355558,8699,145,5,1
39183,2014/03/31,2010/11/05,208,7,0.586933301,8201,208,4,3
39184,2014/03/31,2011/06/07,361,4,0.587985585,8186,361,2,2
39185,2014/03/31,2010/09/23,129,4,0.7191915720000001,6692,129,0,4
39186,2014/03/31,2008/11/21,229,8,0.683802217,7038,229,3,5
39187,2014/03/31,2006/03/01,652,4,0.638274307,7539,652,4,0
39188,2014/03/31,2012/02/08,169,4,1.441986815,3337,169,0,4
39189,2014/03/31,2010/02/28,25,8,0.716040179,6720,25,0,8
39190,2014/03/31,2008/06/02,374,6,0.8746864209999999,5501,374,6,0
39191,2014/03/31,2007/09/16,89,8,0.507868904,9474,89,2,6
39192,2014/03/31,2005/09/09,221,4,0.7488793770000001,6425,221,0,4
39193,2014/03/31,2012/05/19,515,6,0.698736567,6886,515,6,0
39194,2014/03/31,2011/05/08,4,3,0.643333333,7479,4,2,1
39195,2014/03/31,2010/05/19,238,7,0.653378599,7364,238,3,4
39196,2014/03/31,2005/02/08,139,8,0.448575424,10726,139,6,2
39197,2014/03/31,2007/09/10,39,3,0.5872281220000001,8193,39,0,3
39198,2014/03/31,2006/01/28,138,3,0.988498048,4867,138,1,2
39199,2014/03/31,2007/10/21,229,5,0.764471635,6293,229,1,4
39200,2014/03/31,2011/01/07,644,3,0.7621673000000001,6312,644,3,0
39201,2014/03/31,2006/05/06,145,6,0.583378608,8246,145,3,3
39202,2014/03/31,2008/08/07,136,4,0.7213195379999999,6669,136,3,1
39203,2014/03/31,2012/07/26,488,5,0.7401677179999999,6499,488,5,0
39204,2014/03/31,2008/09/30,178,6,0.62169704,7737,178,4,2
39205,2014/03/31,2012/06/08,222,7,0.488664025,9843,222,5,2
39206,2014/03/31,2012/07/19,612,3,0.535405766,8983,612,3,0
39207,2014/03/31,2010/11/25,521,4,0.7573937009999999,6350,521,4,0
39208,2014/03/31,2007/07/24,112,8,0.637002649,7550,112,6,2
39209,2014/03/31,2009/12/21,12,5,0.649026859,7409,12,2,3
39210,2014/03/31,2011/03/01,414,4,0.66994566,7177,414,4,0
39211,2014/03/31,2009/02/27,617,3,0.634377886,7579,617,3,0
39212,2014/03/31,2012/06/25,238,8,0.6775,7096,238,4,4
39213,2014/03/31,2010/05/10,55,6,0.75897695,6334,55,4,2
39214,2014/03/31,2012/05/26,51,7,0.388028089,12389,51,5,2
39215,2014/03/31,2006/05/11,586,4,0.868639321,5534,586,4,0
39216,2014/03/31,2010/09/12,119,6,0.829627201,5794,119,3,3
39217,2014/03/31,2012/08/01,600,3,0.928792271,5175,600,3,0
39218,2014/03/31,2007/05/23,23,7,0.48170475,9978,23,1,6
39219,2014/03/31,2009/02/19,14,6,0.505886749,9501,14,4,2
39220,2014/03/31,2012/04/25,120,4,0.586274701,8198,120,3,1
39221,2014/03/31,2006/08/14,138,4,1.268775079,3788,138,1,3
39222,2014/03/31,2011/12/22,14,4,0.80909244,5939,14,0,4
39223,2014/03/31,2005/05/11,253,4,0.8314552690000001,5779,253,2,2
39224,2014/03/31,2010/04/23,258,8,0.825283408,5822,258,5,3
39225,2014/03/31,2011/09/02,13,8,0.448,10725,13,5,3
39226,2014/03/31,2013/03/01,43,7,0.817605514,5876,43,2,5
39227,2014/03/31,2008/02/16,102,6,0.867479234,5538,102,2,4
39228,2014/03/31,2009/08/05,223,3,0.77684185,6184,223,1,2
39229,2014/03/31,2008/06/23,11,3,0.6962284390000001,6899,11,0,3
39230,2014/03/31,2013/02/18,204,9,0.478885344,10030,204,2,7
39231,2014/03/31,2009/09/13,500,8,0.766182804,6269,500,8,0
39232,2014/03/31,2005/05/03,203,2,0.845,5684,203,0,2
39233,2014/03/31,2011/04/25,76,7,0.422122704,11377,76,4,3
39234,2014/03/31,2010/01/16,126,3,1.163333333,4128,126,0,3
39235,2014/03/31,2011/12/28,121,4,0.960744298,4998,121,3,1
39236,2014/03/31,2010/06/23,601,9,0.713491828,6730,601,9,0
39237,2014/03/31,2005/09/15,309,3,0.85303784,5629,309,2,1
39238,2014/03/31,2010/12/12,534,3,0.75,6402,534,3,0
39239,2014/03/31,2012/11/20,93,9,0.493896718,9721,93,0,9
39240,2014/03/31,2007/04/08,156,5,0.41787797,11489,156,2,3
39241,2014/03/31,2008/03/14,60,6,0.723361458,6637,60,1,5
39242,2014/03/31,2012/10/24,14,13,0.525492063,9135,14,2,11
39243,2014/03/31,2007/05/26,62,4,0.517096844,9283,62,2,2
39244,2014/03/31,2013/03/09,34,4,0.7119400770000001,6742,34,1,3
39245,2014/03/31,2011/08/17,355,4,0.6760811379999999,7099,355,3,1
39246,2014/03/31,2007/12/21,174,6,0.840386973,5711,174,5,1
39247,2014/03/31,2012/07/10,526,3,0.8368439409999999,5735,526,3,0
39248,2014/03/31,2012/12/28,155,7,0.566880463,8466,155,1,6
39249,2014/03/31,2006/03/01,358,4,0.890499165,5389,358,3,1
39250,2014/03/31,2008/02/03,19,7,0.657895531,7294,19,0,7
39251,2014/03/31,2012/09/02,11,3,0.475040095,10101,11,2,1
39252,2014/03/31,2011/03/30,320,4,0.6857367440000001,6997,320,0,4
39253,2014/03/31,2011/01/04,200,4,0.86061704,5575,200,3,1
39254,2014/03/31,2008/09/20,49,3,0.77,6231,49,0,3
39255,2014/03/31,2007/07/28,88,2,1.155,4154,88,0,2
39256,2014/03/31,2012/12/12,123,7,0.5727399710000001,8376,123,5,2
39257,2014/03/31,2012/05/07,433,5,0.498762737,9618,433,5,0
39258,2014/03/31,2007/05/30,454,7,0.534793757,8970,454,7,0
39259,2014/03/31,2009/12/22,432,7,1.0,4797,432,7,0
39260,2014/03/31,2008/07/03,44,2,1.41,3402,44,0,2
39261,2014/03/31,2012/11/30,132,2,0.885,5420,132,1,1
39262,2014/03/31,2011/04/01,234,4,0.686986537,6982,234,2,2
39263,2014/03/31,2012/12/25,67,6,0.542965018,8833,67,2,4
39264,2014/03/31,2009/10/12,392,2,0.941869599,5092,392,2,0
39265,2014/03/31,2006/02/14,289,2,1.4640549619999998,3275,289,0,2
39266,2014/03/31,2010/09/14,14,8,0.397736209,12055,14,2,6
39267,2014/03/31,2006/03/15,73,9,0.487513981,9835,73,7,2
39268,2014/03/31,2011/06/07,58,4,0.5321911420000001,9009,58,0,4
39269,2014/03/31,2008/07/30,10,3,0.819372757,5851,10,0,3
39270,2014/03/31,2006/04/22,109,6,0.570498631,8403,109,3,3
39271,2014/03/31,2006/11/29,161,4,0.908092442,5279,161,0,4
39272,2014/03/31,2009/07/09,383,4,0.727648755,6588,383,4,0
39273,2014/03/31,2012/08/15,482,4,0.5369063620000001,8928,482,4,0
39274,2014/03/31,2009/07/14,21,9,0.669572566,7159,21,2,7
39275,2014/03/31,2011/07/25,28,6,0.449629456,10660,28,2,4
39276,2014/03/31,2011/11/24,204,6,0.590707419,8114,204,3,3
39277,2014/03/31,2010/12/09,210,7,0.6328931729999999,7573,210,2,5
39278,2014/03/31,2011/10/21,324,4,0.538334082,8902,324,3,1
39279,2014/03/31,2013/01/08,35,6,0.638590085,7504,35,0,6
39280,2014/03/31,2010/09/24,123,10,0.401,11950,123,7,3
39281,2014/03/31,2007/06/11,590,7,0.642929022,7453,590,7,0
39282,2014/03/31,2011/01/14,199,4,0.686569709,6979,199,2,2
39283,2014/03/31,2008/09/30,550,4,0.904056604,5300,550,4,0
39284,2014/03/31,2009/04/11,66,6,0.763333333,6276,66,1,5
39285,2014/03/31,2010/04/04,48,4,0.7374753690000001,6496,48,0,4
39286,2014/03/31,2009/11/05,321,7,0.666914938,7183,321,6,1
39287,2014/03/31,2006/05/20,31,7,0.628332896,7624,31,3,4
39288,2014/03/31,2008/12/07,4,9,0.586908846,8162,4,1,8
39289,2014/03/31,2012/08/30,300,4,1.137755344,4210,300,3,1
39290,2014/03/31,2012/07/22,50,6,0.608861065,7867,50,1,5
39291,2014/03/31,2005/07/08,352,4,0.6801618859999999,7042,352,3,1
39292,2014/03/31,2009/11/18,109,5,0.71992184,6653,109,1,4
39293,2014/03/31,2011/04/29,69,7,0.675493653,7090,69,3,4
39294,2014/03/31,2012/10/30,241,6,0.458735632,10440,241,4,2
39295,2014/03/31,2006/03/29,104,5,0.527726722,9075,104,4,1
39296,2014/03/31,2009/06/19,13,6,0.573318966,8352,13,4,2
39297,2014/03/31,2011/02/01,101,9,0.6910405540000001,6929,101,0,9
39298,2014/03/31,2012/01/22,471,7,0.720680313,6644,471,7,0
39299,2014/03/31,2011/09/14,52,3,0.629103929,7611,52,0,3
39300,2014/03/31,2009/11/23,307,2,1.169108669,4095,307,1,1
39301,2014/03/31,2008/04/09,262,6,0.71475963,6698,262,5,1
39302,2014/03/31,2011/09/05,18,4,0.83071317,5763,18,2,2
39303,2014/03/31,2012/09/03,556,3,0.762179589,6281,556,3,0
39304,2014/03/31,2013/01/01,96,3,0.796666667,6009,96,1,2
39305,2014/03/31,2006/08/02,369,2,1.0,4787,369,2,0
39306,2014/03/31,2008/09/07,118,5,0.6448726929999999,7423,118,1,4
39307,2014/03/31,2006/08/07,167,4,0.7942176870000001,6027,167,2,2
39308,2014/03/31,2012/05/19,28,6,0.620822309,7710,28,4,2
39309,2014/03/31,2009/01/20,322,4,0.567766046,8429,322,3,1
39310,2014/03/31,2012/07/29,241,2,1.2,3988,241,1,1
39311,2014/03/31,2006/01/15,248,7,0.546186508,8761,248,3,4
39312,2014/03/31,2007/02/02,266,7,0.467296875,10240,266,6,1
39313,2014/03/31,2011/05/30,309,5,0.969171562,4937,309,4,1
39314,2014/03/31,2011/08/06,218,5,0.879658025,5439,218,1,4
39315,2014/03/31,2010/06/21,158,4,0.72535476,6596,158,3,1
39316,2014/03/31,2007/05/22,298,3,0.657196429,7280,298,0,3
39317,2014/03/31,2012/08/30,1,7,0.7201972,6643,1,2,5
39318,2014/03/31,2013/02/22,159,5,0.450273882,10625,159,2,3
39319,2014/03/31,2010/11/09,263,3,1.087261364,4400,263,2,1
39320,2014/03/31,2008/09/20,71,5,0.954104507,5014,71,2,3
39321,2014/03/31,2011/08/18,316,7,0.707035176,6766,316,6,1
39322,2014/03/31,2012/12/19,73,6,0.8360048929999999,5722,73,1,5
39323,2014/03/31,2012/02/27,16,6,0.539905192,8860,16,3,3
39324,2014/03/31,2011/05/10,46,7,0.700863004,6825,46,3,4
39325,2014/03/31,2009/08/19,173,3,0.6526388320000001,7329,173,1,2
39326,2014/03/31,2008/03/01,27,3,0.695833576,6874,27,0,3
39327,2014/03/31,2012/08/10,37,5,0.565542154,8457,37,2,3
39328,2014/03/31,2011/10/02,259,4,0.7066622340000001,6768,259,3,1
39329,2014/03/31,2006/10/24,50,4,0.760095359,6292,50,1,3
39330,2014/03/31,2006/05/24,431,5,0.619087379,7725,431,5,0
39331,2014/03/31,2012/09/06,202,4,0.5669073020000001,8436,202,3,1
39332,2014/03/31,2005/06/24,492,4,0.543752132,8795,492,4,0
39333,2014/03/31,2011/10/06,142,8,0.76625641,6240,142,2,6
39334,2014/03/31,2012/10/12,65,4,0.50956304,9383,65,2,2
39335,2014/03/31,2012/07/12,193,6,0.938041985,5097,193,3,3
39336,2014/03/31,2005/11/10,416,4,0.946357878,5052,416,4,0
39337,2014/03/31,2009/12/27,305,5,0.6638406,7202,305,3,2
39338,2014/03/31,2009/07/21,50,6,0.791367323,6041,50,3,3
39339,2014/03/31,2010/04/26,389,5,0.581086666,8227,389,5,0
39340,2014/03/31,2006/10/09,320,6,0.4993263,9574,320,2,4
39341,2014/03/31,2007/03/02,460,3,1.403464474,3406,460,3,0
39342,2014/03/31,2010/08/01,49,4,0.56,8536,49,2,2
39343,2014/03/31,2005/06/10,625,5,0.698947215,6839,625,5,0
39344,2014/03/31,2008/02/22,139,9,0.621917773,7686,139,6,3
39345,2014/03/31,2013/02/18,52,2,1.41,3390,52,0,2
39346,2014/03/31,2011/11/27,324,5,0.558251577,8562,324,3,2
39347,2014/03/31,2009/10/01,25,5,0.933296231,5121,25,1,4
39348,2014/03/31,2011/03/29,83,5,0.660309478,7238,83,2,3
39349,2014/03/31,2012/05/31,216,4,0.891660448,5360,216,1,3
39350,2014/03/31,2008/02/05,480,4,0.7142729040000001,6691,480,4,0
39351,2014/03/31,2008/09/13,230,2,1.18956933,4017,230,0,2
39352,2014/03/31,2011/12/11,397,3,0.7306574920000001,6540,397,3,0
39353,2014/03/31,2012/03/06,244,6,0.5980463079999999,7990,244,3,3
39354,2014/03/31,2009/03/21,702,3,0.577908805,8268,702,3,0
39355,2014/03/31,2011/12/07,226,3,0.844027557,5661,226,2,1
39356,2014/03/31,2012/10/24,102,7,0.577022947,8280,102,2,5
39357,2014/03/31,2012/06/06,37,5,0.745285491,6410,37,3,2
39358,2014/03/31,2011/11/18,68,6,0.540337066,8841,68,3,3
39359,2014/03/31,2008/04/18,89,3,0.7666666670000001,6231,89,0,3
39360,2014/03/31,2007/09/29,220,4,0.575,8308,220,1,3
39361,2014/03/31,2011/05/25,553,2,1.15,4154,553,2,0
39362,2014/03/31,2013/01/26,347,3,0.7666666670000001,6231,347,1,2
39363,2014/03/31,2005/10/08,49,4,0.684913966,6974,49,0,4
39364,2014/03/31,2011/07/15,13,8,0.473833333,10080,13,2,6
39365,2014/03/31,2012/04/26,114,7,0.758332804,6298,114,4,3
39366,2014/03/31,2012/05/12,16,4,0.57821528,8259,16,1,3
39367,2014/03/31,2008/11/20,188,7,0.444513637,10743,188,4,3
39368,2014/03/31,2012/08/01,338,5,0.703713528,6786,338,3,2
39369,2014/03/31,2012/05/23,36,6,0.685991955,6961,36,3,3
39370,2014/03/31,2012/06/04,110,3,0.880774765,5421,110,2,1
39371,2014/03/31,2012/10/07,80,5,0.934008216,5112,80,2,3
39372,2014/03/31,2011/12/30,46,3,0.56,8526,46,0,3
39373,2014/03/31,2009/03/05,677,4,0.9125,5232,677,4,0
39374,2014/03/31,2008/11/25,7,9,0.5885170120000001,8112,7,4,5
39375,2014/03/31,2012/12/27,80,4,0.694495199,6874,80,1,3
39376,2014/03/31,2007/06/28,100,5,0.8092761479999999,5899,100,1,4
39377,2014/03/31,2012/12/04,2,6,0.878511226,5434,2,2,4
39378,2014/03/31,2009/03/16,366,7,0.5821358870000001,8198,366,6,1
39379,2014/03/31,2011/09/29,214,4,0.848815368,5622,214,2,2
39380,2014/03/31,2005/03/23,506,6,0.658535744,7246,506,6,0
39381,2014/03/31,2006/06/06,349,5,0.80399326,5935,349,4,1
39382,2014/03/31,2011/12/22,96,10,0.53391786,8936,96,6,4
39383,2014/03/31,2012/03/08,335,8,0.91775683,5198,335,7,1
39384,2014/03/31,2009/08/20,249,6,0.965990279,4938,249,5,1
39385,2014/03/31,2012/07/31,172,4,0.966541033,4935,172,2,2
39386,2014/03/31,2008/06/22,52,2,0.88,5420,52,0,2
39387,2014/03/31,2012/05/31,496,7,0.727057927,6560,496,7,0
39388,2014/03/31,2010/09/30,428,7,0.558727741,8536,428,7,0
39389,2014/03/31,2012/08/01,356,7,0.935714286,5096,356,6,1
39390,2014/03/31,2012/02/15,403,4,0.740434783,6440,403,4,0
39391,2014/03/31,2012/08/31,177,6,0.750306845,6355,177,0,6
39392,2014/03/31,2007/07/05,277,3,0.895567243,5324,277,2,1
39393,2014/03/31,2009/07/31,227,3,0.966919489,4931,227,2,1
39394,2014/03/31,2009/06/25,387,4,0.609933478,7817,387,4,0
39395,2014/03/31,2013/01/23,65,6,0.56587181,8425,65,4,2
39396,2014/03/31,2008/08/24,169,6,0.680672473,7004,169,3,3
39397,2014/03/31,2005/07/02,220,5,0.842045575,5661,220,3,2
39398,2014/03/31,2012/05/22,44,2,0.72554879,6569,44,0,2
39399,2014/03/31,2012/06/03,537,4,0.525294831,9073,537,4,0
39400,2014/03/31,2005/04/02,27,5,0.7276897240000001,6549,27,4,1
39401,2014/03/31,2012/12/26,30,12,0.566172033,8417,30,0,12
39402,2014/03/31,2012/02/18,45,3,0.579099526,8229,45,0,3
39403,2014/03/31,2012/11/02,348,5,0.890691589,5350,348,2,3
39404,2014/03/31,2009/11/19,190,4,0.7461227690000001,6386,190,2,2
39405,2014/03/31,2010/11/14,11,4,0.468477876,10170,11,1,3
39406,2014/03/31,2009/02/12,69,4,0.7085425340000001,6724,69,1,3
39407,2014/03/31,2013/03/27,184,3,0.852271914,5590,184,0,3
39408,2014/03/31,2011/12/26,461,5,0.576691684,8261,461,5,0
39409,2014/03/31,2007/02/12,184,4,0.953291975,4997,184,3,1
39410,2014/03/31,2010/04/14,25,5,0.67953067,7010,25,0,5
39411,2014/03/31,2006/05/14,15,3,0.844221907,5642,15,0,3
39412,2014/03/31,2010/10/31,550,4,0.800865983,5947,550,4,0
39413,2014/03/31,2013/03/16,121,7,0.479512686,9932,121,0,7
39414,2014/03/31,2012/09/16,20,3,0.891683205,5341,20,1,2
39415,2014/03/31,2009/11/06,100,4,0.612652772,7773,100,2,2
39416,2014/03/31,2012/07/21,82,3,0.88154601,5401,82,0,3
39417,2014/03/31,2005/12/20,170,2,0.75,6348,170,0,2
39418,2014/03/31,2011/09/22,115,9,0.417555692,11402,115,5,4
39419,2014/03/31,2012/09/15,427,3,0.645545763,7375,427,3,0
39420,2014/03/31,2011/02/16,68,7,0.476918453,9982,68,6,1
39421,2014/03/31,2007/09/01,33,5,0.77016664,6181,33,3,2
39422,2014/03/31,2008/08/18,195,4,0.7839525690000001,6072,195,3,1
39423,2014/03/31,2010/03/05,596,2,0.71278826,6678,596,2,0
39424,2014/03/31,2009/12/17,688,4,0.737982633,6449,688,4,0
39425,2014/03/31,2011/10/07,217,6,0.503753573,9447,217,3,3
39426,2014/03/31,2005/09/25,415,5,0.670617249,7096,415,5,0
39427,2014/03/31,2011/08/22,340,6,0.611213873,7785,340,5,1
39428,2014/03/31,2010/04/07,593,5,0.8568791640000001,5553,593,5,0
39429,2014/03/31,2005/04/09,4,7,0.7633723729999999,6233,4,2,5
39430,2014/03/31,2008/07/13,120,7,0.538415752,8837,120,3,4
39431,2014/03/31,2005/04/08,67,7,0.731143384,6507,67,4,3
39432,2014/03/31,2007/04/26,165,5,0.758277016,6274,165,3,2
39433,2014/03/31,2012/08/06,599,2,0.9,5286,599,2,0
39434,2014/03/31,2013/03/11,4,9,0.678552275,7011,4,0,9
39435,2014/03/31,2007/08/01,125,6,0.788807826,6031,125,2,4
39436,2014/03/31,2004/11/05,96,4,0.70113633,6785,96,1,3
39437,2014/03/31,2009/10/11,199,2,0.81,5872,199,0,2
39438,2014/03/31,2012/06/24,516,5,0.6161808520000001,7719,516,5,0
39439,2014/03/31,2006/03/28,258,4,0.7117749179999999,6682,258,2,2
39440,2014/03/31,2013/02/21,145,6,0.64227684,7405,145,1,5
39441,2014/03/31,2010/10/21,584,4,0.57053143,8336,584,4,0
39442,2014/03/31,2012/12/30,49,7,0.787531048,6039,49,3,4
39443,2014/03/31,2011/11/21,1,5,0.37120512,12812,1,3,2
39444,2014/03/31,2006/10/01,95,8,0.52604116,9038,95,4,4
39445,2014/03/31,2006/09/12,200,4,0.61201725,7768,200,3,1
39446,2014/03/31,2008/09/04,498,6,0.746802828,6365,498,6,0
39447,2014/03/31,2006/05/13,27,14,0.554239739,8576,27,6,8
39448,2014/03/31,2010/06/08,6,4,0.638648213,7442,6,2,2
39449,2014/03/31,2009/04/12,172,4,0.52,9140,172,2,2
39450,2014/03/31,2010/10/27,429,5,0.648832765,7325,429,5,0
39451,2014/03/31,2008/06/27,177,4,0.680782123,6981,177,2,2
39452,2014/03/31,2012/02/22,169,5,0.748900095,6346,169,0,5
39453,2014/03/31,2012/09/19,196,5,0.8899456929999999,5340,196,1,4
39454,2014/03/31,2010/11/07,45,6,0.51,9318,45,4,2
39455,2014/03/31,2012/09/05,185,5,0.895762488,5305,185,3,2
39456,2014/03/31,2012/05/15,4,7,0.678063642,7008,4,3,4
39457,2014/03/31,2011/09/04,364,3,1.0,4750,364,2,1
39458,2014/03/31,2009/09/18,51,4,0.89804878,5289,51,0,4
39459,2014/03/31,2006/08/24,310,7,0.586623024,8096,310,3,4
39460,2014/03/31,2006/08/21,241,5,0.647233202,7337,241,2,3
39461,2014/03/31,2006/07/10,137,4,0.509113327,9327,137,0,4
39462,2014/03/31,2011/06/28,144,4,0.8143165840000001,5831,144,1,3
39463,2014/03/31,2011/02/11,592,2,0.945291658,5023,592,2,0
39464,2014/03/31,2009/03/26,394,4,0.634192601,7487,394,4,0
39465,2014/03/31,2009/08/24,14,2,1.275345152,3723,14,0,2
39466,2014/03/31,2007/09/04,162,4,0.989426845,4798,162,3,1
39467,2014/03/31,2009/11/04,51,5,0.7117513870000001,6669,51,0,5
39468,2014/03/31,2011/01/20,41,3,0.556666667,8526,41,1,2
39469,2014/03/31,2005/04/20,162,5,0.806028537,5887,162,2,3
39470,2014/03/31,2013/01/02,187,5,0.77965166,6086,187,1,4
39471,2014/03/31,2010/08/03,289,4,0.857981917,5530,289,1,3
39472,2014/03/31,2008/06/07,276,5,0.7165987009999999,6621,276,4,1
39473,2014/03/31,2012/02/27,55,5,0.676599629,7011,55,3,2
39474,2014/03/31,2007/11/15,32,5,0.53289181,8901,32,0,5
39475,2014/03/31,2009/05/22,66,7,0.6642563029999999,7140,66,6,1
39476,2014/03/31,2008/07/12,18,5,0.790715238,5998,18,2,3
39477,2014/03/31,2007/02/28,49,5,0.64852728,7313,49,0,5
39478,2014/03/31,2012/05/12,250,10,0.762958494,6216,250,4,6
39479,2014/03/31,2008/10/23,350,4,1.2,3952,350,0,4
39480,2014/03/31,2008/02/06,440,3,0.78915793,6009,440,3,0
39481,2014/03/31,2012/05/22,404,8,0.611063144,7760,404,8,0
39482,2014/03/31,2011/03/01,215,3,0.800037118,5927,215,0,3
39483,2014/03/31,2012/06/28,517,3,0.677683293,6997,517,3,0
39484,2014/03/31,2006/06/14,110,3,0.7533333329999999,6294,110,1,2
39485,2014/03/31,2011/04/19,565,4,0.947711373,5003,565,4,0
39486,2014/03/31,2011/03/24,501,7,0.714098509,6639,501,7,0
39487,2014/03/31,2012/06/10,67,8,0.7739934690000001,6125,67,2,6
39488,2014/03/31,2005/09/27,116,5,0.7545169509999999,6283,116,3,2
39489,2014/03/31,2007/06/28,66,3,0.803333333,5901,66,0,3
39490,2014/03/31,2012/09/27,80,6,0.716129325,6619,80,5,1
39491,2014/03/31,2011/09/15,279,4,0.652001376,7270,279,3,1
39492,2014/03/31,2011/12/26,48,5,1.032108014,4592,48,0,5
39493,2014/03/31,2007/12/09,107,4,0.659369695,7187,107,2,2
39494,2014/03/31,2010/11/17,27,5,0.518115023,9146,27,2,3
39495,2014/03/31,2007/01/09,251,6,0.717746138,6602,251,1,5
39496,2014/03/31,2006/06/22,7,9,0.654834163,7236,7,0,9
39497,2014/03/31,2011/06/20,2,5,0.546888273,8664,2,3,2
39498,2014/03/31,2005/09/09,316,4,0.6537113689999999,7248,316,2,2
39499,2014/03/31,2012/01/17,529,5,1.0,4738,529,5,0
39500,2014/03/31,2009/08/29,19,6,0.660897042,7168,19,1,5
39501,2014/03/31,2009/01/01,17,4,1.244996058,3805,17,1,3
39502,2014/03/31,2012/01/11,475,4,0.622899408,7605,475,4,0
39503,2014/03/31,2010/12/23,176,6,0.772485323,6132,176,4,2
39504,2014/03/31,2008/09/23,729,2,0.95,4986,729,2,0
39505,2014/03/31,2010/09/15,34,6,0.6976933270000001,6789,34,4,2
39506,2014/03/31,2008/03/08,243,10,0.818,5790,243,6,4
39507,2014/03/31,2010/08/06,599,7,0.445187065,10638,599,7,0
39508,2014/03/31,2012/05/10,112,8,0.7042682929999999,6724,112,5,3
39509,2014/03/31,2012/06/29,4,2,1.445945038,3275,4,1,1
39510,2014/03/31,2007/08/08,359,4,0.799358542,5924,359,2,2
39511,2014/03/31,2013/01/08,2,6,0.5987128589999999,7909,2,1,5
39512,2014/03/31,2009/09/24,127,7,0.508160549,9318,127,1,6
39513,2014/03/31,2008/03/19,569,4,0.817365786,5793,569,4,0
39514,2014/03/31,2013/03/13,291,3,0.597689977,7922,291,1,2
39515,2014/03/31,2008/12/07,91,4,0.795446909,5952,91,0,4
39516,2014/03/31,2012/08/14,92,7,0.615970596,7686,92,3,4
39517,2014/03/31,2010/01/10,332,4,0.641650854,7378,332,2,2
39518,2014/03/31,2012/05/31,34,4,1.468371588,3224,34,3,1
39519,2014/03/31,2007/04/01,562,2,0.9,5260,562,2,0
39520,2014/03/31,2011/05/04,195,4,0.8191883000000001,5778,195,2,2
39521,2014/03/31,2009/09/11,69,5,0.675113393,7011,69,4,1
39522,2014/03/31,2012/11/16,11,9,0.726728082,6513,11,4,5
39523,2014/03/31,2008/05/02,265,5,0.447269634,10581,265,1,4
39524,2014/03/31,2013/03/14,194,3,0.8825885859999999,5362,194,0,3
39525,2014/03/31,2013/01/15,80,5,0.708413174,6680,80,2,3
39526,2014/03/31,2008/08/14,105,5,0.699572738,6764,105,0,5
39527,2014/03/31,2011/05/21,25,5,0.79167308,5977,25,0,5
39528,2014/03/31,2007/10/10,130,5,0.655290859,7220,130,2,3
39529,2014/03/31,2012/10/08,48,6,0.611217054,7740,48,2,4
39530,2014/03/31,2011/09/16,194,7,0.486533635,9722,194,6,1
39531,2014/03/31,2007/09/08,446,6,0.62348405,7586,446,6,0
39532,2014/03/31,2011/02/26,350,6,0.760215399,6221,350,5,1
39533,2014/03/31,2012/05/08,397,3,0.7185050140000001,6582,397,3,0
39534,2014/03/31,2011/03/05,48,3,0.670521764,7053,48,2,1
39535,2014/03/31,2007/10/04,218,5,0.6995576920000001,6760,218,4,1
39536,2014/03/31,2013/03/26,327,4,0.685035492,6903,327,0,4
39537,2014/03/31,2009/11/22,162,6,0.827415573,5715,162,3,3
39538,2014/03/31,2010/06/07,498,6,0.681198675,6941,498,6,0
39539,2014/03/31,2011/06/01,115,3,0.643025976,7353,115,0,3
39540,2014/03/31,2007/01/23,109,6,0.777143327,6084,109,1,5
39541,2014/03/31,2012/05/09,25,9,0.586826362,8057,25,1,8
39542,2014/03/31,2006/09/27,26,6,0.5128867429999999,9218,26,2,4
39543,2014/03/31,2008/07/02,8,6,0.5111579629999999,9249,8,3,3
39544,2014/03/31,2012/06/22,162,7,0.732615838,6453,162,3,4
39545,2014/03/31,2010/05/29,611,8,0.973856613,4854,611,8,0
39546,2014/03/31,2012/08/23,18,7,0.757507613,6239,18,4,3
39547,2014/03/31,2011/06/23,506,6,0.7579149959999999,6235,506,6,0
39548,2014/03/31,2012/05/19,194,6,0.662121637,7136,194,5,1
39549,2014/03/31,2008/09/24,126,5,0.745481224,6338,126,4,1
39550,2014/03/31,2012/11/16,111,13,0.596711291,7918,111,3,10
39551,2014/03/31,2008/08/21,60,10,0.662082399,7136,60,5,5
39552,2014/03/31,2006/02/08,92,6,0.938714484,5033,92,1,5
39553,2014/03/31,2007/05/01,154,7,0.580849625,8133,154,3,4
39554,2014/03/31,2013/01/01,37,5,0.406,11635,37,1,4
39555,2014/03/31,2011/04/06,589,5,0.6814122909999999,6932,589,5,0
39556,2014/03/31,2011/05/19,37,9,0.505284553,9348,37,7,2
39557,2014/03/31,2011/03/25,106,3,0.913132251,5172,106,0,3
39558,2014/03/31,2012/03/29,68,6,0.621735124,7596,68,0,6
39559,2014/03/31,2013/03/23,11,7,0.778519618,6066,11,1,6
39560,2014/03/31,2012/10/17,34,3,0.840428902,5619,34,0,3
39561,2014/03/31,2008/07/17,247,3,0.785286878,6013,247,2,1
39562,2014/03/31,2008/09/28,61,6,0.6992107209999999,6753,61,3,3
39563,2014/03/31,2005/12/01,512,5,0.874550843,5399,512,5,0
39564,2014/03/31,2006/11/07,170,5,0.812545173,5811,170,1,4
39565,2014/03/31,2012/04/17,153,4,0.459863628,10266,153,1,3
39566,2014/03/31,2010/08/20,103,5,0.705032855,6696,103,1,4
39567,2014/03/31,2012/08/08,376,5,0.7335068370000001,6436,376,5,0
39568,2014/03/31,2012/08/20,464,5,0.815909091,5786,464,5,0
39569,2014/03/31,2007/07/25,132,4,0.6,7868,132,2,2
39570,2014/03/31,2013/02/10,227,3,0.8,5901,227,1,2
39571,2014/03/31,2006/09/11,517,4,0.74414315,6343,517,4,0
39572,2014/03/31,2012/08/28,248,4,0.627891446,7517,248,2,2
39573,2014/03/31,2007/11/06,52,4,0.770548571,6125,52,0,4
39574,2014/03/31,2011/08/08,190,2,0.7692665040000001,6135,190,0,2
39575,2014/03/31,2010/07/11,287,5,0.968173984,4874,287,4,1
39576,2014/03/31,2010/05/27,682,3,0.900190767,5242,682,3,0
39577,2014/03/31,2012/08/15,52,6,0.6941783140000001,6797,52,4,2
39578,2014/03/31,2007/12/23,58,4,0.858168425,5498,58,3,1
39579,2014/03/31,2012/09/16,95,7,0.481428571,9800,95,2,5
39580,2014/03/31,2012/09/13,373,6,0.725950146,6499,373,6,0
39581,2014/03/31,2012/12/21,110,5,0.606193781,7782,110,3,2
39582,2014/03/31,2012/08/24,29,4,0.8392350120000001,5621,29,3,1
39583,2014/03/31,2012/03/20,442,5,0.53,8900,442,5,0
39584,2014/03/31,2012/06/19,20,6,0.603118527,7821,20,2,4
39585,2014/03/31,2011/05/09,434,5,0.483521271,9755,434,5,0
39586,2014/03/31,2013/02/14,157,3,0.7050418540000001,6690,157,0,3
39587,2014/03/31,2013/02/25,33,5,0.7360627340000001,6408,33,1,4
39588,2014/03/31,2008/07/15,90,14,0.513571429,9184,90,9,5
39589,2014/03/31,2010/04/09,8,5,0.732006829,6443,8,0,5
39590,2014/03/31,2008/01/22,332,5,0.6224495179999999,7577,332,2,3
39591,2014/03/31,2012/03/14,19,8,0.5933731760000001,7948,19,3,5
39592,2014/03/31,2010/10/03,47,2,0.802607216,5876,47,0,2
39593,2014/03/31,2008/04/02,63,4,0.576115319,8186,63,0,4
39594,2014/03/31,2012/10/16,467,6,0.525,8982,467,6,0
39595,2014/03/31,2012/03/22,354,4,0.5799631,8130,354,3,1
39596,2014/03/31,2012/11/05,392,6,0.909714451,5183,392,6,0
39597,2014/03/31,2011/09/06,137,3,0.7566666670000001,6231,137,0,3
39598,2014/03/31,2009/11/03,243,3,0.7566666670000001,6231,243,2,1
39599,2014/03/31,2009/04/16,551,3,0.882223054,5344,551,3,0
39600,2014/03/31,2013/03/01,13,6,0.704220197,6694,13,0,6
39601,2014/03/31,2012/02/28,33,4,0.772579905,6101,33,1,3
39602,2014/03/31,2009/10/13,101,3,0.770021238,6121,101,1,2
39603,2014/03/31,2005/11/07,50,5,0.596165718,7905,50,2,3
39604,2014/03/31,2012/03/28,30,4,0.627833733,7506,30,1,3
39605,2014/03/31,2009/09/24,352,6,0.6997920999999999,6734,352,4,2
39606,2014/03/31,2008/12/15,175,2,0.870175439,5415,175,0,2
39607,2014/03/31,2013/01/30,374,4,0.6152173910000001,7659,374,4,0
39608,2014/03/31,2009/03/01,167,2,1.128591617,4175,167,1,1
39609,2014/03/31,2012/04/14,10,4,0.662792235,7109,10,1,3
39610,2014/03/31,2008/11/28,107,3,0.654931888,7194,107,2,1
39611,2014/03/31,2011/03/05,229,6,0.752408176,6262,229,5,1
39612,2014/03/31,2012/05/24,338,6,0.75,6282,338,5,1
39613,2014/03/31,2007/02/23,153,7,0.559679259,8418,153,2,5
39614,2014/03/31,2005/12/08,412,4,0.719165013,6551,412,4,0
39615,2014/03/31,2011/11/25,637,3,1.0,4711,637,3,0
39616,2014/03/31,2006/05/17,20,6,0.829556182,5678,20,3,3
39617,2014/03/31,2007/10/01,5,9,0.511032874,9217,5,4,5
39618,2014/03/31,2012/12/11,169,5,0.8232931309999999,5721,169,2,3
39619,2014/03/31,2012/02/08,25,5,0.552673081,8522,25,1,4
39620,2014/03/31,2009/02/27,473,6,0.716826484,6570,473,6,0
39621,2014/03/31,2011/07/10,444,5,0.771375921,6105,444,5,0
39622,2014/03/31,2005/10/20,116,7,0.551727006,8535,116,4,3
39623,2014/03/31,2009/03/16,144,5,0.633519914,7432,144,3,2
39624,2014/03/31,2013/02/06,359,3,0.5234296829999999,8995,359,2,1
39625,2014/03/31,2013/03/12,162,8,0.484182435,9724,162,1,7
39626,2014/03/31,2011/11/01,5,7,0.8187965220000001,5750,5,3,4
39627,2014/03/31,2012/10/07,195,8,0.565050408,8332,195,6,2
39628,2014/03/31,2012/10/26,4,5,0.788470943,5971,4,1,4
39629,2014/03/31,2010/05/01,321,5,0.522317763,9013,321,4,1
39630,2014/03/31,2005/10/27,45,6,0.8506631729999999,5534,45,3,3
39631,2014/03/31,2011/03/23,202,5,0.8468837709999999,5558,202,4,1
39632,2014/03/31,2011/11/07,34,7,0.5808094770000001,8104,34,5,2
39633,2014/03/31,2010/04/09,101,4,0.575760245,8175,101,1,3
39634,2014/03/31,2010/04/19,353,7,0.6091832770000001,7726,353,6,1
39635,2014/03/31,2007/11/05,291,7,0.611872075,7692,291,5,2
39636,2014/03/31,2009/12/09,112,6,0.762150607,6175,112,4,2
39637,2014/03/31,2009/03/09,40,5,0.7129716620000001,6599,40,2,3
39638,2014/03/31,2010/01/02,20,4,0.8781056359999999,5358,20,0,4
39639,2014/03/31,2010/04/02,260,5,0.751096743,6264,260,2,3
39640,2014/03/31,2011/12/01,340,3,0.54527121,8628,340,1,2
39641,2014/03/31,2011/07/15,138,10,0.487977388,9641,138,4,6
39642,2014/03/31,2010/01/30,42,6,0.86178421,5459,42,3,3
39643,2014/03/31,2008/08/05,200,10,0.436,10790,200,4,6
39644,2014/03/31,2010/04/27,45,4,0.84,5600,45,0,4
39645,2014/03/31,2012/12/13,78,6,0.826636204,5690,78,2,4
39646,2014/03/31,2009/11/14,139,5,0.707723443,6646,139,3,2
39647,2014/03/31,2010/01/17,306,3,0.758629032,6200,306,2,1
39648,2014/03/31,2011/09/14,51,3,0.548189977,8580,51,2,1
39649,2014/03/31,2013/01/26,338,4,0.849873509,5534,338,2,2
39650,2014/03/31,2012/04/30,121,7,0.790389916,5950,121,5,2
39651,2014/03/31,2012/06/06,156,4,0.44,10688,156,2,2
39652,2014/03/31,2012/08/10,232,4,0.792502528,5934,232,2,2
39653,2014/03/31,2012/02/11,134,6,0.722566073,6508,134,4,2
39654,2014/03/31,2012/12/25,299,5,0.755521453,6223,299,2,3
39655,2014/03/31,2010/04/23,32,11,0.630108565,7461,32,3,8
39656,2014/03/31,2010/12/25,77,5,0.554060106,8485,77,2,3
39657,2014/03/31,2009/04/03,17,5,0.685437445,6858,17,0,5
39658,2014/03/31,2011/02/11,344,6,0.754277002,6231,344,4,2
39659,2014/03/31,2012/08/07,395,2,0.7,6714,395,2,0
39660,2014/03/31,2009/11/17,595,3,0.660728346,7112,595,3,0
39661,2014/03/31,2008/02/11,137,3,0.77645076,6052,137,0,3
39662,2014/03/31,2012/02/06,315,6,0.810574435,5797,315,5,1
39663,2014/03/31,2010/11/07,16,7,0.320647649,14653,16,5,2
39664,2014/03/31,2009/10/08,34,4,0.582839598,8061,34,3,1
39665,2014/03/31,2011/05/07,100,4,0.7290657979999999,6444,100,2,2
39666,2014/03/31,2007/03/07,337,6,0.657140859,7149,337,5,1
39667,2014/03/31,2011/02/07,429,2,0.8,5872,429,2,0
39668,2014/03/31,2010/09/07,332,6,1.114495848,4215,332,3,3
39669,2014/03/31,2011/12/01,206,4,0.970578512,4840,206,0,4
39670,2014/03/31,2007/11/16,344,4,0.571738072,8216,344,2,2
39671,2014/03/31,2009/11/19,34,7,0.517752425,9072,34,1,6
39672,2014/03/31,2010/03/18,357,4,0.76206393,6163,357,3,1
39673,2014/03/31,2011/08/30,13,3,0.764421293,6143,13,2,1
39674,2014/03/31,2012/07/11,17,4,0.666417826,7046,17,3,1
39675,2014/03/31,2012/07/05,540,2,0.947226145,4957,540,2,0
39676,2014/03/31,2012/06/26,118,4,0.6766565790000001,6939,118,2,2
39677,2014/03/31,2012/08/16,199,3,0.7008508729999999,6699,199,1,2
39678,2014/03/31,2012/10/20,488,4,0.680687255,6897,488,4,0
39679,2014/03/31,2011/10/06,284,5,0.863764489,5435,284,2,3
39680,2014/03/31,2012/10/11,395,4,0.698690281,6719,395,4,0
39681,2014/03/31,2013/02/03,14,6,0.702027815,6687,14,1,5
39682,2014/03/31,2011/03/03,29,3,0.569981785,8235,29,0,3
39683,2014/03/31,2011/09/19,8,6,0.92415633,5079,8,3,3
39684,2014/03/31,2010/10/30,158,5,0.705066847,6657,158,3,2
39685,2014/03/31,2011/11/27,125,8,0.612011996,7669,125,5,3
39686,2014/03/31,2012/06/11,585,6,0.732771272,6405,585,6,0
39687,2014/03/31,2010/12/21,156,8,0.8365793229999999,5610,156,4,4
39688,2014/03/31,2009/06/28,625,3,1.0,4693,625,3,0
39689,2014/03/31,2013/01/23,45,5,0.686196812,6839,45,2,3
39690,2014/03/31,2012/09/05,101,4,0.87057885,5390,101,3,1
39691,2014/03/31,2010/04/26,27,8,0.90375,5192,27,5,3
39692,2014/03/31,2011/12/10,79,7,0.636887471,7367,79,0,7
39693,2014/03/31,2010/12/07,225,3,1.164978892,4027,225,1,2
39694,2014/03/31,2012/09/28,147,6,0.558739876,8396,147,2,4
39695,2014/03/31,2006/06/01,205,4,0.476887262,9837,205,3,1
39696,2014/03/31,2008/11/21,186,4,0.702884327,6674,186,0,4
39697,2014/03/31,2013/03/21,33,2,0.58,8088,33,0,2
39698,2014/03/31,2010/07/19,151,5,0.901916939,5201,151,3,2
39699,2014/03/31,2007/05/25,551,3,0.93411671,5021,551,3,0
39700,2014/03/31,2010/01/26,13,8,0.6345609529999999,7391,13,1,7
39701,2014/03/31,2011/03/07,355,5,1.0,4690,355,4,1
39702,2014/03/31,2008/03/07,14,2,1.425843721,3289,14,1,1
39703,2014/03/31,2009/12/01,7,6,0.80355209,5836,7,1,5
39704,2014/03/31,2012/03/10,3,4,0.75539143,6208,3,1,3
39705,2014/03/31,2012/02/19,3,5,0.916268073,5118,3,1,4
39706,2014/03/31,2011/11/17,668,4,0.581306558,8067,668,4,0
39707,2014/03/31,2012/12/03,58,4,0.903715552,5189,58,2,2
39708,2014/03/31,2009/08/28,435,2,0.825,5684,435,2,0
39709,2014/03/31,2013/03/22,368,2,0.825,5684,368,2,0
39710,2014/03/31,2007/05/08,133,2,0.825,5684,133,0,2
39711,2014/03/31,2012/08/04,604,2,0.825,5684,604,2,0
39712,2014/03/31,2011/09/03,23,6,0.914211347,5129,23,4,2
39713,2014/03/31,2011/09/14,28,8,0.5908253529999999,7936,28,4,4
39714,2014/03/31,2007/09/15,42,4,0.6363770870000001,7367,42,0,4
39715,2014/03/31,2009/01/24,265,5,0.549832258,8525,265,3,2
39716,2014/03/31,2008/03/19,5,5,0.991590861,4727,5,3,2
39717,2014/03/31,2013/02/17,211,4,0.498882265,9394,211,3,1
39718,2014/03/31,2011/05/16,45,6,0.865273264,5416,45,0,6
39719,2014/03/31,2009/03/19,92,5,0.706572678,6632,92,3,2
39720,2014/03/31,2011/01/04,156,6,0.80005805,5857,156,2,4
39721,2014/03/31,2008/04/22,323,4,0.81664343,5738,323,3,1
39722,2014/03/31,2011/05/27,243,3,0.935996804,5006,243,1,2
39723,2014/03/31,2008/12/01,194,6,0.801721424,5844,194,4,2
39724,2014/03/31,2010/07/12,275,6,0.866513778,5407,275,2,4
39725,2014/03/31,2010/09/29,12,5,0.674504751,6946,12,1,4
39726,2014/03/31,2010/10/22,249,5,0.667766534,7016,249,3,2
39727,2014/03/31,2010/02/19,29,7,0.533961705,8774,29,2,5
39728,2014/03/31,2007/10/18,48,5,0.48,9760,48,0,5
39729,2014/03/31,2008/03/21,15,7,0.888954459,5270,15,2,5
39730,2014/03/31,2008/09/19,151,8,0.929111464,5042,151,7,1
39731,2014/03/31,2012/09/21,31,5,0.6682439370000001,7010,31,1,4
39732,2014/03/31,2006/11/01,672,2,1.025,4570,672,2,0
39733,2014/03/31,2010/12/21,173,5,0.7023661720000001,6669,173,4,1
39734,2014/03/31,2011/12/11,129,6,0.596178717,7856,129,0,6
39735,2014/03/31,2013/01/20,398,2,0.725,6460,398,2,0
39736,2014/03/31,2012/09/14,116,12,0.6720275509999999,6969,116,7,5
39737,2014/03/31,2012/10/24,340,5,0.7129471759999999,6569,340,4,1
39738,2014/03/31,2012/01/05,49,7,0.658729779,7109,49,5,2
39739,2014/03/31,2006/04/03,601,3,0.789812785,5929,601,3,0
39740,2014/03/31,2012/04/22,46,7,0.505580868,9262,46,4,3
39741,2014/03/31,2009/03/30,50,3,0.783952788,5973,50,0,3
39742,2014/03/31,2009/11/25,195,5,0.753647191,6213,195,2,3
39743,2014/03/31,2012/10/06,222,4,0.604483604,7746,222,2,2
39744,2014/03/31,2010/12/20,10,10,0.703,6660,10,4,6
39745,2014/03/31,2012/10/26,168,3,1.336024543,3504,168,1,2
39746,2014/03/31,2012/12/07,79,6,0.679642857,6888,79,1,5
39747,2014/03/31,2009/05/31,562,5,0.735582967,6364,562,5,0
39748,2014/03/31,2008/04/15,148,6,0.660348476,7088,148,1,5
39749,2014/03/31,2006/05/07,3,5,0.90567918,5168,3,1,4
39750,2014/03/31,2012/02/05,135,5,0.732097607,6393,135,4,1
39751,2014/03/31,2007/10/22,273,2,0.6,7800,273,1,1
39752,2014/03/31,2013/01/17,426,2,0.6,7800,426,2,0
39753,2014/03/31,2009/03/07,12,3,1.262808958,3706,12,0,3
39754,2014/03/31,2010/02/02,151,4,1.31716859,3553,151,3,1
39755,2014/03/31,2012/10/26,4,5,0.838816992,5579,4,3,2
39756,2014/03/31,2012/11/12,202,5,0.6765288420000001,6917,202,3,2
39757,2014/03/31,2010/11/25,33,4,0.5817829170000001,8043,33,0,4
39758,2014/03/31,2008/04/05,142,4,0.545587687,8576,142,2,2
39759,2014/03/31,2011/11/07,16,7,0.674671954,6935,16,5,2
39760,2014/03/31,2013/01/01,373,3,0.8243128959999999,5676,373,3,0
39761,2014/03/31,2009/11/11,400,2,0.75,6238,400,2,0
39762,2014/03/31,2007/08/09,381,7,0.75300177,6213,381,7,0
39763,2014/03/31,2011/05/21,147,2,0.885,5286,147,0,2
39764,2014/03/31,2012/10/15,47,3,0.996712124,4693,47,0,3
39765,2014/03/31,2009/08/03,125,3,0.8621714290000001,5425,125,2,1
39766,2014/03/31,2007/10/08,427,5,0.46539801,10050,427,5,0
39767,2014/03/31,2008/01/24,1,6,0.474989337,9847,1,0,6
39768,2014/03/31,2012/10/17,27,5,0.561648853,8327,27,3,2
39769,2014/03/31,2009/03/10,37,8,0.518718944,9016,37,5,3
39770,2014/03/31,2006/06/15,30,11,0.627799705,7449,30,7,4
39771,2014/03/31,2011/06/02,33,4,0.620972241,7529,33,0,4
39772,2014/03/31,2006/10/01,205,4,0.716388293,6526,205,3,1
39773,2014/03/31,2011/10/13,287,6,0.8489122929999999,5507,287,5,1
39774,2014/03/31,2011/05/17,5,8,0.862476015,5420,5,0,8
39775,2014/03/31,2010/04/23,149,3,1.273716621,3670,149,2,1
39776,2014/03/31,2012/02/10,217,5,0.692518519,6750,217,4,1
39777,2014/03/31,2007/08/02,119,2,0.8411876909999999,5557,119,0,2
39778,2014/03/31,2012/07/24,177,2,0.875,5342,177,0,2
39779,2014/03/31,2007/09/24,715,2,0.6764037629999999,6910,715,2,0
39780,2014/03/31,2010/04/19,125,4,0.94806288,4930,125,0,4
39781,2014/03/31,2011/06/06,428,5,0.717956989,6510,428,5,0
39782,2014/03/31,2010/07/04,117,5,0.658731501,7095,117,3,2
39783,2014/03/31,2011/07/30,457,4,0.652190901,7166,457,4,0
39784,2014/03/31,2012/09/14,31,5,0.646672201,7227,31,2,3
39785,2014/03/31,2011/02/03,190,3,0.73,6402,190,0,3
39786,2014/03/31,2011/07/02,576,4,0.5625,8308,576,4,0
39787,2014/03/31,2007/10/17,31,4,0.5625,8308,31,0,4
39788,2014/03/31,2005/03/24,140,4,0.5625,8308,140,0,4
39789,2014/03/31,2009/08/08,369,13,0.553846154,8437,369,13,0
39790,2014/03/31,2012/04/22,654,4,0.479663279,9741,654,4,0
39791,2014/03/31,2010/03/19,140,4,0.710413562,6577,140,0,4
39792,2014/03/31,2007/02/24,232,4,0.824333098,5668,232,1,3
39793,2014/03/31,2012/03/10,559,3,1.0,4672,559,3,0
39794,2014/03/31,2013/01/26,92,6,0.6561502810000001,7120,92,1,5
39795,2014/03/31,2008/01/09,16,4,0.977558067,4779,16,1,3
39796,2014/03/31,2010/06/17,72,6,0.776515957,6016,72,0,6
39797,2014/03/31,2006/04/03,144,4,0.828271277,5640,144,0,4
39798,2014/03/31,2013/03/28,259,3,0.7033152659999999,6642,259,0,3
39799,2014/03/31,2012/12/02,189,8,0.68233421,6846,189,5,3
39800,2014/03/31,2008/03/25,586,5,0.703796896,6637,586,5,0
39801,2014/03/31,2010/09/26,49,5,0.545487563,8563,49,4,1
39802,2014/03/31,2012/10/09,102,4,0.7926064820000001,5893,102,1,3
39803,2014/03/31,2007/01/07,94,7,0.621347612,7517,94,5,2
39804,2014/03/31,2013/01/23,158,4,0.971137451,4809,158,2,2
39805,2014/03/31,2006/05/26,382,4,0.624251337,7480,382,4,0
39806,2014/03/31,2012/06/09,13,8,0.725,6440,13,1,7
39807,2014/03/31,2006/10/15,40,5,0.456427803,10229,40,0,5
39808,2014/03/31,2013/01/26,202,3,0.663333333,7038,202,0,3
39809,2014/03/31,2009/08/29,147,5,0.58944697,7920,147,0,5
39810,2014/03/31,2006/12/06,126,11,0.4556226820000001,10246,126,6,5
39811,2014/03/31,2013/03/15,70,5,0.799427984,5839,70,0,5
39812,2014/03/31,2007/10/19,192,6,0.737610619,6328,192,2,4
39813,2014/03/31,2011/09/12,232,5,0.715868098,6520,232,2,3
39814,2014/03/31,2011/05/23,283,7,0.73005944,6393,283,5,2
39815,2014/03/31,2010/04/29,12,5,0.62889907,7421,12,2,3
39816,2014/03/31,2012/01/04,195,9,0.600172325,7776,195,4,5
39817,2014/03/31,2012/09/04,310,5,0.418626659,11148,310,3,2
39818,2014/03/31,2007/10/04,109,7,0.625110516,7465,109,6,1
39819,2014/03/31,2009/09/20,5,3,1.19496799,3905,5,1,2
39820,2014/03/31,2008/09/20,386,4,0.618239035,7547,386,4,0
39821,2014/03/31,2011/03/22,423,3,0.620336391,7521,423,3,0
39822,2014/03/31,2008/12/13,236,4,0.825745133,5650,236,0,4
39823,2014/03/31,2007/04/18,532,5,0.516026988,9041,532,5,0
39824,2014/03/31,2012/11/15,214,5,0.876122066,5325,214,2,3
39825,2014/03/31,2012/07/24,81,6,0.585055813,7973,81,1,5
39826,2014/03/31,2008/05/16,58,4,0.6660731120000001,7003,58,0,4
39827,2014/03/31,2008/10/04,333,3,0.7171509840000001,6504,333,2,1
39828,2014/03/31,2012/02/18,333,4,0.5625,8292,333,3,1
39829,2014/03/31,2010/11/10,146,5,0.418456846,11146,146,3,2
39830,2014/03/31,2005/11/21,434,3,1.0,4664,434,3,0
39831,2014/03/31,2008/06/10,27,5,0.500741894,9314,27,1,4
39832,2014/03/31,2012/09/21,44,5,0.730155002,6387,44,0,5
39833,2014/03/31,2009/09/09,523,6,0.669526202,6965,523,6,0
39834,2014/03/31,2010/09/13,21,6,0.545402339,8550,21,0,6
39835,2014/03/31,2010/10/20,89,4,0.620597551,7514,89,2,2
39836,2014/03/31,2012/09/30,533,2,1.136485498,4103,533,2,0
39837,2014/03/31,2007/04/28,526,2,0.488215894,9551,526,2,0
39838,2014/03/31,2006/02/10,49,2,0.76484252,6096,49,0,2
39839,2014/03/31,2013/03/06,122,5,0.754783876,6177,122,2,3
39840,2014/03/31,2010/04/02,384,8,0.875,5328,384,8,0
39841,2014/03/31,2007/09/21,200,9,0.7118262329999999,6549,200,5,4
39842,2014/03/31,2012/05/09,81,5,0.598255903,7792,81,1,4
39843,2014/03/31,2010/11/24,250,6,0.606801614,7682,250,3,3
39844,2014/03/31,2012/05/01,597,10,0.611953525,7617,597,10,0
39845,2014/03/31,2012/01/04,472,4,1.146666667,4065,472,4,0
39846,2014/03/31,2013/01/10,22,7,0.7362375609999999,6331,22,1,6
39847,2014/03/31,2011/06/09,11,5,0.635805484,7331,11,3,2
39848,2014/03/31,2006/06/28,181,4,0.41,11368,181,2,2
39849,2014/03/31,2011/11/22,269,3,0.773333333,6027,269,1,2
39850,2014/03/31,2010/09/17,111,3,0.922160665,5054,111,1,2
39851,2014/03/31,2012/12/05,81,7,0.448215831,10397,81,1,6
39852,2014/03/31,2012/07/15,5,7,0.42037438,11085,5,3,4
39853,2014/03/31,2010/02/06,77,6,0.515512778,9039,77,2,4
39854,2014/03/31,2013/03/01,159,7,0.698124064,6674,159,0,7
39855,2014/03/31,2012/11/17,389,7,0.914285714,5096,389,7,0
39856,2014/03/31,2010/10/07,213,3,0.8,5823,213,2,1
39857,2014/03/31,2010/11/29,2,4,0.616982781,7550,2,2,2
39858,2014/03/31,2010/11/04,353,3,0.766655695,6076,353,2,1
39859,2014/03/31,2011/10/02,125,5,0.77439734,6015,125,2,3
39860,2014/03/31,2011/12/21,13,8,0.624047428,7464,13,3,5
39861,2014/03/31,2011/11/19,14,10,0.640843423,7268,14,1,9
39862,2014/03/31,2012/06/24,642,3,0.6738425929999999,6912,642,3,0
39863,2014/03/31,2012/02/20,120,5,0.627527621,7422,120,4,1
39864,2014/03/31,2006/01/13,45,5,0.522069275,8921,45,1,4
39865,2014/03/31,2008/11/28,24,5,0.6718450659999999,6932,24,2,3
39866,2014/03/31,2012/08/06,288,7,0.75,6209,288,4,3
39867,2014/03/31,2007/10/31,249,6,0.681407668,6834,249,4,2
39868,2014/03/31,2010/03/25,508,4,0.8414528370000001,5534,508,4,0
39869,2014/03/31,2008/12/04,477,3,1.0,4656,477,3,0
39870,2014/03/31,2011/09/14,35,6,0.806507882,5773,35,3,3
39871,2014/03/31,2005/03/06,151,4,0.713631208,6524,151,3,1
39872,2014/03/31,2011/05/31,21,6,0.721689661,6451,21,2,4
39873,2014/03/31,2012/06/14,503,4,0.846264316,5501,503,4,0
39874,2014/03/31,2010/12/17,68,6,0.519966492,8953,68,3,3
39875,2014/03/31,2012/08/08,237,4,0.693439595,6713,237,1,3
39876,2014/03/31,2013/01/04,4,7,0.49359597,9430,4,4,3
39877,2014/03/31,2012/12/26,212,3,0.42,11082,212,1,2
39878,2014/03/31,2011/10/11,567,5,0.71,6555,567,5,0
39879,2014/03/31,2011/04/15,657,4,0.901549787,5162,657,4,0
39880,2014/03/31,2006/04/30,110,4,0.617747245,7533,110,0,4
39881,2014/03/31,2005/07/07,310,4,0.52336333,8890,310,3,1
39882,2014/03/31,2010/04/10,186,3,0.6926663690000001,6717,186,2,1
39883,2014/03/31,2010/01/04,56,10,0.508095238,9156,56,7,3
39884,2014/03/31,2008/12/24,49,4,0.8120230409999999,5729,49,0,4
39885,2014/03/31,2012/06/22,372,8,0.604227822,7699,372,8,0
39886,2014/03/31,2008/09/14,147,7,0.624918055,7444,147,3,4
39887,2014/03/31,2010/12/30,291,5,0.6471647189999999,7188,291,4,1
39888,2014/03/31,2012/07/10,491,3,0.681860158,6822,491,3,0
39889,2014/03/31,2009/07/02,297,4,0.738334921,6300,297,3,1
39890,2014/03/31,2010/09/13,202,5,0.927332536,5016,202,2,3
39891,2014/03/31,2007/08/06,12,6,0.558324331,8331,12,2,4
39892,2014/03/31,2009/08/12,25,5,0.758387412,6133,25,3,2
39893,2014/03/31,2006/03/31,30,9,0.465788683,9985,30,4,5
39894,2014/03/31,2009/10/24,244,4,0.76557037,6075,244,3,1
39895,2014/03/31,2011/02/12,65,4,0.7994997420000001,5817,65,2,2
39896,2014/03/31,2012/04/10,329,5,0.626427802,7424,329,3,2
39897,2014/03/31,2009/09/08,152,4,0.868671773,5353,152,2,2
39898,2014/03/31,2010/02/04,60,7,0.71263295,6525,60,4,3
39899,2014/03/31,2012/10/10,62,4,0.555543076,8369,62,2,2
39900,2014/03/31,2008/05/13,303,3,0.801144236,5803,303,1,2
39901,2014/03/31,2008/08/31,113,9,0.7755555559999999,5994,113,4,5
39902,2014/03/31,2013/02/27,370,4,0.508189372,9146,370,4,0
39903,2014/03/31,2009/04/13,139,5,0.459536286,10114,139,3,2
39904,2014/03/31,2010/09/14,224,3,0.620759984,7487,224,2,1
39905,2014/03/31,2009/12/06,326,7,0.731552023,6353,326,5,2
39906,2014/03/31,2013/03/09,340,4,0.7888134440000001,5891,340,1,3
39907,2014/03/31,2012/11/02,222,4,0.782661277,5937,222,1,3
39908,2014/03/31,2012/09/23,271,3,0.880849289,5275,271,1,2
39909,2014/03/31,2010/12/06,362,3,1.471247625,3158,362,1,2
39910,2014/03/31,2008/08/12,441,6,0.941247974,4936,441,6,0
39911,2014/03/31,2011/09/04,57,6,0.545222392,8521,57,2,4
39912,2014/03/31,2011/04/01,94,3,0.691870718,6714,94,2,1
39913,2014/03/31,2012/09/12,141,5,0.595224244,7804,141,1,4
39914,2014/03/31,2012/10/01,230,6,0.516751585,8989,230,3,3
39915,2014/03/31,2008/04/19,88,7,0.6907911959999999,6724,88,1,6
39916,2014/03/31,2011/07/14,553,7,0.82958564,5599,553,7,0
39917,2014/03/31,2010/11/25,82,5,0.600321872,7736,82,0,5
39918,2014/03/31,2008/12/20,2,4,0.70750457,6564,2,1,3
39919,2014/03/31,2011/10/16,180,4,0.59000127,7871,180,2,2
39920,2014/03/31,2006/09/20,115,3,0.6428073089999999,7224,115,0,3
39921,2014/03/31,2006/03/16,312,6,0.392328489,11836,312,4,2
39922,2014/03/31,2011/02/03,514,5,0.6286894120000001,7386,514,5,0
39923,2014/03/31,2012/12/15,326,4,0.8875,5232,326,2,2
39924,2014/03/31,2005/03/14,364,6,0.669545782,6935,364,5,1
39925,2014/03/31,2010/05/20,388,6,0.893591224,5196,388,6,0
39926,2014/03/31,2007/12/14,56,5,0.586174725,7921,56,4,1
39927,2014/03/31,2010/10/17,26,6,0.649867021,7144,26,2,4
39928,2014/03/31,2006/10/29,210,6,0.697495493,6656,210,4,2
39929,2014/03/31,2012/11/06,14,4,0.719463732,6452,14,1,3
39930,2014/03/31,2012/11/02,1,9,0.424436723,10936,1,1,8
39931,2014/03/31,2012/12/16,30,3,0.91314578,5083,30,1,2
39932,2014/03/31,2013/03/18,140,8,0.866348703,5357,140,1,7
39933,2014/03/31,2010/08/09,536,7,0.7768664209999999,5974,536,7,0
39934,2014/03/31,2007/03/13,196,5,0.479237918,9684,196,4,1
39935,2014/03/31,2007/02/08,15,5,0.480122077,9666,15,2,3
39936,2014/03/31,2013/02/27,309,6,0.819314972,5664,309,4,2
39937,2014/03/31,2013/01/18,130,7,0.635158774,7306,130,4,3
39938,2014/03/31,2008/02/02,271,5,0.972796646,4770,271,3,2
39939,2014/03/31,2010/09/09,390,4,0.808362369,5740,390,4,0
39940,2014/03/31,2012/04/08,370,4,0.873912225,5309,370,4,0
39941,2014/03/31,2010/05/04,177,7,0.508144578,9130,177,3,4
39942,2014/03/31,2013/02/08,206,4,0.889227525,5217,206,2,2
39943,2014/03/31,2011/09/30,598,3,0.8292813729999999,5594,598,3,0
39944,2014/03/31,2008/06/23,247,6,0.6038115070000001,7682,247,5,1
39945,2014/03/31,2008/06/11,166,4,0.6993757540000001,6632,166,2,2
39946,2014/03/31,2008/08/07,36,5,0.7483236529999999,6198,36,1,4
39947,2014/03/31,2011/03/10,137,4,0.579833729,7999,137,2,2
39948,2014/03/31,2012/09/18,124,4,0.547176401,8475,124,0,4
39949,2014/03/31,2011/01/18,304,5,0.503053808,9218,304,4,1
39950,2014/03/31,2008/08/14,107,5,0.550591308,8422,107,2,3
39951,2014/03/31,2012/07/03,240,5,0.783402602,5919,240,3,2
39952,2014/03/31,2007/06/16,57,5,0.857739549,5406,57,2,3
39953,2014/03/31,2005/10/14,254,4,0.539734606,8591,254,2,2
39954,2014/03/31,2012/05/22,9,15,0.5861954739999999,7909,9,2,13
39955,2014/03/31,2012/10/08,21,3,0.8633333329999999,5370,21,1,2
39956,2014/03/31,2011/09/05,132,4,0.433874591,10685,132,2,2
39957,2014/03/31,2007/12/30,452,5,0.755393515,6137,452,5,0
39958,2014/03/31,2013/01/26,3,3,0.393232675,11789,3,2,1
39959,2014/03/31,2012/05/29,213,4,0.828395282,5596,213,0,4
39960,2014/03/31,2011/06/15,493,3,1.0,4635,493,3,0
39961,2014/03/31,2012/11/21,142,7,0.899053346,5155,142,0,7
39962,2014/03/31,2012/11/13,380,4,0.815663499,5682,380,4,0
39963,2014/03/31,2010/11/10,233,4,0.753048424,6154,233,2,2
39964,2014/03/31,2005/07/10,17,6,0.3483619,13302,17,2,4
39965,2014/03/31,2009/11/20,62,2,0.980469742,4726,62,1,1
39966,2014/03/31,2011/07/29,274,6,0.692167613,6694,274,2,4
39967,2014/03/31,2011/06/09,537,3,0.83815123,5528,537,3,0
39968,2014/03/31,2009/03/02,246,3,0.801737325,5779,246,1,2
39969,2014/03/31,2007/03/24,74,5,0.7983922109999999,5803,74,0,5
39970,2014/03/31,2010/07/23,562,4,0.836272563,5540,562,4,0
39971,2014/03/31,2006/05/15,96,8,0.536761673,8631,96,6,2
39972,2014/03/31,2009/03/17,14,5,1.440046627,3217,14,2,3
39973,2014/03/31,2011/10/04,72,6,0.797491823,5809,72,2,4
39974,2014/03/31,2012/02/15,85,6,0.561634336,8248,85,3,3
39975,2014/03/31,2007/10/10,548,4,0.7339961970000001,6311,548,4,0
39976,2014/03/31,2012/11/30,225,4,0.968066876,4785,225,3,1
39977,2014/03/31,2011/05/10,368,5,0.441194399,10499,368,5,0
39978,2014/03/31,2012/09/18,178,4,0.7296754879999999,6348,178,2,2
39979,2014/03/31,2013/01/14,186,4,0.780972854,5931,186,0,4
39980,2014/03/31,2012/11/16,26,7,0.894346399,5179,26,4,3
39981,2014/03/31,2009/03/23,287,2,0.6935849059999999,6678,287,1,1
39982,2014/03/31,2012/06/15,52,4,0.7423385159999999,6239,52,2,2
39983,2014/03/31,2008/11/22,127,3,0.723333333,6402,127,2,1
39984,2014/03/31,2012/04/14,121,3,0.5928847629999999,7810,121,1,2
39985,2014/03/31,2009/07/07,125,6,0.377646195,12261,125,0,6
39986,2014/03/31,2010/04/27,432,6,0.6,7716,432,6,0
39987,2014/03/31,2005/11/30,6,5,0.564303998,8204,6,0,5
39988,2014/03/31,2012/03/26,261,4,0.8870224179999999,5219,261,0,4
39989,2014/03/31,2009/04/17,108,3,0.72636435,6373,108,1,2
39990,2014/03/31,2012/01/08,265,3,0.6963743040000001,6647,265,1,2
39991,2014/03/31,2006/03/31,185,3,0.8648710759999999,5352,185,0,3
39992,2014/03/31,2011/04/29,56,3,0.70807251,6537,56,1,2
39993,2014/03/31,2012/08/07,203,6,0.842480888,5494,203,3,3
39994,2014/03/31,2007/01/11,613,3,0.972515234,4759,613,3,0
39995,2014/03/31,2007/12/30,214,6,0.595483788,7772,214,5,1
39996,2014/03/31,2012/12/01,473,3,0.8666666670000001,5340,473,3,0
39997,2014/03/31,2012/11/02,513,2,1.0,4628,513,2,0
39998,2014/03/31,2008/03/07,298,5,0.546470241,8468,298,4,1
39999,2014/03/31,2006/07/25,225,3,0.613156221,7547,225,0,3
40000,2014/03/31,2007/06/10,116,3,0.769916805,6010,116,0,3
40001,2014/03/31,2007/12/08,19,3,0.909585217,5087,19,0,3
40002,2014/03/31,2010/05/06,91,6,0.8833333329999999,5238,91,2,4
40003,2014/03/31,2012/05/18,392,3,1.351270444,3424,392,3,0
40004,2014/03/31,2007/07/09,2,9,0.617777778,7488,2,4,5
40005,2014/03/31,2010/04/15,398,6,0.60455496,7651,398,6,0
40006,2014/03/31,2013/03/07,23,6,0.798980826,5789,23,1,5
40007,2014/03/31,2013/02/24,35,4,0.72054993,6419,35,1,3
40008,2014/03/31,2011/10/29,70,6,0.638721171,7241,70,2,4
40009,2014/03/31,2007/06/18,151,3,0.902783525,5123,151,1,2
40010,2014/03/31,2007/04/11,643,5,0.6243890910000001,7407,643,5,0
40011,2014/03/31,2011/01/13,102,8,0.654123055,7070,102,2,6
40012,2014/03/31,2010/05/29,61,5,0.796526008,5806,61,0,5
40013,2014/03/31,2011/11/14,465,3,0.8456024870000001,5469,465,3,0
40014,2014/03/31,2006/01/01,641,5,0.7734571,5979,641,5,0
40015,2014/03/31,2013/01/16,8,7,0.7140586870000001,6475,8,0,7
40016,2014/03/31,2011/05/29,292,4,0.575,8040,292,2,2
40017,2014/03/31,2013/03/08,321,7,0.884915773,5224,321,1,6
40018,2014/03/31,2010/07/31,141,13,0.6130769229999999,7540,141,5,8
40019,2014/03/31,2012/08/21,462,4,0.5875,7868,462,4,0
40020,2014/03/31,2008/08/29,20,5,0.54329102,8508,20,2,3
40021,2014/03/31,2005/10/29,143,5,0.832239827,5554,143,1,4
40022,2014/03/31,2011/08/01,430,5,0.632478106,7308,430,5,0
40023,2014/03/31,2010/05/08,265,3,0.786747234,5875,265,2,1
40024,2014/03/31,2013/03/23,54,3,0.434288668,10642,54,1,2
40025,2014/03/31,2011/06/09,44,8,0.524058283,8819,44,7,1
40026,2014/03/31,2007/06/12,279,3,0.576669578,8014,279,2,1
40027,2014/03/31,2011/06/21,153,5,0.91296128,5062,153,1,4
40028,2014/03/31,2012/09/08,263,5,0.649602193,7114,263,4,1
40029,2014/03/31,2010/04/15,163,8,0.783494405,5898,163,4,4
40030,2014/03/31,2012/11/29,171,6,0.518747194,8908,171,0,6
40031,2014/03/31,2010/12/03,144,7,0.6788482440000001,6807,144,0,7
40032,2014/03/31,2006/01/30,142,4,0.6344473429999999,7283,142,0,4
40033,2014/03/31,2010/02/12,45,6,0.634267673,7285,45,2,4
40034,2014/03/31,2008/01/22,111,4,0.757454098,6100,111,1,3
40035,2014/03/31,2007/04/26,350,4,0.745177419,6200,350,2,2
40036,2014/03/31,2008/07/25,600,4,0.825,5600,600,4,0
40037,2014/03/31,2007/10/28,42,8,0.683324952,6761,42,4,4
40038,2014/03/31,2011/05/15,161,8,0.616648425,7492,161,6,2
40039,2014/03/31,2009/10/13,616,5,0.765865385,6032,616,5,0
40040,2014/03/31,2013/01/02,75,4,0.633499726,7292,75,0,4
40041,2014/03/31,2012/04/16,306,4,0.640789291,7209,306,2,2
40042,2014/03/31,2011/07/07,23,4,0.552131246,8366,23,0,4
40043,2014/03/31,2011/05/29,231,4,0.88907411,5195,231,3,1
40044,2014/03/31,2010/05/26,47,6,0.600501885,7691,47,3,3
40045,2014/03/31,2011/04/15,341,7,0.707142857,6531,341,5,2
40046,2014/03/31,2009/09/08,15,6,0.595777319,7751,15,3,3
40047,2014/03/31,2011/10/12,207,3,0.723333333,6384,207,2,1
40048,2014/03/31,2012/12/02,151,5,0.5933033529999999,7783,151,0,5
40049,2014/03/31,2012/12/08,162,4,0.910710059,5070,162,2,2
40050,2014/03/31,2007/06/01,67,6,0.485773803,9505,67,0,6
40051,2014/03/31,2008/08/05,655,5,0.574350044,8039,655,5,0
40052,2014/03/31,2012/02/24,602,5,0.693764087,6655,602,5,0
40053,2014/03/31,2012/03/09,78,5,0.620020145,7446,78,4,1
40054,2014/03/31,2009/06/14,24,3,0.493333333,9357,24,0,3
40055,2014/03/31,2011/01/15,53,4,0.748883842,6164,53,0,4
40056,2014/03/31,2007/02/28,430,3,0.7358680059999999,6273,430,3,0
40057,2014/03/31,2010/07/27,477,7,0.716444203,6443,477,7,0
40058,2014/03/31,2012/01/02,118,7,0.466872661,9887,118,1,6
40059,2014/03/31,2007/01/11,20,4,0.6543748229999999,7054,20,2,2
40060,2014/03/31,2010/04/11,363,7,0.668978261,6900,363,6,1
40061,2014/03/31,2007/07/03,128,3,0.7333333329999999,6294,128,0,3
40062,2014/03/31,2013/03/01,374,3,0.624820631,7387,374,3,0
40063,2014/03/31,2012/12/06,76,4,0.8237140820000001,5603,76,1,3
40064,2014/03/31,2012/11/24,143,5,0.880551421,5241,143,1,4
40065,2014/03/31,2008/07/17,591,3,0.837701942,5509,591,3,0
40066,2014/03/31,2012/10/15,266,4,0.854879585,5398,266,3,1
40067,2014/03/31,2011/05/31,341,6,0.7113629359999999,6486,341,4,2
40068,2014/03/31,2011/08/03,39,3,0.693333333,6654,39,2,1
40069,2014/03/31,2007/05/22,12,7,0.639405405,7215,12,4,3
40070,2014/03/31,2008/03/11,8,5,0.906112748,5091,8,2,3
40071,2014/03/31,2012/02/17,558,5,0.571977681,8065,558,5,0
40072,2014/03/31,2012/12/10,26,3,0.742884522,6209,26,0,3
40073,2014/03/31,2011/07/03,44,5,0.5205372460000001,8860,44,0,5
40074,2014/03/31,2006/11/23,134,5,0.7210774040000001,6395,134,3,2
40075,2014/03/31,2011/07/31,130,8,0.627784888,7345,130,5,3
40076,2014/03/31,2010/11/01,584,4,0.92156706,5003,584,4,0
40077,2014/03/31,2008/11/09,620,5,0.607045036,7594,620,5,0
40078,2014/03/31,2008/01/19,89,6,0.601645784,7662,89,2,4
40079,2014/03/31,2008/05/21,239,5,0.714356113,6453,239,1,4
40080,2014/03/31,2011/08/01,10,7,0.706720331,6522,10,2,5
40081,2014/03/31,2008/08/10,78,7,0.645440415,7141,78,3,4
40082,2014/03/31,2010/09/07,295,6,0.823333333,5598,295,4,2
40083,2014/03/31,2012/11/28,172,6,0.668886792,6890,172,2,4
40084,2014/03/31,2005/11/23,291,6,0.582319939,7914,291,5,1
40085,2014/03/31,2011/08/31,191,7,0.609662654,7559,191,3,4
40086,2014/03/31,2011/12/06,360,4,0.621701295,7412,360,3,1
40087,2014/03/31,2011/10/01,344,5,0.813236851,5666,344,4,1
40088,2014/03/31,2010/02/21,166,4,0.7141227529999999,6452,166,0,4
40089,2014/03/31,2010/02/06,72,7,0.6170975089999999,7466,72,0,7
40090,2014/03/31,2012/07/06,81,4,0.71929274,6405,81,0,4
40091,2014/03/31,2013/01/15,318,4,0.469771592,9807,318,1,3
40092,2014/03/31,2012/08/30,569,2,0.85,5420,569,2,0
40093,2014/03/31,2005/11/07,299,4,0.8420709190000001,5471,299,2,2
40094,2014/03/31,2010/02/03,54,5,0.753733639,6112,54,1,4
40095,2014/03/31,2011/04/12,409,4,0.754446446,6106,409,4,0
40096,2014/03/31,2008/05/14,300,4,0.524733424,8778,300,0,4
40097,2014/03/31,2008/07/15,201,7,0.516762033,8913,201,2,5
40098,2014/03/31,2011/05/24,73,8,0.584012682,7885,73,6,2
40099,2014/03/31,2006/02/09,38,7,0.7622880790000001,6040,38,2,5
40100,2014/03/31,2012/09/21,130,4,0.92319631,4987,130,1,3
40101,2014/03/31,2012/11/08,480,2,0.6,7672,480,2,0
40102,2014/03/31,2012/08/07,382,3,0.4,11508,382,3,0
40103,2014/03/31,2011/03/24,49,7,0.7057712359999999,6522,49,2,5
40104,2014/03/31,2008/06/16,258,7,0.412188591,11167,258,1,6
40105,2014/03/31,2008/09/22,39,7,0.566922035,8119,39,1,6
40106,2014/03/31,2008/07/27,3,3,0.78,5901,3,0,3
40107,2014/03/31,2008/10/28,101,2,0.678750922,6781,101,0,2
40108,2014/03/31,2013/02/27,15,6,1.111666667,4140,15,1,5
40109,2014/03/31,2011/11/20,493,5,0.925769463,4971,493,5,0
40110,2014/03/31,2012/08/28,76,4,0.724498504,6351,76,1,3
40111,2014/03/31,2012/11/10,113,6,0.6670353729999999,6898,113,1,5
40112,2014/03/31,2011/07/10,390,5,0.504285401,9124,390,5,0
40113,2014/03/31,2006/09/15,99,5,0.5916214479999999,7777,99,3,2
40114,2014/03/31,2007/04/23,32,6,0.7744016159999999,5941,32,3,3
40115,2014/03/31,2010/06/02,415,4,0.7921818490000001,5807,415,4,0
40116,2014/03/31,2012/02/20,498,4,0.55,8364,498,4,0
40117,2014/03/31,2007/08/15,286,9,0.665714906,6910,286,5,4
40118,2014/03/31,2012/06/08,249,4,0.831234189,5534,249,3,1
40119,2014/03/31,2009/08/01,417,7,0.6608030460000001,6961,417,7,0
40120,2014/03/31,2012/10/01,98,3,0.689133953,6674,98,1,2
40121,2014/03/31,2008/06/21,58,3,0.534238588,8609,58,0,3
40122,2014/03/31,2012/05/31,457,5,0.79861087,5759,457,5,0
40123,2014/03/31,2008/12/20,13,4,0.784266712,5864,13,1,3
40124,2014/03/31,2011/10/12,190,6,0.656580525,7004,190,2,4
40125,2014/03/31,2011/12/31,76,4,0.695109599,6615,76,2,2
40126,2014/03/31,2012/04/23,5,6,0.6944524999999999,6621,5,2,4
40127,2014/03/31,2011/03/23,222,6,0.7462506090000001,6161,222,4,2
40128,2014/03/31,2012/10/12,57,7,0.862752862,5329,57,2,5
40129,2014/03/31,2011/06/20,514,3,0.81143664,5666,514,3,0
40130,2014/03/31,2013/01/05,5,3,0.66,6966,5,2,1
40131,2014/03/31,2011/09/01,97,3,0.66,6966,97,2,1
40132,2014/03/31,2013/01/01,5,4,0.907099448,5068,5,0,4
40133,2014/03/31,2008/10/24,5,7,0.868961997,5289,5,1,6
40134,2014/03/31,2012/01/15,513,6,0.7668279659999999,5993,513,6,0
40135,2014/03/31,2012/05/08,191,3,0.7164172120000001,6414,191,0,3
40136,2014/03/31,2010/03/29,132,6,0.6014319370000001,7640,132,5,1
40137,2014/03/31,2010/02/06,349,4,0.975695477,4709,349,3,1
40138,2014/03/31,2007/09/21,248,4,0.920863901,4989,248,2,2
40139,2014/03/31,2008/10/16,159,3,0.484561181,9480,159,0,3
40140,2014/03/31,2005/12/17,45,5,0.7832054559999999,5865,45,3,2
40141,2014/03/31,2012/07/19,141,7,0.5352377070000001,8582,141,6,1
40142,2014/03/31,2012/04/27,154,3,0.7424426120000001,6186,154,2,1
40143,2014/03/31,2012/12/18,426,8,0.514127393,8933,426,8,0
40144,2014/03/31,2009/08/23,142,10,0.580758725,7908,142,4,6
40145,2014/03/31,2005/09/17,120,7,0.7804979609999999,5884,120,3,4
40146,2014/03/31,2011/07/21,167,4,0.759300595,6048,167,1,3
40147,2014/03/31,2012/01/16,60,6,0.921195587,4985,60,0,6
40148,2014/03/31,2011/05/21,202,6,1.008333333,4554,202,3,3
40149,2014/03/31,2009/11/11,192,6,0.731666667,6276,192,4,2
40150,2014/03/31,2006/01/17,513,6,0.577184161,7955,513,6,0
40151,2014/03/31,2011/10/29,670,3,0.844317764,5438,670,3,0
40152,2014/03/31,2012/09/16,312,4,0.453491703,10124,312,2,2
40153,2014/03/31,2010/12/17,615,5,0.79647814,5764,615,5,0
40154,2014/03/31,2012/05/05,556,4,0.512606074,8956,556,4,0
40155,2014/03/31,2006/05/05,38,3,0.7477960579999999,6139,38,0,3
40156,2014/03/31,2007/11/25,21,3,0.68949985,6658,21,0,3
40157,2014/03/31,2012/12/17,220,5,0.6747905340000001,6803,220,1,4
40158,2014/03/31,2011/01/13,638,5,0.7138958009999999,6430,638,5,0
40159,2014/03/31,2008/08/09,15,4,0.5424415029999999,8462,15,2,2
40160,2014/03/31,2011/10/31,255,3,0.664263386,6910,255,0,3
40161,2014/03/31,2009/07/27,1,5,0.488,9405,1,1,4
40162,2014/03/31,2011/02/17,425,7,0.663495735,6917,425,7,0
40163,2014/03/31,2013/01/28,57,2,0.675577801,6793,57,1,1
40164,2014/03/31,2007/08/16,124,6,0.727387859,6309,124,2,4
40165,2014/03/31,2008/01/27,448,3,1.166200762,3935,448,3,0
40166,2014/03/31,2010/04/19,160,2,0.965622896,4752,160,1,1
40167,2014/03/31,2006/01/24,206,4,1.113737864,4120,206,2,2
40168,2014/03/31,2010/09/07,115,5,0.545211502,8416,115,2,3
40169,2014/03/31,2005/12/01,355,3,0.716666667,6402,355,2,1
40170,2014/03/31,2010/10/27,254,3,0.816325623,5620,254,2,1
40171,2014/03/31,2011/04/26,351,3,0.63222161,7256,351,2,1
40172,2014/03/31,2009/09/12,346,4,0.636287973,7209,346,3,1
40173,2014/03/31,2011/02/11,187,5,0.6589541729999999,6961,187,2,3
40174,2014/03/31,2007/09/02,220,3,0.739504998,6202,220,2,1
40175,2014/03/31,2010/08/24,115,6,0.499771167,9177,115,4,2
40176,2014/03/31,2011/03/02,15,28,0.89,5152,15,15,13
40177,2014/03/31,2006/06/08,77,5,0.8851698840000001,5180,77,2,3
40178,2014/03/31,2012/04/29,314,6,0.806756995,5683,314,5,1
40179,2014/03/31,2012/10/16,344,3,0.8080190340000001,5674,344,2,1
40180,2014/03/31,2012/01/25,39,6,0.687861965,6665,39,4,2
40181,2014/03/31,2009/04/01,71,7,0.875871227,5234,71,3,4
40182,2014/03/31,2012/10/23,108,3,0.76256197,6011,108,0,3
40183,2014/03/31,2008/07/10,35,6,0.638248155,7181,35,3,3
40184,2014/03/31,2008/11/06,176,6,0.771290811,5942,176,2,4
40185,2014/03/31,2006/04/15,144,5,0.94925435,4828,144,4,1
40186,2014/03/31,2011/12/28,705,3,1.0,4583,705,3,0
40187,2014/03/31,2012/02/26,137,6,0.646456482,7089,137,3,3
40188,2014/03/31,2005/10/10,501,6,0.546481813,8385,501,6,0
40189,2014/03/31,2007/06/22,49,8,0.800753233,5722,49,5,3
40190,2014/03/31,2009/07/13,115,9,0.60510169,7572,115,1,8
40191,2014/03/31,2009/07/28,163,7,0.948571429,4830,163,5,2
40192,2014/03/31,2011/06/29,203,6,0.829990942,5520,203,5,1
40193,2014/03/31,2009/09/15,319,5,0.6379752120000001,7181,319,3,2
40194,2014/03/31,2012/04/29,608,5,0.80159258,5714,608,5,0
40195,2014/03/31,2012/05/18,414,5,0.530589666,8632,414,5,0
40196,2014/03/31,2010/03/16,360,5,0.747860875,6124,360,3,2
40197,2014/03/31,2008/10/29,128,2,0.845,5420,128,0,2
40198,2014/03/31,2005/06/18,209,4,0.755867305,6059,209,2,2
40199,2014/03/31,2005/01/01,148,3,0.77022368,5946,148,2,1
40200,2014/03/31,2007/03/02,384,5,1.059625174,4322,384,5,0
40201,2014/03/31,2012/06/05,241,3,0.600852795,7622,241,2,1
40202,2014/03/31,2011/01/18,73,5,0.58025849,7892,73,3,2
40203,2014/03/31,2012/12/28,245,3,0.931226358,4917,245,1,2
40204,2014/03/31,2012/12/19,332,5,0.52756654,8679,332,3,2
40205,2014/03/31,2011/05/18,335,6,0.96760355,4732,335,4,2
40206,2014/03/31,2008/03/15,193,6,0.82435722,5554,193,0,6
40207,2014/03/31,2013/02/21,14,5,0.6,7630,14,1,4
40208,2014/03/31,2012/07/22,591,4,0.875,5232,591,4,0
40209,2014/03/31,2012/03/01,70,4,0.846057301,5410,70,0,4
40210,2014/03/31,2010/06/25,111,5,0.8961973759999999,5107,111,4,1
40211,2014/03/31,2010/09/09,8,4,0.671821785,6812,8,2,2
40212,2014/03/31,2007/06/08,26,5,0.4953230870000001,9239,26,4,1
40213,2014/03/31,2013/02/20,397,2,0.625,7322,397,2,0
40214,2014/03/31,2009/07/08,325,4,0.7215468309999999,6342,325,3,1
40215,2014/03/31,2008/11/23,158,5,0.7123209840000001,6424,158,3,2
40216,2014/03/31,2013/03/09,11,5,0.658184695,6952,11,2,3
40217,2014/03/31,2009/11/13,256,4,0.845338137,5412,256,3,1
40218,2014/03/31,2010/08/14,9,6,0.5227148079999999,8752,9,2,4
40219,2014/03/31,2005/11/22,2,4,0.7582446540000001,6033,2,3,1
40220,2014/03/31,2013/02/27,101,5,0.57266433,7987,101,0,5
40221,2014/03/31,2007/08/27,115,5,0.782384944,5845,115,0,5
40222,2014/03/31,2006/08/04,145,6,0.623725276,7331,145,2,4
40223,2014/03/31,2008/11/17,433,7,0.658840058,6940,433,7,0
40224,2014/03/31,2012/02/27,94,6,0.654929093,6981,94,1,5
40225,2014/03/31,2012/07/30,16,11,0.669015218,6834,16,3,8
40226,2014/03/31,2012/03/06,423,2,1.05,4354,423,2,0
40227,2014/03/31,2011/01/12,35,7,0.672226471,6800,35,3,4
40228,2014/03/31,2007/06/21,192,5,0.8740000000000001,5230,192,4,1
40229,2014/03/31,2013/03/17,164,3,0.589847722,7749,164,1,2
40230,2014/03/31,2012/06/19,204,3,0.6115683129999999,7473,204,2,1
40231,2014/03/31,2009/03/10,87,7,0.657751871,6948,87,1,6
40232,2014/03/31,2007/02/04,67,6,0.570501935,8009,67,0,6
40233,2014/03/31,2009/12/06,20,6,0.631112032,7239,20,0,6
40234,2014/03/31,2011/11/21,690,2,0.7881987579999999,5796,690,2,0
40235,2014/03/31,2012/04/07,186,4,0.528611433,8642,186,3,1
40236,2014/03/31,2012/05/19,307,11,0.770362563,5930,307,8,3
40237,2014/03/31,2010/06/02,489,4,0.819318386,5575,489,4,0
40238,2014/03/31,2012/05/08,101,6,0.623039149,7331,101,3,3
40239,2014/03/31,2007/03/29,351,4,0.512218235,8917,351,0,4
40240,2014/03/31,2012/08/16,2,7,0.656703091,6955,2,1,6
40241,2014/03/31,2011/12/16,346,5,0.931111111,4905,346,4,1
40242,2014/03/31,2012/10/10,344,10,0.5638333329999999,8100,344,6,4
40243,2014/03/31,2012/07/19,172,6,0.824927746,5536,172,4,2
40244,2014/03/31,2008/08/11,68,5,0.7945797809999999,5747,68,0,5
40245,2014/03/31,2009/02/23,90,5,1.088788746,4194,90,3,2
40246,2014/03/31,2005/07/06,27,9,0.54393925,8395,27,1,8
40247,2014/03/31,2006/02/27,44,5,0.674,6775,44,4,1
40248,2014/03/31,2007/09/04,338,6,0.7888908090000001,5788,338,3,3
40249,2014/03/31,2012/05/23,558,4,0.42704826,10692,558,4,0
40250,2014/03/31,2009/08/01,145,6,0.695984756,6560,145,1,5
40251,2014/03/31,2011/09/24,187,4,0.590170631,7736,187,2,2
40252,2014/03/31,2010/11/17,80,16,0.723502377,6310,80,10,6
40253,2014/03/31,2011/05/24,114,9,0.550822876,8288,114,6,3
40254,2014/03/31,2008/03/10,109,10,0.72185642,6324,109,6,4
40255,2014/03/31,2011/04/17,218,4,0.8725,5232,218,2,2
40256,2014/03/31,2010/01/19,85,4,0.749445083,6091,85,2,2
40257,2014/03/31,2006/09/10,4,5,0.655114811,6968,4,0,5
40258,2014/03/31,2006/07/25,146,5,0.794693593,5744,146,1,4
40259,2014/03/31,2011/08/22,535,5,0.543604097,8396,535,5,0
40260,2014/03/31,2007/12/26,66,4,0.6323638629999999,7217,66,2,2
40261,2014/03/31,2009/07/04,40,8,0.540087574,8450,40,6,2
40262,2014/03/31,2010/01/08,344,5,0.900236733,5069,344,3,2
40263,2014/03/31,2005/10/30,188,5,0.6674286970000001,6837,188,3,2
40264,2014/03/31,2011/07/31,308,4,0.95704698,4768,308,2,2
40265,2014/03/31,2013/01/30,43,5,0.527550879,8648,43,0,5
40266,2014/03/31,2011/05/26,25,10,0.606243189,7525,25,3,7
40267,2014/03/31,2009/03/12,47,5,0.768,5940,47,2,3
40268,2014/03/31,2011/03/31,60,9,0.4266666670000001,10692,60,4,5
40269,2014/03/31,2011/03/13,132,3,0.811551325,5621,132,2,1
40270,2014/03/31,2013/01/11,249,5,0.63268516,7210,249,2,3
40271,2014/03/31,2006/04/03,273,7,0.797133869,5722,273,4,3
40272,2014/03/31,2009/10/24,78,4,0.661617583,6893,78,1,3
40273,2014/03/31,2010/09/09,35,5,0.743960848,6130,35,1,4
40274,2014/03/31,2006/02/21,45,4,0.7002871620000001,6512,45,2,2
40275,2014/03/31,2008/02/20,244,5,0.91332866,4993,244,4,1
40276,2014/03/31,2010/12/27,136,6,0.6537496420000001,6974,136,3,3
40277,2014/03/31,2011/04/08,20,5,0.6869127620000001,6637,20,2,3
40278,2014/03/31,2012/06/13,619,3,0.8505597009999999,5360,619,3,0
40279,2014/03/31,2007/10/30,71,7,0.8081847190000001,5641,71,4,3
40280,2014/03/31,2012/05/23,39,2,1.305892294,3491,39,1,1
40281,2014/03/31,2012/04/23,23,6,0.466174064,9778,23,2,4
40282,2014/03/31,2010/06/26,102,6,0.558786318,8157,102,3,3
40283,2014/03/31,2006/02/28,489,2,0.978321528,4659,489,2,0
40284,2014/03/31,2012/10/02,541,2,1.202294909,3791,541,2,0
40285,2014/03/31,2012/08/31,571,3,0.727734313,6263,571,3,0
40286,2014/03/31,2009/01/23,164,4,0.670055866,6802,164,3,1
40287,2014/03/31,2012/10/15,123,7,0.812857143,5607,123,5,2
40288,2014/03/31,2012/04/16,35,5,0.774429907,5885,35,3,2
40289,2014/03/31,2010/03/01,45,8,0.546773845,8335,45,3,5
40290,2014/03/31,2010/11/17,147,5,0.8180362590000001,5571,147,3,2
40291,2014/03/31,2010/05/16,136,6,0.7121565870000001,6399,136,4,2
40292,2014/03/31,2010/11/01,91,5,0.551096868,8269,91,4,1
40293,2014/03/31,2009/11/05,125,5,0.6665945,6836,125,1,4
40294,2014/03/31,2011/10/14,261,4,0.747065093,6099,261,1,3
40295,2014/03/31,2008/12/11,170,7,0.586652073,7766,170,2,5
40296,2014/03/31,2012/06/07,315,7,0.480553797,9480,315,4,3
40297,2014/03/31,2007/02/15,159,6,0.653745695,6968,159,3,3
40298,2014/03/31,2012/05/16,18,7,0.6251104710000001,7287,18,2,5
40299,2014/03/31,2013/02/11,39,4,0.612711864,7434,39,1,3
40300,2014/03/31,2011/01/24,143,6,0.662135485,6879,143,2,4
40301,2014/03/31,2012/02/06,137,7,0.628794698,7243,137,4,3
40302,2014/03/31,2012/03/06,94,9,0.6760189999999999,6737,94,6,3
40303,2014/03/31,2009/01/13,572,2,0.85,5358,572,2,0
40304,2014/03/31,2012/11/01,65,5,0.68023301,6695,65,2,3
40305,2014/03/31,2010/09/21,390,7,0.483294417,9422,390,7,0
40306,2014/03/31,2011/01/01,299,4,0.8493732509999999,5361,299,2,2
40307,2014/03/31,2008/06/26,499,4,0.851402393,5348,499,4,0
40308,2014/03/31,2009/06/23,4,14,0.738169585,6168,4,8,6
40309,2014/03/31,2013/01/31,7,6,0.7354959609999999,6190,7,1,5
40310,2014/03/31,2009/02/19,251,3,0.723333333,6294,251,2,1
40311,2014/03/31,2011/02/04,124,4,0.692896499,6570,124,2,2
40312,2014/03/31,2011/09/09,61,4,0.72007118,6322,61,0,4
40313,2014/03/31,2012/12/13,331,7,0.54786978,8309,331,5,2
40314,2014/03/31,2008/03/25,172,5,0.6098821010000001,7464,172,1,4
40315,2014/03/31,2012/08/15,57,3,0.806666667,5643,57,2,1
40316,2014/03/31,2012/08/09,12,5,0.7251425840000001,6277,12,2,3
40317,2014/03/31,2007/03/04,73,6,0.6615610470000001,6880,73,3,3
40318,2014/03/31,2008/03/23,440,7,0.954972723,4766,440,7,0
40319,2014/03/31,2012/07/08,432,4,0.5580748010000001,8155,432,4,0
40320,2014/03/31,2008/11/19,395,8,0.786985472,5782,395,8,0
40321,2014/03/31,2010/05/27,20,8,0.545469911,8342,20,4,4
40322,2014/03/31,2008/06/17,155,5,0.65,7000,155,2,3
40323,2014/03/31,2013/03/09,80,5,0.779585332,5836,80,1,4
40324,2014/03/31,2012/08/10,13,6,0.5055022220000001,9000,13,0,6
40325,2014/03/31,2011/01/21,171,6,0.905555334,5024,171,0,6
40326,2014/03/31,2008/07/04,144,3,0.73,6231,144,1,2
40327,2014/03/31,2012/03/01,60,4,0.7391306470000001,6154,60,0,4
40328,2014/03/31,2010/04/19,221,7,0.931837738,4881,221,5,2
40329,2014/03/31,2012/09/12,100,4,0.5825,7808,100,3,1
40330,2014/03/31,2013/02/24,360,2,0.75,6064,360,1,1
40331,2014/03/31,2010/12/29,95,5,0.508214126,8948,95,2,3
40332,2014/03/31,2010/08/19,25,6,0.689629967,6594,25,0,6
40333,2014/03/31,2013/02/27,356,2,0.8,5684,356,1,1
40334,2014/03/31,2012/05/25,661,2,0.8,5684,661,2,0
40335,2014/03/31,2007/07/10,56,3,0.7836728709999999,5802,56,1,2
40336,2014/03/31,2011/01/14,48,6,0.8142550140000001,5584,48,2,4
40337,2014/03/31,2004/11/20,308,9,0.672205795,6764,308,6,3
40338,2014/03/31,2012/10/25,258,5,0.708205607,6420,258,2,3
40339,2014/03/31,2008/01/14,115,4,0.748309465,6075,115,0,4
40340,2014/03/31,2013/01/08,249,4,0.556682586,8166,249,0,4
40341,2014/03/31,2005/10/29,57,2,0.765,5942,57,0,2
40342,2014/03/31,2012/12/19,220,5,0.836897441,5431,220,2,3
40343,2014/03/31,2012/06/13,229,5,0.66820494,6802,229,1,4
40344,2014/03/31,2012/03/07,239,4,0.665362319,6831,239,1,3
40345,2014/03/31,2004/12/03,453,5,0.6101154520000001,7449,453,5,0
40346,2014/03/31,2011/01/14,50,4,0.655121811,6937,50,0,4
40347,2014/03/31,2012/08/12,321,4,0.590482069,7696,321,3,1
40348,2014/03/31,2010/12/28,62,6,0.612795684,7415,62,4,2
40349,2014/03/31,2012/06/05,43,5,0.974,4665,43,4,1
40350,2014/03/31,2009/11/24,43,11,0.551050334,8245,43,4,7
40351,2014/03/31,2012/09/21,352,5,0.8439531859999999,5383,352,4,1
40352,2014/03/31,2007/04/02,81,5,0.844093274,5382,81,1,4
40353,2014/03/31,2011/07/29,142,7,0.626171767,7254,142,4,3
40354,2014/03/31,2008/08/08,101,5,0.7159284359999999,6344,101,3,2
40355,2014/03/31,2006/08/23,47,11,0.442328594,10268,47,5,6
40356,2014/03/31,2007/04/14,128,5,0.652934158,6956,128,2,3
40357,2014/03/31,2007/07/25,259,5,0.821450534,5529,259,4,1
40358,2014/03/31,2012/06/25,528,13,0.430769231,10543,528,13,0
40359,2014/03/31,2008/05/08,83,10,0.56,8110,83,3,7
40360,2014/03/31,2010/04/06,9,4,0.798170475,5690,9,1,3
40361,2014/03/31,2007/04/12,468,4,0.601988335,7544,468,4,0
40362,2014/03/31,2009/09/24,112,8,0.472721216,9606,112,0,8
40363,2014/03/31,2012/05/12,348,4,0.425,10684,348,3,1
40364,2014/03/31,2011/12/25,368,6,0.5074997210000001,8947,368,6,0
40365,2014/03/31,2010/01/04,513,5,0.815876011,5565,513,5,0
40366,2014/03/31,2012/10/09,399,3,1.0,4540,399,3,0
40367,2014/03/31,2007/06/30,35,6,0.852702855,5324,35,2,4
40368,2014/03/31,2012/11/18,142,5,0.623794146,7277,142,0,5
40369,2014/03/31,2006/10/01,632,4,0.836238025,5428,632,4,0
40370,2014/03/31,2006/02/27,151,8,0.6878842070000001,6598,151,5,3
40371,2014/03/31,2009/05/17,418,4,0.693763375,6542,418,4,0
40372,2014/03/31,2009/11/06,269,8,0.6037741120000001,7517,269,5,3
40373,2014/03/31,2007/06/17,61,3,0.7241981809999999,6267,61,1,2
40374,2014/03/31,2011/08/13,235,5,0.6986637929999999,6496,235,2,3
40375,2014/03/31,2011/10/31,123,4,0.8443162790000001,5375,123,0,4
40376,2014/03/31,2010/08/04,333,4,0.5288661,8581,333,2,2
40377,2014/03/31,2011/07/26,156,8,0.406785586,11156,156,3,5
40378,2014/03/31,2013/02/04,85,6,0.637651771,7116,85,2,4
40379,2014/03/31,2006/10/23,52,6,0.577361924,7858,52,3,3
40380,2014/03/31,2010/05/25,284,6,0.715696482,6339,284,5,1
40381,2014/03/31,2007/11/20,692,3,0.6101882989999999,7435,692,3,0
40382,2014/03/31,2010/10/31,330,4,0.7180199429999999,6318,330,3,1
40383,2014/03/31,2012/10/23,87,5,0.6736640429999999,6733,87,0,5
40384,2014/03/31,2009/12/20,159,3,0.935392865,4849,159,1,2
40385,2014/03/31,2011/01/02,232,5,0.688791192,6585,232,3,2
40386,2014/03/31,2012/11/08,229,4,0.871383285,5205,229,0,4
40387,2014/03/31,2012/10/14,87,5,0.6046127179999999,7501,87,0,5
40388,2014/03/31,2011/06/29,324,4,0.822637403,5513,324,1,3
40389,2014/03/31,2011/01/13,90,8,0.794985975,5704,90,6,2
40390,2014/03/31,2010/07/21,332,3,0.994189871,4561,332,2,1
40391,2014/03/31,2009/04/22,74,7,0.472052056,9605,74,3,4
40392,2014/03/31,2011/11/08,271,8,0.68969425,6574,271,7,1
40393,2014/03/31,2009/06/26,247,3,0.7407188370000001,6121,247,2,1
40394,2014/03/31,2011/11/20,168,7,0.706631858,6416,168,4,3
40395,2014/03/31,2010/09/18,163,5,0.658666279,6883,163,2,3
40396,2014/03/31,2012/05/20,196,6,0.766973439,5911,196,4,2
40397,2014/03/31,2012/04/11,115,4,0.7293307590000001,6216,115,2,2
40398,2014/03/31,2012/04/17,415,3,0.852001503,5321,415,3,0
40399,2014/03/31,2012/07/11,24,9,0.574003545,7898,24,4,5
40400,2014/03/31,2007/04/18,340,10,0.6236552479999999,7269,340,6,4
40401,2014/03/31,2012/11/30,264,6,0.43021638,10537,264,3,3
40402,2014/03/31,2012/10/30,88,4,0.641838006,7062,88,2,2
40403,2014/03/31,2012/07/05,158,3,0.595433526,7612,158,2,1
40404,2014/03/31,2012/10/10,177,3,0.70913785,6391,177,1,2
40405,2014/03/31,2010/02/26,38,5,0.600573814,7546,38,4,1
40406,2014/03/31,2012/11/22,255,5,0.7078522340000001,6402,255,2,3
40407,2014/03/31,2013/02/06,106,5,0.649263505,6979,106,2,3
40408,2014/03/31,2009/11/20,186,5,0.543529271,8336,186,2,3
40409,2014/03/31,2012/11/20,142,6,0.726884325,6233,142,3,3
40410,2014/03/31,2007/02/27,432,9,0.445423262,10171,432,9,0
40411,2014/03/31,2011/06/22,43,6,0.82489075,5492,43,2,4
40412,2014/03/31,2008/02/23,195,6,0.521668586,8684,195,1,5
40413,2014/03/31,2012/05/01,101,7,0.7361244720000001,6154,101,3,4
40414,2014/03/31,2007/07/04,288,6,0.399688548,11334,288,4,2
40415,2014/03/31,2012/04/12,96,5,0.807774608,5608,96,3,2
40416,2014/03/31,2013/03/31,365,2,0.575,7878,365,1,1
40417,2014/03/31,2010/03/19,42,5,0.681275572,6648,42,3,2
40418,2014/03/31,2011/06/05,31,5,0.8238839370000001,5497,31,1,4
40419,2014/03/31,2012/06/21,17,2,1.09,4154,17,0,2
40420,2014/03/31,2009/02/13,273,5,0.731944714,6186,273,2,3
40421,2014/03/31,2007/11/21,47,8,0.656672951,6895,47,0,8
40422,2014/03/31,2012/05/26,539,4,0.8519382759999999,5314,539,4,0
40423,2014/03/31,2009/01/01,163,4,0.926184534,4888,163,1,3
40424,2014/03/31,2005/12/25,141,9,0.478050686,9470,141,5,4
40425,2014/03/31,2008/11/09,326,5,0.850921053,5320,326,3,2
40426,2014/03/31,2011/07/26,189,3,0.393333333,11508,189,2,1
40427,2014/03/31,2012/09/09,159,6,0.621059276,7288,159,4,2
40428,2014/03/31,2009/02/22,42,4,0.6891397690000001,6568,42,1,3
40429,2014/03/31,2012/06/04,121,3,0.716046512,6321,121,1,2
40430,2014/03/31,2011/03/29,37,6,0.583688419,7754,37,5,1
40431,2014/03/31,2008/05/19,283,2,0.540904745,8367,283,1,1
40432,2014/03/31,2005/10/29,109,2,0.835,5420,109,0,2
40433,2014/03/31,2012/05/23,139,3,0.774945205,5840,139,1,2
40434,2014/03/31,2009/12/19,113,7,0.559552423,8088,113,2,5
40435,2014/03/31,2009/09/22,188,5,0.741535562,6102,188,3,2
40436,2014/03/31,2013/03/11,140,2,0.776779399,5825,140,1,1
40437,2014/03/31,2013/02/19,232,2,0.785203054,5762,232,1,1
40438,2014/03/31,2012/11/06,2,5,0.6515164170000001,6944,2,0,5
40439,2014/03/31,2011/11/10,489,4,0.575,7868,489,4,0
40440,2014/03/31,2008/10/01,588,3,0.7666666670000001,5901,588,3,0
40441,2014/03/31,2010/06/04,505,4,0.575,7868,505,4,0
40442,2014/03/31,2012/09/14,11,4,0.84451372,5357,11,2,2
40443,2014/03/31,2009/08/01,95,6,0.625614714,7231,95,3,3
40444,2014/03/31,2011/12/16,98,3,0.8899783590000001,5083,98,1,2
40445,2014/03/31,2011/03/25,14,5,0.674879905,6703,14,3,2
40446,2014/03/31,2011/03/13,117,5,0.6994001240000001,6468,117,0,5
40447,2014/03/31,2012/03/03,89,4,0.709673674,6374,89,1,3
40448,2014/03/31,2010/02/09,59,4,0.76136509,5941,59,0,4
40449,2014/03/31,2012/04/16,125,8,0.854374764,5294,125,2,6
40450,2014/03/31,2007/09/15,379,3,0.7548314420000001,5992,379,3,0
40451,2014/03/31,2008/09/10,142,4,0.366972008,12325,142,2,2
40452,2014/03/31,2010/10/25,116,7,0.7282995170000001,6210,116,6,1
40453,2014/03/31,2013/01/05,448,2,0.725,6238,448,2,0
40454,2014/03/31,2012/06/27,68,5,0.556722886,8123,68,0,5
40455,2014/03/31,2006/02/05,560,2,0.7,6460,560,2,0
40456,2014/03/31,2012/12/06,16,4,0.666801357,6781,16,0,4
40457,2014/03/31,2007/05/22,552,3,0.73878268,6120,552,3,0
40458,2014/03/31,2006/03/22,34,5,0.753044637,6004,34,1,4
40459,2014/03/31,2011/02/16,110,3,0.855509084,5284,110,0,3
40460,2014/03/31,2011/08/14,259,3,1.17107513,3860,259,2,1
40461,2014/03/31,2013/01/01,162,3,0.5651537879999999,7998,162,2,1
40462,2014/03/31,2013/03/24,169,5,0.853580737,5295,169,1,4
40463,2014/03/31,2005/12/25,230,3,0.8381769290000001,5392,230,2,1
40464,2014/03/31,2013/02/25,184,7,0.949187146,4761,184,1,6
40465,2014/03/31,2009/07/10,207,6,0.6818922590000001,6627,207,4,2
40466,2014/03/31,2012/03/29,483,5,0.583077419,7750,483,5,0
40467,2014/03/31,2007/03/30,93,8,0.527218528,8571,93,6,2
40468,2014/03/31,2009/09/10,255,2,0.795,5684,255,0,2
40469,2014/03/31,2008/05/10,54,4,0.477226154,9467,54,2,2
40470,2014/03/31,2012/12/21,56,8,0.736412388,6135,56,2,6
40471,2014/03/31,2008/07/03,218,6,0.672017257,6722,218,2,4
40472,2014/03/31,2012/09/30,121,7,0.6757142859999999,6685,121,0,7
40473,2014/03/31,2013/01/01,24,4,0.54,8364,24,0,4
40474,2014/03/31,2012/06/23,5,3,0.737864728,6121,5,0,3
40475,2014/03/31,2012/05/26,608,6,0.454589834,9935,608,6,0
40476,2014/03/31,2012/07/21,303,7,0.728548153,6199,303,4,3
40477,2014/03/31,2008/12/26,6,6,0.71178093,6345,6,0,6
40478,2014/03/31,2008/04/19,10,5,0.8580752420000001,5263,10,4,1
40479,2014/03/31,2012/01/01,706,2,1.0,4516,706,2,0
40480,2014/03/31,2013/03/27,90,5,0.7761945690000001,5818,90,1,4
40481,2014/03/31,2006/03/13,289,5,0.968,4665,289,3,2
40482,2014/03/31,2009/11/11,1,2,0.81743664,5524,1,0,2
40483,2014/03/31,2011/01/24,48,5,0.644494719,7006,48,4,1
40484,2014/03/31,2013/03/11,187,5,0.792295139,5699,187,1,4
40485,2014/03/31,2008/10/01,18,11,0.519056105,8698,18,0,11
40486,2014/03/31,2011/08/25,137,7,0.638571429,7070,137,6,1
40487,2014/03/31,2008/07/18,445,6,0.634593759,7114,445,6,0
40488,2014/03/31,2012/05/10,67,9,0.91418388,4938,67,3,6
40489,2014/03/31,2007/05/29,207,7,0.972259315,4643,207,4,3
40490,2014/03/31,2011/06/27,85,11,0.481208955,9380,85,8,3
40491,2014/03/31,2013/02/18,182,6,0.555799778,8121,182,0,6
40492,2014/03/31,2012/08/05,249,4,0.7957545840000001,5672,249,3,1
40493,2014/03/31,2012/05/27,269,6,0.61591976,7328,269,5,1
40494,2014/03/31,2012/08/25,89,9,0.421738927,10702,89,2,7
40495,2014/03/31,2011/03/24,40,5,0.659602455,6842,40,2,3
40496,2014/03/31,2007/12/21,300,4,0.669255524,6743,300,2,2
40497,2014/03/31,2011/10/06,25,6,0.498310512,9056,25,2,4
40498,2014/03/31,2012/07/14,159,6,0.5640824999999999,8000,159,4,2
40499,2014/03/31,2010/12/31,129,5,0.69,6540,129,2,3
40500,2014/03/31,2008/05/19,597,5,0.69,6540,597,5,0
40501,2014/03/31,2011/07/17,160,6,0.5834535820000001,7734,160,3,3
40502,2014/03/31,2010/04/20,126,4,0.730749798,6175,126,2,2
40503,2014/03/31,2013/02/06,266,4,0.733119415,6155,266,2,2
40504,2014/03/31,2005/10/06,13,6,0.635177365,7104,13,0,6
40505,2014/03/31,2012/09/19,493,4,0.852181303,5295,493,4,0
40506,2014/03/31,2011/02/18,36,8,0.5478593979999999,8236,36,1,7
40507,2014/03/31,2012/07/09,223,5,0.607778825,7424,223,4,1
40508,2014/03/31,2012/01/16,282,4,0.52925044,8525,282,3,1
40509,2014/03/31,2009/05/17,166,3,1.200266028,3759,166,2,1
40510,2014/03/31,2008/08/27,597,3,1.4138201190000002,3191,597,3,0
40511,2014/03/31,2012/10/09,282,5,0.67013369,6732,282,3,2
40512,2014/03/31,2007/09/22,530,3,0.716666667,6294,530,3,0
40513,2014/03/31,2012/06/08,561,2,1.075,4196,561,2,0
40514,2014/03/31,2010/11/20,223,6,0.6141911760000001,7344,223,4,2
40515,2014/03/31,2012/04/28,675,3,0.64101507,7034,675,3,0
40516,2014/03/31,2012/07/11,371,5,0.878585347,5132,371,5,0
40517,2014/03/31,2006/07/31,229,6,0.643930306,7002,229,4,2
40518,2014/03/31,2013/03/23,278,4,0.471625523,9560,278,1,3
40519,2014/03/31,2010/10/15,73,4,1.004816136,4487,73,2,2
40520,2014/03/31,2012/09/15,153,4,0.678741343,6642,153,2,2
40521,2014/03/31,2012/09/30,181,6,0.506215609,8905,181,0,6
40522,2014/03/31,2012/06/22,7,5,0.552755365,8155,7,2,3
40523,2014/03/31,2013/01/13,172,4,0.7580995629999999,5946,172,1,3
40524,2014/03/31,2009/08/02,321,4,0.518001609,8702,321,3,1
40525,2014/03/31,2012/09/01,66,5,0.462171639,9753,66,1,4
40526,2014/03/31,2008/06/25,23,5,0.7986531990000001,5643,23,3,2
40527,2014/03/31,2012/05/18,274,7,0.523164616,8614,274,4,3
40528,2014/03/31,2011/05/10,105,4,0.917975148,4909,105,0,4
40529,2014/03/31,2011/03/29,621,4,0.706854902,6375,621,4,0
40530,2014/03/31,2011/08/01,140,4,0.762192152,5912,140,2,2
40531,2014/03/31,2007/11/06,41,3,0.8335294120000001,5406,41,2,1
40532,2014/03/31,2013/03/27,275,5,0.551633203,8168,275,1,4
40533,2014/03/31,2012/12/27,29,8,0.516868189,8717,29,0,8
40534,2014/03/31,2006/04/07,38,5,0.669064449,6734,38,1,4
40535,2014/03/31,2011/05/07,30,5,0.7859647590000001,5732,30,0,5
40536,2014/03/31,2010/03/22,384,5,0.730517269,6167,384,5,0
40537,2014/03/31,2012/06/28,75,4,0.795618156,5662,75,3,1
40538,2014/03/31,2010/10/07,156,3,0.739481202,6091,156,2,1
40539,2014/03/31,2011/07/29,558,3,0.619958706,7265,558,3,0
40540,2014/03/31,2012/08/24,29,9,0.7444330579999999,6050,29,4,5
40541,2014/03/31,2010/01/05,313,8,0.578225703,7789,313,7,1
40542,2014/03/31,2010/12/07,292,3,0.562190738,8011,292,2,1
40543,2014/03/31,2012/07/13,255,2,0.83001843,5426,255,1,1
40544,2014/03/31,2012/07/29,341,4,0.8143399640000001,5530,341,3,1
40545,2014/03/31,2006/01/24,128,4,0.7768035190000001,5797,128,2,2
40546,2014/03/31,2010/07/14,36,3,0.84404686,5335,36,2,1
40547,2014/03/31,2011/11/08,166,6,0.7015080229999999,6419,166,3,3
40548,2014/03/31,2013/03/10,38,7,0.7569036809999999,5949,38,2,5
40549,2014/03/31,2005/03/18,206,5,0.670287331,6717,206,3,2
40550,2014/03/31,2010/11/19,158,9,0.474818057,9481,158,8,1
40551,2014/03/31,2008/03/18,88,3,0.7463080240000001,6032,88,0,3
40552,2014/03/31,2008/05/29,116,5,0.579661344,7766,116,2,3
40553,2014/03/31,2010/05/03,174,6,0.731291633,6155,174,4,2
40554,2014/03/31,2012/09/10,360,7,0.716687898,6280,360,3,4
40555,2014/03/31,2012/06/09,48,4,0.927596867,4852,48,1,3
40556,2014/03/31,2010/10/25,25,6,0.583459095,7713,25,2,4
40557,2014/03/31,2008/04/27,389,5,0.68119891,6606,389,5,0
40558,2014/03/31,2009/07/08,295,6,0.7531046029999999,5975,295,0,6
40559,2014/03/31,2009/10/14,26,4,0.750196732,5998,26,2,2
40560,2014/03/31,2009/02/20,507,4,0.737678308,6099,507,4,0
40561,2014/03/31,2012/10/18,126,10,0.547333333,8220,126,5,5
40562,2014/03/31,2012/01/16,136,5,0.723772523,6216,136,1,4
40563,2014/03/31,2012/01/19,114,6,0.592589568,7592,114,1,5
40564,2014/03/31,2009/12/31,124,6,0.650224021,6919,124,2,4
40565,2014/03/31,2013/01/10,235,9,0.8633333329999999,5211,235,3,6
40566,2014/03/31,2012/03/15,215,3,0.840710148,5351,215,1,2
40567,2014/03/31,2008/03/09,5,3,1.090310228,4126,5,1,2
40568,2014/03/31,2011/03/24,132,2,0.83,5420,132,0,2
40569,2014/03/31,2008/11/14,11,3,0.894790133,5027,11,0,3
40570,2014/03/31,2008/05/31,34,8,0.530109605,8485,34,7,1
40571,2014/03/31,2010/11/19,27,7,0.664544111,6767,27,3,4
40572,2014/03/31,2009/12/29,124,4,0.57823068,7777,124,0,4
40573,2014/03/31,2013/01/18,75,6,0.621964039,7230,75,1,5
40574,2014/03/31,2009/01/17,623,7,0.8895351140000001,5055,623,7,0
40575,2014/03/31,2009/03/01,347,4,0.66125,6800,347,2,2
40576,2014/03/31,2011/06/30,11,4,0.817512727,5500,11,2,2
40577,2014/03/31,2007/07/19,202,4,0.749128624,6002,202,2,2
40578,2014/03/31,2007/02/25,163,4,0.610458927,7365,163,0,4
40579,2014/03/31,2010/08/18,39,4,0.790298822,5689,39,0,4
40580,2014/03/31,2011/12/24,516,5,0.714983299,6287,516,5,0
40581,2014/03/31,2011/07/01,152,7,0.572653841,7849,152,5,2
40582,2014/03/31,2012/06/04,365,4,0.59928,7500,365,3,1
40583,2014/03/31,2013/01/01,107,6,0.7416666670000001,6060,107,0,6
40584,2014/03/31,2013/01/01,214,5,0.89,5050,214,0,5
40585,2014/03/31,2009/10/31,335,4,0.556225248,8080,335,1,3
40586,2014/03/31,2013/03/25,86,4,0.572781035,7846,86,0,4
40587,2014/03/31,2005/10/19,77,6,0.756761536,5938,77,0,6
40588,2014/03/31,2008/11/18,494,3,1.417476341,3170,494,3,0
40589,2014/03/31,2007/07/03,122,4,0.8769106170000001,5124,122,1,3
40590,2014/03/31,2006/11/27,187,6,0.599181224,7499,187,4,2
40591,2014/03/31,2011/11/13,190,3,0.8007699159999999,5611,190,1,2
40592,2014/03/31,2005/01/01,361,5,0.650419803,6908,361,4,1
40593,2014/03/31,2008/08/19,589,2,0.85,5286,589,2,0
40594,2014/03/31,2008/11/02,225,2,0.85,5286,225,0,2
40595,2014/03/31,2012/12/10,268,2,0.85,5286,268,0,2
40596,2014/03/31,2012/08/10,597,2,0.85,5286,597,2,0
40597,2014/03/31,2007/06/15,29,8,0.6052101289999999,7424,29,5,3
40598,2014/03/31,2011/08/28,441,5,0.688091591,6529,441,5,0
40599,2014/03/31,2005/11/15,55,8,0.7238527229999999,6206,55,4,4
40600,2014/03/31,2010/04/11,219,2,0.72,6238,219,0,2
40601,2014/03/31,2012/06/07,134,3,0.48,9357,134,2,1
40602,2014/03/31,2011/05/19,294,6,0.623015675,7209,294,4,2
40603,2014/03/31,2005/09/20,193,6,0.75226001,5969,193,2,4
40604,2014/03/31,2010/12/01,149,5,0.640604937,7009,149,3,2
40605,2014/03/31,2012/10/02,5,5,0.7498062790000001,5988,5,3,2
40606,2014/03/31,2011/08/15,527,3,0.7666666670000001,5856,527,3,0
40607,2014/03/31,2010/07/27,216,3,0.586593493,7653,216,1,2
40608,2014/03/31,2012/04/18,101,2,0.937727178,4787,101,1,1
40609,2014/03/31,2010/01/18,76,6,0.665533808,6744,76,3,3
40610,2014/03/31,2012/07/13,2,4,0.751683135,5971,2,0,4
40611,2014/03/31,2012/10/13,323,6,0.6166666670000001,7278,323,4,2
40612,2014/03/31,2007/12/12,674,4,0.782783883,5733,674,4,0
40613,2014/03/31,2007/04/30,177,4,0.520090403,8628,177,2,2
40614,2014/03/31,2007/11/20,5,3,0.883674675,5078,5,2,1
40615,2014/03/31,2008/05/17,256,5,0.919127407,4882,256,0,5
40616,2014/03/31,2008/11/03,284,6,0.561032758,7998,284,1,5
40617,2014/03/31,2005/11/02,230,3,1.182677912,3794,230,1,2
40618,2014/03/31,2007/12/20,54,3,0.48075217,9333,54,1,2
40619,2014/03/31,2011/05/24,297,7,0.8221261000000001,5456,297,6,1
40620,2014/03/31,2008/10/29,36,6,0.68626377,6536,36,2,4
40621,2014/03/31,2012/04/17,195,4,0.57,7868,195,2,2
40622,2014/03/31,2007/04/27,30,8,0.86375,5192,30,4,4
40623,2014/03/31,2011/06/06,30,8,0.7848179909999999,5714,30,3,5
40624,2014/03/31,2008/10/11,16,6,0.973323204,4607,16,2,4
40625,2014/03/31,2008/04/11,74,6,0.764631651,5864,74,0,6
40626,2014/03/31,2011/05/15,100,5,0.644489004,6957,100,3,2
40627,2014/03/31,2012/08/27,241,6,0.587980328,7625,241,0,6
40628,2014/03/31,2011/07/07,80,13,0.662791248,6764,80,7,6
40629,2014/03/31,2007/08/12,182,5,0.724919146,6184,182,2,3
40630,2014/03/31,2012/05/20,93,9,0.603298789,7430,93,6,3
40631,2014/03/31,2009/03/13,15,6,0.468258462,9572,15,3,3
40632,2014/03/31,2012/06/30,60,6,0.6470733470000001,6926,60,2,4
40633,2014/03/31,2011/01/04,152,7,0.548226083,8174,152,3,4
40634,2014/03/31,2008/11/17,511,8,1.0,4481,511,8,0
40635,2014/03/31,2011/01/15,220,5,0.595046481,7530,220,4,1
40636,2014/03/31,2010/05/28,64,9,0.491611806,9114,64,4,5
40637,2014/03/31,2009/01/08,85,3,0.875241258,5119,85,2,1
40638,2014/03/31,2012/08/24,60,4,0.492118849,9104,60,1,3
40639,2014/03/31,2011/08/28,262,5,0.64,7000,262,1,4
40640,2014/03/31,2012/09/02,516,4,0.8430560779999999,5314,516,4,0
40641,2014/03/31,2008/02/04,431,3,0.65303207,6860,431,3,0
40642,2014/03/31,2006/05/08,501,4,0.57066879,7850,501,4,0
40643,2014/03/31,2008/02/08,529,4,0.782873121,5722,529,4,0
40644,2014/03/31,2011/06/25,2,4,0.6752426890000001,6634,2,3,1
40645,2014/03/31,2013/03/12,231,4,0.667187965,6714,231,0,4
40646,2014/03/31,2011/01/09,11,3,0.606547055,7385,11,2,1
40647,2014/03/31,2013/02/23,42,4,0.776660309,5767,42,1,3
40648,2014/03/31,2008/09/07,485,3,0.590350646,7586,485,3,0
40649,2014/03/31,2010/12/27,133,2,0.917467732,4881,133,1,1
40650,2014/03/31,2011/12/16,183,5,0.684410821,6543,183,3,2
40651,2014/03/31,2007/02/17,178,7,0.536544452,8346,178,5,2
40652,2014/03/31,2013/01/16,134,6,0.528337463,8475,134,4,2
40653,2014/03/31,2011/03/15,5,7,0.559906215,7997,5,4,3
40654,2014/03/31,2006/07/23,391,5,0.685996629,6527,391,5,0
40655,2014/03/31,2008/11/20,170,4,0.8391116940000001,5336,170,2,2
40656,2014/03/31,2009/01/22,94,3,0.8282408440000001,5406,94,2,1
40657,2014/03/31,2013/02/27,386,2,0.646649336,6924,386,2,0
40658,2014/03/31,2012/12/12,367,6,0.644579614,6946,367,6,0
40659,2014/03/31,2012/10/16,237,5,0.912196414,4908,237,2,3
40660,2014/03/31,2007/08/13,321,3,0.826208933,5418,321,2,1
40661,2014/03/31,2013/01/04,248,4,0.8422163690000001,5315,248,0,4
40662,2014/03/31,2008/11/01,484,2,1.0,4476,484,2,0
40663,2014/03/31,2012/03/06,133,4,0.70505041,6348,133,0,4
40664,2014/03/31,2010/03/21,159,5,0.904161616,4950,159,0,5
40665,2014/03/31,2013/02/23,316,3,0.7408707170000001,6041,316,0,3
40666,2014/03/31,2007/06/01,22,5,0.79,5665,22,0,5
40667,2014/03/31,2008/09/03,466,4,0.438143724,10214,466,4,0
40668,2014/03/31,2013/03/20,365,4,0.489263066,9146,365,2,2
40669,2014/03/31,2012/07/04,625,4,0.489263066,9146,625,4,0
40670,2014/03/31,2012/04/13,219,5,0.821509088,5447,219,1,4
40671,2014/03/31,2010/04/27,225,5,0.96104811,4656,225,2,3
40672,2014/03/31,2009/05/16,105,8,0.527710815,8479,105,7,1
40673,2014/03/31,2007/12/22,233,6,0.6913349809999999,6472,233,5,1
40674,2014/03/31,2012/07/19,95,11,0.7381818179999999,6061,95,3,8
40675,2014/03/31,2012/01/16,145,4,0.706684568,6331,145,1,3
40676,2014/03/31,2008/02/17,179,6,0.688174127,6501,179,5,1
40677,2014/03/31,2013/01/09,176,6,0.719723295,6216,176,3,3
40678,2014/03/31,2010/11/17,75,6,0.6930751359999999,6455,75,0,6
40679,2014/03/31,2012/04/15,133,5,0.551417478,8113,133,3,2
40680,2014/03/31,2010/11/02,47,4,0.479634395,9327,47,0,4
40681,2014/03/31,2005/01/13,102,4,0.678318423,6595,102,1,3
40682,2014/03/31,2009/04/24,550,12,0.660280443,6775,550,12,0
40683,2014/03/31,2013/03/08,33,4,0.83354454,5366,33,1,3
40684,2014/03/31,2012/08/01,480,5,0.857515337,5216,480,5,0
40685,2014/03/31,2012/11/09,151,9,0.584929375,7646,151,3,6
40686,2014/03/31,2010/09/21,552,5,0.785396909,5694,552,5,0
40687,2014/03/31,2006/06/20,474,4,0.896372018,4989,474,4,0
40688,2014/03/31,2006/07/31,248,4,0.8125,5504,248,1,3
40689,2014/03/31,2009/02/01,129,5,0.796287393,5616,129,0,5
40690,2014/03/31,2006/01/12,158,7,0.577995347,7737,158,6,1
40691,2014/03/31,2012/12/15,351,3,0.55,8130,351,1,2
40692,2014/03/31,2008/04/01,501,2,0.825,5420,501,2,0
40693,2014/03/31,2006/06/04,86,5,0.7240518220000001,6175,86,0,5
40694,2014/03/31,2012/04/09,615,4,0.880271707,5079,615,4,0
40695,2014/03/31,2011/05/09,368,6,0.4845870370000001,9226,368,6,0
40696,2014/03/31,2009/09/17,147,5,0.626422867,7137,147,3,2
40697,2014/03/31,2006/04/16,63,9,0.644999279,6931,63,5,4
40698,2014/03/31,2007/09/11,181,4,0.534125941,8369,181,0,4
40699,2014/03/31,2012/12/15,6,3,0.786314215,5684,6,2,1
40700,2014/03/31,2005/03/31,335,5,0.604872107,7389,335,4,1
40701,2014/03/31,2011/12/31,76,3,0.948112007,4714,76,2,1
40702,2014/03/31,2013/01/17,50,5,0.928074766,4815,50,1,4
40703,2014/03/31,2011/08/25,195,4,0.45,9930,195,0,4
40704,2014/03/31,2013/01/15,211,5,0.621987751,7184,211,2,3
40705,2014/03/31,2010/08/15,200,7,0.7014285709999999,6370,200,4,3
40706,2014/03/31,2012/05/01,144,9,0.4588692620000001,9737,144,6,3
40707,2014/03/31,2011/10/10,341,3,0.849486594,5259,341,1,2
40708,2014/03/31,2012/01/08,528,4,0.87373362,5113,528,4,0
40709,2014/03/31,2012/09/05,106,6,0.611889041,7300,106,3,3
40710,2014/03/31,2007/08/09,74,8,0.697154675,6407,74,5,3
40711,2014/03/31,2012/04/20,173,5,0.696280592,6415,173,1,4
40712,2014/03/31,2006/04/15,152,4,0.8956799040000001,4986,152,2,2
40713,2014/03/31,2013/03/31,69,6,0.622300725,7176,69,1,5
40714,2014/03/31,2012/04/07,41,7,0.936387083,4769,41,5,2
40715,2014/03/31,2007/04/07,74,4,0.5375,8308,74,2,2
40716,2014/03/31,2007/04/09,77,2,1.41,3167,77,0,2
40717,2014/03/31,2007/10/12,147,3,0.6732006629999999,6633,147,1,2
40718,2014/03/31,2013/01/08,251,3,0.7566666670000001,5901,251,1,2
40719,2014/03/31,2010/10/04,198,4,0.5675,7868,198,2,2
40720,2014/03/31,2009/12/01,163,3,0.6924627790000001,6448,163,0,3
40721,2014/03/31,2011/08/16,40,6,0.77204738,5783,40,0,6
40722,2014/03/31,2011/01/26,67,5,0.884,5050,67,0,5
40723,2014/03/31,2005/10/25,420,7,0.72621604,6147,420,7,0
40724,2014/03/31,2009/02/10,267,5,0.6113998079999999,7301,267,2,3
40725,2014/03/31,2012/07/23,228,5,0.563380033,7923,228,2,3
40726,2014/03/31,2010/02/26,24,6,0.8793380609999999,5076,24,1,5
40727,2014/03/31,2008/01/07,93,7,0.440607108,10130,93,0,7
40728,2014/03/31,2011/03/11,417,5,0.810036298,5510,417,5,0
40729,2014/03/31,2011/02/19,646,5,0.825716929,5405,646,5,0
40730,2014/03/31,2009/11/03,2,6,0.880065076,5071,2,1,5
40731,2014/03/31,2012/12/21,146,4,0.543568819,8210,146,2,2
40732,2014/03/31,2012/12/01,412,4,0.6375,7000,412,4,0
40733,2014/03/31,2011/05/09,201,6,0.662023739,6740,201,0,6
40734,2014/03/31,2011/01/04,72,4,0.7301325479999999,6111,72,2,2
40735,2014/03/31,2009/10/25,330,7,0.6156754520000001,7247,330,5,2
40736,2014/03/31,2011/05/26,314,4,0.510708562,8736,314,3,1
40737,2014/03/31,2011/09/28,453,5,0.7221673679999999,6178,453,5,0
40738,2014/03/31,2013/02/17,225,5,0.550440469,8105,225,2,3
40739,2014/03/31,2009/10/21,395,4,0.8023835220000001,5559,395,4,0
40740,2014/03/31,2011/07/29,352,3,0.588132911,7584,352,2,1
40741,2014/03/31,2011/07/06,390,9,0.8022302159999999,5560,390,9,0
40742,2014/03/31,2013/01/24,17,5,0.682,6540,17,0,5
40743,2014/03/31,2011/02/18,169,9,0.7970407429999999,5596,169,5,4
40744,2014/03/31,2011/02/21,37,3,0.696666667,6402,37,1,2
40745,2014/03/31,2012/08/19,55,5,0.67453418,6612,55,0,5
40746,2014/03/31,2007/10/18,162,3,0.722140544,6176,162,0,3
40747,2014/03/31,2013/02/07,14,4,0.7014013840000001,6358,14,1,3
40748,2014/03/31,2010/03/02,41,4,0.67916692,6566,41,1,3
40749,2014/03/31,2012/03/31,385,5,0.613397524,7270,385,5,0
40750,2014/03/31,2005/12/24,170,3,0.723333333,6165,170,2,1
40751,2014/03/31,2011/10/14,16,8,0.5148014320000001,8662,16,2,6
40752,2014/03/31,2010/04/01,506,5,0.61818938,7213,506,5,0
40753,2014/03/31,2007/06/05,357,2,1.191766907,3741,357,1,1
40754,2014/03/31,2008/04/07,204,4,0.793020277,5622,204,3,1
40755,2014/03/31,2011/01/23,117,7,0.595310455,7489,117,6,1
40756,2014/03/31,2007/07/20,236,4,0.883595639,5045,236,2,2
40757,2014/03/31,2012/12/23,68,3,0.6993567620000001,6374,68,0,3
40758,2014/03/31,2011/10/16,14,7,0.473415463,9416,14,4,3
40759,2014/03/31,2009/12/13,164,2,0.621352105,7174,164,0,2
40760,2014/03/31,2012/12/08,380,5,0.7637765590000001,5836,380,5,0
40761,2014/03/31,2012/08/21,16,6,0.6202588370000001,7186,16,3,3
40762,2014/03/31,2011/11/29,378,5,0.43,10365,378,5,0
40763,2014/03/31,2011/04/07,648,4,0.536007216,8315,648,4,0
40764,2014/03/31,2010/03/11,32,4,0.683501534,6520,32,0,4
40765,2014/03/31,2009/04/27,162,4,0.7091343090000001,6284,162,3,1
40766,2014/03/31,2013/03/04,34,3,0.497999553,8948,34,0,3
40767,2014/03/31,2011/09/28,252,7,0.657626919,6776,252,6,1
40768,2014/03/31,2011/04/20,145,7,0.7763048779999999,5740,145,4,3
40769,2014/03/31,2009/02/10,500,4,0.663672922,6714,500,4,0
40770,2014/03/31,2012/08/26,206,3,0.819803128,5435,206,2,1
40771,2014/03/31,2008/01/13,130,6,0.6475610470000001,6880,130,3,3
40772,2014/03/31,2005/10/05,235,3,0.62650682,7111,235,1,2
40773,2014/03/31,2013/02/02,4,3,0.953080873,4674,4,0,3
40774,2014/03/31,2012/04/14,301,8,0.633686682,7028,301,4,4
40775,2014/03/31,2011/04/11,458,5,0.434897461,10240,458,5,0
40776,2014/03/31,2012/06/14,336,5,0.8966371329999999,4966,336,3,2
40777,2014/03/31,2012/10/20,341,4,0.7610152109999999,5851,341,3,1
40778,2014/03/31,2012/12/15,136,5,0.390928885,11390,136,4,1
40779,2014/03/31,2007/11/02,118,3,0.697933845,6379,118,2,1
40780,2014/03/31,2008/11/23,187,6,0.675673092,6589,187,3,3
40781,2014/03/31,2007/01/22,243,3,0.75,5936,243,2,1
40782,2014/03/31,2012/01/02,156,4,0.716446733,6214,156,0,4
40783,2014/03/31,2005/03/15,619,5,0.690522724,6447,619,5,0
40784,2014/03/31,2010/09/27,123,5,0.6989195979999999,6368,123,1,4
40785,2014/03/31,2012/01/20,5,5,0.503718166,8835,5,1,4
40786,2014/03/31,2011/11/05,8,7,0.459689082,9681,8,0,7
40787,2014/03/31,2009/11/08,605,2,0.894292605,4976,605,2,0
40788,2014/03/31,2009/12/08,205,2,0.58,7672,205,0,2
40789,2014/03/31,2007/09/07,210,2,0.58,7672,210,0,2
40790,2014/03/31,2012/09/28,494,4,1.061474237,4192,494,4,0
40791,2014/03/31,2011/05/24,481,5,0.49633575,8965,481,5,0
40792,2014/03/31,2008/04/10,114,6,0.576077162,7724,114,1,5
40793,2014/03/31,2012/11/02,138,3,0.5503017929999999,8085,138,1,2
40794,2014/03/31,2013/01/22,116,9,0.552418674,8054,116,1,8
40795,2014/03/31,2011/04/19,347,4,0.917037724,4851,347,1,3
40796,2014/03/31,2006/04/01,156,6,0.745781355,5964,156,4,2
40797,2014/03/31,2013/03/26,284,8,0.8401605590000001,5294,284,0,8
40798,2014/03/31,2010/04/20,35,4,0.705436955,6305,35,0,4
40799,2014/03/31,2011/10/28,673,4,0.719451634,6182,673,4,0
40800,2014/03/31,2010/11/19,235,3,0.614733932,7235,235,1,2
40801,2014/03/31,2007/07/19,158,6,1.112704528,3997,158,4,2
40802,2014/03/31,2006/09/08,375,4,0.85,5232,375,4,0
40803,2014/03/31,2011/11/18,320,5,0.477032826,9322,320,4,1
40804,2014/03/31,2008/01/06,234,2,0.878733202,5060,234,0,2
40805,2014/03/31,2012/09/17,11,5,0.905367542,4911,11,1,4
40806,2014/03/31,2010/02/03,72,5,0.565781369,7858,72,3,2
40807,2014/03/31,2009/12/30,106,5,0.653711219,6801,106,0,5
40808,2014/03/31,2011/10/20,233,4,0.523531559,8492,233,0,4
40809,2014/03/31,2012/11/02,197,6,0.523275659,8496,197,4,2
40810,2014/03/31,2012/02/25,550,3,0.849617737,5232,550,3,0
40811,2014/03/31,2012/11/20,311,6,0.705011895,6305,311,4,2
40812,2014/03/31,2012/07/25,47,2,0.82,5420,47,0,2
40813,2014/03/31,2010/03/30,15,2,0.82,5420,15,0,2
40814,2014/03/31,2011/06/07,175,4,0.8023686590000001,5539,175,3,1
40815,2014/03/31,2013/03/16,50,4,0.776705697,5722,50,0,4
40816,2014/03/31,2013/03/03,27,6,0.6334521089999999,7016,27,0,6
40817,2014/03/31,2007/10/10,22,3,0.81635011,5444,22,0,3
40818,2014/03/31,2013/01/23,353,6,0.6793456659999999,6541,353,4,2
40819,2014/03/31,2011/11/03,25,7,0.589485275,7538,25,1,6
40820,2014/03/31,2010/08/17,533,6,0.639883353,6944,533,6,0
40821,2014/03/31,2006/09/19,261,4,0.6683513839999999,6648,261,2,2
40822,2014/03/31,2005/01/06,100,2,1.098704253,4044,100,0,2
40823,2014/03/31,2005/11/16,61,6,0.763944292,5816,61,1,5
40824,2014/03/31,2012/08/18,172,5,0.657440071,6758,172,3,2
40825,2014/03/31,2011/01/07,160,10,0.581195709,7644,160,8,2
40826,2014/03/31,2012/03/27,356,3,0.806133188,5511,356,2,1
40827,2014/03/31,2010/04/15,42,4,0.664628965,6684,42,3,1
40828,2014/03/31,2007/05/28,69,7,0.496537,8946,69,4,3
40829,2014/03/31,2011/10/28,530,6,0.779885865,5695,530,6,0
40830,2014/03/31,2007/02/05,80,6,0.582624951,7623,80,4,2
40831,2014/03/31,2012/02/08,188,6,0.842740038,5270,188,0,6
40832,2014/03/31,2012/05/09,177,3,0.798342621,5563,177,2,1
40833,2014/03/31,2012/05/15,18,8,0.686776987,6466,18,4,4
40834,2014/03/31,2008/12/15,8,5,0.471246949,9423,8,2,3
40835,2014/03/31,2005/09/29,205,7,0.930138249,4774,205,3,4
40836,2014/03/31,2010/07/15,68,5,0.8716921870000001,5094,68,2,3
40837,2014/03/31,2010/02/21,332,3,0.791690442,5608,332,2,1
40838,2014/03/31,2012/01/24,87,5,0.6426081920000001,6909,87,3,2
40839,2014/03/31,2009/07/15,14,5,0.76759509,5784,14,1,4
40840,2014/03/31,2010/09/25,91,5,0.753642845,5891,91,1,4
40841,2014/03/31,2008/11/26,481,4,0.480881716,9232,481,4,0
40842,2014/03/31,2006/04/10,36,4,0.6777740459999999,6550,36,2,2
40843,2014/03/31,2011/03/15,5,3,0.87560355,5070,5,1,2
40844,2014/03/31,2011/04/03,125,6,0.543628459,8166,125,3,3
40845,2014/03/31,2006/04/29,214,3,0.47563913,9333,214,1,2
40846,2014/03/31,2011/08/16,284,5,0.8065207120000001,5504,284,4,1
40847,2014/03/31,2013/02/26,67,4,0.717422014,6187,67,2,2
40848,2014/03/31,2011/01/14,216,4,0.662477612,6700,216,3,1
40849,2014/03/31,2008/08/22,481,5,0.7028503559999999,6315,481,5,0
40850,2014/03/31,2012/12/23,292,3,0.62066704,7151,292,2,1
40851,2014/03/31,2005/08/26,42,6,0.706513849,6282,42,3,3
40852,2014/03/31,2012/10/05,42,6,0.727583607,6100,42,1,5
40853,2014/03/31,2008/04/13,287,7,0.71827642,6179,287,6,1
40854,2014/03/31,2008/10/03,157,8,0.623464456,7118,157,6,2
40855,2014/03/31,2008/02/27,34,4,0.781283451,5680,34,0,4
40856,2014/03/31,2013/02/12,57,3,0.792394643,5600,57,0,3
40857,2014/03/31,2011/02/08,57,5,0.526435691,8428,57,1,4
40858,2014/03/31,2011/10/08,342,5,0.7502198170000001,5914,342,3,2
40859,2014/03/31,2010/09/17,165,5,0.682681951,6499,165,3,2
40860,2014/03/31,2009/01/06,34,14,0.601419276,7377,34,7,7
40861,2014/03/31,2012/03/19,100,3,0.8659886790000001,5123,100,0,3
40862,2014/03/31,2010/03/27,127,13,0.852667692,5203,127,5,8
40863,2014/03/31,2011/12/25,231,6,0.5949255729999999,7457,231,2,4
40864,2014/03/31,2012/06/29,560,4,0.599344772,7402,560,4,0
40865,2014/03/31,2009/07/25,481,8,0.835757347,5308,481,8,0
40866,2014/03/31,2009/10/12,339,7,0.849502106,5222,339,4,3
40867,2014/03/31,2009/11/11,165,6,0.686419065,6462,165,0,6
40868,2014/03/31,2010/10/26,140,5,0.575559304,7706,140,4,1
40869,2014/03/31,2013/02/26,7,7,0.431386187,10280,7,0,7
40870,2014/03/31,2012/11/22,267,5,0.71952945,6163,267,3,2
40871,2014/03/31,2006/03/17,367,4,0.515693685,8599,367,4,0
40872,2014/03/31,2009/10/12,134,5,0.834796687,5312,134,2,3
40873,2014/03/31,2011/03/21,378,4,0.969403148,4574,378,4,0
40874,2014/03/31,2011/02/03,70,6,0.413732388,10717,70,5,1
40875,2014/03/31,2007/07/15,256,3,0.707613727,6265,256,0,3
40876,2014/03/31,2010/11/01,32,6,0.7746182070000001,5723,32,4,2
40877,2014/03/31,2011/01/20,46,4,0.485,9140,46,1,3
40878,2014/03/31,2005/09/14,162,2,0.92,4818,162,0,2
40879,2014/03/31,2008/10/26,324,4,0.404822799,10948,324,3,1
40880,2014/03/31,2013/03/29,1,5,0.657545994,6740,1,0,5
40881,2014/03/31,2007/11/18,26,6,0.6723805190000001,6591,26,0,6
40882,2014/03/31,2010/06/21,293,5,0.610983042,7253,293,4,1
40883,2014/03/31,2012/09/02,168,3,0.616328234,7190,168,2,1
40884,2014/03/31,2011/08/21,56,2,0.68311392,6487,56,0,2
40885,2014/03/31,2008/09/02,151,5,0.658731976,6727,151,0,5
40886,2014/03/31,2008/06/05,2,9,0.6440625,6880,2,1,8
40887,2014/03/31,2012/12/06,237,4,0.363948255,12175,237,2,2
40888,2014/03/31,2009/12/13,191,8,0.682933107,6488,191,1,7
40889,2014/03/31,2011/02/25,38,2,0.82,5403,38,0,2
40890,2014/03/31,2010/11/29,107,4,0.71,6240,107,0,4
40891,2014/03/31,2011/03/23,235,4,0.879964243,5034,235,1,3
40892,2014/03/31,2007/01/28,4,3,0.822560817,5385,4,1,2
40893,2014/03/31,2009/10/03,210,8,0.530667306,8347,210,4,4
40894,2014/03/31,2008/11/03,335,5,0.7983868059999999,5548,335,4,1
40895,2014/03/31,2012/06/15,328,5,0.4831897020000001,9167,328,1,4
40896,2014/03/31,2012/02/28,6,6,0.60132908,7366,6,4,2
40897,2014/03/31,2011/11/11,478,4,0.425,10422,478,4,0
40898,2014/03/31,2007/03/30,12,6,0.580136215,7635,12,0,6
40899,2014/03/31,2012/11/29,94,5,0.863248879,5131,94,2,3
40900,2014/03/31,2007/07/23,144,5,0.777894275,5694,144,1,4
40901,2014/03/31,2010/03/25,350,5,0.6975744209999999,6349,350,3,2
40902,2014/03/31,2013/03/22,91,5,0.536518052,8254,91,0,5
40903,2014/03/31,2012/07/10,61,5,0.6363150329999999,6958,61,1,4
40904,2014/03/31,2011/04/03,79,4,1.072024213,4130,79,1,3
40905,2014/03/31,2011/03/13,58,10,0.5308466239999999,8339,58,5,5
40906,2014/03/31,2006/01/31,204,3,0.725779636,6099,204,1,2
40907,2014/03/31,2011/03/01,10,6,0.7724397909999999,5730,10,2,4
40908,2014/03/31,2007/01/11,9,4,0.928068778,4769,9,0,4
40909,2014/03/31,2012/12/15,158,2,1.09905637,4027,158,0,2
40910,2014/03/31,2011/08/11,7,3,0.75,5901,7,1,2
40911,2014/03/31,2011/11/18,134,3,0.7891690440000001,5608,134,0,3
40912,2014/03/31,2007/09/11,481,3,0.605631586,7307,481,3,0
40913,2014/03/31,2005/06/14,19,6,0.699754902,6324,19,4,2
40914,2014/03/31,2011/08/31,48,5,0.617168759,7170,48,3,2
40915,2014/03/31,2009/09/08,368,4,0.830518018,5328,368,4,0
40916,2014/03/31,2011/09/12,1,8,0.883393891,5009,1,4,4
40917,2014/03/31,2011/06/18,69,3,0.8059253190000001,5490,69,0,3
40918,2014/03/31,2011/07/23,521,3,0.931267102,4751,521,3,0
40919,2014/03/31,2012/09/06,102,3,0.5540889170000001,7985,102,1,2
40920,2014/03/31,2011/08/01,86,9,0.332435194,13309,86,3,6
40921,2014/03/31,2007/01/11,109,3,0.8206176959999999,5391,109,2,1
40922,2014/03/31,2010/05/27,414,9,0.5365130379999999,8245,414,9,0
40923,2014/03/31,2009/09/23,339,5,0.908876104,4867,339,3,2
40924,2014/03/31,2011/12/16,492,2,1.306794682,3385,492,2,0
40925,2014/03/31,2012/07/01,40,7,0.915714286,4830,40,0,7
40926,2014/03/31,2006/02/16,12,5,0.663489349,6666,12,1,4
40927,2014/03/31,2011/12/26,521,4,0.6335482020000001,6981,521,4,0
40928,2014/03/31,2010/03/22,364,5,0.736257699,6007,364,4,1
40929,2014/03/31,2007/06/01,62,2,0.7052463720000001,6271,62,0,2
40930,2014/03/31,2009/11/24,212,4,0.8083604459999999,5471,212,2,2
40931,2014/03/31,2012/12/20,175,3,0.644465171,6862,175,0,3
40932,2014/03/31,2009/01/16,244,6,0.8546888290000001,5174,244,4,2
40933,2014/03/31,2011/03/20,175,4,0.650485437,6798,175,1,3
40934,2014/03/31,2010/10/20,612,4,0.728339648,6071,612,4,0
40935,2014/03/31,2009/12/05,73,7,0.8004109340000001,5524,73,0,7
40936,2014/03/31,2011/12/27,111,5,0.504317326,8767,111,0,5
40937,2014/03/31,2011/01/13,87,9,0.375555556,11772,87,6,3
40938,2014/03/31,2010/09/08,31,7,0.7619544979999999,5802,31,6,1
40939,2014/03/31,2012/11/12,503,3,0.8957649440000001,4935,503,3,0
40940,2014/03/31,2012/03/26,550,4,0.706158147,6260,550,4,0
40941,2014/03/31,2012/05/06,35,2,1.056703323,4183,35,0,2
40942,2014/03/31,2008/05/17,153,4,0.739963168,5973,153,3,1
40943,2014/03/31,2011/06/02,146,8,0.7133085859999999,6196,146,5,3
40944,2014/03/31,2012/08/28,17,5,0.64904671,6808,17,0,5
40945,2014/03/31,2012/08/22,354,3,0.6959206170000001,6349,354,1,2
40946,2014/03/31,2011/02/28,116,4,0.7524012259999999,5872,116,1,3
40947,2014/03/31,2009/08/25,32,6,0.663117682,6662,32,3,3
40948,2014/03/31,2012/04/25,22,6,0.7619230770000001,5798,22,5,1
40949,2014/03/31,2010/11/14,241,2,0.92,4801,241,0,2
40950,2014/03/31,2010/08/09,211,3,0.933133319,4733,211,2,1
40951,2014/03/31,2012/07/29,100,6,0.614425431,7188,100,2,4
40952,2014/03/31,2011/06/16,438,3,1.0,4416,438,3,0
40953,2014/03/31,2013/01/29,93,6,0.604422393,7306,93,1,5
40954,2014/03/31,2010/08/31,327,7,0.377713626,11691,327,4,3
40955,2014/03/31,2008/04/18,299,4,0.616566602,7162,299,3,1
40956,2014/03/31,2009/10/09,230,5,0.6629334929999999,6661,230,3,2
40957,2014/03/31,2005/11/05,21,4,0.423744722,10420,21,2,2
40958,2014/03/31,2012/08/09,475,4,0.532681868,8289,475,4,0
40959,2014/03/31,2012/07/11,205,8,0.843411652,5235,205,2,6
40960,2014/03/31,2006/10/07,67,5,0.48759249,9055,67,0,5
40961,2014/03/31,2010/09/25,20,5,0.863968689,5110,20,1,4
40962,2014/03/31,2009/12/10,308,4,0.6616381889999999,6672,308,2,2
40963,2014/03/31,2006/03/26,315,3,1.045876777,4220,315,0,3
40964,2014/03/31,2009/12/15,205,4,0.7061488,6250,205,1,3
40965,2014/03/31,2011/01/21,375,5,0.441187644,10003,375,5,0
40966,2014/03/31,2008/08/19,120,4,0.701143947,6294,120,1,3
40967,2014/03/31,2011/07/10,203,5,0.755900993,5838,203,3,2
40968,2014/03/31,2010/09/14,39,7,0.745166357,5921,39,4,3
40969,2014/03/31,2005/12/29,34,8,0.542817421,8128,34,4,4
40970,2014/03/31,2012/12/15,14,6,0.7553141590000001,5841,14,0,6
40971,2014/03/31,2013/02/01,120,4,0.567337963,7776,120,0,4
40972,2014/03/31,2013/01/06,35,5,0.867206605,5087,35,0,5
40973,2014/03/31,2012/08/12,591,2,0.575,7672,591,2,0
40974,2014/03/31,2013/01/27,318,2,0.575,7672,318,1,1
40975,2014/03/31,2012/12/15,231,10,0.7771863990000001,5676,231,2,8
40976,2014/03/31,2006/10/03,12,4,0.711598645,6199,12,0,4
40977,2014/03/31,2012/10/29,114,8,0.775161687,5690,114,4,4
40978,2014/03/31,2007/09/26,323,5,0.611543261,7212,323,4,1
40979,2014/03/31,2008/05/08,60,9,0.817948813,5392,60,3,6
40980,2014/03/31,2011/03/16,402,3,0.73438801,6005,402,3,0
40981,2014/03/31,2013/01/04,221,7,0.867925605,5081,221,4,3
40982,2014/03/31,2009/03/11,84,5,0.6999857140000001,6300,84,0,5
40983,2014/03/31,2012/11/26,268,3,0.93648333,4709,268,1,2
40984,2014/03/31,2007/02/13,12,9,0.540843861,8153,12,3,6
40985,2014/03/31,2010/10/11,313,4,0.812044199,5430,313,2,2
40986,2014/03/31,2007/07/06,210,4,0.523549038,8422,210,1,3
40987,2014/03/31,2010/06/18,33,10,0.771657333,5714,33,4,6
40988,2014/03/31,2011/08/10,278,4,0.559259259,7884,278,3,1
40989,2014/03/31,2009/08/26,354,5,0.561181112,7857,354,3,2
40990,2014/03/31,2006/12/13,117,3,0.679670109,6487,117,1,2
40991,2014/03/31,2012/04/12,477,6,0.821645546,5366,477,6,0
40992,2014/03/31,2011/09/24,594,4,0.821923937,5364,594,4,0
40993,2014/03/31,2012/09/25,273,2,1.468990337,3001,273,1,1
40994,2014/03/31,2012/01/06,261,9,0.8444444440000001,5220,261,8,1
40995,2014/03/31,2013/02/05,65,3,0.73626023,5987,65,1,2
40996,2014/03/31,2007/09/26,130,10,0.613146474,7189,130,0,10
40997,2014/03/31,2012/12/20,401,3,0.788797423,5588,401,3,0
40998,2014/03/31,2006/04/27,205,3,0.507664133,8682,205,0,3
40999,2014/03/31,2011/03/14,167,5,0.707217587,6232,167,2,3
41000,2014/03/31,2008/03/04,2,5,0.891423948,4944,2,3,2
41001,2014/03/31,2008/08/16,576,3,0.693984252,6350,576,3,0
41002,2014/03/31,2010/02/15,343,2,0.925,4764,343,0,2
41003,2014/03/31,2011/01/22,2,5,0.4455510620000001,9890,2,0,5
41004,2014/03/31,2012/08/07,230,10,0.7609999999999999,5790,230,7,3
41005,2014/03/31,2012/05/09,530,5,0.647574956,6804,530,5,0
41006,2014/03/31,2012/11/19,379,4,0.789623656,5580,379,4,0
41007,2014/03/31,2008/12/08,128,6,0.514539297,8563,128,2,4
41008,2014/03/31,2008/02/07,11,5,0.755974605,5828,11,4,1
41009,2014/03/31,2008/05/27,429,2,1.05,4196,429,2,0
41010,2014/03/31,2012/03/26,557,5,0.576580291,7641,557,5,0
41011,2014/03/31,2006/05/25,240,6,0.53823091,8185,240,3,3
41012,2014/03/31,2010/12/20,719,2,0.75,5873,719,2,0
41013,2014/03/31,2012/12/13,40,7,0.500418087,8802,40,4,3
41014,2014/03/31,2007/05/23,53,4,0.622468909,7076,53,0,4
41015,2014/03/31,2010/03/10,423,3,0.943934848,4666,423,3,0
41016,2014/03/31,2012/05/02,597,3,0.933333333,4719,597,3,0
41017,2014/03/31,2007/11/19,164,6,0.552740964,7968,164,0,6
41018,2014/03/31,2012/12/10,199,6,0.7165457209999999,6146,199,3,3
41019,2014/03/31,2013/02/02,169,5,0.944,4665,169,0,5
41020,2014/03/31,2006/12/06,449,7,0.683387647,6444,449,7,0
41021,2014/03/31,2013/02/04,221,4,0.560111931,7862,221,2,2
41022,2014/03/31,2012/03/25,2,3,0.513161636,8581,2,0,3
41023,2014/03/31,2011/12/20,195,3,0.610062344,7218,195,0,3
41024,2014/03/31,2013/03/07,368,3,1.212014864,3633,368,3,0
41025,2014/03/31,2010/09/03,142,7,0.68,6475,142,2,5
41026,2014/03/31,2011/06/01,315,3,0.63635641,6919,315,1,2
41027,2014/03/31,2007/02/25,21,3,1.157753814,3802,21,0,3
41028,2014/03/31,2012/11/13,490,3,0.381090909,11550,490,3,0
41029,2014/03/31,2011/11/21,2,5,0.845787855,5204,2,3,2
41030,2014/03/31,2010/12/24,44,3,0.75097253,5861,44,1,2
41031,2014/03/31,2009/07/09,23,6,0.583162846,7547,23,1,5
41032,2014/03/31,2005/09/10,51,4,0.55165455,7978,51,0,4
41033,2014/03/31,2013/01/21,230,4,0.592643415,7426,230,2,2
41034,2014/03/31,2008/12/22,142,6,0.712006472,6180,142,0,6
41035,2014/03/31,2013/03/19,375,2,0.55,8000,375,2,0
41036,2014/03/31,2011/12/15,362,3,0.977560542,4501,362,2,1
41037,2014/03/31,2012/12/19,173,5,0.93054357,4728,173,1,4
41038,2014/03/31,2012/05/16,411,6,0.7062690640000001,6229,411,6,0
41039,2014/03/31,2012/11/23,337,2,0.925,4756,337,0,2
41040,2014/03/31,2011/04/11,218,3,0.680947368,6460,218,0,3
41041,2014/03/31,2008/01/01,428,8,0.66095417,6655,428,8,0
41042,2014/03/31,2012/05/25,366,5,0.395842333,11112,366,4,1
41043,2014/03/31,2007/10/15,6,6,0.707962337,6213,6,2,4
41044,2014/03/31,2011/05/13,202,4,0.639975266,6873,202,3,1
41045,2014/03/31,2010/07/01,554,2,0.8545472209999999,5146,554,2,0
41046,2014/03/31,2009/07/25,158,4,0.985459435,4462,158,3,1
41047,2014/03/31,2008/08/29,367,4,0.731022444,6015,367,4,0
41048,2014/03/31,2005/02/25,191,10,0.648598613,6779,191,9,1
41049,2014/03/31,2011/08/09,255,2,0.965242591,4555,255,1,1
41050,2014/03/31,2011/11/19,401,3,0.7131549070000001,6165,401,3,0
41051,2014/03/31,2006/04/02,193,5,0.687917384,6391,193,0,5
41052,2014/03/31,2008/03/02,271,3,0.8782261290000001,5006,271,1,2
41053,2014/03/31,2010/10/31,67,5,0.6465965579999999,6799,67,4,1
41054,2014/03/31,2012/09/25,7,3,0.844585975,5205,7,2,1
41055,2014/03/31,2008/03/03,278,5,0.772925972,5687,278,4,1
41056,2014/03/31,2011/09/25,328,3,0.486023883,9044,328,1,2
41057,2014/03/31,2012/08/04,1,7,0.532988966,8247,1,2,5
41058,2014/03/31,2010/04/22,108,6,0.412183046,10664,108,2,4
41059,2014/03/31,2008/03/10,283,6,0.719021757,6113,283,2,4
41060,2014/03/31,2011/07/09,32,7,0.779039348,5642,32,2,5
41061,2014/03/31,2007/02/26,103,8,0.461051086,9533,103,3,5
41062,2014/03/31,2005/04/12,34,3,0.661224613,6647,34,0,3
41063,2014/03/31,2012/06/13,12,7,0.664903177,6610,12,2,5
41064,2014/03/31,2007/09/20,51,5,0.58966859,7453,51,2,3
41065,2014/03/31,2008/09/17,89,7,0.684104919,6424,89,4,3
41066,2014/03/31,2007/07/04,104,6,0.8445762059999999,5203,104,4,2
41067,2014/03/31,2009/07/25,262,5,0.7990634659999999,5499,262,4,1
41068,2014/03/31,2011/07/22,22,5,0.387478836,11340,22,3,2
41069,2014/03/31,2011/07/27,609,7,0.5792682929999999,7585,609,7,0
41070,2014/03/31,2008/10/31,579,2,1.4030820819999998,3131,579,2,0
41071,2014/03/31,2013/02/03,260,3,1.042924976,4212,260,2,1
41072,2014/03/31,2007/07/20,114,3,0.816340829,5381,114,2,1
41073,2014/03/31,2012/07/12,2,6,0.978480731,4489,2,4,2
41074,2014/03/31,2011/12/31,532,5,0.848069125,5179,532,5,0
41075,2014/03/31,2009/03/21,438,4,0.494276871,8885,438,4,0
41076,2014/03/31,2007/11/29,10,3,0.5651981979999999,7770,10,0,3
41077,2014/03/31,2006/11/06,12,5,0.716877245,6126,12,0,5
41078,2014/03/31,2008/08/11,133,6,0.658350825,6670,133,1,5
41079,2014/03/31,2005/09/18,299,7,0.8242857140000001,5327,299,6,1
41080,2014/03/31,2006/11/07,239,4,0.6469230770000001,6786,239,0,4
41081,2014/03/31,2012/07/20,327,3,0.959222028,4576,327,2,1
41082,2014/03/31,2010/12/05,102,3,0.866242352,5067,102,0,3
41083,2014/03/31,2013/03/16,213,3,0.810694496,5414,213,1,2
41084,2014/03/31,2012/01/15,127,3,0.830001891,5287,127,2,1
41085,2014/03/31,2007/01/06,280,5,1.023024015,4289,280,3,2
41086,2014/03/31,2008/04/04,309,4,0.6698167939999999,6550,309,3,1
41087,2014/03/31,2012/09/14,2,6,0.929237288,4720,2,3,3
41088,2014/03/31,2012/10/17,42,6,0.7387013640000001,5937,42,2,4
41089,2014/03/31,2006/08/27,137,6,0.531685257,8248,137,4,2
41090,2014/03/31,2008/02/20,298,2,0.785,5586,298,0,2
41091,2014/03/31,2009/11/13,14,6,0.5313025570000001,8253,14,3,3
41092,2014/03/31,2010/07/02,68,5,0.601146148,7294,68,1,4
41093,2014/03/31,2006/10/16,101,6,0.5028294529999999,8719,101,0,6
41094,2014/03/31,2012/11/12,228,5,0.914860184,4792,228,3,2
41095,2014/03/31,2005/12/02,467,5,0.605260251,7243,467,5,0
41096,2014/03/31,2011/11/04,368,4,0.5811348270000001,7543,368,4,0
41097,2014/03/31,2007/11/01,271,6,0.733682625,5974,271,3,3
41098,2014/03/31,2006/12/06,128,5,0.466,9405,128,2,3
41099,2014/03/31,2005/08/27,36,3,0.703333333,6231,36,0,3
41100,2014/03/31,2006/11/09,174,3,0.703333333,6231,174,0,3
41101,2014/03/31,2010/01/17,17,3,0.703333333,6231,17,0,3
41102,2014/03/31,2008/12/04,468,3,0.729063384,6011,468,3,0
41103,2014/03/31,2013/01/28,43,2,0.82,5344,43,0,2
41104,2014/03/31,2011/08/29,197,4,1.101005025,3980,197,3,1
41105,2014/03/31,2006/06/01,27,5,0.461650864,9492,27,0,5
41106,2014/03/31,2008/01/03,37,3,0.548900163,7983,37,1,2
41107,2014/03/31,2011/11/20,635,3,1.2339481840000002,3551,635,3,0
41108,2014/03/31,2008/03/27,110,4,0.896643471,4886,110,3,1
41109,2014/03/31,2012/11/02,389,3,0.890949766,4917,389,3,0
41110,2014/03/31,2012/11/01,16,5,0.823251269,5321,16,0,5
41111,2014/03/31,2011/05/20,260,2,0.9721083,4506,260,1,1
41112,2014/03/31,2008/07/15,247,5,0.740038858,5919,247,3,2
41113,2014/03/31,2012/10/25,205,5,0.7869739440000001,5565,205,1,4
41114,2014/03/31,2013/03/07,7,5,0.908798506,4819,7,0,5
41115,2014/03/31,2010/11/28,39,4,0.972349023,4504,39,2,2
41116,2014/03/31,2012/08/20,422,4,0.7405462540000001,5913,422,4,0
41117,2014/03/31,2006/05/16,286,4,0.7866852320000001,5566,286,2,2
41118,2014/03/31,2007/11/01,102,3,0.8155503820000001,5369,102,0,3
41119,2014/03/31,2011/01/24,25,7,0.523938016,8357,25,3,4
41120,2014/03/31,2011/08/29,127,5,0.58423195,7493,127,0,5
41121,2014/03/31,2011/04/17,44,9,0.7917616209999999,5529,44,2,7
41122,2014/03/31,2007/01/09,94,6,0.5959836620000001,7345,94,4,2
41123,2014/03/31,2011/01/04,49,3,0.854638813,5122,49,0,3
41124,2014/03/31,2010/05/10,266,7,0.896803934,4881,266,6,1
41125,2014/03/31,2011/09/25,175,3,1.091021934,4012,175,0,3
41126,2014/03/31,2007/05/03,348,7,0.55613723,7870,348,6,1
41127,2014/03/31,2011/07/15,650,4,0.638725919,6852,650,4,0
41128,2014/03/31,2012/08/21,29,6,0.5671941420000001,7716,29,2,4
41129,2014/03/31,2011/08/31,77,7,0.597142857,7329,77,0,7
41130,2014/03/31,2008/08/13,68,6,0.525240038,8332,68,1,5
41131,2014/03/31,2013/02/07,200,6,0.6412131870000001,6825,200,1,5
41132,2014/03/31,2008/01/17,5,6,0.453118658,9658,5,2,4
41133,2014/03/31,2008/07/08,189,4,0.7058354840000001,6200,189,1,3
41134,2014/03/31,2012/07/06,624,3,0.819015534,5343,624,3,0
41135,2014/03/31,2006/04/12,146,6,0.781666667,5598,146,5,1
41136,2014/03/31,2012/12/11,107,3,0.747718729,5852,107,2,1
41137,2014/03/31,2010/06/10,190,6,0.521963498,8383,190,4,2
41138,2014/03/31,2012/09/15,205,5,0.8800100559999999,4972,205,4,1
41139,2014/03/31,2008/06/10,263,6,0.682270742,6412,263,3,3
41140,2014/03/31,2008/05/07,601,3,0.683333333,6402,601,3,0
41141,2014/03/31,2012/09/26,546,2,1.025,4268,546,2,0
41142,2014/03/31,2012/08/17,496,2,1.025,4268,496,2,0
41143,2014/03/31,2012/08/04,190,4,0.561199487,7795,190,2,2
41144,2014/03/31,2010/01/23,696,2,0.775,5644,696,2,0
41145,2014/03/31,2008/02/17,18,5,0.694490314,6298,18,2,3
41146,2014/03/31,2010/07/27,5,5,0.866,5050,5,4,1
41147,2014/03/31,2011/12/25,107,5,0.746132059,5861,107,2,3
41148,2014/03/31,2006/03/04,510,4,0.917456987,4766,510,4,0
41149,2014/03/31,2010/12/12,168,6,0.7736305729999999,5652,168,2,4
41150,2014/03/31,2011/04/17,405,2,1.5,2915,405,2,0
41151,2014/03/31,2009/09/02,224,6,0.431374309,10136,224,5,1
41152,2014/03/31,2006/05/24,415,5,0.655011236,6675,415,5,0
41153,2014/03/31,2013/01/24,52,4,0.5175,8448,52,0,4
41154,2014/03/31,2010/09/22,565,2,0.910435326,4801,565,2,0
41155,2014/03/31,2005/05/24,98,3,0.833332698,5245,98,1,2
41156,2014/03/31,2011/06/01,231,4,0.8024270240000001,5447,231,2,2
41157,2014/03/31,2012/04/26,166,4,0.693635931,6301,166,3,1
41158,2014/03/31,2008/09/15,160,3,1.283118027,3406,160,0,3
41159,2014/03/31,2006/04/25,162,6,0.5252391829999999,8320,162,4,2
41160,2014/03/31,2010/01/17,150,4,0.7880883679999999,5545,150,0,4
41161,2014/03/31,2012/02/17,404,3,0.594099252,7355,404,3,0
41162,2014/03/31,2005/09/29,305,6,0.544015189,8032,305,5,1
41163,2014/03/31,2013/01/12,21,6,0.43636173,10013,21,1,5
41164,2014/03/31,2010/04/04,14,9,0.578790568,7549,14,1,8
41165,2014/03/31,2012/01/20,320,3,0.734072581,5952,320,2,1
41166,2014/03/31,2006/03/01,387,4,0.53055623,8234,387,4,0
41167,2014/03/31,2008/03/04,104,6,0.6706109920000001,6514,104,0,6
41168,2014/03/31,2011/08/31,301,5,0.944297449,4626,301,3,2
41169,2014/03/31,2012/03/29,580,5,0.575632578,7588,580,5,0
41170,2014/03/31,2012/04/28,537,5,0.389994642,11199,537,5,0
41171,2014/03/31,2009/04/19,97,2,0.735,5942,97,0,2
41172,2014/03/31,2012/01/25,48,6,0.90990623,4799,48,2,4
41173,2014/03/31,2011/07/17,195,7,0.716767892,6092,195,5,2
41174,2014/03/31,2012/08/09,405,6,0.520175125,8394,405,6,0
41175,2014/03/31,2011/09/14,40,3,0.858164308,5088,40,0,3
41176,2014/03/31,2013/01/03,218,6,0.6940524640000001,6290,218,2,4
41177,2014/03/31,2006/07/07,292,5,0.658614967,6628,292,2,3
41178,2014/03/31,2006/10/27,56,4,0.769347903,5674,56,0,4
41179,2014/03/31,2012/12/22,20,6,0.520769506,8382,20,0,6
41180,2014/03/31,2012/08/29,147,3,0.8816360329999999,4951,147,0,3
41181,2014/03/31,2011/01/20,156,9,0.7909242479999999,5518,156,2,7
41182,2014/03/31,2012/10/14,380,3,0.641141472,6807,380,3,0
41183,2014/03/31,2011/02/01,620,3,0.696695402,6264,620,3,0
41184,2014/03/31,2012/04/16,531,3,0.889523033,4906,531,3,0
41185,2014/03/31,2011/10/16,155,4,0.640720893,6811,155,0,4
41186,2014/03/31,2009/12/14,169,6,0.5679008329999999,7684,169,1,5
41187,2014/03/31,2012/12/15,73,5,0.777267545,5614,73,3,2
41188,2014/03/31,2011/07/17,344,6,0.669769762,6515,344,4,2
41189,2014/03/31,2007/08/30,709,3,0.621641259,7019,709,3,0
41190,2014/03/31,2013/03/01,171,3,0.705318461,6186,171,1,2
41191,2014/03/31,2012/04/21,90,4,0.605046457,7211,90,1,3
41192,2014/03/31,2013/03/07,60,2,0.769717713,5668,60,0,2
41193,2014/03/31,2011/01/24,268,5,0.8387810040000001,5201,268,3,2
41194,2014/03/31,2012/08/06,65,6,0.7408865490000001,5888,65,1,5
41195,2014/03/31,2008/10/13,69,3,0.919134008,4746,69,1,2
41196,2014/03/31,2007/10/29,38,4,0.721384157,6047,38,0,4
41197,2014/03/31,2012/09/29,135,4,0.6090673000000001,7162,135,1,3
41198,2014/03/31,2007/03/06,11,11,0.467785523,9325,11,0,11
41199,2014/03/31,2010/10/18,460,5,0.901674592,4837,460,5,0
41200,2014/03/31,2010/01/13,84,12,0.8918936609999999,4890,84,6,6
41201,2014/03/31,2011/05/20,113,7,0.521422764,8364,113,3,4
41202,2014/03/31,2012/07/20,175,3,0.643543388,6776,175,1,2
41203,2014/03/31,2008/08/05,13,9,0.5973229210000001,7299,13,0,9
41204,2014/03/31,2009/11/01,72,3,1.170679377,3724,72,0,3
41205,2014/03/31,2008/02/24,18,5,0.652901003,6677,18,0,5
41206,2014/03/31,2011/09/14,4,5,0.693496659,6286,4,4,1
41207,2014/03/31,2012/08/28,107,4,0.527743341,8260,107,1,3
41208,2014/03/31,2008/04/07,334,5,0.7137956440000001,6107,334,2,3
41209,2014/03/31,2007/10/12,170,3,0.76365452,5708,170,1,2
41210,2014/03/31,2012/08/17,173,7,0.689150988,6325,173,5,2
41211,2014/03/31,2008/05/25,13,6,0.79237775,5501,13,0,6
41212,2014/03/31,2013/02/23,46,4,0.703714885,6194,46,1,3
41213,2014/03/31,2007/11/07,104,3,0.934016288,4666,104,1,2
41214,2014/03/31,2005/01/07,284,3,0.800521675,5444,284,0,3
41215,2014/03/31,2010/11/07,566,4,1.0,4358,566,4,0
41216,2014/03/31,2011/09/01,177,7,0.651630272,6686,177,3,4
41217,2014/03/31,2009/08/21,240,4,1.059978102,4110,240,2,2
41218,2014/03/31,2008/10/05,164,4,0.531910867,8190,164,0,4
41219,2014/03/31,2005/03/07,134,7,0.468859111,9291,134,4,3
41220,2014/03/31,2007/03/11,17,8,0.622772376,6994,17,3,5
41221,2014/03/31,2006/12/14,71,2,0.815,5344,71,0,2
41222,2014/03/31,2005/05/01,268,8,0.455099269,9570,268,6,2
41223,2014/03/31,2008/10/25,37,5,0.40681177,10705,37,1,4
41224,2014/03/31,2011/03/04,185,4,0.579592706,7513,185,1,3
41225,2014/03/31,2013/02/24,12,7,0.87239431,4991,12,2,5
41226,2014/03/31,2006/07/09,82,5,0.674104351,6459,82,2,3
41227,2014/03/31,2008/06/25,158,2,1.323739739,3289,158,0,2
41228,2014/03/31,2012/04/26,16,3,0.813935315,5349,16,0,3
41229,2014/03/31,2012/11/04,19,4,0.572995525,7598,19,1,3
41230,2014/03/31,2012/10/07,141,3,0.68,6402,141,0,3
41231,2014/03/31,2011/12/01,303,6,0.6789394879999999,6412,303,2,4
41232,2014/03/31,2011/01/13,18,5,0.778767442,5590,18,1,4
41233,2014/03/31,2012/02/06,193,5,0.490114839,8882,193,3,2
41234,2014/03/31,2012/02/22,1,5,0.8363266090000001,5205,1,4,1
41235,2014/03/31,2007/11/15,6,5,0.789571921,5513,6,0,5
41236,2014/03/31,2007/06/25,230,4,0.8098232559999999,5375,230,3,1
41237,2014/03/31,2008/08/05,17,4,0.830188823,5243,17,1,3
41238,2014/03/31,2010/08/03,201,4,0.810087474,5373,201,1,3
41239,2014/03/31,2010/10/25,5,6,0.7531510640000001,5779,5,4,2
41240,2014/03/31,2009/01/23,191,5,0.76467229,5691,191,1,4
41241,2014/03/31,2005/02/02,137,5,0.763955407,5696,137,1,4
41242,2014/03/31,2006/08/14,335,6,0.506276905,8595,335,5,1
41243,2014/03/31,2010/02/10,485,4,0.787280622,5527,485,4,0
41244,2014/03/31,2012/11/24,187,4,0.572143327,7605,187,0,4
41245,2014/03/31,2009/10/13,27,7,0.494778258,8794,27,4,3
41246,2014/03/31,2012/04/22,23,6,0.778473788,5589,23,4,2
41247,2014/03/31,2012/12/07,477,2,0.618362706,7036,477,2,0
41248,2014/03/31,2010/06/20,659,5,0.608404419,7151,659,5,0
41249,2014/03/31,2012/04/11,109,4,0.60901442,7143,109,2,2
41250,2014/03/31,2012/05/23,293,6,0.656593208,6625,293,4,2
41251,2014/03/31,2010/09/29,68,4,0.71427422,6090,68,1,3
41252,2014/03/31,2012/04/26,189,4,0.959770521,4532,189,2,2
41253,2014/03/31,2011/08/01,8,9,0.701892851,6197,8,2,7
41254,2014/03/31,2012/06/01,271,9,0.8602887659999999,5056,271,8,1
41255,2014/03/31,2012/06/06,83,9,0.499370838,8710,83,8,1
41256,2014/03/31,2006/08/05,51,4,0.978715122,4444,51,2,2
41257,2014/03/31,2011/02/27,72,5,0.7211374559999999,6031,72,1,4
41258,2014/03/31,2007/04/29,630,4,0.715531425,6078,630,4,0
41259,2014/03/31,2010/12/20,81,5,0.826591903,5261,81,2,3
41260,2014/03/31,2010/05/15,291,9,0.448643351,9693,291,7,2
41261,2014/03/31,2010/03/02,98,7,0.671713006,6474,98,3,4
41262,2014/03/31,2008/08/08,48,5,0.724237175,6004,48,0,5
41263,2014/03/31,2012/06/25,561,5,0.619277881,7021,561,5,0
41264,2014/03/31,2006/05/08,78,4,0.8051018520000001,5400,78,0,4
41265,2014/03/31,2007/01/31,385,6,0.626668589,6937,385,6,0
41266,2014/03/31,2007/07/20,174,4,0.5525,7868,174,2,2
41267,2014/03/31,2007/07/31,23,2,1.343462133,3235,23,1,1
41268,2014/03/31,2012/11/01,33,5,0.377772079,11504,33,4,1
41269,2014/03/31,2013/02/26,45,4,0.689384518,6304,45,0,4
41270,2014/03/31,2010/06/18,711,3,0.899751553,4830,711,3,0
41271,2014/03/31,2008/03/21,76,8,0.636506518,6827,76,5,3
41272,2014/03/31,2012/12/13,207,4,1.187837616,3658,207,2,2
41273,2014/03/31,2011/09/01,62,6,0.48808807,8902,62,4,2
41274,2014/03/31,2005/03/10,79,3,1.050977262,4134,79,2,1
41275,2014/03/31,2011/07/30,596,3,0.628803011,6909,596,3,0
41276,2014/03/31,2012/11/13,79,7,0.378524005,11477,79,2,5
41277,2014/03/31,2012/02/16,82,4,0.66318626,6550,82,1,3
41278,2014/03/31,2013/03/02,141,4,0.6887787470000001,6305,141,1,3
41279,2014/03/31,2008/09/27,156,5,0.651064468,6670,156,4,1
41280,2014/03/31,2008/04/16,338,5,0.8273194890000001,5249,338,3,2
41281,2014/03/31,2007/04/15,152,5,0.6966773620000001,6233,152,4,1
41282,2014/03/31,2008/01/24,5,4,0.654836375,6631,5,1,3
41283,2014/03/31,2008/07/01,128,4,0.7335225540000001,5919,128,2,2
41284,2014/03/31,2012/10/20,65,5,0.644136499,6740,65,0,5
41285,2014/03/31,2012/02/08,531,4,0.725,5988,531,4,0
41286,2014/03/31,2012/07/21,102,6,0.507733333,8550,102,0,6
41287,2014/03/31,2007/02/01,382,7,0.6108203179999999,7107,382,7,0
41288,2014/03/31,2010/05/18,23,2,1.045,4154,23,0,2
41289,2014/03/31,2011/05/18,506,3,0.7869289340000001,5516,506,3,0
41290,2014/03/31,2006/06/06,337,5,0.732343513,5927,337,4,1
41291,2014/03/31,2011/12/27,615,4,0.7484997409999999,5799,615,4,0
41292,2014/03/31,2011/05/15,86,6,0.579118079,7495,86,2,4
41293,2014/03/31,2012/08/24,69,5,0.84771875,5120,69,1,4
41294,2014/03/31,2008/04/09,285,5,0.8579106540000001,5059,285,4,1
41295,2014/03/31,2008/03/07,688,2,0.75,5786,688,2,0
41296,2014/03/31,2012/11/29,102,3,0.762983999,5687,102,1,2
41297,2014/03/31,2008/08/07,410,3,0.44180837,9821,410,3,0
41298,2014/03/31,2010/03/12,255,5,0.8312990990000001,5219,255,2,3
41299,2014/03/31,2009/09/25,326,5,0.672322951,6453,326,4,1
41300,2014/03/31,2009/11/12,523,6,0.805944641,5383,523,6,0
41301,2014/03/31,2013/02/16,77,6,0.8828225479999999,4914,77,2,4
41302,2014/03/31,2010/11/04,716,3,1.0,4338,716,3,0
41303,2014/03/31,2011/11/27,393,3,1.0,4338,393,3,0
41304,2014/03/31,2012/10/07,213,4,0.579436281,7486,213,2,2
41305,2014/03/31,2008/10/22,14,4,0.681576053,6364,14,0,4
41306,2014/03/31,2012/04/13,121,5,0.536344299,8086,121,3,2
41307,2014/03/31,2006/06/27,42,5,0.6803655479999999,6374,42,1,4
41308,2014/03/31,2009/09/17,104,3,0.806666667,5376,104,1,2
41309,2014/03/31,2011/05/01,382,5,1.09755758,3951,382,5,0
41310,2014/03/31,2012/08/04,46,4,0.763836533,5677,46,3,1
41311,2014/03/31,2013/01/09,446,2,0.9,4818,446,2,0
41312,2014/03/31,2013/03/22,370,2,0.9,4818,370,2,0
41313,2014/03/31,2011/09/14,22,4,0.5839078910000001,7426,22,2,2
41314,2014/03/31,2011/12/14,214,3,0.747471126,5801,214,1,2
41315,2014/03/31,2006/04/24,341,2,0.8,5420,341,1,1
41316,2014/03/31,2012/09/06,570,2,0.8,5420,570,2,0
41317,2014/03/31,2010/03/22,102,5,0.867188,5000,102,3,2
41318,2014/03/31,2007/10/25,44,3,0.672027278,6452,44,0,3
41319,2014/03/31,2011/04/01,508,5,0.628858428,6894,508,5,0
41320,2014/03/31,2012/03/06,162,6,0.509160207,8514,162,5,1
41321,2014/03/31,2005/02/20,37,8,0.605706499,7155,37,5,3
41322,2014/03/31,2012/08/08,141,3,0.74,5856,141,2,1
41323,2014/03/31,2012/02/10,224,3,0.640073855,6770,224,2,1
41324,2014/03/31,2012/09/18,399,3,0.70135157,6178,399,3,0
41325,2014/03/31,2007/07/04,503,6,0.639831635,6771,503,6,0
41326,2014/03/31,2010/01/26,162,4,0.7401298479999999,5853,162,0,4
41327,2014/03/31,2012/05/04,110,11,0.35440235600000003,12223,110,8,3
41328,2014/03/31,2012/08/22,382,4,0.723259309,5989,382,4,0
41329,2014/03/31,2011/12/09,192,2,1.08119321,4006,192,0,2
41330,2014/03/31,2013/03/28,220,6,0.66252907,6536,220,1,5
41331,2014/03/31,2012/12/01,23,4,0.7025,6164,23,1,3
41332,2014/03/31,2009/02/24,287,3,0.7246594140000001,5975,287,1,2
41333,2014/03/31,2010/07/11,387,4,0.825,5248,387,4,0
41334,2014/03/31,2011/06/05,160,6,0.651400843,6646,160,2,4
41335,2014/03/31,2012/11/20,328,5,0.5489538420000001,7886,328,2,3
41336,2014/03/31,2012/03/03,329,7,0.566935167,7635,329,5,2
41337,2014/03/31,2007/06/09,26,7,0.5946599810000001,7279,26,3,4
41338,2014/03/31,2008/07/13,345,6,0.509919887,8488,345,2,4
41339,2014/03/31,2010/04/12,269,2,0.67,6460,269,0,2
41340,2014/03/31,2009/11/16,84,5,0.861297512,5025,84,3,2
41341,2014/03/31,2006/05/25,95,5,0.851132743,5085,95,0,5
41342,2014/03/31,2012/08/24,419,5,1.0,4328,419,5,0
41343,2014/03/31,2009/11/28,4,3,0.53998378,8015,4,0,3
41344,2014/03/31,2010/05/18,64,3,0.782890738,5528,64,0,3
41345,2014/03/31,2011/03/02,91,5,0.6623939999999999,6533,91,2,3
41346,2014/03/31,2005/09/01,692,3,0.7333333329999999,5901,692,3,0
41347,2014/03/31,2011/07/30,54,4,0.72573226,5961,54,2,2
41348,2014/03/31,2012/01/13,590,3,0.7662976090000001,5645,590,3,0
41349,2014/03/31,2005/06/18,3,4,0.919946831,4702,3,2,2
41350,2014/03/31,2011/09/14,69,5,0.789735257,5477,69,2,3
41351,2014/03/31,2007/04/10,272,3,0.707905074,6110,272,2,1
41352,2014/03/31,2010/12/22,164,4,0.636815371,6792,164,2,2
41353,2014/03/31,2009/11/27,399,6,0.907130872,4768,399,6,0
41354,2014/03/31,2009/02/18,7,7,0.467335494,9255,7,0,7
41355,2014/03/31,2011/08/18,279,3,0.65,6654,279,2,1
41356,2014/03/31,2008/07/19,110,7,0.8331477559999999,5191,110,4,3
41357,2014/03/31,2005/07/31,25,6,0.5448311920000001,7938,25,5,1
41358,2014/03/31,2008/07/12,391,3,0.72004662,6006,391,3,0
41359,2014/03/31,2013/02/11,153,4,0.745037905,5804,153,3,1
41360,2014/03/31,2010/10/26,159,8,0.96709461,4471,159,3,5
41361,2014/03/31,2007/09/10,140,6,0.373941019,11563,140,5,1
41362,2014/03/31,2012/03/15,545,4,0.938324653,4608,545,4,0
41363,2014/03/31,2010/09/04,168,10,0.712404417,6068,168,3,7
41364,2014/03/31,2013/01/17,22,7,0.560276086,7715,22,3,4
41365,2014/03/31,2011/08/16,26,5,0.681234043,6345,26,2,3
41366,2014/03/31,2012/05/02,448,5,0.56455721,7656,448,5,0
41367,2014/03/31,2012/08/30,469,4,0.6375,6780,469,4,0
41368,2014/03/31,2009/08/16,108,6,0.82857362,5216,108,0,6
41369,2014/03/31,2007/05/15,320,4,0.657092899,6577,320,3,1
41370,2014/03/31,2012/10/21,45,4,0.913233305,4732,45,2,2
41371,2014/03/31,2013/03/12,369,3,0.942919485,4583,369,3,0
41372,2014/03/31,2011/04/19,163,5,0.6222246220000001,6945,163,4,1
41373,2014/03/31,2006/07/23,424,3,0.8892776290000001,4859,424,3,0
41374,2014/03/31,2012/10/30,173,6,0.7022363070000001,6153,173,0,6
41375,2014/03/31,2012/05/07,463,3,0.658490854,6560,463,3,0
41376,2014/03/31,2011/09/08,658,3,0.5,8639,658,3,0
41377,2014/03/31,2009/01/24,171,6,0.610489046,7075,171,4,2
41378,2014/03/31,2011/09/12,22,4,0.729832714,5918,22,2,2
41379,2014/03/31,2011/06/01,2,5,0.906356768,4765,2,0,5
41380,2014/03/31,2005/11/20,275,6,0.948333333,4554,275,2,4
41381,2014/03/31,2008/08/21,105,4,1.062598425,4064,105,0,4
41382,2014/03/31,2012/01/06,114,5,0.724015761,5964,114,1,4
41383,2014/03/31,2011/03/13,566,3,1.0,4318,566,3,0
41384,2014/03/31,2011/05/01,349,3,0.856526483,5041,349,0,3
41385,2014/03/31,2009/09/14,48,10,0.710498601,6077,48,7,3
41386,2014/03/31,2012/04/11,251,4,0.831262996,5194,251,2,2
41387,2014/03/31,2010/08/01,48,5,0.753339731,5731,48,2,3
41388,2014/03/31,2011/12/07,17,7,0.7025862629999999,6144,17,2,5
41389,2014/03/31,2012/05/15,136,5,0.426312099,10125,136,1,4
41390,2014/03/31,2004/11/25,66,5,1.075864905,4012,66,0,5
41391,2014/03/31,2007/05/03,187,3,0.7479396979999999,5771,187,0,3
41392,2014/03/31,2013/03/25,178,3,0.723333333,5967,178,1,2
41393,2014/03/31,2011/11/27,185,4,0.658871756,6550,185,2,2
41394,2014/03/31,2009/10/19,193,4,0.752105263,5738,193,1,3
41395,2014/03/31,2012/03/26,211,7,0.63513247,6794,211,3,4
41396,2014/03/31,2012/09/06,488,4,0.631934681,6828,488,4,0
41397,2014/03/31,2011/09/26,33,6,0.699961064,6164,33,3,3
41398,2014/03/31,2012/12/06,21,6,0.520062681,8296,21,2,4
41399,2014/03/31,2007/04/18,298,3,0.7550612529999999,5714,298,2,1
41400,2014/03/31,2012/03/21,111,4,0.976899909,4416,111,3,1
41401,2014/03/31,2008/10/31,412,5,0.943525809,4572,412,5,0
41402,2014/03/31,2007/09/04,123,3,0.902426778,4780,123,0,3
41403,2014/03/31,2012/02/15,190,4,0.767246531,5622,190,3,1
41404,2014/03/31,2011/07/03,215,4,0.8352827270000001,5164,215,3,1
41405,2014/03/31,2012/02/02,19,3,0.615561581,7007,19,0,3
41406,2014/03/31,2011/09/25,80,4,0.716958112,6016,80,2,2
41407,2014/03/31,2012/07/10,598,4,0.761511299,5664,598,4,0
41408,2014/03/31,2010/12/14,138,9,0.403333333,10692,138,2,7
41409,2014/03/31,2006/03/20,530,4,0.658582773,6548,530,4,0
41410,2014/03/31,2013/01/28,423,3,0.70279498,6136,423,3,0
41411,2014/03/31,2009/02/21,3,6,0.603801456,7142,3,1,5
41412,2014/03/31,2009/05/25,113,2,0.895,4818,113,0,2
41413,2014/03/31,2012/02/13,351,4,0.601737371,7166,351,3,1
41414,2014/03/31,2008/02/01,210,4,0.72,5988,210,2,2
41415,2014/03/31,2007/03/02,212,5,0.485292727,8882,212,1,4
41416,2014/03/31,2011/01/14,21,3,0.850590093,5067,21,0,3
41417,2014/03/31,2011/09/16,7,4,0.636025679,6776,7,3,1
41418,2014/03/31,2013/03/14,12,5,0.7339100820000001,5872,12,1,4
41419,2014/03/31,2011/03/06,642,5,0.801022305,5380,642,5,0
41420,2014/03/31,2012/10/05,301,4,0.591691611,7283,301,3,1
41421,2014/03/31,2008/07/10,140,6,0.8871958000000001,4857,140,3,3
41422,2014/03/31,2007/05/17,44,4,0.917236534,4697,44,3,1
41423,2014/03/31,2012/09/30,223,2,0.959503341,4490,223,1,1
41424,2014/03/31,2009/12/11,71,4,0.889001238,4846,71,3,1
41425,2014/03/31,2009/05/09,34,3,0.720411371,5980,34,1,2
41426,2014/03/31,2009/12/30,70,2,0.725,5942,70,0,2
41427,2014/03/31,2005/03/24,123,3,0.73,5901,123,0,3
41428,2014/03/31,2006/01/20,14,4,0.5475,7868,14,0,4
41429,2014/03/31,2005/04/07,104,7,0.4183828670000001,10296,104,2,5
41430,2014/03/31,2011/01/27,108,4,0.73232574,5882,108,2,2
41431,2014/03/31,2009/11/09,381,3,0.875645456,4919,381,3,0
41432,2014/03/31,2011/03/03,551,4,1.0,4307,551,4,0
41433,2014/03/31,2013/01/25,157,4,0.7955079420000001,5414,157,1,3
41434,2014/03/31,2012/09/15,222,4,0.978264425,4402,222,2,2
41435,2014/03/31,2011/01/13,625,2,0.8411799179999999,5119,625,2,0
41436,2014/03/31,2007/11/27,128,6,0.664576324,6479,128,2,4
41437,2014/03/31,2008/09/21,88,3,1.079669007,3988,88,2,1
41438,2014/03/31,2012/05/13,198,5,0.7086109279999999,6076,198,2,3
41439,2014/03/31,2012/01/20,51,7,0.454645686,9469,51,3,4
41440,2014/03/31,2010/07/16,57,7,0.658842975,6534,57,2,5
41441,2014/03/31,2009/06/25,46,3,1.074026946,4008,46,0,3
41442,2014/03/31,2010/05/18,224,4,0.719607155,5982,224,2,2
41443,2014/03/31,2010/07/30,75,8,0.894016615,4815,75,3,5
41444,2014/03/31,2006/03/20,27,11,0.803831933,5355,27,2,9
41445,2014/03/31,2011/09/07,458,5,0.592056396,7270,458,5,0
41446,2014/03/31,2010/10/26,22,5,0.55353955,7775,22,2,3
41447,2014/03/31,2008/05/19,207,6,0.8413587490000001,5115,207,4,2
41448,2014/03/31,2012/05/25,79,4,1.285016423,3349,79,2,2
41449,2014/03/31,2011/04/20,25,6,0.600160391,7170,25,1,5
41450,2014/03/31,2011/10/08,341,5,0.7585140140000001,5673,341,3,2
41451,2014/03/31,2012/10/28,15,5,0.755557507,5695,15,2,3
41452,2014/03/31,2004/11/13,105,5,0.581890722,7394,105,0,5
41453,2014/03/31,2007/08/15,309,3,0.749416478,5741,309,1,2
41454,2014/03/31,2009/11/19,159,4,0.897062135,4796,159,2,2
41455,2014/03/31,2008/09/04,2,5,0.517215677,8318,2,2,3
41456,2014/03/31,2011/12/28,65,8,0.693331721,6204,65,3,5
41457,2014/03/31,2007/07/12,20,4,0.608785563,7065,20,1,3
41458,2014/03/31,2007/12/04,138,3,0.65058085,6611,138,0,3
41459,2014/03/31,2011/09/29,240,3,0.683333333,6294,240,2,1
41460,2014/03/31,2008/09/10,121,5,0.8524975220000001,5045,121,2,3
41461,2014/03/31,2006/01/19,82,8,0.33681262700000003,12766,82,0,8
41462,2014/03/31,2006/06/30,364,10,0.59803867,7189,364,9,1
41463,2014/03/31,2008/02/16,136,6,0.600989794,7153,136,2,4
41464,2014/03/31,2011/08/04,357,6,0.6397886279999999,6718,357,5,1
41465,2014/03/31,2012/05/26,670,5,0.547382832,7852,670,5,0
41466,2014/03/31,2011/09/27,575,2,0.64360587,6678,575,2,0
41467,2014/03/31,2012/11/14,64,13,0.57,7540,64,3,10
41468,2014/03/31,2011/08/08,11,7,0.7460520829999999,5760,11,3,4
41469,2014/03/31,2005/03/21,504,4,1.0,4297,504,4,0
41470,2014/03/31,2009/10/06,15,4,0.79116369,5431,15,2,2
41471,2014/03/31,2012/08/11,151,5,0.66,6510,151,1,4
41472,2014/03/31,2012/07/10,625,2,0.7,6138,625,2,0
41473,2014/03/31,2010/10/13,40,2,0.7,6138,40,0,2
41474,2014/03/31,2012/01/07,61,7,0.842132497,5102,61,4,3
41475,2014/03/31,2011/07/02,560,2,1.2205965909999998,3520,560,2,0
41476,2014/03/31,2006/09/22,249,2,0.834908667,5146,249,1,1
41477,2014/03/31,2012/01/18,139,5,0.424335802,10125,139,3,2
41478,2014/03/31,2009/11/25,106,2,0.56,7672,106,0,2
41479,2014/03/31,2012/03/03,564,9,0.590522337,7275,564,9,0
41480,2014/03/31,2011/11/06,236,2,0.67,6412,236,0,2
41481,2014/03/31,2012/08/09,292,3,0.6166666670000001,6966,292,0,3
41482,2014/03/31,2011/07/14,218,2,0.72,5966,218,0,2
41483,2014/03/31,2012/08/13,355,5,0.908887008,4726,355,4,1
41484,2014/03/31,2008/12/15,63,5,0.596707419,7198,63,3,2
41485,2014/03/31,2012/07/17,311,3,1.0,4295,311,1,2
41486,2014/03/31,2005/08/07,458,4,0.501940159,8556,458,4,0
41487,2014/03/31,2008/04/10,359,3,1.5,2863,359,2,1
41488,2014/03/31,2011/06/14,313,3,0.7333333329999999,5856,313,1,2
41489,2014/03/31,2007/11/28,394,3,0.81882151,5244,394,3,0
41490,2014/03/31,2012/12/16,319,4,0.770041248,5576,319,2,2
41491,2014/03/31,2012/05/15,437,4,0.610587315,7032,437,4,0
41492,2014/03/31,2013/03/19,264,4,0.735084746,5841,264,2,2
41493,2014/03/31,2007/06/19,136,3,0.950086302,4519,136,0,3
41494,2014/03/31,2012/03/15,187,6,0.81313447,5280,187,2,4
41495,2014/03/31,2009/01/21,66,5,0.790618785,5430,66,2,3
41496,2014/03/31,2013/03/15,6,4,0.640804598,6699,6,1,3
41497,2014/03/31,2011/01/13,157,6,0.424557864,10110,157,0,6
41498,2014/03/31,2008/05/11,449,5,0.601745409,7133,449,5,0
41499,2014/03/31,2010/02/01,226,6,0.353775964,12132,226,5,1
41500,2014/03/31,2011/04/02,478,9,0.8222222220000001,5220,478,9,0
41501,2014/03/31,2012/07/15,625,2,1.0,4292,625,2,0
41502,2014/03/31,2010/06/26,64,7,0.393460763,10908,64,0,7
41503,2014/03/31,2009/04/05,196,4,0.3,14306,196,0,4
41504,2014/03/31,2013/01/22,74,3,0.5033333329999999,8526,74,1,2
41505,2014/03/31,2010/09/22,9,2,0.755,5684,9,0,2
41506,2014/03/31,2008/02/17,28,4,0.715226667,6000,28,2,2
41507,2014/03/31,2013/01/26,101,4,0.4532393320000001,9468,101,2,2
41508,2014/03/31,2010/09/26,43,4,0.603196514,7114,43,1,3
41509,2014/03/31,2007/02/28,191,10,0.528583395,8118,191,5,5
41510,2014/03/31,2010/02/17,66,5,0.624043048,6876,66,2,3
41511,2014/03/31,2010/06/21,64,4,0.750236055,5719,64,1,3
41512,2014/03/31,2012/11/10,70,3,0.953823922,4498,70,2,1
41513,2014/03/31,2007/01/09,11,4,0.5477147960000001,7833,11,1,3
41514,2014/03/31,2008/09/16,507,2,0.65,6600,507,2,0
41515,2014/03/31,2012/04/17,191,4,0.54864177,7819,191,3,1
41516,2014/03/31,2012/02/15,107,7,0.619131062,6928,107,3,4
41517,2014/03/31,2012/06/04,275,3,0.8431295459999999,5087,275,2,1
41518,2014/03/31,2010/12/26,385,6,0.440163177,9744,385,6,0
41519,2014/03/31,2007/10/03,71,4,0.447933988,9574,71,2,2
41520,2014/03/31,2007/10/11,142,7,0.607128699,7063,142,5,2
41521,2014/03/31,2007/12/02,344,2,1.0,4288,344,1,1
41522,2014/03/31,2011/10/16,486,7,0.977656179,4386,486,7,0
41523,2014/03/31,2011/12/14,340,6,0.680987929,6296,340,4,2
41524,2014/03/31,2006/07/10,179,6,0.6793660859999999,6310,179,5,1
41525,2014/03/31,2012/12/07,224,6,0.5777840679999999,7419,224,5,1
41526,2014/03/31,2011/06/08,79,9,0.423059613,10132,79,4,5
41527,2014/03/31,2011/04/28,32,8,0.408525543,10492,32,0,8
41528,2014/03/31,2011/12/05,220,3,0.876888298,4888,220,0,3
41529,2014/03/31,2010/09/06,122,6,0.707515682,6058,122,5,1
41530,2014/03/31,2012/05/03,308,5,0.5545478070000001,7729,308,4,1
41531,2014/03/31,2008/10/08,199,3,0.672716999,6371,199,2,1
41532,2014/03/31,2007/03/18,193,3,0.953202847,4496,193,2,1
41533,2014/03/31,2012/06/04,200,6,0.587537702,7294,200,3,3
41534,2014/03/31,2011/12/12,116,6,0.900262605,4760,116,2,4
41535,2014/03/31,2008/04/10,269,5,0.739830801,5792,269,2,3
41536,2014/03/31,2011/04/20,172,5,0.691353662,6198,172,1,4
41537,2014/03/31,2006/07/03,171,3,0.562922086,7611,171,1,2
41538,2014/03/31,2013/03/28,219,5,0.607097506,7056,219,1,4
41539,2014/03/31,2011/02/01,77,4,0.6159102670000001,6954,77,0,4
41540,2014/03/31,2007/10/27,268,4,0.57457875,7454,268,3,1
41541,2014/03/31,2012/01/12,31,6,0.660175736,6487,31,4,2
41542,2014/03/31,2009/03/04,62,6,0.581613473,7363,62,3,3
41543,2014/03/31,2007/07/04,45,6,0.763333333,5610,45,0,6
41544,2014/03/31,2013/03/01,99,4,0.919510414,4657,99,1,3
41545,2014/03/31,2011/12/02,393,7,0.7031280790000001,6090,393,7,0
41546,2014/03/31,2009/08/04,72,5,0.492282134,8698,72,1,4
41547,2014/03/31,2009/01/20,90,4,0.79,5420,90,3,1
41548,2014/03/31,2012/03/28,71,4,0.359919301,11896,71,1,3
41549,2014/03/31,2011/07/27,426,4,0.749081365,5715,426,4,0
41550,2014/03/31,2012/10/26,147,4,0.816788781,5241,147,2,2
41551,2014/03/31,2011/07/23,77,5,0.740709465,5779,77,2,3
41552,2014/03/31,2007/09/14,549,2,0.9,4756,549,2,0
41553,2014/03/31,2009/07/25,333,5,0.695660653,6153,333,4,1
41554,2014/03/31,2008/01/28,39,6,0.475115995,9009,39,1,5
41555,2014/03/31,2012/08/13,179,5,0.539828478,7929,179,2,3
41556,2014/03/31,2012/05/26,481,4,1.0,4280,481,4,0
41557,2014/03/31,2012/09/23,156,4,0.8274825990000001,5172,156,0,4
41558,2014/03/31,2005/04/08,207,6,0.624186114,6856,207,0,6
41559,2014/03/31,2011/08/09,190,7,0.836327209,5116,190,1,6
41560,2014/03/31,2007/06/27,137,7,0.641756412,6667,137,1,6
41561,2014/03/31,2009/07/31,112,5,0.534485946,8005,112,1,4
41562,2014/03/31,2011/08/08,167,5,0.719994951,5942,167,3,2
41563,2014/03/31,2011/09/13,81,3,0.783249725,5462,81,1,2
41564,2014/03/31,2007/04/24,48,7,0.620783631,6891,48,2,5
41565,2014/03/31,2007/11/01,704,4,0.655199877,6529,704,4,0
41566,2014/03/31,2008/03/02,214,6,0.909185972,4705,214,1,5
41567,2014/03/31,2006/10/13,33,7,0.4003556720000001,10684,33,1,6
41568,2014/03/31,2010/03/03,316,13,0.44103939,9698,316,8,5
41569,2014/03/31,2009/03/21,69,7,0.671428571,6370,69,2,5
41570,2014/03/31,2005/06/27,599,3,1.096244553,3901,599,3,0
41571,2014/03/31,2012/07/07,505,4,0.5375,7956,505,4,0
41572,2014/03/31,2007/05/24,429,8,0.64005988,6680,429,8,0
41573,2014/03/31,2005/12/15,194,5,0.8192278209999999,5219,194,2,3
41574,2014/03/31,2012/04/13,192,6,0.6050806679999999,7066,192,2,4
41575,2014/03/31,2007/06/28,393,4,0.818415008,5224,393,4,0
41576,2014/03/31,2012/05/26,48,7,0.688571429,6209,48,2,5
41577,2014/03/31,2010/04/21,64,4,0.550015438,7773,64,0,4
41578,2014/03/31,2012/07/21,211,3,0.95,4500,211,2,1
41579,2014/03/31,2012/09/27,80,4,0.529388235,8075,80,2,2
41580,2014/03/31,2012/11/02,120,5,0.5345342,7997,120,0,5
41581,2014/03/31,2011/12/19,68,5,0.543950115,7858,68,2,3
41582,2014/03/31,2013/02/10,74,4,0.6893903229999999,6200,74,1,3
41583,2014/03/31,2011/06/14,273,8,0.430694277,9924,273,4,4
41584,2014/03/31,2012/07/11,437,3,0.799457538,5346,437,3,0
41585,2014/03/31,2013/02/05,61,8,0.508198359,8409,61,2,6
41586,2014/03/31,2012/09/12,324,6,0.7666666670000001,5574,324,4,2
41587,2014/03/31,2013/02/28,74,6,0.7666666670000001,5574,74,1,5
41588,2014/03/31,2012/06/17,475,5,0.92,4645,475,5,0
41589,2014/03/31,2012/04/25,638,6,0.7666666670000001,5574,638,6,0
41590,2014/03/31,2013/03/19,244,3,0.815200305,5242,244,1,2
41591,2014/03/31,2012/07/05,225,4,0.667038714,6406,225,1,3
41592,2014/03/31,2006/06/21,408,2,0.91108742,4690,408,2,0
41593,2014/03/31,2005/11/11,84,3,0.6233333329999999,6855,84,2,1
41594,2014/03/31,2013/01/12,45,7,0.708496103,6031,45,1,6
41595,2014/03/31,2012/04/18,567,4,0.613203215,6968,567,4,0
41596,2014/03/31,2010/03/21,488,3,0.77096716,5542,488,3,0
41597,2014/03/31,2010/10/06,159,3,0.7440595609999999,5742,159,0,3
41598,2014/03/31,2006/08/25,38,5,0.846,5050,38,0,5
41599,2014/03/31,2011/10/11,615,4,0.6,7120,615,4,0
41600,2014/03/31,2012/04/15,569,4,1.0,4272,569,4,0
41601,2014/03/31,2008/07/06,324,8,0.620345629,6886,324,5,3
41602,2014/03/31,2013/02/10,400,2,0.7,6102,400,2,0
41603,2014/03/31,2011/06/21,295,7,0.6,7119,295,6,1
41604,2014/03/31,2009/10/14,42,3,0.950102336,4495,42,1,2
41605,2014/03/31,2011/08/05,376,4,0.946101019,4514,376,4,0
41606,2014/03/31,2010/06/08,260,4,0.6609781770000001,6461,260,2,2
41607,2014/03/31,2008/12/03,302,4,0.7984779359999999,5348,302,3,1
41608,2014/03/31,2010/04/27,157,7,0.717066331,5955,157,3,4
41609,2014/03/31,2012/11/15,300,10,0.505856635,8440,300,6,4
41610,2014/03/31,2011/04/18,100,6,0.590636414,7228,100,2,4
41611,2014/03/31,2011/09/06,68,3,0.6967422879999999,6127,68,1,2
41612,2014/03/31,2010/09/29,204,3,0.645120145,6617,204,2,1
41613,2014/03/31,2008/08/12,177,5,0.728692386,5858,177,0,5
41614,2014/03/31,2010/01/11,427,4,0.5,8536,427,4,0
41615,2014/03/31,2012/09/19,257,2,1.436445641,2971,257,1,1
41616,2014/03/31,2012/03/02,534,4,0.965716225,4419,534,4,0
41617,2014/03/31,2011/12/20,88,5,0.667388176,6394,88,2,3
41618,2014/03/31,2008/02/28,170,5,0.84902109,5026,170,3,2
41619,2014/03/31,2006/11/21,62,6,0.709163896,6016,62,0,6
41620,2014/03/31,2006/06/12,207,7,0.6731145470000001,6338,207,6,1
41621,2014/03/31,2012/01/05,260,5,0.654107636,6522,260,4,1
41622,2014/03/31,2005/10/18,27,3,1.030604011,4139,27,0,3
41623,2014/03/31,2007/07/31,31,6,0.649260274,6570,31,0,6
41624,2014/03/31,2008/12/26,537,5,0.716383944,5954,537,5,0
41625,2014/03/31,2011/12/20,408,5,0.8981048640000001,4749,408,5,0
41626,2014/03/31,2011/03/01,193,5,0.746147656,5716,193,4,1
41627,2014/03/31,2006/02/17,480,4,0.7950783,5364,480,4,0
41628,2014/03/31,2013/01/25,81,6,0.7291160879999999,5849,81,3,3
41629,2014/03/31,2010/06/10,68,7,0.7779095220000001,5482,68,4,3
41630,2014/03/31,2008/05/27,272,6,0.402721692,10589,272,4,2
41631,2014/03/31,2007/05/08,347,3,0.858200845,4969,347,2,1
41632,2014/03/31,2007/11/02,68,6,0.7642946759999999,5579,68,5,1
41633,2014/03/31,2005/09/01,467,6,0.8848308779999999,4819,467,6,0
41634,2014/03/31,2011/11/05,14,4,0.8125,5248,14,1,3
41635,2014/03/31,2013/03/27,366,2,0.75,5684,366,1,1
41636,2014/03/31,2012/08/20,561,2,0.75,5684,561,2,0
41637,2014/03/31,2012/12/01,484,2,0.75,5684,484,2,0
41638,2014/03/31,2009/01/13,259,2,0.75,5684,259,0,2
41639,2014/03/31,2012/03/28,590,2,0.75,5684,590,2,0
41640,2014/03/31,2011/07/11,415,2,0.75,5684,415,2,0
41641,2014/03/31,2012/08/20,561,2,0.75,5684,561,2,0
41642,2014/03/31,2012/11/06,6,5,0.842141446,5062,6,0,5
41643,2014/03/31,2012/05/24,152,6,0.548420172,7773,152,1,5
41644,2014/03/31,2011/06/06,209,4,0.912936389,4669,209,3,1
41645,2014/03/31,2011/04/29,93,6,0.67948023,6272,93,2,4
41646,2014/03/31,2012/11/22,221,6,0.684473177,6226,221,2,4
41647,2014/03/31,2011/03/27,22,9,0.568784036,7492,22,2,7
41648,2014/03/31,2007/09/15,285,3,1.4459755680000002,2947,285,0,3
41649,2014/03/31,2009/08/13,20,6,0.561474503,7589,20,3,3
41650,2014/03/31,2012/03/28,76,7,0.512225295,8318,76,5,2
41651,2014/03/31,2009/02/24,179,5,0.580230151,7343,179,3,2
41652,2014/03/31,2009/03/15,264,9,0.753422356,5654,264,8,1
41653,2014/03/31,2006/06/01,49,3,0.751510233,5668,49,1,2
41654,2014/03/31,2008/11/18,209,3,0.58986013,7221,209,2,1
41655,2014/03/31,2012/06/05,102,5,0.8387554159999999,5078,102,0,5
41656,2014/03/31,2006/09/07,155,8,0.483424518,8810,155,4,4
41657,2014/03/31,2005/10/02,662,2,1.3,3276,662,2,0
41658,2014/03/31,2012/04/14,20,3,0.67437213,6315,20,1,2
41659,2014/03/31,2008/08/06,412,2,0.493064722,8637,412,2,0
41660,2014/03/31,2013/01/01,189,4,0.590485302,7212,189,1,3
41661,2014/03/31,2012/07/10,4,13,0.793076923,5369,4,9,4
41662,2014/03/31,2012/11/10,35,4,0.5125,8308,35,1,3
41663,2014/03/31,2012/04/30,389,5,0.777236218,5478,389,5,0
41664,2014/03/31,2010/08/01,141,9,0.7105457279999999,5992,141,5,4
41665,2014/03/31,2006/11/01,145,7,0.419893481,10139,145,2,5
41666,2014/03/31,2006/01/20,20,6,0.443684211,9595,20,4,2
41667,2014/03/31,2010/04/22,220,4,0.570200911,7466,220,0,4
41668,2014/03/31,2010/03/16,83,7,0.8039376770000001,5295,83,1,6
41669,2014/03/31,2012/12/03,268,4,0.6555967970000001,6493,268,0,4
41670,2014/03/31,2010/12/13,78,6,0.450357596,9452,78,2,4
41671,2014/03/31,2013/02/16,253,3,0.66428839,6408,253,1,2
41672,2014/03/31,2012/02/07,459,3,0.871182972,4886,459,3,0
41673,2014/03/31,2006/01/13,13,5,0.605394681,7031,13,0,5
41674,2014/03/31,2012/08/16,345,3,0.933852567,4558,345,2,1
41675,2014/03/31,2009/07/15,168,6,0.575272334,7399,168,5,1
41676,2014/03/31,2011/01/14,55,4,0.74923429,5681,55,1,3
41677,2014/03/31,2010/09/15,264,5,0.90769887,4689,264,3,2
41678,2014/03/31,2006/07/01,142,5,0.635253731,6700,142,3,2
41679,2014/03/31,2012/09/09,432,7,0.384193898,11078,432,7,0
41680,2014/03/31,2013/02/11,413,2,1.0,4256,413,2,0
41681,2014/03/31,2011/10/07,74,6,0.689230769,6175,74,4,2
41682,2014/03/31,2006/06/05,117,6,0.555460715,7662,117,4,2
41683,2014/03/31,2006/08/20,109,4,0.702897258,6054,109,0,4
41684,2014/03/31,2012/04/21,23,6,0.796114125,5345,23,4,2
41685,2014/03/31,2010/11/03,278,4,0.785218675,5419,278,3,1
41686,2014/03/31,2011/08/03,153,4,0.616053279,6907,153,0,4
41687,2014/03/31,2011/11/18,385,2,0.7507057159999999,5668,385,2,0
41688,2014/03/31,2011/09/07,72,5,0.578268551,7358,72,4,1
41689,2014/03/31,2007/07/17,1,4,0.532968809,7983,1,0,4
41690,2014/03/31,2011/08/22,4,5,0.552160934,7705,4,2,3
41691,2014/03/31,2012/03/05,178,6,0.526923458,8074,178,4,2
41692,2014/03/31,2012/10/17,218,4,0.8149425290000001,5220,218,3,1
41693,2014/03/31,2012/06/29,184,5,0.927298888,4587,184,3,2
41694,2014/03/31,2010/06/15,68,6,0.8043116490000001,5288,68,4,2
41695,2014/03/31,2011/03/03,2,7,0.688391065,6178,2,6,1
41696,2014/03/31,2013/03/30,79,4,0.746733977,5695,79,0,4
41697,2014/03/31,2008/11/05,313,7,0.563754474,7543,313,6,1
41698,2014/03/31,2012/10/10,342,8,0.68245065,6231,342,7,1
41699,2014/03/31,2008/11/27,1,4,0.682869761,6227,1,0,4
41700,2014/03/31,2012/10/14,49,5,0.595379446,7142,49,4,1
41701,2014/03/31,2009/10/31,252,5,0.941998228,4514,252,4,1
41702,2014/03/31,2013/02/20,183,5,0.8420000000000001,5050,183,0,5
41703,2014/03/31,2006/04/20,15,5,0.6735181370000001,6313,15,2,3
41704,2014/03/31,2012/12/11,107,8,0.498444314,8530,107,1,7
41705,2014/03/31,2012/08/14,128,6,0.405542732,10484,128,4,2
41706,2014/03/31,2013/02/12,12,6,0.7716333940000001,5510,12,0,6
41707,2014/03/31,2005/05/30,11,8,0.563221147,7547,11,1,7
41708,2014/03/31,2005/01/26,67,4,0.854048624,4977,67,0,4
41709,2014/03/31,2008/08/18,690,3,0.8841377159999999,4807,690,3,0
41710,2014/03/31,2012/05/08,449,3,0.833333333,5100,449,3,0
41711,2014/03/31,2011/11/09,133,5,0.5009984679999999,8483,133,1,4
41712,2014/03/31,2011/06/21,44,6,0.559237957,7598,44,3,3
41713,2014/03/31,2012/03/05,96,7,0.495664956,8572,96,4,3
41714,2014/03/31,2009/10/21,101,7,0.713957318,5951,101,3,4
41715,2014/03/31,2005/04/26,82,3,0.72,5901,82,2,1
41716,2014/03/31,2008/06/29,16,4,0.7404688859999999,5737,16,1,3
41717,2014/03/31,2012/04/10,197,7,0.64449249,6591,197,4,3
41718,2014/03/31,2010/10/29,127,6,0.55981811,7587,127,3,3
41719,2014/03/31,2010/12/18,3,6,0.56597548,7504,3,2,4
41720,2014/03/31,2007/12/06,119,4,0.589085865,7209,119,2,2
41721,2014/03/31,2009/12/22,159,4,0.7867061870000001,5398,159,2,2
41722,2014/03/31,2009/10/12,177,2,0.548772293,7738,177,0,2
41723,2014/03/31,2013/03/01,166,3,0.820974478,5172,166,2,1
41724,2014/03/31,2007/08/23,15,10,0.5181730529999999,8194,15,3,7
41725,2014/03/31,2010/06/02,154,4,0.7583300590000001,5599,154,2,2
41726,2014/03/31,2008/11/14,104,7,0.815183407,5207,104,4,3
41727,2014/03/31,2011/09/04,11,6,0.812550258,5223,11,1,5
41728,2014/03/31,2011/10/31,284,4,0.618561434,6861,284,3,1
41729,2014/03/31,2011/03/28,48,5,0.78967994,5374,48,4,1
41730,2014/03/31,2007/04/01,391,5,0.7482454590000001,5671,391,5,0
41731,2014/03/31,2011/10/16,1,9,0.377512456,11240,1,7,2
41732,2014/03/31,2012/05/25,431,5,0.758573217,5593,431,5,0
41733,2014/03/31,2012/08/12,270,7,0.597142857,7105,270,4,3
41734,2014/03/31,2009/07/14,75,8,0.664996865,6380,75,3,5
41735,2014/03/31,2007/08/28,555,5,0.546445131,7764,555,5,0
41736,2014/03/31,2012/05/09,114,4,0.695,6104,114,3,1
41737,2014/03/31,2012/06/09,178,3,0.7211934720000001,5882,178,2,1
41738,2014/03/31,2011/01/24,213,5,0.694954128,6104,213,3,2
41739,2014/03/31,2010/09/10,13,7,0.713513877,5945,13,2,5
41740,2014/03/31,2010/09/04,337,4,0.6792233790000001,6245,337,3,1
41741,2014/03/31,2007/04/26,81,4,0.829413375,5114,81,0,4
41742,2014/03/31,2008/06/26,162,5,0.660063803,6426,162,1,4
41743,2014/03/31,2012/09/27,225,5,0.8063384029999999,5260,225,1,4
41744,2014/03/31,2006/05/27,127,5,0.600407701,7064,127,2,3
41745,2014/03/31,2010/10/21,154,7,0.8828143209999999,4804,154,1,6
41746,2014/03/31,2012/09/03,310,3,0.816666667,5193,310,2,1
41747,2014/03/31,2010/09/23,122,5,0.775010965,5472,122,3,2
41748,2014/03/31,2010/07/19,382,4,1.225310604,3461,382,4,0
41749,2014/03/31,2013/03/07,82,5,0.648464597,6539,82,0,5
41750,2014/03/31,2009/09/01,263,6,0.553912987,7654,263,3,3
41751,2014/03/31,2012/09/30,55,3,0.77986755,5436,55,1,2
41752,2014/03/31,2012/11/19,90,8,0.770069028,5505,90,5,3
41753,2014/03/31,2011/09/20,340,5,0.4566627170000001,9283,340,1,4
41754,2014/03/31,2006/03/26,120,3,0.779676292,5437,120,0,3
41755,2014/03/31,2009/09/03,61,5,0.8269761999999998,5126,61,2,3
41756,2014/03/31,2012/02/22,95,3,0.673333333,6294,95,0,3
41757,2014/03/31,2006/05/24,363,5,0.92262138,4593,363,4,1
41758,2014/03/31,2011/02/01,302,6,0.508711885,8330,302,4,2
41759,2014/03/31,2004/12/05,224,2,1.462720055,2897,224,1,1
41760,2014/03/31,2013/01/21,229,3,0.665744815,6364,229,2,1
41761,2014/03/31,2012/04/30,544,6,0.643958048,6579,544,6,0
41762,2014/03/31,2013/01/15,172,5,0.688409165,6154,172,3,2
41763,2014/03/31,2012/07/10,211,4,0.6631386979999999,6388,211,1,3
41764,2014/03/31,2007/05/22,27,5,0.471668151,8980,27,3,2
41765,2014/03/31,2007/09/06,19,5,0.686578052,6169,19,3,2
41766,2014/03/31,2010/04/26,619,2,1.20463595,3516,619,2,0
41767,2014/03/31,2008/10/22,18,8,0.507053753,8353,18,5,3
41768,2014/03/31,2011/07/11,101,3,0.496666667,8526,101,2,1
41769,2014/03/31,2012/02/20,38,3,0.496666667,8526,38,0,3
41770,2014/03/31,2013/02/25,141,3,0.574466151,7371,141,1,2
41771,2014/03/31,2013/03/29,231,3,0.63181167,6701,231,1,2
41772,2014/03/31,2012/09/13,263,7,0.62421852,6782,263,5,2
41773,2014/03/31,2012/06/14,638,2,0.75,5644,638,2,0
41774,2014/03/31,2008/12/24,712,2,0.75,5644,712,2,0
41775,2014/03/31,2011/06/22,618,2,0.75,5644,618,2,0
41776,2014/03/31,2007/12/05,502,6,0.949528937,4458,502,6,0
41777,2014/03/31,2012/11/29,454,2,0.75,5644,454,2,0
41778,2014/03/31,2012/04/23,69,8,0.439240428,9637,69,6,2
41779,2014/03/31,2012/08/11,500,4,0.5625,7524,500,4,0
41780,2014/03/31,2012/02/24,111,4,0.7254130959999999,5834,111,2,2
41781,2014/03/31,2008/03/01,108,5,0.952511816,4443,108,1,4
41782,2014/03/31,2006/05/27,221,4,0.928659206,4557,221,2,2
41783,2014/03/31,2009/03/05,161,6,0.497280846,8510,161,3,3
41784,2014/03/31,2006/09/10,524,4,0.620902421,6815,524,4,0
41785,2014/03/31,2011/01/18,704,3,0.8440454820000001,5013,704,3,0
41786,2014/03/31,2010/01/06,536,4,0.7601060009999999,5566,536,4,0
41787,2014/03/31,2011/10/28,366,5,0.491319243,8611,366,4,1
41788,2014/03/31,2007/04/17,424,4,0.642152398,6588,424,4,0
41789,2014/03/31,2011/11/19,192,5,0.670095042,6313,192,2,3
41790,2014/03/31,2013/02/01,109,5,0.750553682,5635,109,2,3
41791,2014/03/31,2007/11/30,517,4,0.643517955,6572,517,4,0
41792,2014/03/31,2012/07/11,583,3,0.716666667,5901,583,3,0
41793,2014/03/31,2012/03/15,515,5,1.0,4229,515,5,0
41794,2014/03/31,2013/03/01,378,2,0.8,5286,378,2,0
41795,2014/03/31,2011/01/23,463,2,0.8,5286,463,2,0
41796,2014/03/31,2007/11/23,273,4,0.903729429,4679,273,3,1
41797,2014/03/31,2009/10/25,676,4,0.7210948159999999,5864,676,4,0
41798,2014/03/31,2012/01/01,5,4,0.705508093,5993,5,0,4
41799,2014/03/31,2009/06/01,166,5,0.930470951,4544,166,4,1
41800,2014/03/31,2010/07/13,176,7,0.6064782670000001,6971,176,1,6
41801,2014/03/31,2012/09/18,48,7,0.513374621,8235,48,1,6
41802,2014/03/31,2010/08/09,220,4,0.39,10840,220,2,2
41803,2014/03/31,2011/10/21,518,4,0.4625,9140,518,4,0
41804,2014/03/31,2007/10/01,106,6,0.6168291260000001,6853,106,2,4
41805,2014/03/31,2011/03/24,429,3,0.712833052,5930,429,3,0
41806,2014/03/31,2011/01/14,204,5,0.647771648,6525,204,2,3
41807,2014/03/31,2013/01/06,320,8,0.9125,4632,320,6,2
41808,2014/03/31,2010/04/23,193,2,0.72,5870,193,0,2
41809,2014/03/31,2011/07/12,239,5,0.984,4295,239,4,1
41810,2014/03/31,2013/02/20,112,8,0.637850566,6625,112,1,7
41811,2014/03/31,2006/05/06,83,3,0.635632616,6647,83,1,2
41812,2014/03/31,2012/06/10,229,5,0.430337136,9818,229,3,2
41813,2014/03/31,2011/06/23,282,3,0.690691515,6117,282,1,2
41814,2014/03/31,2010/01/02,241,3,1.092505818,3867,241,1,2
41815,2014/03/31,2012/08/07,178,6,0.695301185,6076,178,0,6
41816,2014/03/31,2011/05/12,362,4,0.6917226129999999,6107,362,3,1
41817,2014/03/31,2007/09/06,96,5,0.880437682,4798,96,0,5
41818,2014/03/31,2010/05/14,579,5,0.603543363,6999,579,5,0
41819,2014/03/31,2008/01/11,145,7,0.661572435,6385,145,3,4
41820,2014/03/31,2006/03/30,445,4,0.825,5120,445,4,0
41821,2014/03/31,2012/11/05,311,4,0.707885034,5967,311,1,3
41822,2014/03/31,2012/11/02,192,8,0.439001143,9621,192,4,4
41823,2014/03/31,2011/01/21,466,4,1.0,4223,466,4,0
41824,2014/03/31,2013/01/28,398,4,0.608648025,6938,398,4,0
41825,2014/03/31,2010/04/10,7,7,0.764260633,5525,7,5,2
41826,2014/03/31,2012/10/02,130,5,0.627675041,6727,130,4,1
41827,2014/03/31,2006/05/28,115,5,0.565073608,7472,115,2,3
41828,2014/03/31,2012/11/19,180,4,0.539693212,7823,180,1,3
41829,2014/03/31,2008/08/07,17,5,0.6140226879999999,6876,17,2,3
41830,2014/03/31,2007/12/19,137,3,0.885463507,4768,137,0,3
41831,2014/03/31,2006/06/02,23,4,0.654241438,6453,23,2,2
41832,2014/03/31,2012/07/30,152,6,0.818813033,5156,152,3,3
41833,2014/03/31,2008/12/20,4,2,1.41,2994,4,0,2
41834,2014/03/31,2009/07/02,571,4,0.6647874020000001,6350,571,4,0
41835,2014/03/31,2006/03/31,84,4,0.553235911,7630,84,2,2
41836,2014/03/31,2011/04/25,72,3,0.622081061,6785,72,0,3
41837,2014/03/31,2012/07/28,609,2,0.7839245909999999,5384,609,2,0
41838,2014/03/31,2011/11/07,108,4,0.8551914890000001,4935,108,1,3
41839,2014/03/31,2012/05/09,339,5,0.59548469,7087,339,2,3
41840,2014/03/31,2010/04/04,31,7,0.8635481890000001,4887,31,0,7
41841,2014/03/31,2011/01/15,54,3,0.754537815,5593,54,0,3
41842,2014/03/31,2008/08/14,214,7,0.642231015,6571,214,4,3
41843,2014/03/31,2011/01/13,77,6,0.5801897429999999,7273,77,1,5
41844,2014/03/31,2008/02/16,220,3,0.611097755,6905,220,1,2
41845,2014/03/31,2011/01/24,250,2,0.55,7672,250,0,2
41846,2014/03/31,2009/08/06,247,4,0.419944268,10048,247,0,4
41847,2014/03/31,2012/08/15,356,9,0.855555556,4932,356,7,2
41848,2014/03/31,2009/03/28,141,6,0.502382426,8399,141,5,1
41849,2014/03/31,2012/08/13,111,3,0.813333333,5187,111,1,2
41850,2014/03/31,2009/11/26,382,6,0.920445123,4583,382,6,0
41851,2014/03/31,2010/07/21,636,3,0.886134454,4760,636,3,0
41852,2014/03/31,2010/04/26,243,5,0.7104008759999999,5937,243,3,2
41853,2014/03/31,2009/07/25,115,5,0.8283264579999999,5091,115,4,1
41854,2014/03/31,2008/08/14,426,2,1.0,4217,426,2,0
41855,2014/03/31,2011/11/18,236,3,0.544179894,7749,236,2,1
41856,2014/03/31,2012/08/28,347,7,0.900213493,4684,347,5,2
41857,2014/03/31,2012/10/08,182,5,0.785491803,5368,182,2,3
41858,2014/03/31,2010/09/20,44,5,0.523640089,8052,44,3,2
41859,2014/03/31,2012/07/06,262,4,0.5075,8308,262,3,1
41860,2014/03/31,2007/09/20,9,4,0.709784512,5940,9,0,4
41861,2014/03/31,2008/09/27,65,5,0.69034878,6107,65,3,2
41862,2014/03/31,2011/04/30,593,9,0.872222222,4833,593,9,0
41863,2014/03/31,2012/02/28,598,5,0.797832671,5283,598,5,0
41864,2014/03/31,2010/09/22,269,5,0.692654067,6085,269,4,1
41865,2014/03/31,2012/08/23,126,5,0.366245221,11508,126,1,4
41866,2014/03/31,2005/03/29,82,4,0.695608186,6059,82,0,4
41867,2014/03/31,2011/11/07,17,3,0.655763187,6427,17,1,2
41868,2014/03/31,2011/06/27,335,4,0.627703307,6714,335,3,1
41869,2014/03/31,2008/01/27,244,3,0.8358290359999999,5042,244,2,1
41870,2014/03/31,2006/07/19,355,5,0.7498576509999999,5620,355,4,1
41871,2014/03/31,2011/03/31,524,5,0.385234961,10938,524,5,0
41872,2014/03/31,2006/09/28,255,5,0.514833822,8184,255,4,1
41873,2014/03/31,2008/03/27,33,7,0.5932328920000001,7102,33,4,3
41874,2014/03/31,2012/05/10,585,4,0.6875,6128,585,4,0
41875,2014/03/31,2007/12/06,375,3,0.689525368,6110,375,3,0
41876,2014/03/31,2012/03/13,82,3,0.82135699,5129,82,0,3
41877,2014/03/31,2007/12/29,453,3,0.646417063,6517,453,3,0
41878,2014/03/31,2012/03/12,2,6,0.772812328,5451,2,3,3
41879,2014/03/31,2012/10/29,115,3,0.663819729,6346,115,0,3
41880,2014/03/31,2012/08/28,313,4,0.89340403,4715,313,2,2
41881,2014/03/31,2012/12/30,191,9,0.759352803,5547,191,7,2
41882,2014/03/31,2012/11/30,48,6,0.630065819,6685,48,4,2
41883,2014/03/31,2005/10/01,391,5,0.662232704,6360,391,5,0
41884,2014/03/31,2012/04/24,81,9,0.713333333,5904,81,8,1
41885,2014/03/31,2013/01/19,222,5,0.5488439979999999,7673,222,2,3
41886,2014/03/31,2008/06/09,3,4,0.6259051720000001,6728,3,0,4
41887,2014/03/31,2008/10/23,158,5,0.978619568,4303,158,2,3
41888,2014/03/31,2010/08/09,210,5,0.928441014,4535,210,3,2
41889,2014/03/31,2012/06/27,22,5,0.6844034459999999,6152,22,3,2
41890,2014/03/31,2008/05/27,654,7,0.571275441,7370,654,7,0
41891,2014/03/31,2013/03/22,9,5,0.5922380079999999,7109,9,0,5
41892,2014/03/31,2011/12/28,422,4,0.565860215,7440,422,4,0
41893,2014/03/31,2011/12/28,6,4,0.548409328,7676,6,2,2
41894,2014/03/31,2011/11/18,201,6,0.573501362,7340,201,3,3
41895,2014/03/31,2008/03/26,144,6,0.623978654,6746,144,3,3
41896,2014/03/31,2011/04/20,154,3,0.4465814320000001,9425,154,1,2
41897,2014/03/31,2009/06/17,9,6,0.535895085,7854,9,4,2
41898,2014/03/31,2011/09/11,553,5,0.748107003,5626,553,5,0
41899,2014/03/31,2006/12/10,94,11,0.8427272729999999,4994,94,4,7
41900,2014/03/31,2012/01/21,317,7,0.557142857,7553,317,6,1
41901,2014/03/31,2012/10/04,74,4,0.6967019870000001,6040,74,1,3
41902,2014/03/31,2012/11/27,21,2,1.455,2892,21,1,1
41903,2014/03/31,2013/03/06,312,5,0.320306076,13134,312,1,4
41904,2014/03/31,2008/05/13,274,3,0.915127257,4597,274,1,2
41905,2014/03/31,2010/04/19,621,2,0.812065637,5180,621,2,0
41906,2014/03/31,2012/06/09,399,5,1.0,4206,399,5,0
41907,2014/03/31,2009/11/01,213,6,0.709064239,5931,213,3,3
41908,2014/03/31,2011/03/27,231,3,0.870907208,4828,231,2,1
41909,2014/03/31,2008/05/29,124,5,0.6122877529999999,6867,124,3,2
41910,2014/03/31,2012/05/22,492,4,0.689262295,6100,492,4,0
41911,2014/03/31,2012/04/29,306,8,0.58952608,7132,306,7,1
41912,2014/03/31,2009/12/02,311,7,0.70055824,6001,311,4,3
41913,2014/03/31,2009/10/21,420,3,0.724711257,5801,420,3,0
41914,2014/03/31,2010/09/26,7,4,0.70563203,5957,7,0,4
41915,2014/03/31,2008/01/31,154,3,0.654707165,6420,154,1,2
41916,2014/03/31,2012/11/03,94,5,0.630443978,6667,94,1,4
41917,2014/03/31,2006/04/20,295,6,0.51846059,8107,295,5,1
41918,2014/03/31,2011/04/13,248,7,0.673464188,6241,248,2,5
41919,2014/03/31,2012/10/06,192,6,0.5159828120000001,8145,192,3,3
41920,2014/03/31,2012/06/27,77,5,0.761890863,5516,77,3,2
41921,2014/03/31,2012/04/06,112,6,0.744603118,5644,112,3,3
41922,2014/03/31,2010/02/08,478,4,0.796531463,5276,478,4,0
41923,2014/03/31,2008/04/18,8,5,0.617642563,6804,8,0,5
41924,2014/03/31,2011/03/29,227,5,0.712628455,5897,227,3,2
41925,2014/03/31,2006/04/12,554,4,0.774986165,5421,554,4,0
41926,2014/03/31,2012/08/27,583,2,0.497477499,8444,583,2,0
41927,2014/03/31,2012/04/11,509,5,0.626768129,6702,509,5,0
41928,2014/03/31,2012/11/12,300,7,0.622949726,6743,300,4,3
41929,2014/03/31,2012/12/17,305,4,0.77185226,5442,305,0,4
41930,2014/03/31,2011/01/15,379,5,0.7862223890000001,5342,379,5,0
41931,2014/03/31,2008/07/03,130,2,1.472946335,2851,130,0,2
41932,2014/03/31,2009/11/05,83,7,0.7,5999,83,4,3
41933,2014/03/31,2012/03/17,50,12,0.6033333329999999,6960,50,5,7
41934,2014/03/31,2008/10/09,238,6,0.5922679829999999,7090,238,2,4
41935,2014/03/31,2010/03/18,152,4,0.7477969720000001,5615,152,0,4
41936,2014/03/31,2011/01/15,23,3,0.570173819,7364,23,2,1
41937,2014/03/31,2013/01/28,117,6,0.619272861,6780,117,2,4
41938,2014/03/31,2012/09/21,146,4,0.529859919,7924,146,2,2
41939,2014/03/31,2012/12/26,23,5,0.670872483,6258,23,3,2
41940,2014/03/31,2008/05/21,609,5,0.818701248,5128,609,5,0
41941,2014/03/31,2010/02/24,199,3,0.5811906410000001,7223,199,0,3
41942,2014/03/31,2008/01/30,170,6,0.498256173,8424,170,2,4
41943,2014/03/31,2007/12/12,715,2,1.0,4196,715,2,0
41944,2014/03/31,2010/08/26,516,2,1.0,4196,516,2,0
41945,2014/03/31,2010/11/03,507,2,1.0,4196,507,2,0
41946,2014/03/31,2007/05/15,540,2,1.0,4196,540,2,0
41947,2014/03/31,2012/04/23,656,2,1.0,4196,656,2,0
41948,2014/03/31,2008/01/31,588,2,1.0,4196,588,2,0
41949,2014/03/31,2009/12/16,515,2,1.0,4196,515,2,0
41950,2014/03/31,2008/08/14,257,5,0.695118476,6035,257,4,1
41951,2014/03/31,2011/02/01,512,5,0.360108164,11649,512,5,0
41952,2014/03/31,2005/08/12,32,5,0.792232295,5295,32,1,4
41953,2014/03/31,2013/01/04,44,3,0.641762546,6536,44,1,2
41954,2014/03/31,2011/05/18,415,3,0.6942072159999999,6042,415,3,0
41955,2014/03/31,2012/05/28,222,3,0.7168415659999999,5851,222,1,2
41956,2014/03/31,2011/12/16,71,9,0.485367434,8641,71,5,4
41957,2014/03/31,2007/10/10,421,3,0.8,5242,421,3,0
41958,2014/03/31,2013/01/23,36,6,0.434193415,9658,36,4,2
41959,2014/03/31,2010/03/29,132,4,0.565983264,7409,132,0,4
41960,2014/03/31,2011/12/29,267,4,1.176140252,3565,267,2,2
41961,2014/03/31,2011/06/03,275,6,0.792312925,5292,275,4,2
41962,2014/03/31,2005/10/18,198,4,0.89763648,4671,198,2,2
41963,2014/03/31,2008/09/19,233,4,0.885867315,4733,233,3,1
41964,2014/03/31,2007/07/01,78,6,0.655141428,6399,78,5,1
41965,2014/03/31,2011/08/24,552,7,0.7767648690000001,5397,552,7,0
41966,2014/03/31,2005/06/26,281,4,0.6037154379999999,6944,281,3,1
41967,2014/03/31,2008/11/28,619,4,0.927638858,4519,619,4,0
41968,2014/03/31,2013/02/10,15,5,0.608633658,6887,15,1,4
41969,2014/03/31,2010/12/14,620,5,0.783018868,5353,620,5,0
41970,2014/03/31,2012/01/02,258,3,0.721794695,5806,258,1,2
41971,2014/03/31,2011/01/29,60,4,0.7980784609999999,5251,60,3,1
41972,2014/03/31,2013/03/04,120,3,0.663785839,6313,120,1,2
41973,2014/03/31,2013/03/23,308,5,0.574300987,7296,308,0,5
41974,2014/03/31,2012/06/28,18,6,0.577767512,7252,18,3,3
41975,2014/03/31,2012/10/20,71,5,0.641635528,6530,71,2,3
41976,2014/03/31,2007/06/24,681,4,0.544412682,7696,681,4,0
41977,2014/03/31,2013/01/01,9,4,0.489612014,8557,9,0,4
41978,2014/03/31,2006/05/05,174,2,0.75,5586,174,0,2
41979,2014/03/31,2007/07/25,387,2,0.75,5586,387,2,0
41980,2014/03/31,2008/05/13,18,6,0.457058695,9166,18,2,4
41981,2014/03/31,2011/06/14,256,3,0.743327418,5635,256,2,1
41982,2014/03/31,2011/07/26,83,6,0.666656056,6283,83,0,6
41983,2014/03/31,2008/09/21,285,8,0.606070033,6911,285,7,1
41984,2014/03/31,2013/03/21,26,6,0.849417968,4931,26,0,6
41985,2014/03/31,2010/05/27,42,2,0.71523224,5856,42,1,1
41986,2014/03/31,2006/08/15,526,4,0.786516432,5325,526,4,0
41987,2014/03/31,2007/11/22,104,5,0.5763638870000001,7266,104,0,5
41988,2014/03/31,2010/06/16,369,4,1.044748004,4008,369,4,0
41989,2014/03/31,2013/01/22,336,3,0.786938545,5321,336,1,2
41990,2014/03/31,2010/04/08,284,6,0.68050707,6153,284,1,5
41991,2014/03/31,2011/01/04,11,5,0.700428237,5978,11,4,1
41992,2014/03/31,2011/11/22,257,4,0.974382127,4297,257,3,1
41993,2014/03/31,2011/06/16,128,5,0.6181544370000001,6773,128,4,1
41994,2014/03/31,2007/10/09,8,5,0.873090719,4795,8,0,5
41995,2014/03/31,2012/05/18,126,7,0.42707887,9801,126,6,1
41996,2014/03/31,2008/04/03,198,5,0.7218954809999999,5798,198,3,2
41997,2014/03/31,2010/08/26,8,7,0.469994385,8905,8,3,4
41998,2014/03/31,2012/05/06,2,3,0.858322395,4876,2,1,2
41999,2014/03/31,2011/09/08,188,5,0.702919046,5954,188,3,2
42000,2014/03/31,2008/05/26,35,3,1.236001181,3386,35,0,3
42001,2014/03/31,2012/03/25,470,7,0.800028675,5231,470,7,0
42002,2014/03/31,2012/04/26,61,3,1.023333333,4089,61,2,1
42003,2014/03/31,2006/04/13,11,6,0.754869204,5543,11,5,1
42004,2014/03/31,2008/02/23,22,8,0.497279534,8414,22,1,7
42005,2014/03/31,2012/04/09,216,4,0.811297266,5157,216,3,1
42006,2014/03/31,2013/03/18,51,5,0.641196935,6525,51,1,4
42007,2014/03/31,2012/08/28,429,4,0.723090218,5786,429,4,0
42008,2014/03/31,2007/10/29,14,4,0.8580188679999999,4876,14,0,4
42009,2014/03/31,2006/03/12,233,4,0.989647504,4227,233,2,2
42010,2014/03/31,2011/03/30,242,5,0.926222321,4516,242,4,1
42011,2014/03/31,2012/05/26,156,3,0.600091822,6970,156,2,1
42012,2014/03/31,2012/11/20,15,3,0.813407235,5142,15,0,3
42013,2014/03/31,2008/09/12,373,4,0.595486259,7023,373,4,0
42014,2014/03/31,2008/07/11,37,5,0.784002625,5334,37,3,2
42015,2014/03/31,2012/10/28,93,2,0.8768211370000001,4769,93,1,1
42016,2014/03/31,2006/06/05,214,8,0.54409499,7685,214,6,2
42017,2014/03/31,2010/08/09,22,6,0.749324373,5580,22,2,4
42018,2014/03/31,2012/03/20,74,10,0.396796052,10537,74,3,7
42019,2014/03/31,2012/02/09,355,5,0.748692693,5584,355,4,1
42020,2014/03/31,2007/09/28,183,4,0.698511278,5985,183,2,2
42021,2014/03/31,2005/09/04,157,2,0.75,5574,157,0,2
42022,2014/03/31,2012/12/09,231,2,0.75,5574,231,0,2
42023,2014/03/31,2011/05/16,1,10,0.713387372,5860,1,0,10
42024,2014/03/31,2006/11/15,18,5,0.582220056,7180,18,0,5
42025,2014/03/31,2011/02/18,162,4,0.637113245,6561,162,0,4
42026,2014/03/31,2008/07/17,197,5,0.8072808029999999,5178,197,4,1
42027,2014/03/31,2012/07/17,66,2,1.25862692,3321,66,1,1
42028,2014/03/31,2006/07/14,69,5,0.860766063,4856,69,3,2
42029,2014/03/31,2007/10/22,479,5,0.86716805,4820,479,5,0
42030,2014/03/31,2012/07/18,619,2,0.9,4644,619,2,0
42031,2014/03/31,2012/10/23,525,2,0.9,4644,525,2,0
42032,2014/03/31,2012/12/11,118,9,0.443768316,9418,118,2,7
42033,2014/03/31,2006/04/16,265,4,0.930202537,4493,265,3,1
42034,2014/03/31,2008/04/12,265,3,0.980591272,4262,265,2,1
42035,2014/03/31,2012/01/12,512,3,1.148419896,3639,512,3,0
42036,2014/03/31,2007/05/10,433,3,0.7144896559999999,5849,433,3,0
42037,2014/03/31,2007/10/06,44,4,0.751561151,5560,44,0,4
42038,2014/03/31,2008/04/04,48,6,0.5886911810000001,7098,48,1,5
42039,2014/03/31,2012/04/25,366,4,0.7,5969,366,3,1
42040,2014/03/31,2005/09/05,193,3,0.7404111290000001,5643,193,1,2
42041,2014/03/31,2012/04/26,389,4,0.94205186,4435,389,4,0
42042,2014/03/31,2010/10/08,435,4,0.640736196,6520,435,4,0
42043,2014/03/31,2012/08/06,110,3,0.889586882,4696,110,2,1
42044,2014/03/31,2011/08/19,50,5,0.882816991,4732,50,0,5
42045,2014/03/31,2010/07/01,241,7,0.7376408259999999,5663,241,5,2
42046,2014/03/31,2012/12/17,67,10,0.468488111,8916,67,0,10
42047,2014/03/31,2009/03/12,69,3,0.714017094,5850,69,0,3
42048,2014/03/31,2012/08/05,412,3,0.7,5967,412,3,0
42049,2014/03/31,2011/09/19,147,4,0.909503484,4592,147,3,1
42050,2014/03/31,2011/08/09,154,3,0.940195858,4442,154,1,2
42051,2014/03/31,2009/03/07,536,4,1.163638897,3589,536,4,0
42052,2014/03/31,2011/12/28,120,7,0.73397188,5690,120,5,2
42053,2014/03/31,2012/09/07,13,4,0.662059616,6307,13,2,2
42054,2014/03/31,2005/09/01,109,7,0.5760173820000001,7249,109,2,5
42055,2014/03/31,2010/03/12,515,5,0.75274022,5547,515,5,0
42056,2014/03/31,2010/11/06,340,4,0.717970765,5815,340,3,1
42057,2014/03/31,2011/09/19,124,7,0.7818314609999999,5340,124,2,5
42058,2014/03/31,2013/03/19,142,7,0.586780042,7115,142,0,7
42059,2014/03/31,2012/09/17,559,3,1.187624467,3515,559,3,0
42060,2014/03/31,2012/07/10,601,2,1.323818585,3153,601,2,0
42061,2014/03/31,2010/08/03,166,10,0.67132379,6217,166,4,6
42062,2014/03/31,2012/09/01,130,4,1.04127994,4008,130,3,1
42063,2014/03/31,2012/10/31,223,4,0.5375,7764,223,2,2
42064,2014/03/31,2012/08/20,10,6,0.61340438,6803,10,3,3
42065,2014/03/31,2013/01/01,37,5,0.7371241829999999,5661,37,0,5
42066,2014/03/31,2005/03/22,307,6,0.494589309,8437,307,4,2
42067,2014/03/31,2010/01/16,152,6,0.792019742,5268,152,2,4
42068,2014/03/31,2012/01/05,187,8,0.794927591,5248,187,3,5
42069,2014/03/31,2010/07/07,371,4,0.573968079,7268,371,4,0
42070,2014/03/31,2009/12/20,167,7,0.899,4640,167,1,6
42071,2014/03/31,2005/12/23,39,6,0.4622941370000001,9023,39,2,4
42072,2014/03/31,2012/08/29,256,4,0.66018202,6318,256,2,2
42073,2014/03/31,2006/08/16,80,6,0.6835398229999999,6102,80,3,3
42074,2014/03/31,2008/11/07,62,7,0.786205467,5305,62,1,6
42075,2014/03/31,2010/03/06,18,6,0.6023440210000001,6924,18,3,3
42076,2014/03/31,2008/09/05,300,5,0.894,4665,300,4,1
42077,2014/03/31,2011/04/21,227,6,0.7815610940000001,5336,227,3,3
42078,2014/03/31,2008/04/11,220,4,0.747908895,5576,220,2,2
42079,2014/03/31,2009/12/07,202,5,0.7055151409999999,5911,202,4,1
42080,2014/03/31,2011/07/14,522,4,0.7731368190000001,5394,522,4,0
42081,2014/03/31,2007/02/19,98,3,0.706666667,5901,98,0,3
42082,2014/03/31,2005/10/21,101,5,0.709994892,5873,101,4,1
42083,2014/03/31,2007/10/09,114,3,0.485746738,8584,114,1,2
42084,2014/03/31,2012/06/28,57,8,0.5991592410000001,6958,57,5,3
42085,2014/03/31,2005/06/10,97,5,0.5544234610000001,7519,97,2,3
42086,2014/03/31,2011/03/27,513,7,0.529259777,7876,513,7,0
42087,2014/03/31,2011/08/11,15,5,0.6472406829999999,6440,15,4,1
42088,2014/03/31,2012/11/17,347,3,0.8885525470000001,4691,347,1,2
42089,2014/03/31,2009/08/23,482,4,0.768267281,5425,482,4,0
42090,2014/03/31,2008/11/25,6,2,0.906419404,4597,6,0,2
42091,2014/03/31,2010/01/02,338,5,0.670658297,6213,338,4,1
42092,2014/03/31,2008/09/30,159,4,0.5179637,8044,159,1,3
42093,2014/03/31,2008/12/08,176,2,0.8,5208,176,0,2
42094,2014/03/31,2013/01/01,196,5,0.488536585,8528,196,0,5
42095,2014/03/31,2010/03/30,93,2,0.58,7183,93,0,2
42096,2014/03/31,2005/11/09,43,2,0.58,7183,43,0,2
42097,2014/03/31,2012/09/03,47,5,0.583912251,7134,47,0,5
42098,2014/03/31,2012/07/04,269,8,0.586948006,7097,269,6,2
42099,2014/03/31,2011/12/18,47,4,0.37149291,11213,47,0,4
42100,2014/03/31,2010/10/31,18,5,0.707310239,5889,18,3,2
42101,2014/03/31,2007/04/28,34,3,0.695944862,5985,34,1,2
42102,2014/03/31,2011/07/01,488,4,0.7057184009999999,5902,488,4,0
42103,2014/03/31,2008/09/16,317,5,0.690271793,6034,317,4,1
42104,2014/03/31,2008/04/18,436,3,0.5052468760000001,8243,436,3,0
42105,2014/03/31,2013/03/19,90,6,0.7953314229999999,5235,90,2,4
42106,2014/03/31,2009/09/12,600,4,0.691069057,6024,600,4,0
42107,2014/03/31,2006/06/30,193,3,0.6863643859999999,6065,193,2,1
42108,2014/03/31,2012/10/11,417,3,0.6,6938,417,3,0
42109,2014/03/31,2012/10/14,170,4,0.908071553,4584,170,3,1
42110,2014/03/31,2005/08/16,219,9,0.534266461,7791,219,7,2
42111,2014/03/31,2009/08/26,139,6,0.781773103,5324,139,4,2
42112,2014/03/31,2010/06/12,89,7,0.707950332,5879,89,4,3
42113,2014/03/31,2011/05/27,119,5,0.721428324,5769,119,1,4
42114,2014/03/31,2011/05/25,670,3,0.9,4624,670,3,0
42115,2014/03/31,2012/12/25,10,4,0.785250047,5299,10,1,3
42116,2014/03/31,2010/01/29,653,2,1.0,4161,653,2,0
42117,2014/03/31,2007/02/05,214,2,0.589259312,7061,214,0,2
42118,2014/03/31,2012/12/08,97,6,0.683750205,6085,97,1,5
42119,2014/03/31,2013/01/03,123,6,0.596865136,6970,123,1,5
42120,2014/03/31,2006/03/23,264,6,0.70136402,5931,264,3,3
42121,2014/03/31,2011/09/21,170,5,0.7409636620000001,5614,170,4,1
42122,2014/03/31,2008/10/09,116,6,0.759853855,5474,116,4,2
42123,2014/03/31,2010/10/29,543,2,0.7,5942,543,2,0
42124,2014/03/31,2012/09/15,556,2,0.7,5942,556,2,0
42125,2014/03/31,2012/04/08,254,4,0.7107552970000001,5852,254,3,1
42126,2014/03/31,2008/07/09,629,3,0.716953973,5801,629,3,0
42127,2014/03/31,2012/05/30,12,6,0.7894760820000001,5268,12,3,3
42128,2014/03/31,2008/06/14,39,4,0.626406085,6639,39,0,4
42129,2014/03/31,2008/05/07,196,4,0.461148813,9018,196,2,2
42130,2014/03/31,2011/01/28,104,5,0.8765809440000001,4744,104,2,3
42131,2014/03/31,2008/01/22,398,4,0.669845361,6208,398,4,0
42132,2014/03/31,2012/09/23,93,4,0.837850091,4963,93,3,1
42133,2014/03/31,2012/07/18,144,6,0.75387126,5515,144,3,3
42134,2014/03/31,2005/07/29,6,7,0.6632929160000001,6268,6,0,7
42135,2014/03/31,2009/11/01,200,3,1.060558673,3920,200,2,1
42136,2014/03/31,2013/02/28,274,7,0.622041,6683,274,0,7
42137,2014/03/31,2012/09/23,276,5,0.644560397,6449,276,3,2
42138,2014/03/31,2006/01/16,525,4,0.832632212,4992,525,4,0
42139,2014/03/31,2005/06/23,319,4,0.585972085,7093,319,3,1
42140,2014/03/31,2012/11/17,112,7,0.530575769,7833,112,4,3
42141,2014/03/31,2011/03/19,50,7,0.6971850359999999,5961,50,4,3
42142,2014/03/31,2011/07/16,214,6,0.710309455,5849,214,5,1
42143,2014/03/31,2012/11/01,106,6,0.906449924,4583,106,1,5
42144,2014/03/31,2006/04/19,492,3,0.666666667,6231,492,3,0
42145,2014/03/31,2007/01/06,432,2,1.0,4154,432,2,0
42146,2014/03/31,2008/11/22,627,2,1.0,4154,627,2,0
42147,2014/03/31,2006/04/13,505,3,0.666666667,6231,505,3,0
42148,2014/03/31,2006/11/17,562,2,1.0,4154,562,2,0
42149,2014/03/31,2005/04/28,676,2,1.0,4154,676,2,0
42150,2014/03/31,2008/04/21,643,2,1.0,4154,643,2,0
42151,2014/03/31,2010/10/20,15,4,0.646578456,6424,15,2,2
42152,2014/03/31,2009/01/23,209,4,1.070773395,3879,209,1,3
42153,2014/03/31,2010/02/13,9,7,0.6041352729999999,6875,9,1,6
42154,2014/03/31,2010/12/07,286,7,0.770031522,5393,286,6,1
42155,2014/03/31,2011/08/08,443,4,0.90690107,4579,443,4,0
42156,2014/03/31,2008/01/26,208,12,0.7816076809999999,5312,208,5,7
42157,2014/03/31,2011/03/13,298,3,0.583478566,7115,298,0,3
42158,2014/03/31,2012/12/30,294,8,0.89625,4632,294,7,1
42159,2014/03/31,2012/01/09,13,3,0.791737555,5243,13,0,3
42160,2014/03/31,2006/04/28,564,3,0.843113955,4923,564,3,0
42161,2014/03/31,2012/11/17,118,6,0.683885319,6069,118,0,6
42162,2014/03/31,2011/06/02,307,5,0.634036053,6546,307,2,3
42163,2014/03/31,2005/09/01,100,3,0.703333333,5901,100,0,3
42164,2014/03/31,2013/01/19,197,4,0.537962147,7714,197,0,4
42165,2014/03/31,2010/08/13,5,6,0.945481887,4389,5,3,3
42166,2014/03/31,2011/01/16,105,6,0.601801305,6895,105,4,2
42167,2014/03/31,2012/09/22,231,2,0.7603133590000001,5457,231,1,1
42168,2014/03/31,2010/08/10,71,4,0.70652248,5872,71,0,4
42169,2014/03/31,2007/02/01,573,3,1.120008099,3704,573,3,0
42170,2014/03/31,2005/11/13,330,3,0.804752667,5155,330,1,2
42171,2014/03/31,2011/06/14,8,4,0.783617303,5294,8,1,3
42172,2014/03/31,2011/05/11,191,5,0.686923332,6039,191,2,3
42173,2014/03/31,2012/07/16,617,4,0.549430464,7550,617,4,0
42174,2014/03/31,2008/06/05,271,4,0.8494593490000001,4883,271,0,4
42175,2014/03/31,2011/10/14,576,5,0.7248514509999999,5722,576,5,0
42176,2014/03/31,2007/06/07,21,6,0.396175965,10468,21,0,6
42177,2014/03/31,2008/04/14,95,10,0.376252949,11022,95,2,8
42178,2014/03/31,2013/03/30,213,4,0.492834898,8413,213,2,2
42179,2014/03/31,2009/08/05,477,3,0.740375,5600,477,3,0
42180,2014/03/31,2013/01/15,226,2,0.67,6188,226,0,2
42181,2014/03/31,2007/04/08,644,5,0.738553358,5613,644,5,0
42182,2014/03/31,2010/02/18,11,5,0.663149896,6251,11,3,2
42183,2014/03/31,2008/05/10,239,6,0.664210864,6241,239,5,1
42184,2014/03/31,2007/05/16,68,3,0.7573757309999999,5472,68,1,2
42185,2014/03/31,2008/06/07,27,6,0.619934181,6685,27,3,3
42186,2014/03/31,2011/04/01,628,7,0.632887905,6548,628,7,0
42187,2014/03/31,2011/06/02,97,5,0.5887865870000001,7038,97,0,5
42188,2014/03/31,2010/12/07,47,20,0.686240477,6038,47,11,9
42189,2014/03/31,2007/11/07,372,5,0.588202726,7044,372,5,0
42190,2014/03/31,2012/04/16,203,9,0.794325153,5216,203,8,1
42191,2014/03/31,2009/07/31,135,5,0.833789495,4969,135,2,3
42192,2014/03/31,2012/06/01,164,5,0.7895997709999999,5247,164,2,3
42193,2014/03/31,2012/04/13,185,3,0.36,11508,185,2,1
42194,2014/03/31,2012/08/07,73,6,0.653032787,6344,73,0,6
42195,2014/03/31,2011/01/24,269,4,0.570085317,7267,269,0,4
42196,2014/03/31,2005/11/01,158,4,0.747929229,5539,158,0,4
42197,2014/03/31,2010/11/11,497,5,0.770600818,5376,497,5,0
42198,2014/03/31,2012/04/21,278,6,0.74,5598,278,3,3
42199,2014/03/31,2012/04/16,140,5,0.631397866,6560,140,1,4
42200,2014/03/31,2007/04/24,545,3,0.5166666670000001,8016,545,3,0
42201,2014/03/31,2013/03/13,333,6,0.697633086,5936,333,2,4
42202,2014/03/31,2008/10/14,305,7,0.624178475,6634,305,5,2
42203,2014/03/31,2013/01/24,139,5,0.537550305,7703,139,0,5
42204,2014/03/31,2012/10/16,390,3,0.719112539,5758,390,3,0
42205,2014/03/31,2005/03/27,390,4,0.723200559,5724,390,4,0
42206,2014/03/31,2012/12/11,65,5,0.634586847,6523,65,0,5
42207,2014/03/31,2012/08/20,95,7,0.568228995,7284,95,2,5
42208,2014/03/31,2008/07/22,582,5,0.7203829420000001,5745,582,5,0
42209,2014/03/31,2011/10/24,99,3,0.947892808,4366,99,2,1
42210,2014/03/31,2013/02/12,140,4,0.489739645,8450,140,2,2
42211,2014/03/31,2013/01/22,429,4,0.647535211,6390,429,4,0
42212,2014/03/31,2005/11/21,20,8,0.778457197,5315,20,0,8
42213,2014/03/31,2012/11/06,128,6,0.422458899,9793,128,2,4
42214,2014/03/31,2007/05/18,24,3,0.671278598,6163,24,0,3
42215,2014/03/31,2012/01/05,151,4,0.781746032,5292,151,2,2
42216,2014/03/31,2012/06/25,636,2,0.75,5516,636,2,0
42217,2014/03/31,2012/08/09,599,2,0.75,5516,599,2,0
42218,2014/03/31,2006/12/14,576,2,0.75,5516,576,2,0
42219,2014/03/31,2012/02/27,327,5,0.8751639520000001,4727,327,4,1
42220,2014/03/31,2012/09/21,387,3,0.689926618,5996,387,3,0
42221,2014/03/31,2009/03/25,40,4,0.518470795,7978,40,3,1
42222,2014/03/31,2013/03/05,34,3,0.35,11817,34,1,2
42223,2014/03/31,2009/11/04,217,2,0.8173814229999999,5060,217,0,2
42224,2014/03/31,2012/07/09,98,4,0.761402798,5432,98,2,2
42225,2014/03/31,2008/09/02,184,5,0.902627674,4582,184,2,3
42226,2014/03/31,2006/05/25,64,2,0.8639669940000001,4787,64,0,2
42227,2014/03/31,2007/08/03,288,6,0.703333333,5880,288,3,3
42228,2014/03/31,2011/11/23,238,5,0.94355008,4383,238,3,2
42229,2014/03/31,2008/03/16,9,7,0.655746908,6306,9,0,7
42230,2014/03/31,2005/11/23,31,5,0.611432796,6763,31,1,4
42231,2014/03/31,2011/09/14,315,6,0.398592635,10374,315,4,2
42232,2014/03/31,2009/09/27,85,5,0.7678588670000001,5385,85,2,3
42233,2014/03/31,2005/12/28,575,4,0.7614364640000001,5430,575,4,0
42234,2014/03/31,2005/05/19,145,3,1.023162584,4041,145,2,1
42235,2014/03/31,2007/05/19,185,3,0.7887428459999999,5242,185,1,2
42236,2014/03/31,2008/07/21,161,6,1.033366658,4001,161,5,1
42237,2014/03/31,2010/09/07,41,4,0.710109928,5822,41,1,3
42238,2014/03/31,2013/03/21,239,6,0.718736092,5752,239,1,5
42239,2014/03/31,2010/05/24,144,4,0.770962327,5362,144,3,1
42240,2014/03/31,2007/06/27,13,3,0.7524390240000001,5494,13,1,2
42241,2014/03/31,2012/05/08,288,4,0.730600919,5658,288,3,1
42242,2014/03/31,2012/10/10,391,5,0.8028160809999999,5149,391,5,0
42243,2014/03/31,2006/11/15,115,3,0.815776594,5067,115,0,3
42244,2014/03/31,2010/07/08,92,3,0.663333333,6231,92,1,2
42245,2014/03/31,2008/01/13,87,4,0.698059449,5921,87,2,2
42246,2014/03/31,2006/07/21,172,6,0.580234452,7123,172,4,2
42247,2014/03/31,2010/12/24,12,22,0.728311597,5674,12,11,11
42248,2014/03/31,2011/05/19,267,5,0.731907545,5646,267,4,1
42249,2014/03/31,2010/03/02,76,8,0.494703065,8352,76,0,8
42250,2014/03/31,2007/10/30,543,3,0.8689945309999999,4754,543,3,0
42251,2014/03/31,2009/08/07,419,5,0.55862069,7395,419,5,0
42252,2014/03/31,2013/03/17,254,5,0.818,5050,254,0,5
42253,2014/03/31,2008/06/14,2,6,0.582296307,7094,2,3,3
42254,2014/03/31,2004/12/24,306,3,0.7,5901,306,2,1
42255,2014/03/31,2013/02/11,395,3,0.7,5901,395,3,0
42256,2014/03/31,2009/01/13,85,4,0.737345591,5602,85,1,3
42257,2014/03/31,2008/03/02,167,7,0.6226775210000001,6633,167,2,5
42258,2014/03/31,2012/05/21,72,10,0.59877483,6897,72,7,3
42259,2014/03/31,2012/02/15,140,3,0.463333333,8913,140,1,2
42260,2014/03/31,2005/11/13,242,2,0.71308755,5791,242,0,2
42261,2014/03/31,2009/10/01,26,11,0.624232804,6615,26,5,6
42262,2014/03/31,2004/11/10,532,4,0.618506591,6676,532,4,0
42263,2014/03/31,2012/09/30,50,3,0.927219852,4453,50,2,1
42264,2014/03/31,2010/11/17,57,3,0.738170928,5593,57,0,3
42265,2014/03/31,2007/10/20,246,6,0.743034557,5556,246,5,1
42266,2014/03/31,2011/12/30,51,2,0.882617062,4677,51,1,1
42267,2014/03/31,2011/10/24,354,2,1.5,2752,354,0,2
42268,2014/03/31,2011/10/05,25,9,0.70997248,5814,25,2,7
42269,2014/03/31,2012/09/05,422,3,0.787428462,5242,422,3,0
42270,2014/03/31,2007/03/27,146,6,0.6721429729999999,6141,146,0,6
42271,2014/03/31,2005/01/29,28,7,0.5166821079999999,7987,28,2,5
42272,2014/03/31,2010/08/23,271,5,0.50683577,8141,271,3,2
42273,2014/03/31,2008/01/19,179,3,0.62,6654,179,1,2
42274,2014/03/31,2010/04/08,657,4,0.6782801709999999,6082,657,4,0
42275,2014/03/31,2007/07/01,11,5,0.625272093,6597,11,0,5
42276,2014/03/31,2012/07/26,207,3,0.90002182,4583,207,1,2
42277,2014/03/31,2012/01/30,236,8,0.481253209,8570,236,6,2
42278,2014/03/31,2011/09/30,143,5,0.703433396,5863,143,2,3
42279,2014/03/31,2011/03/20,137,6,0.566666667,7278,137,2,4
42280,2014/03/31,2010/01/09,151,5,0.809283752,5096,151,4,1
42281,2014/03/31,2012/07/23,214,6,0.736666667,5598,214,3,3
42282,2014/03/31,2008/05/15,75,3,0.847252928,4867,75,0,3
42283,2014/03/31,2011/12/01,176,2,0.565,7298,176,0,2
42284,2014/03/31,2008/02/05,306,6,0.428533569,9622,306,3,3
42285,2014/03/31,2012/06/20,227,4,0.571925371,7209,227,2,2
42286,2014/03/31,2007/07/19,667,6,0.575,7170,667,6,0
42287,2014/03/31,2012/04/10,354,7,0.522172261,7895,354,6,1
42288,2014/03/31,2008/04/14,150,4,0.851340355,4842,150,0,4
42289,2014/03/31,2008/05/01,199,4,0.472549582,8723,199,2,2
42290,2014/03/31,2009/07/16,55,3,0.673414475,6121,55,0,3
42291,2014/03/31,2008/11/01,113,4,0.665261459,6196,113,0,4
42292,2014/03/31,2012/07/03,392,6,0.550688043,7485,392,6,0
42293,2014/03/31,2010/11/05,235,3,0.943967018,4366,235,0,3
42294,2014/03/31,2008/07/11,260,5,0.730015943,5645,260,1,4
42295,2014/03/31,2011/04/23,427,2,0.725,5684,427,2,0
42296,2014/03/31,2008/03/13,31,2,0.725,5684,31,0,2
42297,2014/03/31,2010/07/22,650,2,0.725,5684,650,2,0
42298,2014/03/31,2008/04/10,106,3,0.805970266,5112,106,0,3
42299,2014/03/31,2013/01/23,270,5,0.694083558,5936,270,2,3
42300,2014/03/31,2005/07/08,69,8,0.548844924,7506,69,0,8
42301,2014/03/31,2008/12/14,675,2,0.8947654209999999,4604,675,2,0
42302,2014/03/31,2005/07/20,360,4,0.743117445,5543,360,3,1
42303,2014/03/31,2010/07/26,121,5,0.6353632579999999,6483,121,1,4
42304,2014/03/31,2011/10/12,565,2,0.791658658,5203,565,2,0
42305,2014/03/31,2011/05/26,21,7,0.541663598,7604,21,2,5
42306,2014/03/31,2012/11/24,36,12,0.7911256240000001,5206,36,0,12
42307,2014/03/31,2008/01/13,90,2,1.304164028,3158,90,1,1
42308,2014/03/31,2006/07/22,34,4,0.840945477,4897,34,2,2
42309,2014/03/31,2012/10/09,270,3,0.684919315,6011,270,1,2
42310,2014/03/31,2008/12/13,112,4,0.526341432,7820,112,2,2
42311,2014/03/31,2005/10/17,104,6,0.6258987229999999,6576,104,5,1
42312,2014/03/31,2011/10/30,320,6,0.533756971,7711,320,5,1
42313,2014/03/31,2008/04/05,614,5,0.825295769,4987,614,5,0
42314,2014/03/31,2012/12/26,174,4,0.763506494,5390,174,2,2
42315,2014/03/31,2005/04/16,657,3,0.6645994829999999,6192,657,3,0
42316,2014/03/31,2011/10/13,230,4,0.964142455,4268,230,1,3
42317,2014/03/31,2010/02/20,44,2,0.77,5344,44,0,2
42318,2014/03/31,2011/12/01,5,4,0.8208398159999999,5013,5,1,3
42319,2014/03/31,2006/09/06,181,5,0.839714286,4900,181,3,2
42320,2014/03/31,2006/03/20,41,5,0.628070524,6551,41,3,2
42321,2014/03/31,2009/01/09,216,4,0.784758726,5243,216,2,2
42322,2014/03/31,2008/06/04,13,6,0.622205082,6612,13,0,6
42323,2014/03/31,2007/04/07,282,7,0.46680472,8813,282,6,1
42324,2014/03/31,2009/04/19,43,3,0.937279563,4389,43,1,2
42325,2014/03/31,2007/11/26,14,3,0.681954576,6032,14,1,2
42326,2014/03/31,2008/09/07,52,14,0.652857143,6300,52,5,9
42327,2014/03/31,2010/03/23,136,7,0.64646652,6362,136,3,4
42328,2014/03/31,2010/05/21,456,5,0.882743078,4659,456,5,0
42329,2014/03/31,2013/02/17,226,2,0.67,6138,226,0,2
42330,2014/03/31,2007/12/16,132,5,0.717049695,5735,132,3,2
42331,2014/03/31,2011/08/16,516,5,0.607676962,6767,516,5,0
42332,2014/03/31,2009/10/07,558,2,1.21714032,3378,558,2,0
42333,2014/03/31,2010/01/05,568,5,0.603892479,6808,568,5,0
42334,2014/03/31,2012/07/27,26,6,0.793671815,5180,26,5,1
42335,2014/03/31,2012/10/30,375,4,0.7464052290000001,5508,375,4,0
42336,2014/03/31,2013/03/07,364,8,0.8875,4632,364,7,1
42337,2014/03/31,2007/09/20,84,6,0.581085666,7074,84,3,3
42338,2014/03/31,2013/03/15,96,3,0.4595315820000001,8945,96,1,2
42339,2014/03/31,2012/09/19,28,5,0.492767054,8341,28,0,5
42340,2014/03/31,2011/11/23,509,2,0.6,6850,509,2,0
42341,2014/03/31,2012/04/27,44,2,0.885,4644,44,1,1
42342,2014/03/31,2009/11/20,418,7,0.815093217,5042,418,7,0
42343,2014/03/31,2011/10/28,360,5,0.5802880539999999,7082,360,3,2
42344,2014/03/31,2012/09/26,230,3,0.832146618,4938,230,0,3
42345,2014/03/31,2009/11/21,84,11,0.521979167,7872,84,3,8
42346,2014/03/31,2012/12/02,3,6,0.5491939579999999,7481,3,1,5
42347,2014/03/31,2008/10/23,690,2,1.134576084,3621,690,2,0
42348,2014/03/31,2012/09/12,510,3,0.7333333329999999,5601,510,3,0
42349,2014/03/31,2012/01/18,55,2,0.650665399,6312,55,0,2
42350,2014/03/31,2008/09/15,44,6,0.34163297600000003,12021,44,0,6
42351,2014/03/31,2012/09/23,61,5,0.6967102140000001,5894,61,1,4
42352,2014/03/31,2006/11/18,439,7,0.8556574290000001,4799,439,7,0
42353,2014/03/31,2008/02/27,340,2,0.6148846960000001,6678,340,0,2
42354,2014/03/31,2009/01/09,16,9,0.554881081,7400,16,1,8
42355,2014/03/31,2012/08/18,568,3,0.753920308,5446,568,3,0
42356,2014/03/31,2010/10/10,4,8,0.63547748,6461,4,0,8
42357,2014/03/31,2010/07/12,702,2,0.875,4692,702,2,0
42358,2014/03/31,2006/08/15,284,3,0.82619038,4969,284,0,3
42359,2014/03/31,2011/02/16,340,6,0.717074236,5725,340,3,3
42360,2014/03/31,2012/09/05,203,3,0.904382022,4539,203,2,1
42361,2014/03/31,2008/09/05,139,5,0.596357693,6883,139,0,5
42362,2014/03/31,2009/12/19,37,3,0.870540827,4715,37,1,2
42363,2014/03/31,2011/06/14,304,6,0.6458457910000001,6355,304,5,1
42364,2014/03/31,2013/01/24,221,5,0.862420677,4759,221,2,3
42365,2014/03/31,2012/10/05,88,8,0.8012670829999999,5122,88,3,5
42366,2014/03/31,2012/12/22,263,3,0.807864173,5080,263,1,2
42367,2014/03/31,2010/07/05,38,3,0.867665468,4729,38,2,1
42368,2014/03/31,2007/07/14,258,2,1.45388377,2822,258,1,1
42369,2014/03/31,2012/12/01,87,7,0.812857143,5047,87,1,6
42370,2014/03/31,2011/06/10,362,5,0.734915801,5582,362,4,1
42371,2014/03/31,2012/08/22,554,3,0.8873458790000001,4623,554,3,0
42372,2014/03/31,2012/11/25,218,6,0.511221336,8024,218,3,3
42373,2014/03/31,2012/12/16,217,5,0.72511225,5657,217,0,5
42374,2014/03/31,2012/12/21,89,4,0.494841356,8289,89,0,4
42375,2014/03/31,2008/09/23,392,3,0.5195971620000001,7894,392,3,0
42376,2014/03/31,2012/11/10,123,5,0.523773464,7831,123,4,1
42377,2014/03/31,2011/09/15,347,4,0.7875,5208,347,3,1
42378,2014/03/31,2013/01/01,6,7,0.58,7070,6,1,6
42379,2014/03/31,2012/07/26,397,4,0.7375,5560,397,4,0
42380,2014/03/31,2011/03/19,44,5,0.536908472,7637,44,3,2
42381,2014/03/31,2006/09/24,34,4,0.568609069,7211,34,3,1
42382,2014/03/31,2007/05/09,228,6,0.5409168870000001,7580,228,3,3
42383,2014/03/31,2011/05/28,250,10,0.625,6560,250,9,1
42384,2014/03/31,2013/03/12,47,5,0.411921029,9953,47,0,5
42385,2014/03/31,2011/10/30,18,5,0.562433804,7289,18,0,5
42386,2014/03/31,2010/02/25,107,6,0.647427353,6332,107,0,6
42387,2014/03/31,2011/07/09,170,2,0.826951785,4957,170,1,1
42388,2014/03/31,2005/02/01,445,3,0.7,5856,445,3,0
42389,2014/03/31,2012/06/20,487,3,0.7,5856,487,3,0
42390,2014/03/31,2010/12/27,187,4,0.937383947,4373,187,0,4
42391,2014/03/31,2011/03/03,4,8,0.832131547,4926,4,2,6
42392,2014/03/31,2012/04/27,657,4,0.667741935,6138,657,4,0
42393,2014/03/31,2010/11/02,174,5,0.8059999999999999,5085,174,4,1
42394,2014/03/31,2011/08/04,340,5,0.7155202509999999,5728,340,4,1
42395,2014/03/31,2013/03/19,4,9,0.750140948,5463,4,2,7
42396,2014/03/31,2012/09/19,527,6,0.707518992,5792,527,6,0
42397,2014/03/31,2008/11/13,91,5,0.5856424179999999,6997,91,1,4
42398,2014/03/31,2010/05/25,226,3,0.8694799409999999,4711,226,1,2
42399,2014/03/31,2012/04/04,111,4,0.5779638779999999,7087,111,0,4
42400,2014/03/31,2012/11/28,123,8,0.502187347,8156,123,3,5
42401,2014/03/31,2010/09/29,409,4,0.548112955,7472,409,4,0
42402,2014/03/31,2012/11/02,65,6,0.654746603,6255,65,2,4
42403,2014/03/31,2009/01/15,27,4,0.7264715270000001,5637,27,2,2
42404,2014/03/31,2009/07/18,355,4,0.973377704,4207,355,3,1
42405,2014/03/31,2010/06/18,548,2,1.163540779,3519,548,2,0
42406,2014/03/31,2007/07/13,57,5,0.935237551,4378,57,2,3
42407,2014/03/31,2013/03/01,8,6,0.859269675,4765,8,0,6
42408,2014/03/31,2012/08/10,12,8,0.736486778,5559,12,3,5
42409,2014/03/31,2005/11/19,127,4,0.8139324059999999,5030,127,2,2
42410,2014/03/31,2012/04/21,697,4,0.625,6550,697,4,0
42411,2014/03/31,2013/02/21,45,3,0.7979766079999999,5130,45,0,3
42412,2014/03/31,2010/11/30,663,2,1.5,2729,663,2,0
42413,2014/03/31,2011/01/25,400,5,0.52179095,7845,400,5,0
42414,2014/03/31,2007/11/09,128,5,0.70486654,5807,128,1,4
42415,2014/03/31,2013/01/08,227,5,0.50058953,8176,227,1,4
42416,2014/03/31,2012/09/14,485,4,0.796419537,5139,485,4,0
42417,2014/03/31,2012/08/30,323,2,0.902226631,4536,323,1,1
42418,2014/03/31,2009/10/20,378,4,0.6247709920000001,6550,378,4,0
42419,2014/03/31,2006/06/02,82,4,0.793361768,5158,82,0,4
42420,2014/03/31,2009/02/11,80,2,0.62,6600,80,0,2
42421,2014/03/31,2012/06/19,646,4,1.20993495,3382,646,4,0
42422,2014/03/31,2012/01/19,112,8,0.656521181,6232,112,5,3
42423,2014/03/31,2007/09/15,43,2,1.04,3934,43,0,2
42424,2014/03/31,2011/01/14,289,4,0.7945445720000001,5149,289,0,4
42425,2014/03/31,2009/08/18,688,3,0.63298004,6463,688,3,0
42426,2014/03/31,2012/04/25,694,3,0.701879183,5827,694,3,0
42427,2014/03/31,2012/01/27,168,5,0.630437799,6487,168,2,3
42428,2014/03/31,2009/06/22,182,4,0.530208738,7713,182,2,2
42429,2014/03/31,2013/01/15,46,4,0.911596077,4486,46,1,3
42430,2014/03/31,2013/03/20,28,4,0.4123374,9917,28,0,4
42431,2014/03/31,2012/12/15,42,8,0.616198011,6636,42,4,4
42432,2014/03/31,2010/03/24,10,7,0.851001041,4805,10,3,4
42433,2014/03/31,2011/07/03,523,9,0.783333333,5220,523,9,0
42434,2014/03/31,2007/05/23,641,4,0.8,5111,641,4,0
42435,2014/03/31,2012/10/08,2,3,0.702784462,5818,2,1,2
42436,2014/03/31,2013/01/13,441,2,0.770126201,5309,441,2,0
42437,2014/03/31,2007/12/11,49,2,0.82,4986,49,0,2
42438,2014/03/31,2013/01/26,254,5,0.70649905,5787,254,2,3
42439,2014/03/31,2012/09/24,475,4,0.684594776,5972,475,4,0
42440,2014/03/31,2012/11/30,206,4,0.589868706,6931,206,1,3
42441,2014/03/31,2009/11/22,14,6,0.71673913,5704,14,1,5
42442,2014/03/31,2013/02/26,147,3,0.578002262,7073,147,1,2
42443,2014/03/31,2008/12/13,118,4,0.69800239,5857,118,2,2
42444,2014/03/31,2011/11/07,44,11,0.678181818,6028,44,4,7
42445,2014/03/31,2009/08/12,226,4,0.829545455,4928,226,3,1
42446,2014/03/31,2012/10/31,429,3,0.466666667,8760,429,3,0
42447,2014/03/31,2011/01/13,50,6,0.5963165570000001,6855,50,0,6
42448,2014/03/31,2011/12/18,591,5,0.712108014,5740,591,5,0
42449,2014/03/31,2011/01/01,443,8,0.587791199,6954,443,8,0
42450,2014/03/31,2010/06/30,92,4,0.769147535,5314,92,2,2
42451,2014/03/31,2005/07/03,501,7,0.671353482,6088,501,7,0
42452,2014/03/31,2011/01/19,292,6,0.6979098359999999,5856,292,4,2
42453,2014/03/31,2011/01/13,224,7,0.488571429,8365,224,3,4
42454,2014/03/31,2008/07/03,13,5,0.594,6880,13,0,5
42455,2014/03/31,2011/11/12,407,3,0.682781955,5985,407,3,0
42456,2014/03/31,2012/01/25,201,5,0.720808045,5668,201,2,3
42457,2014/03/31,2010/11/02,56,6,0.472258698,8651,56,4,2
42458,2014/03/31,2006/06/27,43,3,0.795747955,5134,43,1,2
42459,2014/03/31,2010/11/29,22,5,0.77770988,5253,22,0,5
42460,2014/03/31,2011/03/16,281,7,0.646759025,6316,281,6,1
42461,2014/03/31,2009/10/22,281,4,0.6693313670000001,6102,281,3,1
42462,2014/03/31,2010/12/22,265,5,0.585194154,6979,265,4,1
42463,2014/03/31,2007/03/30,11,5,0.658038995,6206,11,2,3
42464,2014/03/31,2008/03/10,147,6,0.628457512,6496,147,1,5
42465,2014/03/31,2008/07/26,622,4,0.721293515,5659,622,4,0
42466,2014/03/31,2006/05/29,42,2,0.880440035,4636,42,0,2
42467,2014/03/31,2011/01/05,235,8,0.632652302,6451,235,5,3
42468,2014/03/31,2008/06/08,48,7,0.571676705,7139,48,3,4
42469,2014/03/31,2013/01/19,78,3,0.687728345,5934,78,1,2
42470,2014/03/31,2011/09/13,24,4,0.73227705,5573,24,1,3
42471,2014/03/31,2012/11/27,142,6,0.538232656,7582,142,1,5
42472,2014/03/31,2006/07/26,121,4,0.557051195,7325,121,0,4
42473,2014/03/31,2012/01/26,4,6,0.86722848,4705,4,4,2
42474,2014/03/31,2012/11/05,253,7,0.635240542,6423,253,6,1
42475,2014/03/31,2009/12/06,553,5,0.79719617,5118,553,5,0
42476,2014/03/31,2011/09/01,308,3,0.816980376,4994,308,2,1
42477,2014/03/31,2009/03/10,263,4,0.7423216890000001,5496,263,3,1
42478,2014/03/31,2006/03/17,590,3,0.727478602,5608,590,3,0
42479,2014/03/31,2011/04/18,247,6,0.748691263,5448,247,4,2
42480,2014/03/31,2013/03/02,148,3,0.667122996,6114,148,0,3
42481,2014/03/31,2009/04/06,710,3,0.746067313,5467,710,3,0
42482,2014/03/31,2011/03/14,362,4,0.748641703,5448,362,3,1
42483,2014/03/31,2009/08/22,198,4,0.692632473,5888,198,1,3
42484,2014/03/31,2011/10/20,99,4,0.8755130959999999,4658,99,1,3
42485,2014/03/31,2010/02/02,678,3,0.666666667,6117,678,3,0
42486,2014/03/31,2007/05/09,322,4,0.86430691,4718,322,3,1
42487,2014/03/31,2012/07/23,266,4,0.634175739,6430,266,1,3
42488,2014/03/31,2012/12/03,4,4,0.705,5784,4,2,2
42489,2014/03/31,2012/04/01,241,3,0.94,4338,241,1,2
42490,2014/03/31,2012/06/03,35,6,0.49126506,8300,35,2,4
42491,2014/03/31,2010/12/16,219,4,0.4875,8364,219,2,2
42492,2014/03/31,2007/03/29,671,4,0.734056536,5554,671,4,0
42493,2014/03/31,2012/09/23,18,3,0.977886783,4169,18,0,3
42494,2014/03/31,2008/06/09,39,5,0.702355272,5804,39,2,3
42495,2014/03/31,2011/12/17,111,5,0.581520685,7010,111,4,1
42496,2014/03/31,2012/01/01,678,2,0.625,6522,678,2,0
42497,2014/03/31,2007/08/20,11,6,0.644524035,6324,11,1,5
42498,2014/03/31,2010/04/20,290,4,0.750080972,5434,290,3,1
42499,2014/03/31,2007/04/03,160,6,0.7025340459999999,5801,160,5,1
42500,2014/03/31,2009/10/13,480,3,0.687042657,5931,480,3,0
42501,2014/03/31,2009/12/29,99,4,0.80229179,5079,99,2,2
42502,2014/03/31,2011/12/21,193,4,0.596406616,6832,193,0,4
42503,2014/03/31,2012/12/03,165,3,1.266562014,3217,165,0,3
42504,2014/03/31,2012/04/14,262,4,0.6282022820000001,6486,262,3,1
42505,2014/03/31,2006/06/05,84,5,0.967911122,4208,84,4,1
42506,2014/03/31,2011/10/12,314,5,0.7737272040000001,5264,314,3,2
42507,2014/03/31,2005/07/10,152,2,0.871890387,4671,152,1,1
42508,2014/03/31,2010/02/08,15,7,0.653879255,6228,15,4,3
42509,2014/03/31,2011/05/07,216,14,0.501428571,8120,216,0,14
42510,2014/03/31,2007/03/18,330,9,0.594444444,6849,330,7,2
42511,2014/03/31,2011/11/29,162,5,0.697968455,5833,162,3,2
42512,2014/03/31,2012/11/08,504,3,0.45,9047,504,3,0
42513,2014/03/31,2011/08/20,90,9,0.529336801,7690,90,3,6
42514,2014/03/31,2012/01/08,212,2,0.77,5286,212,0,2
42515,2014/03/31,2009/07/02,56,4,0.8364611590000001,4866,56,2,2
42516,2014/03/31,2009/12/04,209,2,0.77,5286,209,0,2
42517,2014/03/31,2009/01/17,186,2,0.77,5286,186,0,2
42518,2014/03/31,2010/12/10,242,2,0.77,5286,242,0,2
42519,2014/03/31,2012/06/25,237,6,0.617780814,6588,237,2,4
42520,2014/03/31,2009/11/12,264,5,0.7335652490000001,5548,264,4,1
42521,2014/03/31,2008/03/31,160,5,0.721617308,5639,160,1,4
42522,2014/03/31,2011/09/30,296,4,0.5508230679999999,7387,296,2,2
42523,2014/03/31,2011/12/24,61,7,0.422839327,9622,61,5,2
42524,2014/03/31,2010/01/13,480,7,0.664236735,6125,480,7,0
42525,2014/03/31,2011/06/20,21,9,0.433995093,9374,21,6,3
42526,2014/03/31,2007/05/27,208,3,0.92,4422,208,0,3
42527,2014/03/31,2011/04/12,153,8,0.7046804090000001,5773,153,7,1
42528,2014/03/31,2009/02/08,64,3,0.509551547,7983,64,2,1
42529,2014/03/31,2005/05/24,172,3,0.924226312,4401,172,1,2
42530,2014/03/31,2012/12/08,32,5,0.7979615459999999,5097,32,1,4
42531,2014/03/31,2010/07/24,97,3,0.6630551029999999,6134,97,1,2
42532,2014/03/31,2010/09/06,31,6,0.493333333,8244,31,1,5
42533,2014/03/31,2009/10/09,166,6,0.832978288,4882,166,5,1
42534,2014/03/31,2005/11/27,75,4,0.927586679,4384,75,1,3
42535,2014/03/31,2012/07/25,464,4,0.912999551,4454,464,4,0
42536,2014/03/31,2006/11/07,210,4,0.646027963,6294,210,1,3
42537,2014/03/31,2012/03/17,6,4,0.8626946740000001,4713,6,1,3
42538,2014/03/31,2007/12/14,139,6,0.5971214570000001,6809,139,3,3
42539,2014/03/31,2006/01/25,346,5,0.606549306,6703,346,4,1
42540,2014/03/31,2012/04/29,410,5,0.449474848,9045,410,5,0
42541,2014/03/31,2010/08/21,65,4,0.497854519,8166,65,3,1
42542,2014/03/31,2010/09/04,54,5,0.7680748159999999,5293,54,3,2
42543,2014/03/31,2010/04/01,604,5,0.940388619,4323,604,5,0
42544,2014/03/31,2010/07/12,450,2,1.025,3966,450,2,0
42545,2014/03/31,2012/12/11,472,2,0.75,5420,472,2,0
42546,2014/03/31,2012/10/26,273,3,0.8634154629999999,4708,273,1,2
42547,2014/03/31,2011/02/01,383,4,0.584457225,6955,383,4,0
42548,2014/03/31,2011/09/13,428,3,0.650167946,6252,428,3,0
42549,2014/03/31,2005/06/16,326,10,0.34908966,11644,326,8,2
42550,2014/03/31,2009/11/03,15,3,0.432917244,9389,15,2,1
42551,2014/03/31,2011/02/04,48,7,0.6777505420000001,5997,48,3,4
42552,2014/03/31,2011/01/20,636,6,0.679257897,5983,636,6,0
42553,2014/03/31,2007/10/07,367,5,0.796394278,5103,367,5,0
42554,2014/03/31,2012/11/18,496,2,0.875,4644,496,2,0
42555,2014/03/31,2012/11/18,496,2,0.875,4644,496,2,0
42556,2014/03/31,2011/09/16,390,3,0.767983368,5291,390,3,0
42557,2014/03/31,2012/07/09,39,3,0.936666667,4338,39,1,2
42558,2014/03/31,2008/03/01,299,6,0.982398453,4136,299,5,1
42559,2014/03/31,2011/01/04,290,4,0.503921617,8063,290,2,2
42560,2014/03/31,2011/10/13,124,7,0.52224865,7778,124,4,3
42561,2014/03/31,2012/12/26,444,3,0.373583517,10872,444,3,0
42562,2014/03/31,2008/06/13,26,4,0.825997559,4917,26,1,3
42563,2014/03/31,2011/08/29,481,3,0.761627907,5332,481,3,0
42564,2014/03/31,2012/01/16,260,3,0.8152901020000001,4981,260,2,1
42565,2014/03/31,2008/11/29,141,5,0.591174843,6869,141,3,2
42566,2014/03/31,2011/11/24,415,3,0.8732043009999999,4650,415,3,0
42567,2014/03/31,2012/08/10,254,4,0.892120413,4551,254,2,2
42568,2014/03/31,2009/09/17,648,4,0.725,5600,648,4,0
42569,2014/03/31,2010/10/16,677,7,1.0,4060,677,7,0
42570,2014/03/31,2007/08/01,231,6,0.6108907610000001,6646,231,3,3
42571,2014/03/31,2013/01/30,231,3,0.81883219,4958,231,1,2
42572,2014/03/31,2012/01/06,40,6,0.7283333329999999,5574,40,2,4
42573,2014/03/31,2009/07/07,617,4,0.558711808,7266,617,4,0
42574,2014/03/31,2011/06/26,4,3,0.885751691,4583,4,0,3
42575,2014/03/31,2013/03/29,130,3,0.855311842,4746,130,0,3
42576,2014/03/31,2005/12/28,20,4,0.8559278790000001,4742,20,0,4
42577,2014/03/31,2007/12/21,579,4,0.6524517679999999,6220,579,4,0
42578,2014/03/31,2005/03/30,440,4,0.5499525679999999,7379,440,4,0
42579,2014/03/31,2012/03/21,111,9,0.585955235,6925,111,4,5
42580,2014/03/31,2010/09/02,288,3,0.453333333,8949,288,1,2
42581,2014/03/31,2008/07/10,152,3,0.54556213,7436,152,2,1
42582,2014/03/31,2007/05/11,326,3,0.839354438,4833,326,2,1
42583,2014/03/31,2010/07/23,383,3,0.657791471,6167,383,3,0
42584,2014/03/31,2007/10/11,121,7,0.892857143,4543,121,2,5
42585,2014/03/31,2008/08/25,414,4,0.499599704,8119,414,4,0
42586,2014/03/31,2012/11/04,483,3,1.0,4056,483,3,0
42587,2014/03/31,2008/08/12,511,3,1.209662988,3353,511,3,0
42588,2014/03/31,2008/11/26,298,4,0.535081794,7580,298,2,2
42589,2014/03/31,2012/11/23,334,7,0.586444477,6916,334,6,1
42590,2014/03/31,2009/01/24,22,10,0.963608933,4209,22,8,2
42591,2014/03/31,2013/03/08,136,5,0.830427928,4884,136,2,3
42592,2014/03/31,2010/04/09,40,5,0.764230262,5307,40,1,4
42593,2014/03/31,2011/04/08,44,5,0.8945213940000001,4534,44,3,2
42594,2014/03/31,2010/04/12,112,5,0.628586485,6452,112,4,1
42595,2014/03/31,2011/09/25,45,4,0.90002885,4506,45,0,4
42596,2014/03/31,2007/02/27,231,3,0.981927361,4130,231,2,1
42597,2014/03/31,2012/12/21,148,5,0.823070834,4927,148,2,3
42598,2014/03/31,2012/01/01,402,4,0.925,4384,402,4,0
42599,2014/03/31,2008/05/03,694,4,0.578459344,7010,694,4,0
42600,2014/03/31,2012/09/06,19,7,0.471383399,8602,19,2,5
42601,2014/03/31,2009/08/13,579,7,0.7686824640000001,5275,579,7,0
42602,2014/03/31,2011/05/04,186,8,0.43978308,9220,186,7,1
42603,2014/03/31,2012/04/08,69,4,0.677255721,5987,69,1,3
42604,2014/03/31,2012/04/20,704,2,0.65,6238,704,2,0
42605,2014/03/31,2012/01/22,621,2,0.65,6238,621,2,0
42606,2014/03/31,2008/03/08,421,2,0.65,6238,421,2,0
42607,2014/03/31,2012/04/13,380,3,0.433333333,9357,380,3,0
42608,2014/03/31,2012/08/14,441,2,0.65,6238,441,2,0
42609,2014/03/31,2005/08/07,67,3,0.6333333329999999,6402,67,0,3
42610,2014/03/31,2012/09/13,33,6,1.40439903,2887,33,3,3
42611,2014/03/31,2007/09/13,116,6,0.9151693,4430,116,0,6
42612,2014/03/31,2011/11/24,2,6,0.6794134409999999,5967,2,0,6
42613,2014/03/31,2011/01/06,120,3,0.955685997,4242,120,2,1
42614,2014/03/31,2012/01/15,181,3,0.655987055,6180,181,1,2
42615,2014/03/31,2007/08/07,120,6,0.5681850039999999,7135,120,0,6
42616,2014/03/31,2012/03/10,7,8,0.794230016,5104,7,5,3
42617,2014/03/31,2012/07/30,441,3,0.762394207,5317,441,3,0
42618,2014/03/31,2007/06/28,255,3,0.569091675,7123,255,1,2
42619,2014/03/31,2012/10/10,286,3,0.750444362,5401,286,1,2
42620,2014/03/31,2008/04/16,694,2,0.959039281,4226,694,2,0
42621,2014/03/31,2007/07/06,7,5,0.444922604,9109,7,0,5
42622,2014/03/31,2011/11/20,43,5,0.72809558,5566,43,2,3
42623,2014/03/31,2007/09/08,52,4,0.818965238,4948,52,2,2
42624,2014/03/31,2011/01/15,416,4,0.565784697,7162,416,4,0
42625,2014/03/31,2012/10/30,50,3,0.75411502,5373,50,2,1
42626,2014/03/31,2013/01/25,136,6,0.5328830720000001,7603,136,0,6
42627,2014/03/31,2012/03/15,168,3,0.544846692,7436,168,1,2
42628,2014/03/31,2008/11/08,246,2,0.843870027,4801,246,0,2
42629,2014/03/31,2008/11/19,327,5,0.604040555,6707,327,4,1
42630,2014/03/31,2008/04/07,6,2,0.7491068790000001,5408,6,0,2
42631,2014/03/31,2009/08/16,192,2,0.66,6138,192,0,2
42632,2014/03/31,2011/06/23,306,5,0.706980803,5730,306,3,2
42633,2014/03/31,2010/06/20,226,4,0.7875,5144,226,2,2
42634,2014/03/31,2012/11/09,132,6,0.726666667,5574,132,4,2
42635,2014/03/31,2013/02/23,360,3,0.65,6231,360,1,2
42636,2014/03/31,2008/12/31,341,6,0.589633081,6868,341,3,3
42637,2014/03/31,2011/04/04,537,6,0.909003143,4454,537,6,0
42638,2014/03/31,2011/03/24,81,6,0.8252181000000001,4906,81,5,1
42639,2014/03/31,2013/01/17,154,6,0.629039776,6436,154,1,5
42640,2014/03/31,2009/11/26,232,9,0.7755555559999999,5220,232,5,4
42641,2014/03/31,2011/10/25,444,3,0.8654125690000001,4678,444,3,0
42642,2014/03/31,2011/08/03,56,4,0.6892712409999999,5873,56,1,3
42643,2014/03/31,2006/10/09,115,8,0.5502161210000001,7357,115,2,6
42644,2014/03/31,2011/06/25,270,5,0.693138699,5840,270,2,3
42645,2014/03/31,2012/08/01,176,5,0.937665045,4317,176,1,4
42646,2014/03/31,2007/09/14,49,5,0.944864613,4284,49,1,4
42647,2014/03/31,2012/04/30,78,5,0.551209315,7343,78,2,3
42648,2014/03/31,2008/08/04,179,4,0.755915204,5354,179,2,2
42649,2014/03/31,2008/04/07,328,5,0.6963861640000001,5811,328,4,1
42650,2014/03/31,2011/06/24,137,8,0.5426716739999999,7456,137,0,8
42651,2014/03/31,2008/03/06,394,5,0.557957523,7251,394,5,0
42652,2014/03/31,2007/07/03,3,6,0.500513423,8083,3,3,3
42653,2014/03/31,2012/07/07,69,4,0.63084048,6413,69,2,2
42654,2014/03/31,2007/02/14,492,8,0.6428412520000001,6293,492,8,0
42655,2014/03/31,2011/02/08,14,8,0.57,7096,14,0,8
42656,2014/03/31,2008/09/28,11,3,0.73140868,5530,11,0,3
42657,2014/03/31,2012/08/13,70,8,0.443082822,9128,70,3,5
42658,2014/03/31,2007/11/18,332,7,0.628989114,6430,332,6,1
42659,2014/03/31,2008/04/22,359,3,0.716666667,5643,359,2,1
42660,2014/03/31,2012/11/30,249,3,0.716666667,5643,249,1,2
42661,2014/03/31,2013/03/01,51,4,1.130587084,3577,51,1,3
42662,2014/03/31,2009/10/25,226,4,0.861879795,4692,226,1,3
42663,2014/03/31,2012/04/20,708,4,0.435765086,9280,708,4,0
42664,2014/03/31,2005/04/18,603,4,0.7449521,5428,603,4,0
42665,2014/03/31,2012/11/13,367,3,0.6482125679999999,6238,367,3,0
42666,2014/03/31,2012/05/08,691,3,0.837101449,4830,691,3,0
42667,2014/03/31,2010/12/13,346,3,1.07045274,3777,346,1,2
42668,2014/03/31,2012/12/07,14,3,0.80088748,5048,14,0,3
42669,2014/03/31,2006/10/24,120,7,0.630391392,6413,120,2,5
42670,2014/03/31,2010/08/02,713,2,1.5,2695,713,2,0
42671,2014/03/31,2013/03/01,79,3,0.87421064,4624,79,0,3
42672,2014/03/31,2008/05/06,616,3,0.968887824,4172,616,3,0
42673,2014/03/31,2012/09/24,464,4,0.621685635,6502,464,4,0
42674,2014/03/31,2013/01/04,221,6,0.7445220109999999,5429,221,2,4
42675,2014/03/31,2011/05/15,70,3,0.596666667,6774,70,0,3
42676,2014/03/31,2011/01/14,5,6,0.543538193,7436,5,3,3
42677,2014/03/31,2012/09/19,198,2,0.841782962,4801,198,0,2
42678,2014/03/31,2011/09/16,96,4,0.570974852,7078,96,1,3
42679,2014/03/31,2008/04/12,75,4,0.845649718,4779,75,3,1
42680,2014/03/31,2008/08/21,89,4,0.556076785,7267,89,0,4
42681,2014/03/31,2006/09/30,361,7,0.46016399,8781,361,6,1
42682,2014/03/31,2006/12/01,11,6,0.839156802,4815,11,4,2
42683,2014/03/31,2009/10/09,25,6,0.727224622,5556,25,3,3
42684,2014/03/31,2013/03/13,225,6,0.787884878,5125,225,2,4
42685,2014/03/31,2008/12/28,286,4,0.689175627,5859,286,3,1
42686,2014/03/31,2010/10/28,533,3,0.719586526,5611,533,3,0
42687,2014/03/31,2012/09/28,145,4,0.967041916,4175,145,3,1
42688,2014/03/31,2009/09/23,238,4,0.736196207,5484,238,2,2
42689,2014/03/31,2009/11/08,2,6,0.702979279,5743,2,0,6
42690,2014/03/31,2008/07/03,228,8,0.89,4536,228,7,1
42691,2014/03/31,2012/05/17,137,3,0.586764535,6880,137,1,2
42692,2014/03/31,2008/10/10,73,7,0.5724705720000001,7051,73,3,4
42693,2014/03/31,2006/10/16,167,5,0.484387375,8333,167,4,1
42694,2014/03/31,2005/04/05,33,5,0.762878473,5291,33,4,1
42695,2014/03/31,2011/04/17,14,7,0.6833113259999999,5907,14,6,1
42696,2014/03/31,2009/10/14,311,7,0.656522446,6148,311,6,1
42697,2014/03/31,2011/03/21,31,6,0.688056597,5866,31,0,6
42698,2014/03/31,2012/02/12,571,4,1.0,4036,571,4,0
42699,2014/03/31,2007/05/03,264,4,0.772461715,5224,264,0,4
42700,2014/03/31,2011/02/01,458,5,0.7646769,5277,458,5,0
42701,2014/03/31,2012/12/19,94,3,0.731001993,5519,94,0,3
42702,2014/03/31,2008/06/28,347,9,0.848968855,4752,347,8,1
42703,2014/03/31,2008/01/26,603,3,0.843798369,4781,603,3,0
42704,2014/03/31,2010/03/12,124,5,0.605175518,6666,124,0,5
42705,2014/03/31,2013/01/21,273,5,0.63427673,6360,273,3,2
42706,2014/03/31,2011/07/09,284,9,0.51218131,7876,284,7,2
42707,2014/03/31,2013/01/03,250,4,1.45734104,2768,250,1,3
42708,2014/03/31,2008/07/03,125,4,0.8344600740000001,4834,125,0,4
42709,2014/03/31,2012/10/26,161,5,0.571020668,7064,161,2,3
42710,2014/03/31,2007/06/01,567,5,0.6538579999999999,6169,567,5,0
42711,2014/03/31,2008/03/15,114,4,0.6529965999999999,6177,114,3,1
42712,2014/03/31,2008/03/24,20,5,0.769437238,5242,20,0,5
42713,2014/03/31,2012/07/09,37,7,0.7928739929999999,5087,37,2,5
42714,2014/03/31,2011/01/12,353,4,0.79443569,5077,353,3,1
42715,2014/03/31,2012/05/02,84,8,0.399253613,10102,84,5,3
42716,2014/03/31,2011/12/30,108,9,0.705669291,5715,108,4,5
42717,2014/03/31,2005/09/17,289,4,0.595138725,6776,289,1,3
42718,2014/03/31,2010/06/03,37,7,0.656629213,6141,37,4,3
42719,2014/03/31,2012/04/05,127,5,0.412200981,9782,127,2,3
42720,2014/03/31,2010/05/13,297,3,0.81654921,4938,297,1,2
42721,2014/03/31,2009/01/12,68,6,0.500551279,8054,68,0,6
42722,2014/03/31,2013/03/18,121,4,0.704042962,5726,121,1,3
42723,2014/03/31,2010/11/23,488,3,0.668934617,6026,488,3,0
42724,2014/03/31,2012/07/05,492,2,0.813193464,4957,492,2,0
42725,2014/03/31,2011/04/22,196,5,0.84347353,4779,196,2,3
42726,2014/03/31,2011/09/02,244,5,0.955203791,4220,244,2,3
42727,2014/03/31,2013/01/21,236,2,1.478573001,2726,236,1,1
42728,2014/03/31,2009/12/09,173,3,1.44,2799,173,1,2
42729,2014/03/31,2006/02/14,20,6,0.614828375,6555,20,2,4
42730,2014/03/31,2006/10/12,239,5,0.770793803,5228,239,3,2
42731,2014/03/31,2012/03/19,261,7,0.506941754,7949,261,2,5
42732,2014/03/31,2010/01/07,247,6,0.6414517670000001,6282,247,3,3
42733,2014/03/31,2012/04/20,251,6,0.973333333,4140,251,1,5
42734,2014/03/31,2012/08/05,54,5,0.587389213,6860,54,0,5
42735,2014/03/31,2008/08/02,467,5,0.5294113779999999,7611,467,5,0
42736,2014/03/31,2010/01/03,163,4,0.292462074,13777,163,3,1
42737,2014/03/31,2012/11/03,344,5,0.7423806890000001,5427,344,2,3
42738,2014/03/31,2008/01/31,7,3,1.244569045,3237,7,2,1
42739,2014/03/31,2008/11/05,378,6,0.523807047,7691,378,6,0
42740,2014/03/31,2010/07/04,12,22,0.690768307,5831,12,3,19
42741,2014/03/31,2011/03/02,563,3,0.864705882,4658,563,3,0
42742,2014/03/31,2008/04/22,720,2,0.525,7672,720,2,0
42743,2014/03/31,2011/12/11,361,2,0.525,7672,361,1,1
42744,2014/03/31,2010/05/19,253,4,1.190195035,3384,253,0,4
42745,2014/03/31,2012/08/22,20,7,0.665029723,6056,20,1,6
42746,2014/03/31,2011/08/14,544,2,0.55,7322,544,2,0
42747,2014/03/31,2007/10/16,116,3,0.8593639270000001,4685,116,0,3
42748,2014/03/31,2010/06/21,202,3,0.881076822,4569,202,2,1
42749,2014/03/31,2010/11/19,457,3,0.566666667,7104,457,3,0
42750,2014/03/31,2012/06/05,353,5,0.736327053,5467,353,4,1
42751,2014/03/31,2013/01/26,70,5,0.73494979,5477,70,1,4
42752,2014/03/31,2008/04/10,67,7,0.5234109229999999,7690,67,3,4
42753,2014/03/31,2011/11/21,70,7,0.60844898,6615,70,1,6
42754,2014/03/31,2011/03/01,38,3,0.673475569,5976,38,0,3
42755,2014/03/31,2011/03/21,237,6,0.430754576,9343,237,4,2
42756,2014/03/31,2007/11/11,76,5,0.653295455,6160,76,2,3
42757,2014/03/31,2012/10/15,263,6,0.701097561,5740,263,5,1
42758,2014/03/31,2011/11/21,329,10,0.695,5790,329,9,1
42759,2014/03/31,2012/10/27,87,4,0.542534718,7417,87,3,1
42760,2014/03/31,2013/01/24,45,8,0.624822981,6440,45,0,8
42761,2014/03/31,2006/09/20,13,9,0.701852433,5733,13,5,4
42762,2014/03/31,2012/11/30,31,4,0.525989018,7649,31,2,2
42763,2014/03/31,2012/01/16,37,3,0.8359351620000001,4812,37,2,1
42764,2014/03/31,2011/04/02,435,3,0.671564535,5989,435,3,0
42765,2014/03/31,2010/06/25,1,6,0.599079398,6713,1,3,3
42766,2014/03/31,2008/03/12,297,3,0.586666667,6855,297,0,3
42767,2014/03/31,2012/12/05,18,11,0.7961829340000001,5051,18,5,6
42768,2014/03/31,2012/09/13,159,5,0.687042542,5853,159,2,3
42769,2014/03/31,2013/01/27,331,4,0.573623395,7010,331,3,1
42770,2014/03/31,2009/07/06,627,2,0.774609902,5191,627,2,0
42771,2014/03/31,2010/04/09,353,3,1.0,4021,353,2,1
42772,2014/03/31,2011/03/16,205,2,0.6727003509999999,5977,205,0,2
42773,2014/03/31,2007/05/01,120,6,0.588682284,6830,120,2,4
42774,2014/03/31,2011/03/04,443,2,1.0,4020,443,2,0
42775,2014/03/31,2011/09/15,420,5,0.628517824,6396,420,5,0
42776,2014/03/31,2010/02/20,399,2,1.0,4020,399,2,0
42777,2014/03/31,2011/11/13,132,3,0.828004119,4855,132,2,1
42778,2014/03/31,2008/03/18,214,4,0.8935007779999999,4499,214,2,2
42779,2014/03/31,2006/09/30,249,5,0.997691735,4029,249,0,5
42780,2014/03/31,2007/06/18,136,5,0.7703334609999999,5218,136,4,1
42781,2014/03/31,2012/09/05,201,3,0.823812257,4879,201,2,1
42782,2014/03/31,2012/12/10,4,5,0.536049613,7498,4,3,2
42783,2014/03/31,2012/06/06,43,4,0.7325428359999999,5486,43,1,3
42784,2014/03/31,2012/07/05,423,7,0.491193008,8181,423,7,0
42785,2014/03/31,2013/01/28,422,2,0.575,6988,422,2,0
42786,2014/03/31,2011/12/12,239,3,0.724931433,5542,239,0,3
42787,2014/03/31,2008/10/24,71,2,0.76,5286,71,0,2
42788,2014/03/31,2009/05/15,231,3,0.583486345,6884,231,0,3
42789,2014/03/31,2011/11/08,57,3,0.78009324,5148,57,2,1
42790,2014/03/31,2011/07/18,158,4,0.787514712,5098,158,2,2
42791,2014/03/31,2006/06/30,178,2,1.163239641,3451,178,1,1
42792,2014/03/31,2012/12/06,155,7,0.614841476,6529,155,3,4
42793,2014/03/31,2012/04/11,339,6,0.735712977,5456,339,5,1
42794,2014/03/31,2010/05/16,27,4,0.909782412,4412,27,0,4
42795,2014/03/31,2010/03/28,269,4,0.783027702,5126,269,3,1
42796,2014/03/31,2009/09/27,227,3,0.813987021,4931,227,0,3
42797,2014/03/31,2012/08/27,6,6,0.575845889,6969,6,2,4
42798,2014/03/31,2009/01/03,296,4,0.539006044,7445,296,2,2
42799,2014/03/31,2012/09/12,287,6,0.34,11802,287,2,4
42800,2014/03/31,2011/04/21,16,3,0.68,5901,16,0,3
42801,2014/03/31,2012/10/27,4,4,0.89193197,4498,4,1,3
42802,2014/03/31,2012/09/10,537,5,0.86,4665,537,5,0
42803,2014/03/31,2010/10/22,97,8,0.7940815520000001,5052,97,5,3
42804,2014/03/31,2011/12/07,178,5,0.654071417,6133,178,0,5
42805,2014/03/31,2013/01/22,281,2,0.96520693,4156,281,1,1
42806,2014/03/31,2008/01/09,715,4,0.968421053,4142,715,4,0
42807,2014/03/31,2013/03/31,288,5,0.545957534,7347,288,2,3
42808,2014/03/31,2012/06/19,647,2,0.675,5942,647,2,0
42809,2014/03/31,2010/01/27,2,2,0.74,5420,2,0,2
42810,2014/03/31,2013/02/03,88,4,0.9025,4444,88,1,3
42811,2014/03/31,2007/05/25,102,6,0.903708878,4438,102,2,4
42812,2014/03/31,2007/06/26,262,3,0.679036573,5906,262,1,2
42813,2014/03/31,2010/01/13,84,11,0.89575832,4477,84,5,6
42814,2014/03/31,2006/03/13,146,6,0.807579053,4965,146,4,2
42815,2014/03/31,2007/12/20,410,6,0.489214251,8196,410,6,0
42816,2014/03/31,2011/06/19,521,5,0.5629088870000001,7123,521,5,0
42817,2014/03/31,2010/11/16,170,4,0.528178106,7591,170,1,3
42818,2014/03/31,2012/12/10,258,6,0.7428701129999999,5397,258,3,3
42819,2014/03/31,2008/02/20,224,7,0.711835938,5632,224,3,4
42820,2014/03/31,2012/06/27,322,4,1.0,4009,322,3,1
42821,2014/03/31,2011/09/23,697,3,0.683779635,5863,697,3,0
42822,2014/03/31,2008/08/30,474,7,0.781776521,5128,474,7,0
42823,2014/03/31,2012/04/08,698,3,0.477032012,8403,698,3,0
42824,2014/03/31,2009/06/29,126,9,0.605684497,6618,126,6,3
42825,2014/03/31,2012/11/19,178,3,0.7333333329999999,5466,178,1,2
42826,2014/03/31,2007/09/21,73,3,0.945582822,4238,73,1,2
42827,2014/03/31,2012/12/05,353,6,0.740720887,5410,353,4,2
42828,2014/03/31,2007/07/21,3,6,0.63126339,6348,3,4,2
42829,2014/03/31,2008/10/21,189,2,0.705,5684,189,0,2
42830,2014/03/31,2006/02/20,126,4,0.602103681,6655,126,3,1
42831,2014/03/31,2009/02/14,536,3,0.724855282,5528,536,3,0
42832,2014/03/31,2006/04/18,135,3,0.8532410559999999,4696,135,1,2
42833,2014/03/31,2012/04/23,705,2,0.75,5342,705,2,0
42834,2014/03/31,2008/03/22,168,2,0.75,5342,168,0,2
42835,2014/03/31,2009/08/08,428,3,0.5,8013,428,3,0
42836,2014/03/31,2012/10/11,118,5,0.985349238,4066,118,1,4
42837,2014/03/31,2012/10/15,297,8,0.3825,10472,297,4,4
42838,2014/03/31,2011/07/07,77,7,0.513439303,7801,77,4,3
42839,2014/03/31,2011/07/12,397,5,0.492147948,8138,397,5,0
42840,2014/03/31,2012/08/14,17,5,0.610301737,6562,17,2,3
42841,2014/03/31,2010/09/23,480,5,0.648203302,6178,480,5,0
42842,2014/03/31,2010/04/20,186,6,0.797038217,5024,186,1,5
42843,2014/03/31,2012/03/09,14,6,0.5634829720000001,7106,14,2,4
42844,2014/03/31,2011/08/23,163,9,0.680618732,5883,163,4,5
42845,2014/03/31,2011/08/17,121,6,0.859038833,4661,121,3,3
42846,2014/03/31,2011/06/13,213,6,0.778611435,5142,213,1,5
42847,2014/03/31,2011/09/10,590,4,0.797212266,5022,590,4,0
42848,2014/03/31,2013/01/12,277,2,0.7719051290000001,5186,277,1,1
42849,2014/03/31,2007/11/27,26,6,0.6719825420000001,5957,26,5,1
42850,2014/03/31,2008/05/01,265,3,0.78152089,5122,265,1,2
42851,2014/03/31,2011/12/04,192,4,0.768486943,5208,192,1,3
42852,2014/03/31,2010/09/22,30,9,0.478621143,8362,30,3,6
42853,2014/03/31,2007/07/26,203,6,0.8251381440000001,4850,203,4,2
42854,2014/03/31,2009/02/11,667,3,0.7333333329999999,5457,667,3,0
42855,2014/03/31,2011/02/21,93,5,0.600591325,6663,93,0,5
42856,2014/03/31,2012/04/13,633,4,0.819643589,4882,633,4,0
42857,2014/03/31,2008/05/26,261,3,1.304642974,3067,261,1,2
42858,2014/03/31,2011/08/21,287,5,0.760829055,5259,287,1,4
42859,2014/03/31,2013/01/09,318,3,0.663295756,6032,318,2,1
42860,2014/03/31,2011/08/29,13,4,0.457881666,8738,13,1,3
42861,2014/03/31,2009/12/25,142,3,0.6266666670000001,6384,142,2,1
42862,2014/03/31,2007/02/22,299,6,0.662553826,6038,299,3,3
42863,2014/03/31,2008/04/02,14,7,0.59622093,6708,14,5,2
42864,2014/03/31,2010/11/21,166,6,0.714169643,5600,166,4,2
42865,2014/03/31,2008/12/26,502,5,0.632953466,6318,502,5,0
42866,2014/03/31,2011/02/05,303,3,0.713634416,5602,303,2,1
42867,2014/03/31,2012/12/05,116,6,0.516225465,7744,116,1,5
42868,2014/03/31,2011/07/31,308,4,0.584088252,6844,308,2,2
42869,2014/03/31,2007/05/26,10,7,0.584334162,6841,10,3,4
42870,2014/03/31,2005/08/12,216,5,0.597134319,6693,216,4,1
42871,2014/03/31,2010/01/03,136,3,0.776297591,5148,136,1,2
42872,2014/03/31,2011/11/14,116,5,0.683656116,5845,116,2,3
42873,2014/03/31,2012/06/26,600,4,0.567262919,7044,600,4,0
42874,2014/03/31,2007/06/26,62,4,0.587765519,6798,62,0,4
42875,2014/03/31,2009/12/04,634,5,0.842232293,4744,634,5,0
42876,2014/03/31,2005/09/19,145,6,0.5642042079999999,7081,145,3,3
42877,2014/03/31,2012/05/17,538,8,0.8625,4632,538,8,0
42878,2014/03/31,2013/02/14,232,3,0.61796875,6464,232,1,2
42879,2014/03/31,2013/01/20,84,6,0.659773666,6053,84,1,5
42880,2014/03/31,2011/11/23,112,3,0.7500995490000001,5324,112,0,3
42881,2014/03/31,2011/02/14,29,6,0.812159854,4917,29,1,5
42882,2014/03/31,2011/05/31,153,4,0.7676509029999999,5202,153,2,2
42883,2014/03/31,2012/12/23,3,4,0.5075,7868,3,1,3
42884,2014/03/31,2011/06/08,335,8,0.707316209,5645,335,7,1
42885,2014/03/31,2013/01/31,16,4,0.7550586229999999,5288,16,1,3
42886,2014/03/31,2006/08/19,298,7,0.473443614,8433,298,2,5
42887,2014/03/31,2012/07/26,11,5,0.771832947,5172,11,3,2
42888,2014/03/31,2013/03/06,47,6,0.632562599,6310,47,1,5
42889,2014/03/31,2007/04/03,489,7,0.8785714290000001,4543,489,7,0
42890,2014/03/31,2009/09/22,102,7,0.557448324,7160,102,5,2
42891,2014/03/31,2011/12/01,360,4,0.75,5320,360,3,1
42892,2014/03/31,2011/12/20,605,2,0.65,6138,605,2,0
42893,2014/03/31,2011/07/07,104,2,0.65,6138,104,0,2
42894,2014/03/31,2005/01/01,609,2,0.65,6138,609,2,0
42895,2014/03/31,2006/01/13,151,3,0.8038504940000001,4963,151,0,3
42896,2014/03/31,2012/01/21,420,4,0.5,7978,420,4,0
42897,2014/03/31,2010/04/13,115,6,0.608821734,6552,115,5,1
42898,2014/03/31,2008/03/11,192,3,0.8052089640000001,4953,192,1,2
42899,2014/03/31,2012/10/23,522,2,0.6,6647,522,2,0
42900,2014/03/31,2012/08/01,235,5,0.432671151,9217,235,2,3
42901,2014/03/31,2011/10/01,482,3,0.629403409,6336,482,3,0
42902,2014/03/31,2011/03/18,195,2,0.96,4154,195,1,1
42903,2014/03/31,2012/10/20,249,5,0.665979623,5987,249,3,2
42904,2014/03/31,2012/06/24,45,4,0.537789318,7414,45,2,2
42905,2014/03/31,2012/09/16,12,7,0.8339113159999999,4781,12,1,6
42906,2014/03/31,2013/02/21,399,2,0.7791479379999999,5117,399,2,0
42907,2014/03/31,2009/01/21,133,5,0.856819256,4653,133,2,3
42908,2014/03/31,2008/05/24,27,4,0.8269549890000001,4821,27,3,1
42909,2014/03/31,2012/11/14,13,4,0.31183979999999994,12784,13,1,3
42910,2014/03/31,2012/08/22,241,9,0.674407038,5911,241,5,4
42911,2014/03/31,2007/02/21,433,8,0.6740740740000001,5913,433,8,0
42912,2014/03/31,2011/08/11,593,3,0.843135181,4727,593,3,0
42913,2014/03/31,2010/02/08,18,14,0.976784314,4080,18,9,5
42914,2014/03/31,2013/02/12,46,8,0.8689555170000001,4586,46,1,7
42915,2014/03/31,2006/12/26,62,3,0.785356721,5074,62,0,3
42916,2014/03/31,2008/09/10,112,7,0.7443825890000001,5353,112,2,5
42917,2014/03/31,2012/12/16,228,6,0.62197315,6406,228,1,5
42918,2014/03/31,2005/12/26,468,4,1.5,2656,468,4,0
42919,2014/03/31,2007/10/26,368,5,0.589063886,6762,368,5,0
42920,2014/03/31,2009/07/31,1,3,0.8068017009999999,4937,1,2,1
42921,2014/03/31,2010/07/14,184,3,0.5944991789999999,6699,184,1,2
42922,2014/03/31,2013/01/10,224,7,0.451942805,8812,224,0,7
42923,2014/03/31,2012/11/02,392,4,0.625,6372,392,4,0
42924,2014/03/31,2008/11/06,522,2,0.858297414,4640,522,2,0
42925,2014/03/31,2012/08/28,35,5,0.8380555559999999,4752,35,0,5
42926,2014/03/31,2012/05/24,246,5,0.748252537,5322,246,4,1
42927,2014/03/31,2011/05/12,197,4,0.6573440079999999,6058,197,0,4
42928,2014/03/31,2007/11/01,191,5,0.408824435,9740,191,4,1
42929,2014/03/31,2007/07/11,296,4,0.597881381,6660,296,3,1
42930,2014/03/31,2007/06/23,163,6,0.646319805,6160,163,2,4
42931,2014/03/31,2012/11/08,136,3,0.8052589,4944,136,2,1
42932,2014/03/31,2009/08/26,90,6,0.605679294,6573,90,0,6
42933,2014/03/31,2005/08/03,112,6,0.983478261,4048,112,3,3
42934,2014/03/31,2006/03/31,8,4,0.485619663,8198,8,3,1
42935,2014/03/31,2013/03/18,258,4,0.566999003,7021,258,0,4
42936,2014/03/31,2012/09/23,198,5,0.405599715,9813,198,2,3
42937,2014/03/31,2006/07/18,35,5,1.022281017,3893,35,1,4
42938,2014/03/31,2009/03/08,694,3,0.437510994,9096,694,3,0
42939,2014/03/31,2012/04/13,566,3,1.5,2653,566,3,0
42940,2014/03/31,2006/04/11,337,2,0.779214803,5107,337,1,1
42941,2014/03/31,2006/01/06,63,6,0.529949394,7509,63,4,2
42942,2014/03/31,2010/12/13,57,2,0.7,5684,57,0,2
42943,2014/03/31,2009/03/31,204,6,0.656018137,6065,204,2,4
42944,2014/03/31,2011/09/02,357,3,0.921352478,4318,357,2,1
42945,2014/03/31,2010/10/27,390,3,0.8290954559999999,4798,390,3,0
42946,2014/03/31,2010/10/24,3,7,0.450781958,8824,3,6,1
42947,2014/03/31,2012/03/19,535,4,0.829326522,4796,535,4,0
42948,2014/03/31,2012/12/04,196,5,0.4994249120000001,7964,196,2,3
42949,2014/03/31,2010/10/13,9,5,0.549954363,7231,9,3,2
42950,2014/03/31,2009/01/25,244,5,0.82080512,4844,244,2,3
42951,2014/03/31,2007/05/28,198,6,0.738154475,5386,198,4,2
42952,2014/03/31,2007/03/06,106,5,0.7858489820000001,5059,106,2,3
42953,2014/03/31,2008/02/18,512,5,0.554371775,7171,512,5,0
42954,2014/03/31,2011/06/08,554,2,1.0,3975,554,2,0
42955,2014/03/31,2012/01/17,6,7,0.7405645609999999,5367,6,4,3
42956,2014/03/31,2010/09/06,229,3,0.8191673540000001,4852,229,1,2
42957,2014/03/31,2013/03/16,19,5,0.662957465,5995,19,2,3
42958,2014/03/31,2011/07/16,6,3,0.539828851,7362,6,2,1
42959,2014/03/31,2011/09/05,223,4,0.558614001,7114,223,2,2
42960,2014/03/31,2012/02/08,622,4,0.8318819340000001,4777,622,4,0
42961,2014/03/31,2012/05/02,296,5,0.657781824,6041,296,3,2
42962,2014/03/31,2008/05/30,31,6,0.7875996040000001,5045,31,3,3
42963,2014/03/31,2011/10/16,37,3,0.673333333,5901,37,0,3
42964,2014/03/31,2009/10/09,34,3,0.673333333,5901,34,0,3
42965,2014/03/31,2009/06/16,197,3,0.673333333,5901,197,0,3
42966,2014/03/31,2011/02/21,163,4,0.793358626,5008,163,3,1
42967,2014/03/31,2006/05/28,234,2,0.8751189429999999,4540,234,1,1
42968,2014/03/31,2013/02/16,5,6,0.6394624179999999,6213,5,1,5
42969,2014/03/31,2008/03/01,5,7,0.49896621,7961,5,2,5
42970,2014/03/31,2012/09/25,400,3,0.929775281,4272,400,3,0
42971,2014/03/31,2010/03/28,282,4,0.66242495,5996,282,1,3
42972,2014/03/31,2009/02/17,160,3,0.658244945,6034,160,0,3
42973,2014/03/31,2009/10/26,21,5,0.7349204290000001,5404,21,0,5
42974,2014/03/31,2012/01/12,140,4,0.538982085,7368,140,2,2
42975,2014/03/31,2012/07/05,318,3,1.0,3971,318,2,1
42976,2014/03/31,2009/03/29,4,2,0.664992464,5971,4,0,2
42977,2014/03/31,2006/02/25,241,5,0.589817291,6732,241,4,1
42978,2014/03/31,2012/02/23,229,5,0.756987607,5245,229,1,4
42979,2014/03/31,2007/06/29,187,2,1.457378855,2724,187,1,1
42980,2014/03/31,2012/12/05,479,2,0.8022837509999999,4948,479,2,0
42981,2014/03/31,2005/10/26,11,7,0.787464789,5041,11,0,7
42982,2014/03/31,2011/05/19,89,7,0.53858209,7370,89,2,5
42983,2014/03/31,2010/12/07,14,4,0.465,8536,14,2,2
42984,2014/03/31,2009/03/27,268,5,0.6009190010000001,6605,268,4,1
42985,2014/03/31,2008/04/12,34,9,0.502205492,7903,34,2,7
42986,2014/03/31,2010/01/16,27,2,0.596085912,6658,27,0,2
42987,2014/03/31,2011/01/11,31,5,0.646001953,6143,31,2,3
42988,2014/03/31,2008/08/08,233,4,0.904123946,4389,233,1,3
42989,2014/03/31,2008/08/25,77,4,0.6398451860000001,6201,77,3,1
42990,2014/03/31,2010/08/06,574,4,0.65,6104,574,4,0
42991,2014/03/31,2012/05/11,41,4,0.646164495,6140,41,3,1
42992,2014/03/31,2008/03/05,75,3,0.6366666670000001,6231,75,0,3
42993,2014/03/31,2006/11/29,108,3,0.6428390860000001,6171,108,0,3
42994,2014/03/31,2009/03/28,562,3,0.7149423220000001,5548,562,3,0
42995,2014/03/31,2012/05/21,217,5,0.727814278,5449,217,4,1
42996,2014/03/31,2012/05/19,13,5,0.978,4055,13,4,1
42997,2014/03/31,2007/07/30,268,3,0.554784555,7148,268,2,1
42998,2014/03/31,2008/04/07,145,5,0.562245853,7053,145,2,3
42999,2014/03/31,2007/11/13,347,2,0.75,5286,347,0,2
43000,2014/03/31,2013/02/09,414,2,0.75,5286,414,2,0
43001,2014/03/31,2012/08/03,603,2,0.75,5286,603,2,0
43002,2014/03/31,2012/07/05,154,2,0.75,5286,154,0,2
43003,2014/03/31,2010/04/15,341,4,0.829393305,4780,341,2,2
43004,2014/03/31,2012/08/21,585,2,0.75,5286,585,2,0
43005,2014/03/31,2008/01/10,677,2,0.75,5286,677,2,0
43006,2014/03/31,2012/02/13,579,2,0.75,5286,579,2,0
43007,2014/03/31,2012/07/20,618,2,0.75,5286,618,2,0
43008,2014/03/31,2012/07/26,597,2,0.75,5286,597,2,0
43009,2014/03/31,2013/03/22,373,2,0.75,5286,373,2,0
43010,2014/03/31,2010/04/24,520,2,0.75,5286,520,2,0
43011,2014/03/31,2012/12/10,449,2,0.75,5286,449,2,0
43012,2014/03/31,2009/01/08,205,3,0.756095002,5242,205,1,2
43013,2014/03/31,2008/01/13,15,3,0.8175412540000001,4848,15,2,1
43014,2014/03/31,2009/11/18,201,3,0.809505719,4896,201,2,1
43015,2014/03/31,2011/09/11,79,3,0.774233249,5119,79,2,1
43016,2014/03/31,2012/12/16,62,6,0.835763391,4742,62,1,5
43017,2014/03/31,2008/03/15,56,5,0.573034991,6916,56,1,4
43018,2014/03/31,2006/06/01,14,6,0.884797946,4479,14,2,4
43019,2014/03/31,2007/07/04,513,8,0.625655194,6334,513,8,0
43020,2014/03/31,2012/02/04,2,4,0.768696411,5155,2,2,2
43021,2014/03/31,2009/02/22,214,4,0.7449426579999999,5319,214,2,2
43022,2014/03/31,2013/03/26,72,5,0.812923677,4874,72,0,5
43023,2014/03/31,2011/05/21,105,4,0.768041877,5158,105,3,1
43024,2014/03/31,2006/09/23,22,5,1.219316713,3249,22,0,5
43025,2014/03/31,2012/01/28,149,5,0.5622395689999999,7046,149,4,1
43026,2014/03/31,2008/03/04,86,6,0.6027693239999999,6572,86,4,2
43027,2014/03/31,2012/05/04,582,2,0.91652013,4322,582,2,0
43028,2014/03/31,2012/10/09,51,5,0.545154143,7266,51,3,2
43029,2014/03/31,2013/01/10,70,5,0.460460358,8602,70,1,4
43030,2014/03/31,2012/08/23,316,6,0.815578666,4856,316,4,2
43031,2014/03/31,2012/11/20,159,5,0.51,7765,159,0,5
43032,2014/03/31,2006/06/08,21,2,0.782618577,5060,21,0,2
43033,2014/03/31,2010/07/26,196,7,0.741802173,5338,196,1,6
43034,2014/03/31,2008/06/22,253,3,0.658740642,6011,253,1,2
43035,2014/03/31,2011/10/22,24,6,0.655345912,6042,24,2,4
43036,2014/03/31,2011/01/13,186,5,0.740063551,5350,186,3,2
43037,2014/03/31,2010/12/22,132,4,0.8488636359999999,4664,132,1,3
43038,2014/03/31,2008/08/15,188,5,0.647043151,6118,188,3,2
43039,2014/03/31,2008/06/10,103,5,0.5785589010000001,6842,103,0,5
43040,2014/03/31,2011/01/26,223,4,0.714109688,5543,223,3,1
43041,2014/03/31,2005/10/28,25,3,0.581644379,6805,25,0,3
43042,2014/03/31,2012/12/20,416,6,0.8666666670000001,4566,416,6,0
43043,2014/03/31,2006/03/03,137,4,0.828680628,4775,137,0,4
43044,2014/03/31,2013/01/29,218,4,0.5155981239999999,7674,218,1,3
43045,2014/03/31,2006/07/02,3,2,0.602653465,6565,3,0,2
43046,2014/03/31,2007/10/16,70,5,0.782978429,5053,70,3,2
43047,2014/03/31,2011/10/31,257,2,0.92,4300,257,0,2
43048,2014/03/31,2007/10/17,109,3,0.7788659179999999,5079,109,0,3
43049,2014/03/31,2007/05/15,27,5,0.937835467,4218,27,1,4
43050,2014/03/31,2008/06/12,113,4,0.779860016,5072,113,2,2
43051,2014/03/31,2010/07/29,624,6,0.41433061,9546,624,6,0
43052,2014/03/31,2012/04/03,199,3,0.7324185190000001,5400,199,2,1
43053,2014/03/31,2011/08/04,200,6,0.622614924,6352,200,2,4
43054,2014/03/31,2007/05/14,209,3,0.646088874,6121,209,0,3
43055,2014/03/31,2012/12/04,103,6,0.484459145,8163,103,1,5
43056,2014/03/31,2012/04/12,272,6,0.7373876559999999,5363,272,4,2
43057,2014/03/31,2011/09/30,22,7,0.522969184,7561,22,2,5
43058,2014/03/31,2005/09/02,191,5,0.669732385,5904,191,1,4
43059,2014/03/31,2007/09/19,28,2,0.8453260640000001,4677,28,0,2
43060,2014/03/31,2007/10/01,56,5,0.827069038,4780,56,3,2
43061,2014/03/31,2008/03/13,90,7,0.66628687,5933,90,0,7
43062,2014/03/31,2011/08/31,7,7,0.493939773,8003,7,5,2
43063,2014/03/31,2013/02/19,402,2,0.85414866,4628,402,2,0
43064,2014/03/31,2012/07/07,5,4,0.545972376,7240,5,1,3
43065,2014/03/31,2010/12/10,163,6,0.5603373970000001,7054,163,2,4
43066,2014/03/31,2012/11/28,257,5,0.740871603,5335,257,3,2
43067,2014/03/31,2006/02/15,534,4,0.854203588,4627,534,4,0
43068,2014/03/31,2008/08/29,97,4,0.682498705,5791,97,0,4
43069,2014/03/31,2012/08/06,599,5,0.96171818,4109,599,5,0
43070,2014/03/31,2011/08/15,5,4,0.939434142,4206,5,2,2
43071,2014/03/31,2012/10/09,310,4,0.726590658,5438,310,2,2
43072,2014/03/31,2007/11/17,2,4,0.577975424,6836,2,0,4
43073,2014/03/31,2006/10/30,120,7,0.72600882,5442,120,6,1
43074,2014/03/31,2012/03/22,183,5,0.536882729,7359,183,3,2
43075,2014/03/31,2007/02/28,686,2,0.7,5644,686,2,0
43076,2014/03/31,2012/05/06,687,2,0.55,7183,687,2,0
43077,2014/03/31,2012/01/19,22,5,0.785389662,5030,22,1,4
43078,2014/03/31,2005/05/07,356,3,0.726595549,5437,356,2,1
43079,2014/03/31,2005/01/19,103,6,0.73990635,5339,103,4,2
43080,2014/03/31,2013/02/08,74,5,0.712393147,5545,74,1,4
43081,2014/03/31,2006/08/12,344,9,0.509505998,7753,344,8,1
43082,2014/03/31,2011/07/08,17,2,0.599238471,6592,17,0,2
43083,2014/03/31,2007/10/29,439,3,0.414926471,9520,439,3,0
43084,2014/03/31,2009/05/11,67,3,0.7,5643,67,1,2
43085,2014/03/31,2010/12/13,108,3,0.678687285,5820,108,1,2
43086,2014/03/31,2008/12/05,303,7,0.462827513,8534,303,4,3
43087,2014/03/31,2009/01/18,102,4,0.67269971,5871,102,1,3
43088,2014/03/31,2010/06/01,578,2,0.653009259,6048,578,2,0
43089,2014/03/31,2010/04/12,150,3,0.8092848359999999,4880,150,0,3
43090,2014/03/31,2012/04/30,16,6,0.417448203,9460,16,1,5
43091,2014/03/31,2012/05/26,140,5,0.865426255,4563,140,2,3
43092,2014/03/31,2009/01/14,199,4,1.315399734,3002,199,2,2
43093,2014/03/31,2012/12/08,178,2,0.565,6988,178,0,2
43094,2014/03/31,2008/04/22,211,4,0.565621777,6980,211,3,1
43095,2014/03/31,2008/01/07,283,4,0.66664978,5922,283,3,1
43096,2014/03/31,2012/07/28,527,3,0.6166666670000001,6402,527,3,0
43097,2014/03/31,2008/03/13,356,6,0.7580261140000001,5208,356,5,1
43098,2014/03/31,2012/10/09,466,2,0.85,4644,466,2,0
43099,2014/03/31,2011/06/14,590,2,0.85,4644,590,2,0
43100,2014/03/31,2012/07/20,609,2,0.85,4644,609,2,0
43101,2014/03/31,2011/12/20,711,2,0.85,4644,711,2,0
43102,2014/03/31,2005/09/09,32,10,0.838599958,4707,32,4,6
43103,2014/03/31,2009/07/10,454,4,0.635006435,6216,454,4,0
43104,2014/03/31,2010/08/01,223,5,0.984339152,4010,223,2,3
43105,2014/03/31,2011/05/19,555,4,0.74968661,5265,555,4,0
43106,2014/03/31,2011/02/25,129,3,0.645633895,6113,129,1,2
43107,2014/03/31,2011/09/04,2,5,0.411624948,9588,2,2,3
43108,2014/03/31,2006/05/26,43,3,0.80424088,4907,43,1,2
43109,2014/03/31,2006/04/29,164,4,0.79998581,4933,164,2,2
43110,2014/03/31,2007/05/09,461,4,0.475,8308,461,4,0
43111,2014/03/31,2009/03/01,122,2,0.95,4154,122,1,1
43112,2014/03/31,2013/03/09,236,3,0.71387301,5528,236,1,2
43113,2014/03/31,2008/08/04,207,6,0.478333333,8250,207,2,4
43114,2014/03/31,2012/04/03,324,7,0.8720441990000001,4525,324,6,1
43115,2014/03/31,2009/08/14,41,3,0.7867776670000001,5015,41,0,3
43116,2014/03/31,2009/12/03,74,7,0.559560346,7051,74,5,2
43117,2014/03/31,2012/06/24,363,6,0.585790646,6735,363,4,2
43118,2014/03/31,2008/12/10,108,5,0.815648129,4837,108,4,1
43119,2014/03/31,2010/02/12,118,4,0.962243902,4100,118,2,2
43120,2014/03/31,2012/09/29,237,4,0.564560675,6988,237,0,4
43121,2014/03/31,2012/12/05,30,7,0.972882861,4055,30,3,4
43122,2014/03/31,2008/07/11,511,2,0.75,5260,511,2,0
43123,2014/03/31,2013/03/26,115,5,0.520768317,7575,115,0,5
43124,2014/03/31,2012/12/26,145,3,0.700795878,5629,145,1,2
43125,2014/03/31,2011/01/13,74,3,0.7524952309999999,5242,74,2,1
43126,2014/03/31,2012/08/01,592,2,0.667541039,5909,592,2,0
43127,2014/03/31,2011/08/22,203,5,0.549665552,7176,203,4,1
43128,2014/03/31,2012/04/14,66,4,0.669194096,5894,66,2,2
43129,2014/03/31,2012/12/25,170,5,0.8496682459999999,4642,170,0,5
43130,2014/03/31,2007/06/15,420,4,0.641317073,6150,420,4,0
43131,2014/03/31,2008/09/14,186,2,0.8214788590000001,4801,186,1,1
43132,2014/03/31,2005/08/05,136,6,0.599577315,6577,136,2,4
43133,2014/03/31,2011/01/13,477,4,0.611364341,6450,477,4,0
43134,2014/03/31,2006/11/01,73,4,0.6466448020000001,6098,73,0,4
43135,2014/03/31,2011/11/21,130,4,0.72400661,5446,130,1,3
43136,2014/03/31,2013/03/21,72,5,0.7953318540000001,4957,72,1,4
43137,2014/03/31,2012/03/04,228,5,0.642607987,6135,228,4,1
43138,2014/03/31,2010/06/30,8,4,0.608296559,6481,8,0,4
43139,2014/03/31,2012/06/29,28,6,0.700933499,5624,28,1,5
43140,2014/03/31,2006/12/03,1,4,0.598272879,6589,1,0,4
43141,2014/03/31,2012/08/30,90,3,0.578226493,6817,90,1,2
43142,2014/03/31,2013/02/09,195,4,0.7017447040000001,5617,195,1,3
43143,2014/03/31,2008/10/15,328,6,0.5950558570000001,6624,328,5,1
43144,2014/03/31,2013/02/07,133,4,0.726147752,5428,133,2,2
43145,2014/03/31,2011/09/30,207,6,0.711637775,5538,207,1,5
43146,2014/03/31,2012/02/09,100,2,0.6915107909999999,5699,100,0,2
43147,2014/03/31,2006/10/16,319,3,0.8133952529999999,4845,319,2,1
43148,2014/03/31,2011/06/10,32,4,0.5482343120000001,7187,32,1,3
43149,2014/03/31,2012/05/25,138,12,0.795,4956,138,10,2
43150,2014/03/31,2012/12/18,144,5,0.70003376,5628,144,3,2
43151,2014/03/31,2009/06/03,257,4,0.771710088,5105,257,3,1
43152,2014/03/31,2008/09/11,128,2,0.947834456,4156,128,1,1
43153,2014/03/31,2010/06/01,661,7,0.790913655,4980,661,7,0
43154,2014/03/31,2006/07/12,499,5,0.8129411759999999,4845,499,5,0
43155,2014/03/31,2008/04/01,69,4,0.5301076720000001,7430,69,0,4
43156,2014/03/31,2012/01/17,589,5,0.6919184820000001,5692,589,5,0
43157,2014/03/31,2011/12/22,473,3,0.7032857140000001,5600,473,3,0
43158,2014/03/31,2013/03/16,318,5,0.907628486,4339,318,1,4
43159,2014/03/31,2011/09/09,84,11,0.5927272729999999,6644,84,8,3
43160,2014/03/31,2012/08/03,28,5,0.565611263,6961,28,2,3
43161,2014/03/31,2010/12/29,10,2,0.92135502,4273,10,0,2
43162,2014/03/31,2011/11/16,33,5,0.722214679,5450,33,1,4
43163,2014/03/31,2010/07/29,361,5,0.767980488,5125,361,4,1
43164,2014/03/31,2011/10/23,244,5,0.797861342,4933,244,2,3
43165,2014/03/31,2012/07/18,376,5,0.473040865,8320,376,5,0
43166,2014/03/31,2012/09/23,333,5,0.73188581,5377,333,3,2
43167,2014/03/31,2012/11/15,43,5,0.494,7965,43,1,4
43168,2014/03/31,2012/09/29,4,5,0.8632514259999999,4558,4,4,1
43169,2014/03/31,2005/09/30,130,5,0.633898824,6207,130,0,5
43170,2014/03/31,2013/02/18,1,8,0.620380006,6342,1,1,7
43171,2014/03/31,2012/04/17,151,5,0.725628919,5422,151,4,1
43172,2014/03/31,2013/03/12,382,2,1.0,3934,382,2,0
43173,2014/03/31,2010/08/22,497,2,1.0,3934,497,2,0
43174,2014/03/31,2012/11/24,487,2,1.0,3934,487,2,0
43175,2014/03/31,2011/02/21,471,5,0.6434412820000001,6114,471,5,0
43176,2014/03/31,2012/11/24,487,2,1.0,3934,487,2,0
43177,2014/03/31,2010/03/30,629,2,1.0,3934,629,2,0
43178,2014/03/31,2010/12/13,377,2,1.0,3934,377,2,0
43179,2014/03/31,2010/04/28,619,2,1.0,3934,619,2,0
43180,2014/03/31,2011/07/20,436,4,0.5,7868,436,4,0
43181,2014/03/31,2013/01/30,422,2,1.0,3934,422,2,0
43182,2014/03/31,2012/01/08,179,5,0.852598613,4614,179,3,2
43183,2014/03/31,2012/07/25,113,6,0.642680934,6121,113,2,4
43184,2014/03/31,2012/05/30,44,5,0.571933702,6878,44,1,4
43185,2014/03/31,2008/10/16,10,5,0.5870288020000001,6701,10,0,5
43186,2014/03/31,2011/08/25,261,3,0.721022915,5455,261,2,1
43187,2014/03/31,2008/01/16,70,3,0.906666667,4338,70,0,3
43188,2014/03/31,2013/03/20,4,5,0.583511869,6740,4,0,5
43189,2014/03/31,2011/08/10,132,4,0.851806368,4617,132,0,4
43190,2014/03/31,2008/03/04,67,6,0.8982659359999999,4377,67,0,6
43191,2014/03/31,2007/09/29,70,7,0.351241287,11190,70,5,2
43192,2014/03/31,2012/02/18,185,6,0.528950202,7430,185,1,5
43193,2014/03/31,2012/12/01,79,4,0.49728331,7903,79,1,3
43194,2014/03/31,2008/06/20,346,3,0.6936110129999999,5666,346,1,2
43195,2014/03/31,2007/04/28,168,3,1.248738481,3147,168,2,1
43196,2014/03/31,2012/01/16,572,3,0.766881343,5124,572,3,0
43197,2014/03/31,2012/11/13,500,2,0.725,5420,500,2,0
43198,2014/03/31,2010/02/17,428,4,0.67757372,5799,428,4,0
43199,2014/03/31,2006/01/11,221,4,0.8122472609999999,4837,221,2,2
43200,2014/03/31,2012/09/01,461,4,0.456088925,8614,461,4,0
43201,2014/03/31,2009/04/09,371,4,0.7092706259999999,5539,371,4,0
43202,2014/03/31,2013/02/02,70,2,0.7600367579999999,5169,70,0,2
43203,2014/03/31,2010/04/12,7,2,0.64,6138,7,1,1
43204,2014/03/31,2010/04/16,439,5,0.758642333,5178,439,5,0
43205,2014/03/31,2009/06/29,1,6,0.395627959,9929,1,4,2
43206,2014/03/31,2011/05/09,550,3,0.622467903,6309,550,3,0
43207,2014/03/31,2009/01/21,36,4,0.8470815359999999,4636,36,0,4
43208,2014/03/31,2013/03/04,13,6,0.7038824159999999,5579,13,0,6
43209,2014/03/31,2012/07/21,56,5,0.925053004,4245,56,3,2
43210,2014/03/31,2013/02/16,97,6,0.584569004,6717,97,1,5
43211,2014/03/31,2011/07/27,4,4,0.529600755,7414,4,2,2
43212,2014/03/31,2010/03/27,29,5,0.581763224,6749,29,4,1
43213,2014/03/31,2007/02/18,7,2,1.04641791,3752,7,0,2
43214,2014/03/31,2005/08/11,167,5,0.714747861,5493,167,1,4
43215,2014/03/31,2008/01/23,15,4,0.561725569,6989,15,0,4
43216,2014/03/31,2012/10/26,18,3,0.8639414609999999,4544,18,2,1
43217,2014/03/31,2010/11/25,635,4,0.588603989,6669,635,4,0
43218,2014/03/31,2012/09/20,67,6,0.898053077,4371,67,4,2
43219,2014/03/31,2012/06/28,583,4,0.7666015629999999,5120,583,4,0
43220,2014/03/31,2011/03/08,111,6,0.510754815,7684,111,4,2
43221,2014/03/31,2008/12/27,102,4,0.634541633,6185,102,3,1
43222,2014/03/31,2011/08/01,6,3,0.645646594,6078,6,2,1
43223,2014/03/31,2011/07/31,1,4,0.72225474,5433,1,0,4
43224,2014/03/31,2010/10/18,490,2,1.5,2616,490,2,0
43225,2014/03/31,2011/01/07,429,3,1.0,3924,429,3,0
43226,2014/03/31,2012/11/26,314,3,1.0,3924,314,2,1
43227,2014/03/31,2007/11/17,134,4,0.75,5232,134,3,1
43228,2014/03/31,2010/10/23,534,2,1.5,2616,534,2,0
43229,2014/03/31,2012/08/03,314,5,0.56892852,6897,314,4,1
43230,2014/03/31,2009/02/22,153,3,0.65478972,5992,153,2,1
43231,2014/03/31,2010/03/21,171,4,0.84301676,4654,171,3,1
43232,2014/03/31,2011/08/13,538,5,0.7851510909999999,4997,538,5,0
43233,2014/03/31,2012/05/24,141,4,0.591733032,6630,141,0,4
43234,2014/03/31,2011/01/11,140,4,0.994130765,3946,140,2,2
43235,2014/03/31,2011/01/04,363,3,0.813817427,4820,363,2,1
43236,2014/03/31,2012/09/11,167,5,0.619715595,6329,167,0,5
43237,2014/03/31,2010/06/27,33,3,0.68399721,5734,33,2,1
43238,2014/03/31,2011/07/07,116,3,0.5885294120000001,6664,116,1,2
43239,2014/03/31,2005/05/02,307,4,0.5901655379999999,6645,307,3,1
43240,2014/03/31,2011/07/25,299,6,0.77347929,5070,299,4,2
43241,2014/03/31,2009/07/15,126,4,0.7378024459999999,5315,126,2,2
43242,2014/03/31,2011/01/06,101,4,0.619000789,6335,101,0,4
43243,2014/03/31,2008/04/27,113,4,0.688598525,5694,113,2,2
43244,2014/03/31,2008/06/26,107,2,0.944086203,4153,107,1,1
43245,2014/03/31,2011/04/14,301,4,0.6132926639999999,6393,301,0,4
43246,2014/03/31,2012/11/12,220,5,0.7883973459999999,4973,220,4,1
43247,2014/03/31,2010/02/26,123,5,0.861478796,4551,123,3,2
43248,2014/03/31,2010/01/29,15,5,0.526939516,7440,15,1,4
43249,2014/03/31,2009/09/21,80,5,0.8440000000000001,4645,80,2,3
43250,2014/03/31,2012/05/01,538,2,1.0,3920,538,2,0
43251,2014/03/31,2007/10/13,606,4,0.7,5600,606,4,0
43252,2014/03/31,2007/10/13,37,4,0.7,5600,37,2,2
43253,2014/03/31,2011/12/22,309,6,0.600666565,6526,309,5,1
43254,2014/03/31,2013/03/26,41,4,0.755570547,5188,41,1,3
43255,2014/03/31,2011/07/09,450,4,0.538521775,7279,450,4,0
43256,2014/03/31,2008/06/03,28,6,0.519737435,7541,28,0,6
43257,2014/03/31,2008/09/27,590,3,0.95849841,4089,590,3,0
43258,2014/03/31,2008/03/29,258,6,0.527916218,7424,258,4,2
43259,2014/03/31,2010/08/08,183,6,0.547381285,7160,183,2,4
43260,2014/03/31,2013/03/28,259,6,0.946666667,4140,259,2,4
43261,2014/03/31,2012/05/19,594,6,0.7099365940000001,5520,594,6,0
43262,2014/03/31,2010/11/26,285,5,0.591715494,6622,285,3,2
43263,2014/03/31,2012/08/06,598,3,1.0,3918,598,3,0
43264,2014/03/31,2008/10/25,168,5,0.517068761,7577,168,4,1
43265,2014/03/31,2006/07/04,159,2,0.835,4692,159,0,2
43266,2014/03/31,2009/10/31,106,7,0.847358858,4623,106,0,7
43267,2014/03/31,2010/04/28,124,6,0.476900414,8214,124,4,2
43268,2014/03/31,2007/06/29,76,5,0.628972383,6228,76,2,3
43269,2014/03/31,2008/08/25,244,5,0.954434698,4104,244,4,1
43270,2014/03/31,2011/12/06,184,4,1.039278132,3768,184,2,2
43271,2014/03/31,2011/08/31,175,4,0.830356234,4716,175,2,2
43272,2014/03/31,2007/07/29,454,3,0.7896249240000001,4959,454,3,0
43273,2014/03/31,2010/02/13,29,10,0.7289983240000001,5371,29,1,9
43274,2014/03/31,2013/03/25,219,3,0.7570417629999999,5172,219,2,1
43275,2014/03/31,2013/02/01,217,5,0.8643267109999999,4530,217,0,5
43276,2014/03/31,2012/09/08,565,4,1.111669506,3522,565,4,0
43277,2014/03/31,2012/02/02,561,9,0.75,5220,561,9,0
43278,2014/03/31,2010/10/29,136,2,0.8177689579999999,4787,136,1,1
43279,2014/03/31,2008/08/26,437,2,0.84585134,4628,437,2,0
43280,2014/03/31,2005/10/12,518,5,0.811463516,4824,518,5,0
43281,2014/03/31,2011/08/25,22,3,0.484159555,8085,22,1,2
43282,2014/03/31,2012/04/17,20,6,0.8336443020000001,4695,20,4,2
43283,2014/03/31,2007/05/07,377,6,0.414906701,9432,377,6,0
43284,2014/03/31,2012/07/11,611,2,0.6,6522,611,2,0
43285,2014/03/31,2012/07/05,495,4,0.508697348,7692,495,4,0
43286,2014/03/31,2012/11/08,182,7,0.543452778,7200,182,5,2
43287,2014/03/31,2011/05/14,20,6,0.7437528520000001,5260,20,1,5
43288,2014/03/31,2009/08/20,60,5,0.6202552720000001,6307,60,4,1
43289,2014/03/31,2010/10/19,162,3,0.900723003,4343,162,0,3
43290,2014/03/31,2006/06/17,11,6,0.5082807020000001,7695,11,4,2
43291,2014/03/31,2013/01/08,68,7,0.689913565,5669,68,2,5
43292,2014/03/31,2009/08/30,74,4,0.7898021,4952,74,1,3
43293,2014/03/31,2008/06/10,155,5,0.563553826,6939,155,2,3
43294,2014/03/31,2011/06/20,193,5,0.6585146510000001,5938,193,4,1
43295,2014/03/31,2007/10/06,543,3,0.7569105690000001,5166,543,3,0
43296,2014/03/31,2007/03/20,557,2,0.7,5586,557,2,0
43297,2014/03/31,2013/01/17,184,5,0.974130543,4014,184,1,4
43298,2014/03/31,2011/04/17,159,3,0.92,4250,159,0,3
43299,2014/03/31,2009/09/05,157,6,0.42803022,9133,157,1,5
43300,2014/03/31,2008/07/29,116,2,0.535,7306,116,0,2
43301,2014/03/31,2009/01/09,198,4,0.641588969,6092,198,2,2
43302,2014/03/31,2012/03/13,211,7,0.65,6013,211,5,2
43303,2014/03/31,2010/08/14,221,4,0.883032083,4426,221,2,2
43304,2014/03/31,2009/08/27,152,4,0.650729271,6006,152,0,4
43305,2014/03/31,2010/07/30,68,6,0.521549446,7493,68,5,1
43306,2014/03/31,2012/05/11,509,4,0.669037836,5841,509,4,0
43307,2014/03/31,2007/11/25,260,3,0.748318652,5222,260,1,2
43308,2014/03/31,2013/01/25,18,10,0.7545028,5179,18,1,9
43309,2014/03/31,2010/09/02,51,4,0.707501358,5523,51,1,3
43310,2014/03/31,2008/03/15,67,4,0.731207187,5343,67,2,2
43311,2014/03/31,2012/12/21,154,5,0.524604539,7447,154,1,4
43312,2014/03/31,2011/08/08,238,4,0.648953488,6020,238,2,2
43313,2014/03/31,2012/09/09,321,3,1.079414203,3619,321,1,2
43314,2014/03/31,2005/08/02,222,6,0.600482706,6505,222,2,4
43315,2014/03/31,2013/02/01,331,2,1.0,3906,331,1,1
43316,2014/03/31,2008/06/19,647,2,0.7679512390000001,5086,647,2,0
43317,2014/03/31,2005/04/17,175,6,0.943333333,4140,175,1,5
43318,2014/03/31,2010/01/20,1,4,0.442630923,8822,1,1,3
43319,2014/03/31,2006/06/05,19,5,0.7487114090000001,5215,19,1,4
43320,2014/03/31,2011/11/11,85,4,0.842940415,4632,85,2,2
43321,2014/03/31,2008/07/14,7,3,0.9,4338,7,0,3
43322,2014/03/31,2006/02/27,372,4,0.675,5784,372,4,0
43323,2014/03/31,2006/04/25,260,4,0.61648192,6333,260,3,1
43324,2014/03/31,2010/05/06,9,9,0.57,6849,9,6,3
43325,2014/03/31,2009/02/22,43,3,0.586666667,6654,43,0,3
43326,2014/03/31,2010/02/24,247,5,0.7628747309999999,5117,247,2,3
43327,2014/03/31,2008/09/01,151,4,0.768535145,5079,151,2,2
43328,2014/03/31,2012/04/14,389,9,0.661111111,5904,389,9,0
43329,2014/03/31,2008/11/23,151,3,0.794134283,4915,151,1,2
43330,2014/03/31,2012/10/07,102,9,0.672245952,5806,102,4,5
43331,2014/03/31,2005/03/15,9,5,0.612607126,6371,9,1,4
43332,2014/03/31,2011/11/25,586,2,0.937046819,4165,586,2,0
43333,2014/03/31,2011/05/24,49,2,0.7903321179999999,4938,49,0,2
43334,2014/03/31,2010/07/05,21,4,0.837270972,4661,21,2,2
43335,2014/03/31,2012/03/24,559,2,0.9104993,4286,559,2,0
43336,2014/03/31,2007/04/13,22,6,0.630826059,6186,22,3,3
43337,2014/03/31,2006/03/02,354,3,0.824466512,4733,354,2,1
43338,2014/03/31,2013/02/21,267,3,0.461079995,8463,267,1,2
43339,2014/03/31,2012/03/01,21,6,0.828982367,4707,21,0,6
43340,2014/03/31,2013/03/04,188,5,0.564839317,6908,188,3,2
43341,2014/03/31,2012/10/24,36,2,0.761131487,5126,36,0,2
43342,2014/03/31,2010/12/31,506,3,0.858604754,4544,506,3,0
43343,2014/03/31,2012/09/11,157,8,0.723253615,5394,157,1,7
43344,2014/03/31,2008/01/13,191,5,0.769167981,5072,191,2,3
43345,2014/03/31,2011/12/05,410,3,0.917666431,4251,410,3,0
43346,2014/03/31,2007/09/29,7,3,0.560541745,6959,7,1,2
43347,2014/03/31,2012/09/06,18,7,0.505383519,7718,18,0,7
43348,2014/03/31,2005/12/08,666,6,0.6819055940000001,5720,666,6,0
43349,2014/03/31,2006/07/21,101,4,0.610746946,6386,101,0,4
43350,2014/03/31,2012/03/20,152,6,0.602339768,6475,152,1,5
43351,2014/03/31,2012/05/23,567,4,0.869781445,4484,567,4,0
43352,2014/03/31,2008/03/01,286,4,0.634351008,6148,286,3,1
43353,2014/03/31,2008/05/19,159,5,0.512528585,7609,159,3,2
43354,2014/03/31,2013/03/04,38,5,0.32886237100000004,11858,38,1,4
43355,2014/03/31,2012/12/26,92,5,0.539909997,7222,92,1,4
43356,2014/03/31,2012/06/05,103,3,0.607825409,6415,103,2,1
43357,2014/03/31,2009/03/09,221,4,0.6830746320000001,5708,221,3,1
43358,2014/03/31,2013/03/19,233,4,0.704664739,5533,233,0,4
43359,2014/03/31,2011/11/20,485,7,0.491218344,7937,485,7,0
43360,2014/03/31,2011/08/30,68,4,0.650050025,5997,68,2,2
43361,2014/03/31,2008/05/23,67,4,0.556346511,7007,67,0,4
43362,2014/03/31,2005/03/15,163,3,0.433946343,8983,163,0,3
43363,2014/03/31,2010/10/13,371,6,0.81265638,4796,371,6,0
43364,2014/03/31,2012/03/29,337,3,0.806728778,4830,337,1,2
43365,2014/03/31,2007/07/16,34,7,0.438442669,8887,34,2,5
43366,2014/03/31,2012/08/09,574,3,0.613027061,6356,574,3,0
43367,2014/03/31,2012/03/02,696,3,0.8177896729999999,4764,696,3,0
43368,2014/03/31,2011/09/13,137,7,0.825562619,4719,137,1,6
43369,2014/03/31,2010/11/18,351,5,0.6851389379999999,5686,351,4,1
43370,2014/03/31,2012/02/17,327,4,0.949001218,4105,327,3,1
43371,2014/03/31,2011/09/22,194,3,0.6263836629999999,6219,194,1,2
43372,2014/03/31,2007/06/18,24,5,0.54146789,7194,24,2,3
43373,2014/03/31,2011/08/27,377,2,0.676015272,5762,377,2,0
43374,2014/03/31,2008/05/30,142,3,0.66,5901,142,1,2
43375,2014/03/31,2012/09/04,6,6,0.531549065,7327,6,1,5
43376,2014/03/31,2013/02/20,44,6,0.33,11802,44,1,5
43377,2014/03/31,2009/09/23,75,2,0.935952896,4161,75,1,1
43378,2014/03/31,2011/07/10,67,4,0.874904516,4451,67,3,1
43379,2014/03/31,2012/08/19,268,6,0.578908712,6726,268,3,3
43380,2014/03/31,2011/09/13,36,5,0.6537222970000001,5956,36,1,4
43381,2014/03/31,2011/12/16,121,2,0.685,5684,121,0,2
43382,2014/03/31,2013/03/27,58,2,0.685,5684,58,1,1
43383,2014/03/31,2006/12/31,78,2,0.685,5684,78,1,1
43384,2014/03/31,2006/06/04,45,2,0.685,5684,45,1,1
43385,2014/03/31,2011/11/17,83,2,0.685,5684,83,1,1
43386,2014/03/31,2012/10/19,167,9,0.5267893379999999,7391,167,4,5
43387,2014/03/31,2012/11/18,274,6,0.8216336009999999,4738,274,5,1
43388,2014/03/31,2008/04/27,178,3,0.7163783579999999,5434,178,2,1
43389,2014/03/31,2005/12/18,36,4,0.7283068290000001,5345,36,0,4
43390,2014/03/31,2011/09/26,390,5,0.96,4055,390,5,0
43391,2014/03/31,2012/04/27,69,3,0.810058273,4805,69,1,2
43392,2014/03/31,2012/03/31,673,5,0.745223052,5223,673,5,0
43393,2014/03/31,2011/01/04,659,3,0.719541505,5409,659,3,0
43394,2014/03/31,2008/04/25,199,2,1.13,3444,199,0,2
43395,2014/03/31,2010/07/08,67,5,0.536997378,7247,67,3,2
43396,2014/03/31,2013/03/04,304,2,0.7769115590000001,5009,304,1,1
43397,2014/03/31,2012/05/19,91,4,0.503054047,7734,91,2,2
43398,2014/03/31,2006/05/16,614,3,0.6324743939999999,6151,614,3,0
43399,2014/03/31,2009/12/11,96,4,0.6274237779999999,6199,96,2,2
43400,2014/03/31,2012/02/05,98,7,0.642540889,6053,98,2,5
43401,2014/03/31,2012/12/07,291,4,0.514015332,7566,291,2,2
43402,2014/03/31,2012/07/10,52,5,0.596314982,6521,52,0,5
43403,2014/03/31,2011/08/09,159,8,0.5444441329999999,7142,159,5,3
43404,2014/03/31,2012/04/23,191,5,0.781894229,4973,191,3,2
43405,2014/03/31,2012/10/27,177,5,0.592268088,6565,177,3,2
43406,2014/03/31,2013/02/09,309,5,0.905871389,4292,309,0,5
43407,2014/03/31,2012/12/13,378,2,1.0,3888,378,2,0
43408,2014/03/31,2005/10/31,103,6,0.998333333,3894,103,0,6
43409,2014/03/31,2012/04/19,490,2,0.5,7775,490,2,0
43410,2014/03/31,2010/08/04,208,3,0.92,4225,208,0,3
43411,2014/03/31,2012/01/09,148,7,0.749662488,5185,148,4,3
43412,2014/03/31,2007/03/09,108,3,0.881583125,4409,108,2,1
43413,2014/03/31,2010/08/09,290,5,0.635235371,6118,290,3,2
43414,2014/03/31,2009/09/04,281,8,0.8375,4640,281,7,1
43415,2014/03/31,2006/08/04,5,9,0.6758086959999999,5750,5,3,6
43416,2014/03/31,2007/02/21,319,4,0.68935604,5637,319,2,2
43417,2014/03/31,2007/12/10,27,3,0.758592347,5122,27,0,3
43418,2014/03/31,2013/02/16,34,3,0.74116177,5242,34,0,3
43419,2014/03/31,2012/10/11,81,3,0.668551024,5811,81,1,2
43420,2014/03/31,2008/05/23,77,4,0.7425,5232,77,3,1
43421,2014/03/31,2009/04/10,75,4,0.7425,5232,75,1,3
43422,2014/03/31,2010/01/05,30,4,0.6181938260000001,6284,30,0,4
43423,2014/03/31,2012/12/20,87,4,0.81971935,4739,87,1,3
43424,2014/03/31,2011/01/24,292,10,0.570675775,6807,292,7,3
43425,2014/03/31,2010/12/07,15,6,0.927976589,4186,15,3,3
43426,2014/03/31,2013/01/07,44,3,0.566666667,6855,44,1,2
43427,2014/03/31,2012/08/18,256,6,0.8124806529999999,4781,256,2,4
43428,2014/03/31,2010/06/02,158,4,1.214160675,3199,158,1,3
43429,2014/03/31,2011/02/06,71,2,0.935,4154,71,1,1
43430,2014/03/31,2008/09/12,176,3,0.6233333329999999,6231,176,2,1
43431,2014/03/31,2013/03/12,79,4,0.4497313570000001,8636,79,0,4
43432,2014/03/31,2006/02/22,97,7,0.541599721,7170,97,0,7
43433,2014/03/31,2012/09/26,198,3,0.881332274,4406,198,1,2
43434,2014/03/31,2007/02/20,1,2,0.642037037,6048,1,0,2
43435,2014/03/31,2008/11/11,9,5,0.647568379,5996,9,1,4
43436,2014/03/31,2010/05/24,205,7,0.395863581,9808,205,6,1
43437,2014/03/31,2013/02/11,44,5,0.758300781,5120,44,1,4
43438,2014/03/31,2013/02/01,139,5,0.784620049,4948,139,1,4
43439,2014/03/31,2012/08/18,134,6,0.581413809,6677,134,3,3
43440,2014/03/31,2012/03/21,556,4,0.725471874,5351,556,4,0
43441,2014/03/31,2013/02/06,112,3,0.737871127,5261,112,1,2
43442,2014/03/31,2009/09/19,63,3,0.71045205,5464,63,0,3
43443,2014/03/31,2008/07/24,122,4,0.6762717770000001,5740,122,3,1
43444,2014/03/31,2007/07/12,547,5,0.6808630059999999,5701,547,5,0
43445,2014/03/31,2006/05/25,100,5,0.629187875,6169,100,4,1
43446,2014/03/31,2008/08/05,551,2,0.925,4196,551,2,0
43447,2014/03/31,2011/11/17,44,12,0.549863984,7058,44,1,11
43448,2014/03/31,2011/11/23,122,4,0.613155317,6329,122,1,3
43449,2014/03/31,2010/07/06,118,3,0.622484761,6234,118,0,3
43450,2014/03/31,2006/04/29,262,6,0.589744681,6580,262,0,6
43451,2014/03/31,2008/11/11,110,2,1.41,2752,110,0,2
43452,2014/03/31,2008/08/05,67,6,0.712578512,5445,67,2,4
43453,2014/03/31,2010/08/12,7,5,0.793123467,4892,7,0,5
43454,2014/03/31,2010/12/01,17,4,0.745,5208,17,1,3
43455,2014/03/31,2009/07/15,462,3,0.928356066,4179,462,3,0
43456,2014/03/31,2012/09/09,275,6,0.583572503,6648,275,2,4
43457,2014/03/31,2013/02/03,199,4,0.901710832,4302,199,0,4
43458,2014/03/31,2005/04/21,459,5,0.655032084,5922,459,5,0
43459,2014/03/31,2011/01/04,599,2,1.0,3879,599,2,0
43460,2014/03/31,2007/10/12,204,7,0.651370277,5955,204,3,4
43461,2014/03/31,2013/01/05,438,4,0.62399453,6216,438,4,0
43462,2014/03/31,2012/11/17,449,4,0.692342021,5602,449,4,0
43463,2014/03/31,2011/07/06,106,4,0.7719765129999999,5024,106,3,1
43464,2014/03/31,2008/01/02,416,4,0.8954744859999999,4331,416,4,0
43465,2014/03/31,2013/02/27,58,4,0.5554497279999999,6982,58,2,2
43466,2014/03/31,2013/02/01,222,2,0.885,4382,222,0,2
43467,2014/03/31,2011/03/22,483,2,0.65,5966,483,2,0
43468,2014/03/31,2012/09/11,452,2,0.65,5966,452,2,0
43469,2014/03/31,2010/12/11,278,7,0.6406244839999999,6053,278,6,1
43470,2014/03/31,2009/07/04,100,3,0.7096797220000001,5464,100,1,2
43471,2014/03/31,2011/12/24,444,6,0.610269122,6354,444,6,0
43472,2014/03/31,2011/12/28,68,3,0.8987760779999999,4314,68,0,3
43473,2014/03/31,2010/10/15,618,4,0.715746723,5417,618,4,0
43474,2014/03/31,2012/10/11,24,3,0.502823606,7710,24,2,1
43475,2014/03/31,2010/11/26,470,3,1.152035661,3365,470,3,0
43476,2014/03/31,2012/01/28,42,3,0.7802657,4968,42,1,2
43477,2014/03/31,2012/06/28,599,2,0.6,6460,599,2,0
43478,2014/03/31,2005/06/16,252,3,0.89204603,4345,252,2,1
43479,2014/03/31,2007/04/24,513,4,0.545782284,7101,513,4,0
43480,2014/03/31,2011/09/14,209,8,0.7863494320000001,4928,209,3,5
43481,2014/03/31,2008/05/01,96,3,0.656666667,5901,96,2,1
43482,2014/03/31,2013/03/02,217,2,0.985,3934,217,0,2
43483,2014/03/31,2012/07/22,163,3,0.90536215,4280,163,1,2
43484,2014/03/31,2008/05/06,368,4,0.7745152909999999,5003,368,4,0
43485,2014/03/31,2013/03/27,9,4,0.515,7524,9,2,2
43486,2014/03/31,2011/11/11,254,5,0.852929782,4543,254,3,2
43487,2014/03/31,2012/06/25,168,7,0.691073658,5607,168,3,4
43488,2014/03/31,2009/08/07,188,4,0.589777778,6570,188,2,2
43489,2014/03/31,2006/10/01,369,3,0.483333333,8016,369,3,0
43490,2014/03/31,2006/03/10,171,4,0.786492083,4926,171,0,4
43491,2014/03/31,2006/05/14,324,4,0.6755929540000001,5734,324,2,2
43492,2014/03/31,2007/12/19,255,2,1.224720202,3163,255,0,2
43493,2014/03/31,2007/12/13,711,4,0.769211676,5036,711,4,0
43494,2014/03/31,2011/10/15,419,4,0.6,6456,419,4,0
43495,2014/03/31,2011/08/09,118,5,0.6666265060000001,5810,118,2,3
43496,2014/03/31,2008/02/03,551,3,1.0,3873,551,3,0
43497,2014/03/31,2012/04/24,702,2,0.725,5342,702,2,0
43498,2014/03/31,2007/07/01,329,5,0.651455004,5945,329,1,4
43499,2014/03/31,2013/02/19,157,4,0.639504624,6056,157,3,1
43500,2014/03/31,2012/05/21,144,6,0.687498669,5633,144,3,3
43501,2014/03/31,2010/04/06,238,4,0.762476866,5079,238,3,1
43502,2014/03/31,2008/07/14,250,4,0.557078118,6951,250,0,4
43503,2014/03/31,2011/12/22,115,7,0.6200096079999999,6245,115,2,5
43504,2014/03/31,2011/09/30,25,7,0.715501756,5411,25,4,3
43505,2014/03/31,2011/09/05,120,4,1.058952407,3656,120,2,2
43506,2014/03/31,2008/03/29,39,5,0.744523077,5200,39,3,2
43507,2014/03/31,2013/01/01,34,3,0.7006425340000001,5525,34,0,3
43508,2014/03/31,2012/08/17,390,3,0.7854707790000001,4928,390,3,0
43509,2014/03/31,2007/11/03,313,3,0.7156989640000001,5408,313,1,2
43510,2014/03/31,2009/07/14,187,5,0.671606802,5763,187,3,2
43511,2014/03/31,2012/04/04,62,3,0.525721271,7362,62,0,3
43512,2014/03/31,2013/03/18,47,5,0.434223045,8913,47,2,3
43513,2014/03/31,2010/07/28,78,3,0.8940055440000001,4329,78,1,2
43514,2014/03/31,2006/10/30,32,5,0.695050287,5568,32,1,4
43515,2014/03/31,2012/11/25,226,4,0.927144226,4174,226,1,3
43516,2014/03/31,2012/01/04,70,6,0.974027183,3973,70,3,3
43517,2014/03/31,2007/10/09,67,3,0.8748790409999999,4423,67,1,2
43518,2014/03/31,2013/01/01,59,4,0.629083076,6151,59,0,4
43519,2014/03/31,2012/04/02,100,6,0.623981616,6201,100,3,3
43520,2014/03/31,2012/10/24,250,4,0.479338454,8072,250,2,2
43521,2014/03/31,2011/12/12,112,4,0.7251340209999999,5335,112,0,4
43522,2014/03/31,2009/03/19,620,2,0.733624123,5273,620,2,0
43523,2014/03/31,2013/03/17,12,2,0.97,3988,12,1,1
43524,2014/03/31,2012/10/29,377,5,0.784814364,4929,377,5,0
43525,2014/03/31,2012/10/22,198,3,0.8715953129999999,4438,198,1,2
43526,2014/03/31,2011/02/01,17,10,0.341514215,11326,17,4,6
43527,2014/03/31,2013/01/29,274,5,0.514423461,7519,274,2,3
43528,2014/03/31,2012/11/21,32,4,0.763000592,5069,32,1,3
43529,2014/03/31,2011/04/03,529,4,0.52487785,7368,529,4,0
43530,2014/03/31,2011/01/18,479,4,0.79221471,4881,479,4,0
43531,2014/03/31,2006/05/10,24,2,0.595675551,6491,24,0,2
43532,2014/03/31,2011/01/01,373,7,0.736046069,5253,373,7,0
43533,2014/03/31,2008/12/27,551,4,0.8476754390000001,4560,551,4,0
43534,2014/03/31,2008/04/22,363,4,0.661761685,5841,363,2,2
43535,2014/03/31,2007/06/26,199,3,0.57889022,6677,199,1,2
43536,2014/03/31,2012/01/25,61,2,0.941329761,4106,61,0,2
43537,2014/03/31,2005/06/19,587,2,1.180183206,3275,587,2,0
43538,2014/03/31,2010/03/22,503,3,0.7373330790000001,5242,503,3,0
43539,2014/03/31,2007/07/19,115,4,0.779054626,4961,115,0,4
43540,2014/03/31,2010/04/26,122,5,0.450286613,8583,122,0,5
43541,2014/03/31,2012/01/25,192,4,1.142732111,3382,192,0,4
43542,2014/03/31,2011/05/31,182,4,0.7078205129999999,5460,182,1,3
43543,2014/03/31,2011/07/10,357,6,0.922511339,4189,357,5,1
43544,2014/03/31,2011/11/14,137,6,0.569032543,6791,137,5,1
43545,2014/03/31,2010/10/21,205,5,0.66,5855,205,3,2
43546,2014/03/31,2008/02/18,7,8,0.471194976,8201,7,6,2
43547,2014/03/31,2011/07/28,516,6,0.747292593,5171,516,6,0
43548,2014/03/31,2009/09/27,43,5,0.562037818,6875,43,0,5
43549,2014/03/31,2011/12/06,275,4,0.8625,4480,275,2,2
43550,2014/03/31,2013/01/31,424,2,0.75,5152,424,2,0
43551,2014/03/31,2012/07/25,67,3,0.7257682190000001,5324,67,2,1
43552,2014/03/31,2010/03/07,42,3,0.851472014,4538,42,0,3
43553,2014/03/31,2010/12/08,621,5,0.774483865,4989,621,5,0
43554,2014/03/31,2013/02/03,123,5,0.869772625,4442,123,1,4
43555,2014/03/31,2010/03/23,201,4,0.740289383,5218,201,1,3
43556,2014/03/31,2008/08/06,138,6,0.687291815,5620,138,5,1
43557,2014/03/31,2010/10/13,400,3,0.67173913,5750,400,3,0
43558,2014/03/31,2007/05/05,152,6,0.634535896,6087,152,5,1
43559,2014/03/31,2012/08/18,65,2,0.578322851,6678,65,0,2
43560,2014/03/31,2008/01/03,230,6,0.740402607,5216,230,1,5
43561,2014/03/31,2012/01/16,9,5,0.644501001,5992,9,2,3
43562,2014/03/31,2013/03/03,54,6,0.332944219,11599,54,2,4
43563,2014/03/31,2007/12/04,36,4,0.839146023,4602,36,0,4
43564,2014/03/31,2008/10/11,83,4,0.963829256,4006,83,0,4
43565,2014/03/31,2006/11/19,167,4,0.79128305,4879,167,2,2
43566,2014/03/31,2011/01/13,150,2,0.92,4196,150,0,2
43567,2014/03/31,2006/12/22,241,2,0.92,4196,241,0,2
43568,2014/03/31,2013/03/04,271,2,0.92,4196,271,0,2
43569,2014/03/31,2008/12/21,113,5,0.873371041,4420,113,4,1
43570,2014/03/31,2010/05/22,376,3,0.8,4825,376,3,0
43571,2014/03/31,2007/09/20,202,4,0.579983471,6655,202,3,1
43572,2014/03/31,2013/03/28,20,3,0.458303052,8421,20,1,2
43573,2014/03/31,2012/02/17,100,5,0.445738046,8658,100,3,2
43574,2014/03/31,2013/02/13,147,6,0.8635377040000001,4469,147,0,6
43575,2014/03/31,2009/08/28,27,5,0.688985895,5601,27,0,5
43576,2014/03/31,2012/12/17,176,5,0.848,4550,176,2,3
43577,2014/03/31,2011/04/11,359,4,0.417395067,9244,359,2,2
43578,2014/03/31,2006/12/06,299,4,0.6891051970000001,5599,299,3,1
43579,2014/03/31,2012/02/10,39,4,0.7134153109999999,5408,39,2,2
43580,2014/03/31,2006/08/20,236,5,0.913065089,4225,236,1,4
43581,2014/03/31,2011/01/15,321,4,0.956034696,4035,321,3,1
43582,2014/03/31,2012/02/13,446,8,0.83125,4640,446,8,0
43583,2014/03/31,2008/08/15,78,5,0.969758612,3977,78,1,4
43584,2014/03/31,2012/02/04,227,4,0.651579659,5919,227,2,2
43585,2014/03/31,2009/01/09,44,8,0.480448486,8027,44,3,5
43586,2014/03/31,2010/12/04,90,5,0.795867905,4845,90,2,3
43587,2014/03/31,2006/03/22,47,3,0.821005111,4696,47,2,1
43588,2014/03/31,2012/12/15,253,4,0.987701768,3903,253,0,4
43589,2014/03/31,2010/01/10,55,5,0.7167292670000001,5378,55,1,4
43590,2014/03/31,2010/04/26,32,9,0.6399535120000001,6023,32,4,5
43591,2014/03/31,2012/07/24,613,3,0.79649721,4839,613,3,0
43592,2014/03/31,2012/04/23,175,5,0.407713953,9453,175,2,3
43593,2014/03/31,2011/03/05,149,4,0.455182473,8467,149,2,2
43594,2014/03/31,2013/02/17,168,2,0.64144474,6008,168,1,1
43595,2014/03/31,2010/12/01,292,3,0.730540284,5275,292,2,1
43596,2014/03/31,2009/08/03,352,2,0.926099495,4161,352,0,2
43597,2014/03/31,2011/11/09,112,7,0.599011348,6433,112,2,5
43598,2014/03/31,2012/07/29,212,6,0.73832535,5219,212,4,2
43599,2014/03/31,2008/08/12,115,6,0.397026275,9705,115,0,6
43600,2014/03/31,2012/10/27,360,6,0.938840156,4104,360,5,1
43601,2014/03/31,2010/11/16,156,5,0.469366395,8207,156,1,4
43602,2014/03/31,2012/12/10,55,3,0.749850107,5137,55,2,1
43603,2014/03/31,2012/11/16,306,5,0.781446541,4929,306,1,4
43604,2014/03/31,2010/10/25,146,4,0.689282391,5588,146,0,4
43605,2014/03/31,2007/12/16,587,3,0.88973204,4329,587,3,0
43606,2014/03/31,2007/10/10,147,5,0.365179672,10547,147,3,2
43607,2014/03/31,2009/04/07,542,3,0.741385948,5195,542,3,0
43608,2014/03/31,2010/01/30,431,5,0.613998724,6272,431,5,0
43609,2014/03/31,2007/03/02,57,7,0.652694915,5900,57,5,2
43610,2014/03/31,2009/08/06,489,4,0.7879680790000001,4887,489,4,0
43611,2014/03/31,2007/11/18,117,6,0.668825777,5757,117,2,4
43612,2014/03/31,2011/12/27,94,5,0.7598815870000001,5067,94,0,5
43613,2014/03/31,2010/10/21,291,2,0.955334988,4030,291,1,1
43614,2014/03/31,2013/01/24,108,5,0.56,6875,108,0,5
43615,2014/03/31,2009/10/02,136,4,0.443166014,8686,136,0,4
43616,2014/03/31,2010/09/17,104,4,0.556709575,6914,104,2,2
43617,2014/03/31,2013/03/27,12,4,0.653355967,5891,12,0,4
43618,2014/03/31,2013/01/20,247,4,0.498666753,7718,247,2,2
43619,2014/03/31,2011/10/28,130,3,0.989632296,3889,130,2,1
43620,2014/03/31,2011/09/21,417,5,0.659432831,5836,417,5,0
43621,2014/03/31,2011/09/23,280,2,0.826713212,4655,280,1,1
43622,2014/03/31,2008/04/21,83,5,0.762,5050,83,4,1
43623,2014/03/31,2008/05/13,367,6,0.52970815,7264,367,6,0
43624,2014/03/31,2006/05/31,69,2,0.72,5344,69,0,2
43625,2014/03/31,2009/10/10,19,3,0.48,8016,19,0,3
43626,2014/03/31,2011/12/27,496,5,0.525850759,7317,496,5,0
43627,2014/03/31,2009/08/02,139,4,0.686752945,5602,139,1,3
43628,2014/03/31,2009/08/30,130,4,0.865294647,4446,130,0,4
43629,2014/03/31,2012/07/28,501,3,0.7470576809999999,5149,501,3,0
43630,2014/03/31,2011/07/21,62,6,0.621522055,6189,62,5,1
43631,2014/03/31,2006/08/17,123,4,0.7702342809999999,4994,123,2,2
43632,2014/03/31,2011/11/24,591,4,0.8,4808,591,4,0
43633,2014/03/31,2011/09/07,273,5,0.53563292,7181,273,3,2
43634,2014/03/31,2007/08/02,169,4,0.653230299,5888,169,0,4
43635,2014/03/31,2008/09/10,161,7,0.499631073,7698,161,0,7
43636,2014/03/31,2013/01/20,268,5,0.8533503440000001,4507,268,1,4
43637,2014/03/31,2007/02/08,550,4,0.907195093,4239,550,4,0
43638,2014/03/31,2012/07/09,250,3,1.0337634409999998,3720,250,2,1
43639,2014/03/31,2010/09/25,19,5,0.535273563,7183,19,3,2
43640,2014/03/31,2012/06/08,81,4,0.40676788,9452,81,1,3
43641,2014/03/31,2006/09/23,578,5,0.926337349,4150,578,5,0
43642,2014/03/31,2011/08/23,526,3,0.675571178,5690,526,3,0
43643,2014/03/31,2007/08/09,12,4,0.856403743,4488,12,1,3
43644,2014/03/31,2011/11/28,298,3,0.697423335,5511,298,2,1
43645,2014/03/31,2012/07/10,483,4,0.772522613,4975,483,4,0
43646,2014/03/31,2005/03/17,90,6,0.549981397,6988,90,3,3
43647,2014/03/31,2013/01/08,49,6,0.428732709,8964,49,5,1
43648,2014/03/31,2010/06/28,194,3,0.7359440829999999,5222,194,2,1
43649,2014/03/31,2011/10/07,443,2,1.5,2562,443,2,0
43650,2014/03/31,2009/10/24,535,3,0.82536512,4656,535,3,0
43651,2014/03/31,2005/04/07,32,4,0.6375,6028,32,2,2
43652,2014/03/31,2007/05/23,37,5,0.7228649359999999,5316,37,1,4
43653,2014/03/31,2011/11/26,164,6,0.580728427,6617,164,2,4
43654,2014/03/31,2012/09/05,154,3,0.82777682,4642,154,2,1
43655,2014/03/31,2007/03/20,317,2,0.925,4154,317,0,2
43656,2014/03/31,2011/08/01,14,3,0.6110718829999999,6288,14,0,3
43657,2014/03/31,2011/10/09,425,5,0.732367518,5246,425,5,0
43658,2014/03/31,2009/01/11,4,5,0.534933166,7182,4,2,3
43659,2014/03/31,2007/11/08,647,4,0.45,8536,647,4,0
43660,2014/03/31,2012/05/22,640,4,0.45,8536,640,4,0
43661,2014/03/31,2010/09/19,34,4,0.7375,5208,34,0,4
43662,2014/03/31,2011/01/13,611,5,0.892379182,4304,611,5,0
43663,2014/03/31,2012/05/15,115,4,0.542443503,7080,115,0,4
43664,2014/03/31,2008/05/07,31,3,0.605368852,6344,31,1,2
43665,2014/03/31,2010/07/26,312,4,0.9512757,4037,312,3,1
43666,2014/03/31,2009/01/14,221,8,0.484705882,7922,221,3,5
43667,2014/03/31,2011/12/22,147,6,0.509958826,7529,147,4,2
43668,2014/03/31,2011/08/27,36,4,0.35214528100000003,10903,36,2,2
43669,2014/03/31,2008/02/02,121,2,0.77,4986,121,0,2
43670,2014/03/31,2011/11/13,51,2,0.77,4986,51,0,2
43671,2014/03/31,2008/01/21,36,5,0.637109193,6026,36,3,2
43672,2014/03/31,2009/11/03,233,4,0.576873028,6655,233,2,2
43673,2014/03/31,2010/10/25,563,4,1.0,3839,563,4,0
43674,2014/03/31,2008/01/24,40,4,0.83108898,4619,40,3,1
43675,2014/03/31,2012/09/28,187,3,0.68560993,5599,187,1,2
43676,2014/03/31,2008/12/11,107,3,0.642661979,5973,107,0,3
43677,2014/03/31,2012/08/06,597,2,0.85,4516,597,2,0
43678,2014/03/31,2011/07/31,49,3,0.8733333329999999,4395,49,2,1
43679,2014/03/31,2011/09/27,589,5,0.655389477,5854,589,5,0
43680,2014/03/31,2011/07/10,489,2,0.625,6138,489,2,0
43681,2014/03/31,2013/01/25,237,2,0.625,6138,237,0,2
43682,2014/03/31,2005/08/10,154,6,0.5368345929999999,7146,154,2,4
43683,2014/03/31,2010/06/13,134,5,0.975595117,3932,134,3,2
43684,2014/03/31,2013/03/17,235,4,0.94294002,4068,235,2,2
43685,2014/03/31,2006/10/28,130,6,0.587857471,6525,130,2,4
43686,2014/03/31,2011/09/02,78,3,0.932357803,4114,78,2,1
43687,2014/03/31,2011/11/30,204,6,0.712947955,5380,204,3,3
43688,2014/03/31,2007/07/21,125,3,0.5722258689999999,6703,125,0,3
43689,2014/03/31,2007/02/25,22,5,1.182,3245,22,2,3
43690,2014/03/31,2008/06/06,18,3,0.887502893,4321,18,1,2
43691,2014/03/31,2006/08/17,232,5,0.6945662020000001,5521,232,1,4
43692,2014/03/31,2012/06/04,68,7,0.604427806,6344,68,3,4
43693,2014/03/31,2012/08/08,602,2,0.740660614,5177,602,2,0
43694,2014/03/31,2007/03/26,487,6,0.8310251409999999,4614,487,6,0
43695,2014/03/31,2011/07/22,324,3,1.184156887,3238,324,2,1
43696,2014/03/31,2009/02/20,76,3,0.909421252,4216,76,0,3
43697,2014/03/31,2008/05/11,195,3,1.362996801,2813,195,1,2
43698,2014/03/31,2007/06/12,390,5,0.6040491570000001,6347,390,5,0
43699,2014/03/31,2006/12/05,492,7,0.740830918,5175,492,7,0
43700,2014/03/31,2011/11/21,702,3,0.972058824,3944,702,3,0
43701,2014/03/31,2012/07/31,607,3,0.972058824,3944,607,3,0
43702,2014/03/31,2007/05/29,12,6,0.507633739,7552,12,5,1
43703,2014/03/31,2007/09/19,142,3,0.912081846,4203,142,1,2
43704,2014/03/31,2006/07/22,64,3,0.600761636,6381,64,0,3
43705,2014/03/31,2012/05/10,584,5,0.667116255,5746,584,5,0
43706,2014/03/31,2013/02/08,76,5,0.6751021490000001,5678,76,1,4
43707,2014/03/31,2011/01/28,166,4,0.800062617,4791,166,1,3
43708,2014/03/31,2009/12/10,51,5,0.484645341,7909,51,1,4
43709,2014/03/31,2012/07/05,491,3,1.0,3833,491,3,0
43710,2014/03/31,2011/09/13,138,4,0.499825248,7668,138,0,4
43711,2014/03/31,2009/02/22,558,3,0.7311426940000001,5242,558,3,0
43712,2014/03/31,2010/07/19,89,5,0.66664579,5748,89,0,5
43713,2014/03/31,2008/04/07,101,5,0.547199372,7002,101,2,3
43714,2014/03/31,2010/08/15,689,2,0.525,7298,689,2,0
43715,2014/03/31,2008/03/17,691,2,0.825,4644,691,2,0
43716,2014/03/31,2011/08/03,641,2,0.825,4644,641,2,0
43717,2014/03/31,2011/07/19,533,2,0.8,4789,533,2,0
43718,2014/03/31,2010/04/11,234,4,0.876078207,4373,234,3,1
43719,2014/03/31,2008/07/13,66,4,0.73,5248,66,0,4
43720,2014/03/31,2010/07/09,54,5,0.607344221,6307,54,4,1
43721,2014/03/31,2012/10/28,372,5,0.535971173,7146,372,5,0
43722,2014/03/31,2011/09/28,132,5,0.616158301,6216,132,0,5
43723,2014/03/31,2011/02/15,86,3,0.7034882440000001,5444,86,0,3
43724,2014/03/31,2011/08/19,236,4,0.436935189,8764,236,3,1
43725,2014/03/31,2011/04/23,292,4,0.72290353,5297,292,3,1
43726,2014/03/31,2010/09/24,45,5,0.74609509,5132,45,0,5
43727,2014/03/31,2008/07/24,250,3,0.957638819,3998,250,1,2
43728,2014/03/31,2008/05/24,326,5,0.514204164,7445,326,4,1
43729,2014/03/31,2012/10/29,117,4,0.653582039,5857,117,1,3
43730,2014/03/31,2012/05/26,148,2,0.58,6600,148,0,2
43731,2014/03/31,2012/12/27,267,4,0.487461774,7848,267,3,1
43732,2014/03/31,2012/03/30,349,10,0.478552664,7994,349,9,1
43733,2014/03/31,2008/04/13,639,6,1.034983766,3696,639,6,0
43734,2014/03/31,2007/06/26,526,2,0.85,4500,526,2,0
43735,2014/03/31,2012/02/24,230,3,0.79708837,4798,230,2,1
43736,2014/03/31,2012/04/30,196,4,0.685871593,5576,196,2,2
43737,2014/03/31,2007/10/31,591,6,1.0,3824,591,6,0
43738,2014/03/31,2007/08/02,494,4,0.954329923,4007,494,4,0
43739,2014/03/31,2010/11/08,22,2,1.1971540390000002,3194,22,1,1
43740,2014/03/31,2012/05/05,159,8,0.634386926,6027,159,4,4
43741,2014/03/31,2011/08/27,18,4,0.647868158,5901,18,0,4
43742,2014/03/31,2010/01/24,177,3,0.906138895,4219,177,2,1
43743,2014/03/31,2011/09/02,123,3,0.754472074,5067,123,2,1
43744,2014/03/31,2010/02/17,301,5,0.451592439,8465,301,3,2
43745,2014/03/31,2011/02/08,545,3,0.776457445,4923,545,3,0
43746,2014/03/31,2007/03/01,536,5,0.751425201,5087,536,5,0
43747,2014/03/31,2012/06/19,156,4,0.6875,5560,156,2,2
43748,2014/03/31,2013/01/22,190,4,0.59187829,6458,190,2,2
43749,2014/03/31,2007/05/10,154,2,0.92,4154,154,0,2
43750,2014/03/31,2008/08/21,72,2,0.92,4154,72,0,2
43751,2014/03/31,2011/07/09,367,5,0.5967286070000001,6404,367,5,0
43752,2014/03/31,2008/04/02,386,5,0.7161075709999999,5336,386,5,0
43753,2014/03/31,2008/08/29,64,3,0.8242256259999999,4636,64,0,3
43754,2014/03/31,2005/06/16,14,2,1.345447183,2840,14,0,2
43755,2014/03/31,2010/05/20,59,2,0.715,5344,59,0,2
43756,2014/03/31,2012/07/31,5,5,0.500302475,7637,5,1,4
43757,2014/03/31,2010/05/18,512,6,0.601416654,6353,512,6,0
43758,2014/03/31,2013/01/01,278,5,0.431692655,8850,278,2,3
43759,2014/03/31,2011/09/01,380,3,0.6986832479999999,5468,380,3,0
43760,2014/03/31,2013/01/15,438,2,0.8412133890000001,4541,438,2,0
43761,2014/03/31,2009/02/07,284,4,0.58318626,6550,284,2,2
43762,2014/03/31,2012/11/03,121,7,0.488385117,7821,121,4,3
43763,2014/03/31,2009/02/12,402,3,0.972650879,3927,402,3,0
43764,2014/03/31,2010/01/01,539,3,0.7809241459999999,4891,539,3,0
43765,2014/03/31,2012/11/22,167,3,0.973333333,3924,167,1,2
43766,2014/03/31,2011/01/13,25,3,0.6839595270000001,5584,25,0,3
43767,2014/03/31,2009/01/02,73,4,0.892711547,4278,73,1,3
43768,2014/03/31,2008/03/15,43,2,0.95,4020,43,0,2
43769,2014/03/31,2008/08/20,335,4,0.725712657,5262,335,3,1
43770,2014/03/31,2012/05/25,574,3,0.6166585920000001,6192,574,3,0
43771,2014/03/31,2008/05/13,400,3,0.837875795,4557,400,3,0
43772,2014/03/31,2012/04/12,518,5,0.819356223,4660,518,5,0
43773,2014/03/31,2008/07/30,75,7,0.646262695,5908,75,5,2
43774,2014/03/31,2009/03/25,319,5,0.812351064,4700,319,4,1
43775,2014/03/31,2010/08/25,35,3,0.701039486,5445,35,0,3
43776,2014/03/31,2010/12/28,144,8,0.616463178,6192,144,1,7
43777,2014/03/31,2008/04/13,557,4,0.951608078,4011,557,4,0
43778,2014/03/31,2007/09/19,488,5,0.710348036,5373,488,5,0
43779,2014/03/31,2010/01/17,58,5,0.555701805,6868,58,1,4
43780,2014/03/31,2010/12/22,129,3,0.8336631720000001,4578,129,1,2
43781,2014/03/31,2010/01/14,595,4,0.786217553,4854,595,4,0
43782,2014/03/31,2007/09/28,140,2,0.97,3934,140,1,1
43783,2014/03/31,2011/10/26,47,3,0.6466666670000001,5901,47,1,2
43784,2014/03/31,2009/10/28,368,5,0.689100596,5537,368,5,0
43785,2014/03/31,2011/11/15,192,2,0.65,5870,192,0,2
43786,2014/03/31,2012/01/19,332,2,0.95,4016,332,0,2
43787,2014/03/31,2008/08/25,313,4,0.625,6104,313,3,1
43788,2014/03/31,2010/03/19,2,5,0.94781118,4025,2,4,1
43789,2014/03/31,2007/11/04,25,4,0.745670446,5116,25,2,2
43790,2014/03/31,2008/10/24,206,4,0.637899666,5980,206,1,3
43791,2014/03/31,2008/04/10,102,4,0.8375010979999999,4554,102,2,2
43792,2014/03/31,2013/03/22,109,4,0.727379363,5243,109,0,4
43793,2014/03/31,2013/03/12,155,4,0.565789318,6740,155,1,3
43794,2014/03/31,2010/09/08,233,4,0.8461060570000001,4507,233,1,3
43795,2014/03/31,2006/08/02,268,7,0.418154403,9119,268,6,1
43796,2014/03/31,2007/12/27,165,11,0.483076143,7893,165,10,1
43797,2014/03/31,2012/07/17,261,4,0.488708024,7802,261,1,3
43798,2014/03/31,2007/03/28,166,4,0.7175197590000001,5314,166,2,2
43799,2014/03/31,2011/05/30,448,7,0.626833279,6082,448,7,0
43800,2014/03/31,2012/10/16,364,6,0.7447353,5119,364,5,1
43801,2014/03/31,2012/10/21,119,6,0.6433040839999999,5926,119,1,5
43802,2014/03/31,2012/03/01,1,5,0.408395115,9334,1,1,4
43803,2014/03/31,2012/03/24,38,3,0.76937828,4954,38,2,1
43804,2014/03/31,2008/11/25,147,6,0.622174339,6126,147,4,2
43805,2014/03/31,2012/06/09,550,3,0.399889833,9531,550,3,0
43806,2014/03/31,2010/09/06,238,5,0.8201656979999999,4647,238,2,3
43807,2014/03/31,2012/01/03,133,2,0.93,4098,133,0,2
43808,2014/03/31,2013/02/24,34,6,0.5716244189999999,6667,34,2,4
43809,2014/03/31,2011/08/24,186,5,0.6275967720000001,6071,186,0,5
43810,2014/03/31,2011/04/24,603,6,1.0,3810,603,6,0
43811,2014/03/31,2010/04/27,145,4,0.689695873,5524,145,2,2
43812,2014/03/31,2011/06/13,232,5,0.697646951,5461,232,3,2
43813,2014/03/31,2011/09/01,122,6,0.355861199,10706,122,4,2
43814,2014/03/31,2011/12/22,76,5,0.586480911,6496,76,1,4
43815,2014/03/31,2012/07/18,201,3,0.45,8466,201,1,2
43816,2014/03/31,2007/02/10,321,5,0.8407636279999999,4531,321,4,1
43817,2014/03/31,2010/01/15,50,4,0.7278200229999999,5234,50,0,4
43818,2014/03/31,2007/06/26,42,4,0.725435155,5251,42,0,4
43819,2014/03/31,2009/06/26,14,4,0.622346405,6120,14,0,4
43820,2014/03/31,2009/02/22,349,5,0.564677539,6745,349,4,1
43821,2014/03/31,2012/11/10,302,4,0.552276682,6896,302,3,1
43822,2014/03/31,2013/03/20,22,2,0.67,5684,22,0,2
43823,2014/03/31,2007/04/10,62,8,0.7088011909999999,5372,62,1,7
43824,2014/03/31,2008/08/14,46,4,0.614478696,6196,46,3,1
43825,2014/03/31,2013/03/01,73,5,0.578783825,6578,73,2,3
43826,2014/03/31,2010/11/26,57,5,0.762660256,4992,57,3,2
43827,2014/03/31,2007/08/06,317,4,0.483797179,7869,317,2,2
43828,2014/03/31,2011/10/10,155,3,1.117077465,3408,155,2,1
43829,2014/03/31,2008/03/11,562,3,0.735064684,5179,562,3,0
43830,2014/03/31,2012/12/27,154,3,0.595606321,6391,154,1,2
43831,2014/03/31,2006/08/17,314,7,0.729344702,5219,314,5,2
43832,2014/03/31,2012/09/11,513,3,0.65,5856,513,3,0
43833,2014/03/31,2007/03/13,140,4,0.714662035,5326,140,2,2
43834,2014/03/31,2012/05/06,151,5,0.590690672,6443,151,3,2
43835,2014/03/31,2009/10/06,79,5,0.692969774,5492,79,1,4
43836,2014/03/31,2010/07/18,426,3,0.627746618,6062,426,3,0
43837,2014/03/31,2011/06/21,112,6,0.53877814,7063,112,2,4
43838,2014/03/31,2013/03/27,43,2,0.498654174,7631,43,1,1
43839,2014/03/31,2011/05/21,282,2,0.515,7388,282,0,2
43840,2014/03/31,2008/02/09,145,5,1.086778063,3501,145,2,3
43841,2014/03/31,2012/11/13,348,2,0.8,4756,348,0,2
43842,2014/03/31,2011/11/29,44,3,0.639445378,5950,44,1,2
43843,2014/03/31,2013/03/01,110,5,0.744831637,5108,110,1,4
43844,2014/03/31,2008/08/31,182,2,0.685128759,5553,182,0,2
43845,2014/03/31,2009/08/25,53,3,0.599601261,6345,53,0,3
43846,2014/03/31,2006/02/11,426,4,0.575,6616,426,4,0
43847,2014/03/31,2009/09/15,394,5,0.806273845,4718,394,5,0
43848,2014/03/31,2012/12/07,2,5,0.476797443,7978,2,2,3
43849,2014/03/31,2010/12/10,386,3,1.132375707,3359,386,3,0
43850,2014/03/31,2007/04/27,519,4,0.52997074,7177,519,4,0
43851,2014/03/31,2013/03/06,235,3,0.7982014690000001,4765,235,1,2
43852,2014/03/31,2010/01/01,1,9,0.554007283,6865,1,0,9
43853,2014/03/31,2012/04/17,505,9,0.878088201,4331,505,9,0
43854,2014/03/31,2011/10/19,342,3,1.0,3803,342,2,1
43855,2014/03/31,2011/02/02,268,4,0.786535677,4835,268,3,1
43856,2014/03/31,2013/01/11,9,5,0.685391132,5548,9,1,4
43857,2014/03/31,2012/06/20,340,4,0.870244907,4369,340,3,1
43858,2014/03/31,2012/10/30,234,4,0.653824592,5815,234,2,2
43859,2014/03/31,2011/01/24,133,5,0.673256596,5647,133,3,2
43860,2014/03/31,2008/10/08,208,4,0.792077516,4799,208,2,2
43861,2014/03/31,2011/10/10,18,5,0.3906073370000001,9731,18,3,2
43862,2014/03/31,2007/02/04,136,5,0.867598722,4381,136,3,2
43863,2014/03/31,2012/09/09,360,5,0.670125176,5672,360,4,1
43864,2014/03/31,2012/01/16,223,3,0.709747899,5355,223,1,2
43865,2014/03/31,2012/05/05,579,5,0.618764246,6142,579,5,0
43866,2014/03/31,2006/09/23,534,3,0.724952308,5242,534,3,0
43867,2014/03/31,2007/10/10,268,3,0.7145092140000001,5318,268,1,2
43868,2014/03/31,2008/10/22,36,6,0.8783333329999999,4326,36,2,4
43869,2014/03/31,2012/10/09,58,3,0.673333333,5643,58,0,3
43870,2014/03/31,2012/10/23,117,5,0.782825057,4853,117,0,5
43871,2014/03/31,2012/08/30,91,4,0.63232024,6008,91,1,3
43872,2014/03/31,2008/11/20,47,4,0.52319697,7260,47,1,3
43873,2014/03/31,2013/01/23,179,4,0.675730297,5621,179,2,2
43874,2014/03/31,2008/04/12,134,4,0.549352039,6914,134,3,1
43875,2014/03/31,2010/03/01,11,4,0.845724783,4491,11,2,2
43876,2014/03/31,2013/03/15,32,2,0.8741219790000001,4345,32,1,1
43877,2014/03/31,2013/03/01,342,3,0.73020573,5201,342,0,3
43878,2014/03/31,2013/02/10,15,5,0.923565175,4112,15,1,4
43879,2014/03/31,2012/09/11,394,6,0.483216694,7859,394,6,0
43880,2014/03/31,2008/10/25,299,5,0.8140000000000001,4665,299,0,5
43881,2014/03/31,2013/03/12,22,5,0.8140000000000001,4665,22,2,3
43882,2014/03/31,2007/03/27,225,3,0.6912670670000001,5493,225,1,2
43883,2014/03/31,2006/07/17,282,3,0.906873657,4187,282,2,1
43884,2014/03/31,2012/02/25,17,6,0.646733095,5871,17,4,2
43885,2014/03/31,2013/01/03,305,8,0.44581024,8516,305,3,5
43886,2014/03/31,2009/06/21,16,8,0.891521841,4258,16,5,3
43887,2014/03/31,2008/04/22,400,4,0.733571705,5174,400,4,0
43888,2014/03/31,2006/07/20,525,3,0.895974976,4236,525,3,0
43889,2014/03/31,2013/02/01,173,4,0.948592852,4001,173,1,3
43890,2014/03/31,2010/08/12,282,5,0.607136,6250,282,4,1
43891,2014/03/31,2012/12/25,124,4,0.541372521,7009,124,1,3
43892,2014/03/31,2012/11/11,497,2,0.7,5420,497,2,0
43893,2014/03/31,2012/09/06,570,2,0.7,5420,570,2,0
43894,2014/03/31,2008/02/06,506,2,0.7,5420,506,2,0
43895,2014/03/31,2011/08/16,458,2,0.7,5420,458,2,0
43896,2014/03/31,2012/03/29,37,3,0.7147682740000001,5308,37,2,1
43897,2014/03/31,2013/01/13,244,3,0.586990562,6463,244,1,2
43898,2014/03/31,2010/10/14,308,6,0.570738679,6647,308,4,2
43899,2014/03/31,2013/03/22,151,4,0.579161832,6550,151,1,3
43900,2014/03/31,2012/12/14,194,5,0.690327571,5495,194,1,4
43901,2014/03/31,2010/05/27,37,4,0.7397230890000001,5128,37,2,2
43902,2014/03/31,2011/06/13,140,5,0.7688870870000001,4933,140,1,4
43903,2014/03/31,2011/01/25,189,6,0.526263355,7207,189,4,2
43904,2014/03/31,2013/01/12,108,2,0.925,4100,108,1,1
43905,2014/03/31,2006/07/14,330,4,0.7674863390000001,4941,330,1,3
43906,2014/03/31,2011/09/19,511,4,0.4334323920000001,8749,511,4,0
43907,2014/03/31,2012/05/18,332,4,0.68275117,5554,332,1,3
43908,2014/03/31,2011/02/26,237,4,0.622985541,6086,237,3,1
43909,2014/03/31,2008/03/16,72,7,0.549162804,6904,72,0,7
43910,2014/03/31,2013/01/23,63,4,0.521695335,7267,63,0,4
43911,2014/03/31,2012/08/05,380,6,0.508865772,7450,380,6,0
43912,2014/03/31,2008/08/23,72,3,0.501720487,7556,72,0,3
43913,2014/03/31,2005/07/04,155,8,0.588357908,6443,155,4,4
43914,2014/03/31,2012/09/02,290,5,0.553385401,6850,290,2,3
43915,2014/03/31,2012/05/08,69,3,0.734897247,5158,69,2,1
43916,2014/03/31,2008/02/20,116,4,0.939246592,4035,116,1,3
43917,2014/03/31,2012/07/27,201,3,0.8871348309999999,4272,201,1,2
43918,2014/03/31,2010/10/30,349,4,0.433814103,8736,349,2,2
43919,2014/03/31,2010/09/30,330,3,0.6148953429999999,6163,330,1,2
43920,2014/03/31,2011/01/13,549,3,0.543516925,6972,549,3,0
43921,2014/03/31,2011/10/31,337,5,0.7978942940000001,4749,337,2,3
43922,2014/03/31,2010/01/11,152,3,0.551849694,6866,152,2,1
43923,2014/03/31,2011/09/30,29,4,0.655,5784,29,2,2
43924,2014/03/31,2007/09/11,221,3,0.596313553,6353,221,2,1
43925,2014/03/31,2008/11/11,9,4,0.510402856,7422,9,1,3
43926,2014/03/31,2007/08/04,503,4,0.8354322890000001,4534,503,4,0
43927,2014/03/31,2008/10/08,118,6,0.695018349,5450,118,0,6
43928,2014/03/31,2011/07/13,464,4,0.914634146,4141,464,4,0
43929,2014/03/31,2008/10/31,4,4,0.635434564,5960,4,1,3
43930,2014/03/31,2007/09/15,409,5,0.92591687,4090,409,5,0
43931,2014/03/31,2012/11/27,453,3,0.7537818470000001,5024,453,3,0
43932,2014/03/31,2010/07/24,592,3,0.6940696609999999,5455,592,3,0
43933,2014/03/31,2011/04/21,145,4,0.852384598,4441,145,1,3
43934,2014/03/31,2013/02/05,80,6,0.860131788,4401,80,4,2
43935,2014/03/31,2007/06/26,157,7,0.453822084,8341,157,5,2
43936,2014/03/31,2006/05/06,186,4,0.727514895,5203,186,3,1
43937,2014/03/31,2011/07/24,400,4,0.566285159,6684,400,4,0
43938,2014/03/31,2007/03/07,503,3,0.6758214290000001,5600,503,3,0
43939,2014/03/31,2007/12/19,234,2,0.882097902,4290,234,0,2
43940,2014/03/31,2008/02/21,37,5,0.550869249,6868,37,2,3
43941,2014/03/31,2008/08/09,145,5,0.434460266,8708,145,2,3
43942,2014/03/31,2011/12/06,322,3,0.932281912,4058,322,2,1
43943,2014/03/31,2012/05/15,25,7,0.422179444,8961,25,4,3
43944,2014/03/31,2007/10/16,75,3,1.41,2683,75,0,3
43945,2014/03/31,2007/03/18,99,3,0.7642424240000001,4950,99,0,3
43946,2014/03/31,2013/01/11,12,2,0.674764538,5606,12,0,2
43947,2014/03/31,2013/03/28,331,4,0.660378841,5728,331,2,2
43948,2014/03/31,2012/09/02,415,3,0.7650485440000001,4944,415,3,0
43949,2014/03/31,2007/03/15,632,5,0.6728962820000001,5621,632,5,0
43950,2014/03/31,2010/09/03,542,4,0.50493992,7490,542,4,0
43951,2014/03/31,2012/04/04,134,4,0.49716051,7607,134,2,2
43952,2014/03/31,2012/02/25,451,4,0.729523534,5184,451,4,0
43953,2014/03/31,2013/02/26,56,4,0.948956085,3985,56,1,3
43954,2014/03/31,2010/01/01,34,4,0.7018299929999999,5388,34,0,4
43955,2014/03/31,2008/01/07,20,4,0.6875272729999999,5500,20,0,4
43956,2014/03/31,2012/08/06,525,4,0.848183042,4458,525,4,0
43957,2014/03/31,2008/09/11,192,2,0.6045315,6254,192,0,2
43958,2014/03/31,2005/04/20,138,3,0.782903293,4829,138,1,2
43959,2014/03/31,2012/08/02,172,5,0.895452392,4222,172,4,1
43960,2014/03/31,2007/04/16,3,5,0.7728086670000001,4892,3,0,5
43961,2014/03/31,2010/05/24,421,2,0.72340222,5226,421,2,0
43962,2014/03/31,2009/03/07,57,3,0.643905638,5871,57,0,3
43963,2014/03/31,2007/07/24,174,2,0.91,4154,174,0,2
43964,2014/03/31,2006/03/20,263,6,0.478616105,7898,263,5,1
43965,2014/03/31,2010/03/11,627,3,0.7064100170000001,5351,627,3,0
43966,2014/03/31,2011/06/14,403,4,0.581387479,6501,403,4,0
43967,2014/03/31,2012/10/29,136,7,0.539550321,7005,136,3,4
43968,2014/03/31,2013/01/14,23,4,0.7217284190000001,5236,23,2,2
43969,2014/03/31,2012/06/15,25,4,1.062082631,3558,25,3,1
43970,2014/03/31,2013/03/28,186,4,0.6293904060000001,6004,186,0,4
43971,2014/03/31,2011/01/15,262,4,0.514332381,7347,262,2,2
43972,2014/03/31,2009/12/22,116,6,0.669996454,5640,116,3,3
43973,2014/03/31,2012/01/11,151,4,0.942974794,4007,151,2,2
43974,2014/03/31,2012/01/17,72,3,1.056011738,3578,72,1,2
43975,2014/03/31,2010/04/16,85,6,0.564815313,6687,85,0,6
43976,2014/03/31,2013/03/19,81,5,0.611046756,6181,81,0,5
43977,2014/03/31,2011/08/11,191,2,0.739745348,5105,191,1,1
43978,2014/03/31,2013/01/08,126,6,0.526666667,7170,126,1,5
43979,2014/03/31,2013/02/10,85,5,0.5702234970000001,6622,85,0,5
43980,2014/03/31,2011/04/28,6,3,0.70761057,5336,6,1,2
43981,2014/03/31,2012/12/20,6,3,0.483333333,7812,6,1,2
43982,2014/03/31,2012/10/11,522,6,0.793985279,4755,522,6,0
43983,2014/03/31,2011/05/09,157,5,0.4430595000000001,8521,157,2,3
43984,2014/03/31,2011/10/25,97,6,0.870463454,4337,97,5,1
43985,2014/03/31,2012/07/07,279,8,0.381211754,9903,279,6,2
43986,2014/03/31,2006/11/26,529,2,1.0,3775,529,2,0
43987,2014/03/31,2009/09/16,32,5,0.638371385,5913,32,0,5
43988,2014/03/31,2012/09/03,324,3,0.819010417,4608,324,2,1
43989,2014/03/31,2008/07/30,579,3,1.5,2516,579,3,0
43990,2014/03/31,2012/10/02,428,4,0.889010601,4245,428,4,0
43991,2014/03/31,2011/05/09,86,3,0.726666667,5193,86,1,2
43992,2014/03/31,2009/10/31,151,6,0.765988632,4926,151,1,5
43993,2014/03/31,2010/03/10,158,6,0.797674419,4730,158,4,2
43994,2014/03/31,2011/05/28,107,4,0.843413816,4473,107,1,3
43995,2014/03/31,2012/06/07,195,6,0.457581271,8244,195,4,2
43996,2014/03/31,2012/07/01,101,6,0.819218071,4604,101,0,6
43997,2014/03/31,2009/06/21,463,4,0.600860421,6276,463,4,0
43998,2014/03/31,2007/03/26,4,6,0.7525244459999999,5011,4,5,1
43999,2014/03/31,2013/03/08,31,2,0.589709102,6394,31,0,2
44000,2014/03/31,2009/07/31,114,4,0.627876769,6005,114,2,2
44001,2014/03/31,2009/11/15,75,11,0.5060697989999999,7450,75,2,9
44002,2014/03/31,2012/08/11,95,5,0.665393576,5666,95,1,4
44003,2014/03/31,2006/12/09,567,5,1.0,3770,567,5,0
44004,2014/03/31,2012/11/24,109,4,0.692043327,5447,109,0,4
44005,2014/03/31,2011/03/27,68,6,0.7114684790000001,5298,68,3,3
44006,2014/03/31,2008/11/06,81,3,0.915094706,4118,81,0,3
44007,2014/03/31,2010/06/02,62,5,0.503910136,7478,62,4,1
44008,2014/03/31,2008/04/25,193,3,0.809626128,4654,193,1,2
44009,2014/03/31,2012/07/24,612,2,0.55,6850,612,2,0
44010,2014/03/31,2012/06/01,25,4,0.771554372,4883,25,2,2
44011,2014/03/31,2012/12/06,178,3,0.470002495,8015,178,1,2
44012,2014/03/31,2012/09/18,392,6,0.825,4566,392,6,0
44013,2014/03/31,2013/03/24,225,4,0.752785771,5004,225,1,3
44014,2014/03/31,2012/08/01,69,7,0.640200544,5884,69,1,6
44015,2014/03/31,2012/01/12,652,5,0.497477216,7571,652,5,0
44016,2014/03/31,2013/03/13,28,4,0.8789708279999999,4285,28,0,4
44017,2014/03/31,2012/11/22,20,7,0.499440393,7541,20,1,6
44018,2014/03/31,2011/06/05,536,5,0.987932844,3812,536,5,0
44019,2014/03/31,2009/08/06,362,6,0.8186847829999999,4600,362,4,2
44020,2014/03/31,2012/06/19,127,6,0.3784494020000001,9951,127,4,2
44021,2014/03/31,2008/05/07,85,5,0.496201081,7589,85,1,4
44022,2014/03/31,2006/05/02,209,4,0.487059889,7731,209,3,1
44023,2014/03/31,2007/04/28,216,6,0.64165985,5868,216,4,2
44024,2014/03/31,2011/01/13,130,5,0.454686632,8281,130,1,4
44025,2014/03/31,2010/06/29,617,2,0.8376418240000001,4495,617,2,0
44026,2014/03/31,2012/07/24,3,4,0.695063688,5417,3,3,1
44027,2014/03/31,2011/10/11,200,5,1.212989691,3104,200,2,3
44028,2014/03/31,2013/03/26,3,5,0.736660145,5111,3,2,3
44029,2014/03/31,2010/01/09,236,8,0.6894213509999999,5461,236,2,6
44030,2014/03/31,2011/07/08,352,3,0.699637614,5381,352,2,1
44031,2014/03/31,2013/01/26,225,4,0.922474884,4081,225,1,3
44032,2014/03/31,2013/02/04,258,5,0.589769701,6383,258,1,4
44033,2014/03/31,2010/12/06,466,8,0.640261949,5879,466,8,0
44034,2014/03/31,2012/03/15,485,3,0.7731306490000001,4868,485,3,0
44035,2014/03/31,2012/08/23,107,4,0.540798965,6959,107,3,1
44036,2014/03/31,2009/07/25,84,5,0.727743183,5171,84,1,4
44037,2014/03/31,2008/06/01,78,4,0.573018121,6567,78,3,1
44038,2014/03/31,2012/08/29,162,5,0.585546218,6426,162,4,1
44039,2014/03/31,2010/11/19,32,5,0.394,9550,32,1,4
44040,2014/03/31,2007/10/18,154,4,0.514013661,7320,154,1,3
44041,2014/03/31,2012/08/19,9,6,0.478333333,7866,9,1,5
44042,2014/03/31,2012/04/18,706,5,0.81,4645,706,5,0
44043,2014/03/31,2012/08/31,60,4,0.830289119,4531,60,2,2
44044,2014/03/31,2007/11/30,193,4,0.704717123,5338,193,0,4
44045,2014/03/31,2006/05/09,183,4,0.544786387,6905,183,2,2
44046,2014/03/31,2011/09/16,95,5,0.6638404520000001,5666,95,3,2
44047,2014/03/31,2009/09/27,15,6,0.589251136,6383,15,1,5
44048,2014/03/31,2005/04/04,125,4,1.38732571,2711,125,2,2
44049,2014/03/31,2013/01/05,207,4,0.849369919,4428,207,0,4
44050,2014/03/31,2012/02/04,175,3,0.659015244,5707,175,2,1
44051,2014/03/31,2011/03/18,215,6,0.6733840640000001,5585,215,2,4
44052,2014/03/31,2009/01/22,16,4,0.793823095,4737,16,0,4
44053,2014/03/31,2011/01/15,17,5,0.8059999999999999,4665,17,3,2
44054,2014/03/31,2005/05/14,419,2,0.9005029940000001,4175,419,2,0
44055,2014/03/31,2009/01/23,21,6,0.6015168000000001,6250,21,2,4
44056,2014/03/31,2008/05/22,652,3,0.564813702,6656,652,3,0
44057,2014/03/31,2006/08/24,290,2,0.49,7672,290,0,2
44058,2014/03/31,2007/09/27,14,5,0.632410834,5944,14,2,3
44059,2014/03/31,2007/07/09,380,4,0.690077107,5447,380,4,0
44060,2014/03/31,2010/02/16,134,5,0.53475032,7029,134,3,2
44061,2014/03/31,2012/08/30,20,8,0.393010247,9564,20,5,3
44062,2014/03/31,2011/05/02,40,2,0.935,4020,40,1,1
44063,2014/03/31,2012/03/22,633,4,0.607409502,6188,633,4,0
44064,2014/03/31,2012/09/24,317,4,0.892577197,4210,317,2,2
44065,2014/03/31,2011/11/21,501,4,0.7507692309999999,5005,501,4,0
44066,2014/03/31,2011/01/13,38,6,0.350275007,10727,38,3,3
44067,2014/03/31,2006/09/06,157,5,0.649844345,5782,157,4,1
44068,2014/03/31,2005/03/28,190,3,0.7074599890000001,5311,190,1,2
44069,2014/03/31,2010/08/31,585,5,0.679585745,5528,585,5,0
44070,2014/03/31,2007/11/15,360,5,0.437379206,8589,360,4,1
44071,2014/03/31,2009/11/16,150,5,0.760528447,4939,150,2,3
44072,2014/03/31,2012/05/02,145,5,0.55895669,6719,145,4,1
44073,2014/03/31,2011/12/27,102,5,0.615544993,6101,102,1,4
44074,2014/03/31,2011/05/03,663,3,0.514319956,7301,663,3,0
44075,2014/03/31,2011/10/25,204,4,0.6610862679999999,5680,204,0,4
44076,2014/03/31,2012/09/11,24,5,0.5456146470000001,6882,24,1,4
44077,2014/03/31,2010/11/01,178,4,0.7423408459999999,5058,178,1,3
44078,2014/03/31,2011/07/28,671,4,0.784988501,4783,671,4,0
44079,2014/03/31,2012/11/21,351,5,0.7056004509999999,5321,351,3,2
44080,2014/03/31,2012/10/30,88,3,0.6680195729999999,5620,88,0,3
44081,2014/03/31,2013/01/23,430,4,0.620931194,6046,430,4,0
44082,2014/03/31,2012/03/16,13,4,0.849180995,4420,13,1,3
44083,2014/03/31,2009/10/29,312,2,0.55,6824,312,0,2
44084,2014/03/31,2009/11/14,273,4,0.7239872690000001,5184,273,0,4
44085,2014/03/31,2005/12/14,116,2,0.89,4217,116,0,2
44086,2014/03/31,2009/11/17,180,4,0.599707574,6258,180,2,2
44087,2014/03/31,2013/02/15,243,4,0.6916162920000001,5426,243,0,4
44088,2014/03/31,2009/12/11,2,4,0.8126158509999999,4618,2,2,2
44089,2014/03/31,2012/04/11,388,6,0.63723043,5889,388,6,0
44090,2014/03/31,2012/04/15,207,5,0.723439368,5187,207,4,1
44091,2014/03/31,2012/07/02,106,8,0.701495607,5349,106,1,7
44092,2014/03/31,2008/05/08,184,4,0.8991804459999999,4173,184,2,2
44093,2014/03/31,2011/08/08,26,3,0.437723985,8572,26,1,2
44094,2014/03/31,2012/08/20,559,3,0.532047646,7052,559,3,0
44095,2014/03/31,2007/04/06,140,2,0.7803660570000001,4808,140,0,2
44096,2014/03/31,2008/05/13,3,8,0.429125014,8743,3,1,7
44097,2014/03/31,2011/07/13,234,4,0.811522821,4623,234,1,3
44098,2014/03/31,2010/12/09,247,2,0.66,5684,247,0,2
44099,2014/03/31,2013/03/15,50,2,0.66,5684,50,1,1
44100,2014/03/31,2011/12/21,2,6,0.76357012,4913,2,4,2
44101,2014/03/31,2013/03/09,172,3,0.6418531829999999,5844,172,1,2
44102,2014/03/31,2006/08/06,82,7,0.574285714,6531,82,6,1
44103,2014/03/31,2011/10/31,270,5,0.592873854,6326,270,3,2
44104,2014/03/31,2011/08/06,607,4,0.785599078,4774,607,4,0
44105,2014/03/31,2011/08/01,320,3,0.748433446,5011,320,0,3
44106,2014/03/31,2009/08/18,278,3,0.980486275,3825,278,0,3
44107,2014/03/31,2013/02/03,154,5,0.662,5665,154,1,4
44108,2014/03/31,2006/02/09,470,3,0.916870416,4090,470,3,0
44109,2014/03/31,2011/06/15,9,4,0.938905859,3994,9,1,3
44110,2014/03/31,2011/03/24,1,5,0.661538462,5668,1,0,5
44111,2014/03/31,2012/06/03,195,7,0.479723644,7816,195,5,2
44112,2014/03/31,2009/03/04,526,7,0.881796802,4252,526,7,0
44113,2014/03/31,2012/11/20,293,6,0.710511654,5277,293,3,3
44114,2014/03/31,2010/06/09,97,6,0.566264915,6621,97,1,5
44115,2014/03/31,2012/04/05,14,7,0.632756118,5925,14,0,7
44116,2014/03/31,2009/04/14,26,4,0.634349298,5909,26,2,2
44117,2014/03/31,2007/03/06,469,3,0.935192116,4008,469,3,0
44118,2014/03/31,2010/05/20,410,2,1.0,3748,410,2,0
44119,2014/03/31,2011/10/03,123,6,0.645195386,5809,123,2,4
44120,2014/03/31,2005/05/26,1,5,0.719917403,5206,1,3,2
44121,2014/03/31,2011/01/24,142,3,0.674664266,5555,142,0,3
44122,2014/03/31,2012/09/12,449,3,0.6345496110000001,5906,449,3,0
44123,2014/03/31,2012/01/04,12,7,0.500943724,7481,12,4,3
44124,2014/03/31,2011/07/08,219,4,0.4369216420000001,8576,219,0,4
44125,2014/03/31,2011/01/03,589,3,0.756511205,4953,589,3,0
44126,2014/03/31,2011/09/17,566,4,0.673530469,5563,566,4,0
44127,2014/03/31,2012/09/28,92,2,0.58,6460,92,0,2
44128,2014/03/31,2011/08/01,145,2,0.855,4382,145,0,2
44129,2014/03/31,2009/04/04,40,3,0.940647753,3983,40,2,1
44130,2014/03/31,2012/11/01,297,5,0.904000965,4144,297,4,1
44131,2014/03/31,2010/04/07,56,5,0.488536776,7668,56,2,3
44132,2014/03/31,2011/10/05,95,4,0.669356683,5596,95,2,2
44133,2014/03/31,2010/11/27,243,5,0.6985602390000001,5362,243,2,3
44134,2014/03/31,2007/05/17,34,5,0.576845834,6493,34,2,3
44135,2014/03/31,2012/09/16,226,4,0.455018831,8231,226,3,1
44136,2014/03/31,2011/07/13,39,6,0.6316666670000001,5928,39,2,4
44137,2014/03/31,2013/03/06,42,2,0.61,6138,42,1,1
44138,2014/03/31,2005/08/02,153,4,0.811280607,4615,153,2,2
44139,2014/03/31,2006/08/28,130,4,0.585648365,6393,130,2,2
44140,2014/03/31,2009/07/03,227,2,0.828618858,4518,227,1,1
44141,2014/03/31,2011/04/04,308,6,0.788634927,4747,308,4,2
44142,2014/03/31,2011/01/04,28,3,0.653333333,5730,28,2,1
44143,2014/03/31,2012/05/29,591,5,0.725484496,5160,591,5,0
44144,2014/03/31,2010/01/15,316,6,0.7279754959999999,5142,316,2,4
44145,2014/03/31,2011/06/13,2,3,0.545401428,6863,2,0,3
44146,2014/03/31,2007/07/25,449,2,0.6,6238,449,2,0
44147,2014/03/31,2006/06/12,449,2,0.6,6238,449,2,0
44148,2014/03/31,2007/11/22,449,2,0.6,6238,449,2,0
44149,2014/03/31,2010/08/16,1,4,0.689896774,5425,1,0,4
44150,2014/03/31,2013/02/11,210,6,0.869347271,4305,210,1,5
44151,2014/03/31,2010/01/27,385,4,0.902024584,4149,385,4,0
44152,2014/03/31,2011/01/08,129,4,0.877283169,4266,129,2,2
44153,2014/03/31,2006/03/14,7,4,0.551452991,6786,7,0,4
44154,2014/03/31,2006/03/07,23,7,0.568020644,6588,23,3,4
44155,2014/03/31,2008/03/08,75,4,0.80457751,4651,75,1,3
44156,2014/03/31,2006/07/03,349,2,0.48321281,7744,349,1,1
44157,2014/03/31,2012/03/22,687,2,0.7781821959999999,4808,687,2,0
44158,2014/03/31,2012/01/10,62,4,0.6955010220000001,5379,62,3,1
44159,2014/03/31,2008/06/27,153,4,0.8307683770000001,4503,153,2,2
44160,2014/03/31,2012/10/18,335,3,0.466666667,8016,335,2,1
44161,2014/03/31,2011/03/24,411,7,0.572642376,6532,411,7,0
44162,2014/03/31,2012/08/31,6,4,0.576525894,6488,6,2,2
44163,2014/03/31,2007/12/01,237,4,0.8143413890000001,4593,237,2,2
44164,2014/03/31,2008/02/07,432,3,0.850967008,4395,432,3,0
44165,2014/03/31,2011/10/20,262,3,0.5381277879999999,6949,262,2,1
44166,2014/03/31,2008/05/14,209,2,0.565463481,6613,209,1,1
44167,2014/03/31,2013/02/11,392,2,0.7,5342,392,2,0
44168,2014/03/31,2013/02/11,392,2,0.7,5342,392,2,0
44169,2014/03/31,2012/09/08,258,3,0.85,4399,258,2,1
44170,2014/03/31,2012/08/14,550,2,0.875029253,4273,550,2,0
44171,2014/03/31,2012/10/07,397,2,0.8985340059999999,4161,397,2,0
44172,2014/03/31,2012/10/15,531,2,0.9,4154,531,2,0
44173,2014/03/31,2007/10/07,711,2,0.9,4154,711,2,0
44174,2014/03/31,2011/01/04,606,2,0.9,4154,606,2,0
44175,2014/03/31,2011/02/21,56,3,0.794093033,4708,56,1,2
44176,2014/03/31,2005/03/19,90,5,0.56319072,6638,90,3,2
44177,2014/03/31,2012/03/09,297,7,0.515942029,7245,297,6,1
44178,2014/03/31,2011/11/14,14,6,0.735466352,5082,14,2,4
44179,2014/03/31,2012/09/28,447,2,0.8781954890000001,4256,447,2,0
44180,2014/03/31,2006/04/04,194,2,0.95,3934,194,0,2
44181,2014/03/31,2009/09/26,49,4,0.585575055,6382,49,0,4
44182,2014/03/31,2009/01/27,363,3,1.0,3737,363,2,1
44183,2014/03/31,2010/04/09,6,4,0.796095015,4694,6,2,2
44184,2014/03/31,2010/10/20,276,4,0.7677830290000001,4867,276,3,1
44185,2014/03/31,2008/09/02,131,3,0.63865664,5851,131,0,3
44186,2014/03/31,2005/07/21,331,4,0.7126835779999999,5243,331,2,2
44187,2014/03/31,2010/03/25,192,2,0.700373008,5335,192,1,1
44188,2014/03/31,2012/06/19,9,3,0.600795948,6219,9,0,3
44189,2014/03/31,2011/05/01,206,5,0.768157895,4864,206,1,4
44190,2014/03/31,2009/09/20,307,5,0.7757475079999999,4816,307,3,2
44191,2014/03/31,2005/07/14,48,5,0.544912485,6856,48,0,5
44192,2014/03/31,2008/06/27,35,5,0.686093664,5445,35,4,1
44193,2014/03/31,2012/03/01,389,4,0.662575381,5638,389,4,0
44194,2014/03/31,2013/01/11,163,2,0.756174089,4940,163,1,1
44195,2014/03/31,2011/06/21,210,4,0.66561119,5612,210,1,3
44196,2014/03/31,2009/06/05,156,6,0.766368486,4874,156,4,2
44197,2014/03/31,2008/05/22,30,3,0.528813535,7063,30,1,2
44198,2014/03/31,2009/11/02,415,4,0.470521542,7938,415,4,0
44199,2014/03/31,2011/09/07,34,7,0.51297624,7281,34,6,1
44200,2014/03/31,2012/04/24,591,9,0.716666667,5211,591,9,0
44201,2014/03/31,2012/05/27,672,2,0.875,4268,672,2,0
44202,2014/03/31,2011/09/14,43,6,0.5748891629999999,6496,43,2,4
44203,2014/03/31,2009/03/18,557,2,0.910978287,4099,557,2,0
44204,2014/03/31,2007/12/25,702,2,1.0,3734,702,2,0
44205,2014/03/31,2009/07/09,538,2,1.0,3734,538,2,0
44206,2014/03/31,2006/09/25,260,3,0.864742937,4318,260,2,1
44207,2014/03/31,2009/04/11,413,4,0.6260563379999999,5964,413,4,0
44208,2014/03/31,2011/11/28,416,3,0.75982906,4914,416,3,0
44209,2014/03/31,2011/04/12,5,5,0.5972740360000001,6251,5,0,5
44210,2014/03/31,2011/10/13,340,3,1.5,2489,340,2,1
44211,2014/03/31,2011/08/29,49,8,0.615456644,6066,49,5,3
44212,2014/03/31,2008/06/09,38,6,0.46758517,7984,38,5,1
44213,2014/03/31,2007/04/03,283,4,0.448376171,8326,283,0,4
44214,2014/03/31,2009/04/02,284,3,0.785710377,4751,284,0,3
44215,2014/03/31,2010/06/07,31,4,0.469272064,7954,31,0,4
44216,2014/03/31,2012/04/20,156,4,0.7808661090000001,4780,156,3,1
44217,2014/03/31,2011/07/17,481,5,0.608973731,6129,481,5,0
44218,2014/03/31,2007/09/23,2,4,0.7941063829999999,4700,2,0,4
44219,2014/03/31,2010/11/17,72,6,0.404655752,9223,72,0,6
44220,2014/03/31,2012/06/25,397,5,0.918081181,4065,397,5,0
44221,2014/03/31,2006/10/20,215,5,0.607879133,6139,215,0,5
44222,2014/03/31,2012/04/07,119,6,0.958333333,3894,119,2,4
44223,2014/03/31,2012/10/14,32,8,0.661123317,5644,32,1,7
44224,2014/03/31,2008/11/18,587,6,0.646224454,5774,587,6,0
44225,2014/03/31,2012/03/15,471,3,0.788004224,4735,471,3,0
44226,2014/03/31,2010/06/03,191,2,0.72,5182,191,0,2
44227,2014/03/31,2011/12/11,132,6,0.836529148,4460,132,3,3
44228,2014/03/31,2012/04/06,146,4,0.633716664,5887,146,3,1
44229,2014/03/31,2009/04/01,9,6,0.817032413,4566,9,0,6
44230,2014/03/31,2007/03/13,172,5,0.326690603,11419,172,0,5
44231,2014/03/31,2011/03/21,255,5,0.7386594059999999,5050,255,2,3
44232,2014/03/31,2011/04/08,92,6,0.527090575,7077,92,2,4
44233,2014/03/31,2013/02/06,4,5,0.811063275,4599,4,2,3
44234,2014/03/31,2010/09/14,557,6,0.680744661,5479,557,6,0
44235,2014/03/31,2012/11/04,206,5,0.7397064659999999,5042,206,2,3
44236,2014/03/31,2012/12/17,366,2,0.952349336,3916,366,1,1
44237,2014/03/31,2011/10/28,393,3,0.4166666670000001,8949,393,3,0
44238,2014/03/31,2005/10/23,126,4,0.548872203,6792,126,0,4
44239,2014/03/31,2009/03/03,454,4,0.662855619,5624,454,4,0
44240,2014/03/31,2011/01/15,505,4,0.7741536859999999,4815,505,4,0
44241,2014/03/31,2008/07/14,117,3,0.811316935,4594,117,1,2
44242,2014/03/31,2008/11/13,50,8,0.477466052,7806,50,0,8
44243,2014/03/31,2009/08/28,191,3,0.907475043,4107,191,1,2
44244,2014/03/31,2011/08/02,79,3,0.835411343,4461,79,0,3
44245,2014/03/31,2013/01/09,48,5,0.6809355020000001,5473,48,2,3
44246,2014/03/31,2010/09/09,3,6,0.6883357959999999,5414,3,2,4
44247,2014/03/31,2008/06/14,106,6,0.573637623,6496,106,5,1
44248,2014/03/31,2011/10/29,708,3,0.6712754459999999,5551,708,3,0
44249,2014/03/31,2012/09/09,422,2,0.497556416,7489,422,2,0
44250,2014/03/31,2013/01/31,372,3,0.6869192479999999,5424,372,3,0
44251,2014/03/31,2013/03/07,196,4,0.7427631579999999,5016,196,1,3
44252,2014/03/31,2009/04/11,144,3,0.925629814,4025,144,0,3
44253,2014/03/31,2010/01/11,585,5,0.512109966,7275,585,5,0
44254,2014/03/31,2011/09/26,205,4,0.521624195,7142,205,2,2
44255,2014/03/31,2012/06/16,287,4,0.509938398,7305,287,3,1
44256,2014/03/31,2010/09/02,15,3,0.696877456,5345,15,1,2
44257,2014/03/31,2010/09/18,109,6,0.655421432,5683,109,3,3
44258,2014/03/31,2005/11/01,192,5,0.6388799310000001,5830,192,1,4
44259,2014/03/31,2006/02/18,201,5,0.555583234,6704,201,0,5
44260,2014/03/31,2011/08/21,49,8,0.617037773,6036,49,2,6
44261,2014/03/31,2008/08/20,111,5,0.724122108,5143,111,3,2
44262,2014/03/31,2012/08/09,203,5,0.686099853,5428,203,2,3
44263,2014/03/31,2012/09/13,6,5,0.400370928,9301,6,1,4
44264,2014/03/31,2007/01/29,59,5,0.694098788,5365,59,3,2
44265,2014/03/31,2012/11/08,501,5,0.475901074,7824,501,5,0
44266,2014/03/31,2012/09/09,527,3,0.9,4137,527,3,0
44267,2014/03/31,2004/12/02,312,5,0.73364532,5075,312,4,1
44268,2014/03/31,2005/01/16,3,5,0.590690148,6303,3,1,4
44269,2014/03/31,2008/09/03,25,6,0.452821698,8222,25,1,5
44270,2014/03/31,2010/07/06,663,5,0.721092388,5163,663,5,0
44271,2014/03/31,2012/09/22,238,2,0.96,3878,238,1,1
44272,2014/03/31,2005/06/22,55,5,0.629709066,5912,55,4,1
44273,2014/03/31,2012/11/04,401,3,0.8843549540000001,4209,401,3,0
44274,2014/03/31,2010/04/07,75,4,0.573784492,6487,75,2,2
44275,2014/03/31,2008/06/18,49,4,0.8321126759999999,4473,49,2,2
44276,2014/03/31,2012/08/20,443,5,0.821633554,4530,443,5,0
44277,2014/03/31,2012/05/31,8,3,0.697367435,5337,8,1,2
44278,2014/03/31,2008/07/25,532,4,0.6335801839999999,5874,532,4,0
44279,2014/03/31,2007/11/07,361,3,0.71809147,5182,361,2,1
44280,2014/03/31,2009/01/05,240,4,0.717510605,5186,240,3,1
44281,2014/03/31,2008/10/05,215,4,0.546475253,6809,215,2,2
44282,2014/03/31,2012/04/12,653,4,0.7524570270000001,4945,653,4,0
44283,2014/03/31,2009/09/14,134,6,0.59443042,6259,134,0,6
44284,2014/03/31,2008/09/13,240,6,0.537483386,6922,240,4,2
44285,2014/03/31,2010/11/17,181,4,0.58099797,6403,181,1,3
44286,2014/03/31,2005/07/19,139,5,0.57082093,6517,139,2,3
44287,2014/03/31,2012/08/02,248,5,0.44417194,8375,248,2,3
44288,2014/03/31,2006/01/20,153,4,0.672867221,5528,153,3,1
44289,2014/03/31,2005/02/22,161,5,0.778150628,4780,161,2,3
44290,2014/03/31,2011/10/28,667,3,0.770860104,4825,667,3,0
44291,2014/03/31,2009/07/16,534,3,0.64989516,5723,534,3,0
44292,2014/03/31,2013/02/24,367,2,0.5716723020000001,6506,367,2,0
44293,2014/03/31,2012/08/04,135,4,0.494103893,7527,135,2,2
44294,2014/03/31,2012/08/13,408,3,0.7071686629999999,5259,408,3,0
44295,2014/03/31,2009/02/23,124,3,0.785572455,4734,124,2,1
44296,2014/03/31,2004/12/01,125,4,0.6850902729999999,5428,125,2,2
44297,2014/03/31,2012/04/06,377,2,0.809943367,4591,377,2,0
44298,2014/03/31,2012/10/11,5,6,0.6717777779999999,5535,5,0,6
44299,2014/03/31,2013/03/21,155,2,0.657859165,5652,155,1,1
44300,2014/03/31,2009/11/24,68,5,0.634488055,5860,68,1,4
44301,2014/03/31,2007/11/26,91,3,0.395580381,9399,91,2,1
44302,2014/03/31,2012/04/09,710,4,0.5,7436,710,4,0
44303,2014/03/31,2006/10/19,206,5,0.469786454,7914,206,0,5
44304,2014/03/31,2012/06/04,120,4,0.7145627520000001,5203,120,0,4
44305,2014/03/31,2010/10/02,137,4,1.0225,3636,137,2,2
44306,2014/03/31,2005/12/21,284,3,0.969819984,3833,284,2,1
44307,2014/03/31,2011/11/21,296,3,0.590789892,6292,296,1,2
44308,2014/03/31,2005/12/16,493,5,0.559115523,6648,493,5,0
44309,2014/03/31,2010/10/11,67,7,0.542544154,6851,67,4,3
44310,2014/03/31,2012/12/04,326,3,0.931062124,3992,326,2,1
44311,2014/03/31,2010/10/30,30,5,0.7425594409999999,5005,30,0,5
44312,2014/03/31,2007/02/23,47,7,0.516675935,7193,47,3,4
44313,2014/03/31,2010/11/17,127,6,0.583687765,6367,127,4,2
44314,2014/03/31,2009/06/18,148,2,0.584580777,6357,148,1,1
44315,2014/03/31,2012/05/24,23,4,0.534539701,6952,23,0,4
44316,2014/03/31,2006/10/27,69,8,0.657362462,5653,69,5,3
44317,2014/03/31,2011/04/23,194,6,0.616765145,6025,194,2,4
44318,2014/03/31,2008/10/07,46,4,0.706155454,5262,46,2,2
44319,2014/03/31,2010/10/26,104,4,0.53910621,6892,104,2,2
44320,2014/03/31,2006/08/09,33,3,0.806954822,4604,33,0,3
44321,2014/03/31,2012/09/19,557,2,0.8,4644,557,2,0
44322,2014/03/31,2012/09/15,561,2,0.8,4644,561,2,0
44323,2014/03/31,2013/02/27,385,2,0.8,4644,385,2,0
44324,2014/03/31,2009/12/06,597,2,0.8,4644,597,2,0
44325,2014/03/31,2010/08/28,611,2,0.8,4644,611,2,0
44326,2014/03/31,2012/06/14,586,2,0.8,4644,586,2,0
44327,2014/03/31,2011/09/17,539,2,0.8,4644,539,2,0
44328,2014/03/31,2012/04/18,711,2,0.8,4644,711,2,0
44329,2014/03/31,2011/12/20,708,2,0.8,4644,708,2,0
44330,2014/03/31,2012/12/22,463,2,0.8,4644,463,2,0
44331,2014/03/31,2012/09/30,542,2,0.8,4644,542,2,0
44332,2014/03/31,2013/03/05,391,2,0.8,4644,391,2,0
44333,2014/03/31,2012/04/18,529,3,0.93112782,3990,529,3,0
44334,2014/03/31,2013/01/08,444,2,0.8,4644,444,2,0
44335,2014/03/31,2012/10/23,524,2,0.8,4644,524,2,0
44336,2014/03/31,2012/10/14,532,2,0.8,4644,532,2,0
44337,2014/03/31,2012/08/05,598,2,0.8,4644,598,2,0
44338,2014/03/31,2012/11/06,509,2,0.8,4644,509,2,0
44339,2014/03/31,2008/01/15,516,2,0.8,4644,516,2,0
44340,2014/03/31,2011/09/23,545,2,0.8,4644,545,2,0
44341,2014/03/31,2012/12/08,462,2,0.8,4644,462,2,0
44342,2014/03/31,2012/09/30,542,2,0.8,4644,542,2,0
44343,2014/03/31,2013/03/15,379,2,0.8,4644,379,2,0
44344,2014/03/31,2012/04/26,700,2,0.8,4644,700,2,0
44345,2014/03/31,2012/02/01,656,6,0.733639415,5064,656,6,0
44346,2014/03/31,2012/06/02,6,3,0.914527326,4062,6,0,3
44347,2014/03/31,2005/05/16,183,5,0.568,6540,183,2,3
44348,2014/03/31,2010/06/12,35,3,0.762897926,4869,35,0,3
44349,2014/03/31,2012/04/26,165,4,0.823966282,4508,165,0,4
44350,2014/03/31,2010/11/24,438,5,0.751902834,4940,438,5,0
44351,2014/03/31,2005/05/14,370,4,0.874376177,4248,370,4,0
44352,2014/03/31,2013/03/04,261,5,0.848,4380,261,1,4
44353,2014/03/31,2007/10/29,590,2,0.625,5942,590,2,0
44354,2014/03/31,2012/03/13,568,2,0.625,5942,568,2,0
44355,2014/03/31,2010/02/11,371,4,0.7375769609999999,5035,371,4,0
44356,2014/03/31,2009/11/02,51,3,0.8381020090000001,4431,51,2,1
44357,2014/03/31,2011/05/23,25,4,0.624134454,5950,25,1,3
44358,2014/03/31,2012/09/24,192,7,0.6081739270000001,6106,192,2,5
44359,2014/03/31,2012/05/18,223,3,0.702222012,5288,223,1,2
44360,2014/03/31,2005/04/15,251,3,0.729642366,5089,251,0,3
44361,2014/03/31,2008/08/27,106,11,0.6879914770000001,5397,106,0,11
44362,2014/03/31,2009/08/01,271,6,0.496454071,7479,271,5,1
44363,2014/03/31,2010/08/27,150,7,0.567692661,6540,150,4,3
44364,2014/03/31,2008/09/17,121,3,0.662910714,5600,121,0,3
44365,2014/03/31,2012/11/03,309,2,1.0,3712,309,1,1
44366,2014/03/31,2006/04/07,308,4,0.475182435,7811,308,2,2
44367,2014/03/31,2013/02/18,403,2,0.646533101,5740,403,2,0
44368,2014/03/31,2013/02/18,403,2,0.646533101,5740,403,2,0
44369,2014/03/31,2011/10/04,268,8,0.688730512,5388,268,4,4
44370,2014/03/31,2010/06/20,517,5,0.681566863,5444,517,5,0
44371,2014/03/31,2007/09/24,92,7,0.421724256,8798,92,3,4
44372,2014/03/31,2008/01/03,476,5,0.664050474,5587,476,5,0
44373,2014/03/31,2009/06/29,285,4,0.6625,5600,285,3,1
44374,2014/03/31,2013/01/14,403,4,0.621128411,5973,403,4,0
44375,2014/03/31,2012/03/17,103,3,0.506549228,7323,103,0,3
44376,2014/03/31,2012/12/25,204,3,0.729292175,5086,204,1,2
44377,2014/03/31,2009/04/20,181,5,0.424819608,8731,181,4,1
44378,2014/03/31,2008/05/31,140,4,0.7134256590000001,5199,140,2,2
44379,2014/03/31,2008/08/22,21,6,0.8351407340000001,4441,21,3,3
44380,2014/03/31,2013/03/17,341,3,0.5883169420000001,6304,341,1,2
44381,2014/03/31,2011/08/15,488,4,0.614719045,6033,488,4,0
44382,2014/03/31,2008/01/16,267,5,0.838787605,4421,267,4,1
44383,2014/03/31,2012/10/22,87,3,0.778500945,4763,87,2,1
44384,2014/03/31,2006/11/01,77,5,0.72283681,5129,77,4,1
44385,2014/03/31,2012/03/30,376,5,0.692268908,5355,376,5,0
44386,2014/03/31,2011/11/08,71,7,0.6174662670000001,6003,71,3,4
44387,2014/03/31,2010/02/25,257,5,0.533538727,6946,257,4,1
44388,2014/03/31,2011/01/13,49,3,0.497342282,7450,49,0,3
44389,2014/03/31,2009/04/15,706,2,0.475,7800,706,2,0
44390,2014/03/31,2006/07/23,25,3,0.986891316,3754,25,0,3
44391,2014/03/31,2012/11/28,349,6,0.5166666670000001,7170,349,5,1
44392,2014/03/31,2012/04/22,548,2,0.8012005190000001,4623,548,2,0
44393,2014/03/31,2011/06/24,183,7,0.485393185,7630,183,4,3
44394,2014/03/31,2011/08/11,255,3,0.7300039420000001,5073,255,2,1
44395,2014/03/31,2010/11/23,497,3,0.616575092,6006,497,3,0
44396,2014/03/31,2013/03/23,89,5,0.879126306,4212,89,0,5
44397,2014/03/31,2011/10/16,66,6,0.6211608789999999,5961,66,3,3
44398,2014/03/31,2010/08/23,14,5,0.620808182,5964,14,3,2
44399,2014/03/31,2012/10/16,286,3,0.505521573,7324,286,0,3
44400,2014/03/31,2007/10/11,53,3,0.690570789,5361,53,1,2
44401,2014/03/31,2012/07/01,553,4,0.7327395090000001,5052,553,4,0
44402,2014/03/31,2012/02/03,139,3,0.8533333329999999,4338,139,0,3
44403,2014/03/31,2009/04/14,395,2,0.8,4627,395,2,0
44404,2014/03/31,2011/05/22,23,3,0.706114079,5242,23,0,3
44405,2014/03/31,2010/09/14,335,3,0.683625785,5414,335,2,1
44406,2014/03/31,2012/01/20,39,4,0.649434989,5699,39,0,4
44407,2014/03/31,2011/06/11,37,4,0.71,5212,37,3,1
44408,2014/03/31,2010/10/25,27,4,0.933737068,3963,27,1,3
44409,2014/03/31,2007/06/24,273,3,0.6,6167,273,1,2
44410,2014/03/31,2008/04/12,115,5,0.7394444440000001,5004,115,0,5
44411,2014/03/31,2013/03/11,23,11,0.580909091,6369,23,1,10
44412,2014/03/31,2008/11/23,34,6,0.463211469,7987,34,3,3
44413,2014/03/31,2012/12/19,272,4,0.638054502,5798,272,2,2
44414,2014/03/31,2010/03/20,91,7,0.604622426,6118,91,2,5
44415,2014/03/31,2012/01/19,50,6,0.543970588,6800,50,2,4
44416,2014/03/31,2008/02/13,158,4,0.904244499,4090,158,1,3
44417,2014/03/31,2005/06/21,32,7,0.3951576020000001,9359,32,3,4
44418,2014/03/31,2010/10/12,215,5,0.644859634,5735,215,2,3
44419,2014/03/31,2012/02/08,282,5,0.762900763,4847,282,4,1
44420,2014/03/31,2012/06/29,342,3,0.537974684,6873,342,2,1
44421,2014/03/31,2010/11/29,225,4,0.748776833,4938,225,0,4
44422,2014/03/31,2009/02/26,89,4,0.6723790470000001,5498,89,3,1
44423,2014/03/31,2010/08/01,420,3,0.897123786,4120,420,3,0
44424,2014/03/31,2006/12/01,450,4,0.812854629,4547,450,4,0
44425,2014/03/31,2012/12/06,447,2,1.0,3696,447,2,0
44426,2014/03/31,2011/01/06,45,4,0.781035503,4732,45,2,2
44427,2014/03/31,2010/09/01,281,4,0.555917569,6648,281,3,1
44428,2014/03/31,2011/08/11,104,6,0.853714484,4329,104,2,4
44429,2014/03/31,2011/10/28,617,3,0.579338454,6379,617,3,0
44430,2014/03/31,2006/07/29,221,5,0.466373044,7924,221,4,1
44431,2014/03/31,2011/10/11,171,5,0.646059441,5720,171,2,3
44432,2014/03/31,2012/09/26,530,3,0.739671737,4996,530,3,0
44433,2014/03/31,2012/09/13,528,3,0.666901281,5541,528,3,0
44434,2014/03/31,2012/11/20,13,5,0.615863333,6000,13,0,5
44435,2014/03/31,2013/03/12,247,5,0.460456075,8025,247,0,5
44436,2014/03/31,2009/07/23,156,4,0.715138378,5167,156,0,4
44437,2014/03/31,2012/12/01,152,5,0.632815551,5839,152,1,4
44438,2014/03/31,2009/10/03,232,2,0.65,5684,232,0,2
44439,2014/03/31,2010/07/15,361,5,0.428409091,8624,361,4,1
44440,2014/03/31,2008/04/22,75,5,0.902001953,4096,75,2,3
44441,2014/03/31,2011/08/29,77,2,0.65,5684,77,0,2
44442,2014/03/31,2012/09/11,531,2,1.5,2463,531,2,0
44443,2014/03/31,2011/11/06,12,6,0.7774431820000001,4752,12,1,5
44444,2014/03/31,2011/05/20,351,4,0.7975820379999999,4632,351,3,1
44445,2014/03/31,2009/04/15,96,5,0.613547583,6021,96,0,5
44446,2014/03/31,2012/10/28,375,4,1.31455516,2810,375,4,0
44447,2014/03/31,2011/08/18,432,3,0.789094211,4681,432,3,0
44448,2014/03/31,2008/04/09,616,5,0.6837189929999999,5402,616,5,0
44449,2014/03/31,2010/05/29,23,5,0.592277101,6236,23,2,3
44450,2014/03/31,2012/12/29,79,3,0.893323657,4134,79,0,3
44451,2014/03/31,2005/11/15,16,6,0.948333333,3894,16,0,6
44452,2014/03/31,2011/06/26,347,5,0.72106034,5121,347,3,2
44453,2014/03/31,2010/06/21,505,4,0.86920904,4248,505,4,0
44454,2014/03/31,2007/12/05,86,5,0.532963337,6928,86,3,2
44455,2014/03/31,2008/05/18,9,5,0.7141798840000001,5170,9,0,5
44456,2014/03/31,2012/08/14,322,4,0.922152847,4004,322,2,2
44457,2014/03/31,2005/10/19,103,4,0.635813673,5807,103,3,1
44458,2014/03/31,2010/06/16,49,11,0.555207519,6650,49,7,4
44459,2014/03/31,2006/11/08,25,3,0.5472932110000001,6746,25,1,2
44460,2014/03/31,2011/09/03,80,2,0.795,4644,80,0,2
44461,2014/03/31,2010/04/10,3,5,0.485310898,7607,3,3,2
44462,2014/03/31,2009/10/31,228,4,0.7632816379999999,4836,228,2,2
44463,2014/03/31,2008/10/08,134,3,0.5175322489999999,7132,134,1,2
44464,2014/03/31,2012/11/07,139,6,0.6900224340000001,5349,139,2,4
44465,2014/03/31,2011/12/06,426,4,0.382287135,9654,426,4,0
44466,2014/03/31,2008/05/10,23,5,0.62159845,5937,23,3,2
44467,2014/03/31,2012/09/15,54,9,0.430219165,8578,54,1,8
44468,2014/03/31,2010/05/07,118,7,0.7049417379999999,5235,118,4,3
44469,2014/03/31,2008/07/11,70,3,0.8413771090000001,4386,70,1,2
44470,2014/03/31,2010/07/02,3,4,0.7997572609999999,4614,3,2,2
44471,2014/03/31,2008/07/04,414,4,0.589471162,6259,414,4,0
44472,2014/03/31,2013/03/23,112,7,0.7434522370000001,4962,112,1,6
44473,2014/03/31,2010/12/22,312,4,0.8278725309999999,4456,312,1,3
44474,2014/03/31,2012/01/10,293,8,0.409562562,9007,293,6,2
44475,2014/03/31,2012/12/21,3,4,0.771392723,4782,3,0,4
44476,2014/03/31,2006/10/10,115,4,0.705,5232,115,0,4
44477,2014/03/31,2012/02/22,294,2,1.41,2616,294,0,2
44478,2014/03/31,2012/03/23,21,7,0.401846606,9179,21,3,4
44479,2014/03/31,2012/10/11,68,5,0.641591581,5749,68,0,5
44480,2014/03/31,2012/09/26,380,3,0.721961245,5109,380,3,0
44481,2014/03/31,2004/11/01,2,5,0.582603064,6331,2,3,2
44482,2014/03/31,2011/02/05,44,4,0.7527142859999999,4900,44,2,2
44483,2014/03/31,2009/08/11,223,2,0.635585042,5803,223,1,1
44484,2014/03/31,2006/05/27,272,6,0.596353493,6184,272,5,1
44485,2014/03/31,2011/09/17,460,5,0.7365088879999999,5007,460,5,0
44486,2014/03/31,2011/05/31,261,3,0.7451202259999999,4949,261,2,1
44487,2014/03/31,2011/02/03,46,3,0.7644071309999999,4824,46,1,2
44488,2014/03/31,2011/07/30,112,7,0.455722408,8091,112,4,3
44489,2014/03/31,2012/08/12,205,2,0.435,8476,205,0,2
44490,2014/03/31,2009/10/01,118,3,0.920574282,4005,118,1,2
44491,2014/03/31,2009/08/21,19,4,0.750582248,4912,19,0,4
44492,2014/03/31,2011/01/15,52,3,0.5877267660000001,6273,52,0,3
44493,2014/03/31,2011/10/06,343,5,0.619630252,5950,343,4,1
44494,2014/03/31,2007/10/23,175,3,0.662245375,5567,175,1,2
44495,2014/03/31,2013/03/03,148,4,0.34500093600000004,10686,148,2,2
44496,2014/03/31,2013/03/17,21,4,0.9125,4040,21,0,4
44497,2014/03/31,2010/01/14,344,6,0.940888208,3918,344,2,4
44498,2014/03/31,2011/09/12,186,4,0.7057170209999999,5223,186,3,1
44499,2014/03/31,2011/11/30,95,6,0.6427990929999999,5734,95,2,4
44500,2014/03/31,2011/07/01,118,4,0.653701667,5638,118,1,3
44501,2014/03/31,2013/02/28,81,4,0.743194192,4959,81,2,2
44502,2014/03/31,2007/02/16,480,5,0.915552795,4025,480,5,0
44503,2014/03/31,2008/11/25,416,4,0.626913916,5878,416,4,0
44504,2014/03/31,2010/08/10,232,4,0.6452232529999999,5711,232,0,4
44505,2014/03/31,2006/10/15,215,4,0.79004717,4664,215,2,2
44506,2014/03/31,2012/07/12,319,5,0.628531218,5862,319,4,1
44507,2014/03/31,2013/02/09,361,3,0.502098664,7338,361,2,1
44508,2014/03/31,2009/02/28,204,10,0.511,7210,204,7,3
44509,2014/03/31,2010/03/11,109,6,0.5441146060000001,6771,109,3,3
44510,2014/03/31,2012/08/09,235,4,0.6181107379999999,5960,235,2,2
44511,2014/03/31,2010/02/03,303,4,0.71638273,5142,303,2,2
44512,2014/03/31,2011/10/28,138,5,0.396600625,9287,138,1,4
44513,2014/03/31,2012/06/13,138,2,0.8,4604,138,1,1
44514,2014/03/31,2012/08/23,581,2,0.6,6138,581,2,0
44515,2014/03/31,2010/09/27,156,2,0.6,6138,156,0,2
44516,2014/03/31,2011/09/08,38,2,1.065,3458,38,0,2
44517,2014/03/31,2010/12/06,283,4,0.8415813529999999,4376,283,2,2
44518,2014/03/31,2012/04/11,86,4,0.512419647,7187,86,1,3
44519,2014/03/31,2005/10/20,222,4,0.91838404,4010,222,1,3
44520,2014/03/31,2006/08/20,94,4,0.6725917809999999,5475,94,3,1
44521,2014/03/31,2009/07/25,377,4,0.768126825,4794,377,4,0
44522,2014/03/31,2012/05/17,83,4,0.644410221,5714,83,0,4
44523,2014/03/31,2011/07/22,58,3,0.847041638,4347,58,2,1
44524,2014/03/31,2013/01/09,401,7,0.4071389070000001,9042,401,7,0
44525,2014/03/31,2012/10/19,483,3,0.543765697,6769,483,3,0
44526,2014/03/31,2011/01/15,424,2,0.787821062,4672,424,2,0
44527,2014/03/31,2011/08/15,150,6,0.554635322,6636,150,4,2
44528,2014/03/31,2011/10/21,154,9,1.323942446,2780,154,5,4
44529,2014/03/31,2007/08/29,14,6,0.675434025,5449,14,5,1
44530,2014/03/31,2011/05/01,423,3,0.962196078,3825,423,3,0
44531,2014/03/31,2007/10/09,21,3,0.83102981,4428,21,0,3
44532,2014/03/31,2008/04/27,412,3,0.571100419,6443,412,3,0
44533,2014/03/31,2005/11/07,1,5,0.639796557,5751,1,2,3
44534,2014/03/31,2007/08/20,119,5,0.342811889,10733,119,3,2
44535,2014/03/31,2011/10/29,166,5,0.492406317,7472,166,1,4
44536,2014/03/31,2011/09/28,26,4,0.912955335,4030,26,3,1
44537,2014/03/31,2012/10/17,124,8,0.782475542,4702,124,5,3
44538,2014/03/31,2008/02/10,1,3,0.596662342,6166,1,0,3
44539,2014/03/31,2012/05/22,310,4,0.683537718,5382,310,2,2
44540,2014/03/31,2012/11/29,6,9,0.5437038129999999,6766,6,2,7
44541,2014/03/31,2013/03/14,353,3,1.051600915,3498,353,1,2
44542,2014/03/31,2012/08/16,589,4,0.811829618,4531,589,4,0
44543,2014/03/31,2013/03/23,97,5,0.7465313579999999,4927,97,2,3
44544,2014/03/31,2005/08/05,84,4,0.68345289,5381,84,2,2
44545,2014/03/31,2005/07/05,487,4,0.617825941,5952,487,4,0
44546,2014/03/31,2012/11/20,179,5,0.807100527,4556,179,0,5
44547,2014/03/31,2011/02/16,319,3,0.727562327,5054,319,2,1
44548,2014/03/31,2006/07/05,58,5,0.5510911270000001,6672,58,4,1
44549,2014/03/31,2012/05/24,73,7,0.58912514,6241,73,3,4
44550,2014/03/31,2008/01/06,649,2,1.399581271,2627,649,2,0
44551,2014/03/31,2008/07/12,58,2,0.885,4154,58,0,2
44552,2014/03/31,2010/12/06,115,3,0.751631568,4891,115,0,3
44553,2014/03/31,2012/11/02,137,5,0.777689867,4727,137,1,4
44554,2014/03/31,2012/08/21,162,5,0.633363198,5804,162,1,4
44555,2014/03/31,2013/03/04,94,8,0.626321349,5869,94,0,8
44556,2014/03/31,2012/07/19,230,4,0.7457597890000001,4929,230,3,1
44557,2014/03/31,2008/02/18,128,2,0.7858862520000001,4677,128,0,2
44558,2014/03/31,2011/05/12,157,6,0.651888968,5638,157,4,2
44559,2014/03/31,2011/08/08,485,4,0.928353119,3959,485,4,0
44560,2014/03/31,2012/08/21,97,4,0.475582298,7728,97,2,2
44561,2014/03/31,2009/12/06,17,6,0.678696214,5415,17,2,4
44562,2014/03/31,2012/02/27,164,3,0.622265493,5906,164,1,2
44563,2014/03/31,2010/07/12,180,6,0.440390653,8345,180,1,5
44564,2014/03/31,2008/08/12,72,6,0.686778172,5351,72,5,1
44565,2014/03/31,2012/07/26,134,4,0.858621495,4280,134,1,3
44566,2014/03/31,2011/08/29,203,3,0.6371099170000001,5768,203,0,3
44567,2014/03/31,2007/11/23,64,3,0.7491865440000001,4905,64,0,3
44568,2014/03/31,2012/04/04,666,4,0.73700361,4986,666,4,0
44569,2014/03/31,2012/05/29,226,2,0.85734951,4286,226,0,2
44570,2014/03/31,2009/09/26,525,4,0.713436893,5150,525,4,0
44571,2014/03/31,2011/06/16,75,3,0.6001404770000001,6122,75,2,1
44572,2014/03/31,2006/08/22,417,4,0.6419958060000001,5722,417,4,0
44573,2014/03/31,2007/08/03,9,4,0.533485839,6885,9,1,3
44574,2014/03/31,2010/11/25,596,3,0.44378927,8276,596,3,0
44575,2014/03/31,2007/02/16,243,3,0.732051027,5017,243,0,3
44576,2014/03/31,2005/08/21,166,3,0.8687792759999999,4227,166,1,2
44577,2014/03/31,2010/03/17,33,6,0.669487694,5485,33,5,1
44578,2014/03/31,2011/12/23,159,3,0.848048499,4330,159,0,3
44579,2014/03/31,2008/06/23,309,4,0.671789243,5466,309,3,1
44580,2014/03/31,2010/05/19,57,3,0.94,3906,57,2,1
44581,2014/03/31,2007/07/05,488,2,0.903222632,4065,488,2,0
44582,2014/03/31,2011/11/01,530,2,0.875,4196,530,2,0
44583,2014/03/31,2012/09/29,541,3,0.606158164,6057,541,3,0
44584,2014/03/31,2012/09/29,541,3,0.606158164,6057,541,3,0
44585,2014/03/31,2010/12/14,48,4,0.743568969,4937,48,2,2
44586,2014/03/31,2009/12/24,278,7,0.905714286,4053,278,5,2
44587,2014/03/31,2012/10/21,526,2,1.4,2622,526,2,0
44588,2014/03/31,2007/11/07,176,5,0.751404299,4885,176,4,1
44589,2014/03/31,2009/08/24,488,7,0.8130926009999999,4514,488,7,0
44590,2014/03/31,2012/07/27,606,2,0.9,4078,606,2,0
44591,2014/03/31,2007/03/10,130,3,0.7587285509999999,4837,130,2,1
44592,2014/03/31,2010/09/14,412,3,0.763449137,4807,412,3,0
44593,2014/03/31,2010/03/26,35,12,0.3994492220000001,9187,35,5,7
44594,2014/03/31,2012/04/21,555,4,0.580166008,6325,555,4,0
44595,2014/03/31,2010/11/17,543,4,0.757817018,4842,543,4,0
44596,2014/03/31,2009/03/14,29,2,0.847998613,4327,29,0,2
44597,2014/03/31,2010/11/19,15,4,0.460964824,7960,15,2,2
44598,2014/03/31,2012/06/24,562,3,0.447930656,8191,562,3,0
44599,2014/03/31,2013/03/31,337,2,0.525,6988,337,1,1
44600,2014/03/31,2005/04/14,204,6,0.6450905570000001,5687,204,4,2
44601,2014/03/31,2012/05/29,649,2,0.65,5644,649,2,0
44602,2014/03/31,2012/04/11,466,4,0.645818662,5680,466,4,0
44603,2014/03/31,2010/04/22,702,4,0.807973568,4540,702,4,0
44604,2014/03/31,2009/03/15,375,4,0.6125,5988,375,4,0
44605,2014/03/31,2012/11/08,84,6,0.6549687439999999,5599,84,4,2
44606,2014/03/31,2012/06/28,210,4,0.7233478,5069,210,3,1
44607,2014/03/31,2012/10/23,80,5,0.593300971,6180,80,0,5
44608,2014/03/31,2012/02/28,167,5,0.604643799,6064,167,3,2
44609,2014/03/31,2009/02/14,159,3,0.972251392,3771,159,2,1
44610,2014/03/31,2009/07/16,411,6,0.5839757879999999,6278,411,6,0
44611,2014/03/31,2012/12/11,56,2,0.645,5684,56,1,1
44612,2014/03/31,2007/09/06,14,5,0.57,6430,14,0,5
44613,2014/03/31,2012/01/28,380,6,0.674838888,5431,380,6,0
44614,2014/03/31,2011/12/22,135,5,0.6120657979999999,5988,135,2,3
44615,2014/03/31,2013/03/02,10,3,0.53115942,6900,10,1,2
44616,2014/03/31,2013/03/01,124,3,0.80248741,4567,124,0,3
44617,2014/03/31,2010/06/29,243,4,0.678025902,5405,243,1,3
44618,2014/03/31,2010/05/10,291,5,0.520504261,7040,291,4,1
44619,2014/03/31,2007/03/01,168,5,0.5474081270000001,6694,168,4,1
44620,2014/03/31,2008/10/19,143,4,0.67073769,5463,143,2,2
44621,2014/03/31,2008/03/18,90,7,0.7585714290000001,4830,90,0,7
44622,2014/03/31,2011/08/23,17,4,0.730434609,5016,17,2,2
44623,2014/03/31,2006/10/06,149,7,0.514796965,7117,149,3,4
44624,2014/03/31,2011/08/11,490,3,0.6711302440000001,5459,490,3,0
44625,2014/03/31,2013/01/28,384,3,0.7124854140000001,5142,384,3,0
44626,2014/03/31,2010/08/04,252,3,0.944651882,3878,252,1,2
44627,2014/03/31,2010/03/26,107,6,0.54770933,6688,107,2,4
44628,2014/03/31,2007/10/24,560,6,0.907144626,4038,560,6,0
44629,2014/03/31,2013/01/19,229,3,1.244624533,2943,229,0,3
44630,2014/03/31,2012/05/20,401,4,0.7,5232,401,4,0
44631,2014/03/31,2011/09/21,668,3,0.933333333,3924,668,3,0
44632,2014/03/31,2012/05/13,481,3,0.933333333,3924,481,3,0
44633,2014/03/31,2007/07/20,553,3,0.933333333,3924,553,3,0
44634,2014/03/31,2006/04/24,63,3,0.83501824,4386,63,1,2
44635,2014/03/31,2012/06/11,42,3,0.773209459,4736,42,2,1
44636,2014/03/31,2012/01/22,555,3,0.598202908,6121,555,3,0
44637,2014/03/31,2012/03/02,662,2,0.6,6102,662,2,0
44638,2014/03/31,2011/11/23,593,3,1.166666667,3138,593,3,0
44639,2014/03/31,2012/08/02,195,3,0.7763944859999999,4715,195,2,1
44640,2014/03/31,2013/02/04,422,2,0.774830652,4724,422,2,0
44641,2014/03/31,2007/05/11,516,4,0.610704155,5993,516,4,0
44642,2014/03/31,2007/05/29,5,2,0.8232733409999999,4445,5,0,2
44643,2014/03/31,2011/10/25,512,3,0.776942675,4710,512,3,0
44644,2014/03/31,2005/12/23,17,7,0.362421511,10097,17,3,4
44645,2014/03/31,2011/05/16,47,4,0.732130852,4998,47,2,2
44646,2014/03/31,2012/11/15,7,11,0.469982017,7785,7,3,8
44647,2014/03/31,2007/06/01,140,2,0.93,3934,140,0,2
44648,2014/03/31,2009/01/01,26,3,0.670064103,5460,26,0,3
44649,2014/03/31,2010/11/03,367,2,0.65,5628,367,2,0
44650,2014/03/31,2008/04/13,638,4,0.517794451,7064,638,4,0
44651,2014/03/31,2012/12/07,415,4,0.8,4572,415,4,0
44652,2014/03/31,2011/07/17,31,6,0.744160732,4915,31,5,1
44653,2014/03/31,2010/09/09,422,6,0.689834025,5302,422,6,0
44654,2014/03/31,2012/11/13,264,5,0.70499229,5188,264,4,1
44655,2014/03/31,2006/07/08,439,3,0.901627219,4056,439,3,0
44656,2014/03/31,2013/03/06,267,8,0.85125,4296,267,2,6
44657,2014/03/31,2013/03/07,163,3,0.580079315,6304,163,1,2
44658,2014/03/31,2012/05/10,12,2,0.772935954,4731,12,1,1
44659,2014/03/31,2012/09/03,186,3,0.796666667,4590,186,1,2
44660,2014/03/31,2006/03/01,2,6,0.512657039,7132,2,0,6
44661,2014/03/31,2010/06/13,529,4,0.938703466,3895,529,4,0
44662,2014/03/31,2011/08/26,31,4,0.905,4040,31,0,4
44663,2014/03/31,2005/01/25,549,2,0.8,4570,549,2,0
44664,2014/03/31,2013/03/01,295,2,0.8,4570,295,0,2
44665,2014/03/31,2012/08/23,44,2,0.8,4570,44,0,2
44666,2014/03/31,2012/10/25,167,9,0.639819741,5714,167,2,7
44667,2014/03/31,2012/08/01,36,4,0.745335372,4905,36,1,3
44668,2014/03/31,2007/12/08,26,3,0.486278265,7518,26,2,1
44669,2014/03/31,2013/01/03,145,2,0.88,4154,145,0,2
44670,2014/03/31,2007/11/30,30,2,0.88,4154,30,0,2
44671,2014/03/31,2013/01/24,38,4,0.5086252960000001,7187,38,1,3
44672,2014/03/31,2012/07/13,259,5,0.740693009,4935,259,1,4
44673,2014/03/31,2006/10/21,345,3,0.780936097,4679,345,1,2
44674,2014/03/31,2012/01/26,65,5,0.522,7000,65,3,2
44675,2014/03/31,2010/01/14,80,5,0.625449409,5841,80,2,3
44676,2014/03/31,2013/02/19,234,4,0.691089671,5286,234,0,4
44677,2014/03/31,2012/03/11,388,6,0.69003589,5294,388,6,0
44678,2014/03/31,2006/04/28,541,4,0.561544965,6505,541,4,0
44679,2014/03/31,2005/04/11,316,4,0.8067137809999999,4528,316,3,1
44680,2014/03/31,2010/05/05,263,3,0.79,4623,263,1,2
44681,2014/03/31,2009/08/16,285,4,0.6105148779999999,5982,285,0,4
44682,2014/03/31,2005/08/24,418,9,0.477211551,7653,418,9,0
44683,2014/03/31,2011/01/13,312,3,0.797216765,4581,312,2,1
44684,2014/03/31,2007/07/11,423,4,0.664205166,5498,423,4,0
44685,2014/03/31,2012/04/13,273,4,0.8863559120000001,4119,273,3,1
44686,2014/03/31,2009/12/26,96,7,0.712637127,5123,96,4,3
44687,2014/03/31,2007/02/21,485,3,0.422687276,8637,485,3,0
44688,2014/03/31,2012/11/29,339,5,0.5697674420000001,6407,339,3,2
44689,2014/03/31,2011/12/18,611,4,0.7104515379999999,5138,611,4,0
44690,2014/03/31,2011/09/05,241,9,0.59910046,6092,241,1,8
44691,2014/03/31,2013/03/27,200,2,0.79913291,4567,200,1,1
44692,2014/03/31,2012/04/01,703,2,0.554321738,6583,703,2,0
44693,2014/03/31,2009/10/16,72,4,0.754150475,4838,72,1,3
44694,2014/03/31,2008/07/28,244,5,0.622791055,5858,244,4,1
44695,2014/03/31,2011/12/13,381,3,0.470850542,7748,381,3,0
44696,2014/03/31,2006/03/28,700,3,0.497416144,7334,700,3,0
44697,2014/03/31,2010/10/12,202,3,0.6107266029999999,5973,202,0,3
44698,2014/03/31,2010/05/31,70,8,0.828945455,4400,70,6,2
44699,2014/03/31,2010/02/16,236,4,0.82777576,4406,236,1,3
44700,2014/03/31,2013/03/28,357,4,0.645486726,5650,357,2,2
44701,2014/03/31,2008/04/22,528,5,0.7536474479999999,4839,528,5,0
44702,2014/03/31,2012/05/20,137,5,0.711410456,5126,137,0,5
44703,2014/03/31,2008/09/03,416,3,0.607058432,6007,416,3,0
44704,2014/03/31,2012/08/23,184,3,0.712361789,5119,184,0,3
44705,2014/03/31,2006/11/24,74,3,0.721509695,5054,74,0,3
44706,2014/03/31,2009/09/19,341,3,0.65,5610,341,2,1
44707,2014/03/31,2011/08/30,196,3,0.707605278,5153,196,1,2
44708,2014/03/31,2008/08/12,261,4,0.698737064,5218,261,3,1
44709,2014/03/31,2012/09/18,549,3,1.0,3646,549,3,0
44710,2014/03/31,2011/07/17,438,6,0.818016603,4457,438,6,0
44711,2014/03/31,2012/04/16,57,3,0.7080520490000001,5149,57,1,2
44712,2014/03/31,2008/02/21,187,2,0.49,7440,187,0,2
44713,2014/03/31,2012/09/25,267,7,0.415766423,8768,267,3,4
44714,2014/03/31,2007/06/20,59,4,0.953957079,3821,59,2,2
44715,2014/03/31,2005/05/03,309,7,0.435714286,8365,309,6,1
44716,2014/03/31,2008/08/13,374,4,0.734926396,4959,374,4,0
44717,2014/03/31,2009/07/06,368,4,0.738449848,4935,368,4,0
44718,2014/03/31,2012/01/16,317,2,0.475,7672,317,0,2
44719,2014/03/31,2011/03/01,317,2,0.475,7672,317,0,2
44720,2014/03/31,2012/05/15,468,2,0.475,7672,468,2,0
44721,2014/03/31,2013/01/27,429,2,0.960664382,3793,429,2,0
44722,2014/03/31,2010/10/26,153,4,0.6943140240000001,5248,153,3,1
44723,2014/03/31,2013/03/08,77,4,0.5980351279999999,6092,77,1,3
44724,2014/03/31,2009/11/30,459,5,0.96,3795,459,5,0
44725,2014/03/31,2006/12/07,381,4,0.6876557190000001,5298,381,4,0
44726,2014/03/31,2008/02/17,53,5,0.6594895000000001,5524,53,3,2
44727,2014/03/31,2013/01/01,208,5,0.472370332,7712,208,0,5
44728,2014/03/31,2008/02/10,106,3,0.60351226,6036,106,0,3
44729,2014/03/31,2006/03/09,496,3,0.7557261409999999,4820,496,3,0
44730,2014/03/31,2011/11/24,646,4,0.7820094459999999,4658,646,4,0
44731,2014/03/31,2008/10/07,226,6,0.625406937,5824,226,4,2
44732,2014/03/31,2013/03/19,43,5,0.803494375,4533,43,0,5
44733,2014/03/31,2010/08/19,88,7,0.423374797,8602,88,3,4
44734,2014/03/31,2006/08/27,556,2,1.186608016,3069,556,2,0
44735,2014/03/31,2005/10/21,14,5,0.6840007509999999,5324,14,2,3
44736,2014/03/31,2008/04/07,251,3,0.601675479,6052,251,2,1
44737,2014/03/31,2007/08/10,138,4,0.832102377,4376,138,0,4
44738,2014/03/31,2012/03/13,177,5,0.643073119,5662,177,0,5
44739,2014/03/31,2011/04/26,132,5,0.661486192,5504,132,2,3
44740,2014/03/31,2009/11/06,224,3,0.77927012,4672,224,2,1
44741,2014/03/31,2012/08/28,389,5,0.708041618,5142,389,5,0
44742,2014/03/31,2012/07/10,37,3,0.710544603,5123,37,0,3
44743,2014/03/31,2007/05/01,522,4,0.7252440729999999,5019,522,4,0
44744,2014/03/31,2008/01/29,88,2,0.9,4044,88,0,2
44745,2014/03/31,2012/09/11,27,7,0.573235155,6349,27,0,7
44746,2014/03/31,2010/10/07,590,6,0.933418825,3899,590,6,0
44747,2014/03/31,2010/12/13,184,5,0.578678645,6289,184,3,2
44748,2014/03/31,2012/05/16,613,2,0.925,3934,613,2,0
44749,2014/03/31,2008/01/03,202,5,0.644281161,5648,202,1,4
44750,2014/03/31,2007/12/07,569,2,1.1,3308,569,2,0
44751,2014/03/31,2010/07/10,360,3,0.951215686,3825,360,2,1
44752,2014/03/31,2011/04/13,692,3,0.917397882,3966,692,3,0
44753,2014/03/31,2005/08/25,141,3,0.689210078,5279,141,0,3
44754,2014/03/31,2010/11/29,105,5,0.608439538,5979,105,2,3
44755,2014/03/31,2005/09/10,79,3,0.6302305029999999,5770,79,0,3
44756,2014/03/31,2010/06/24,188,5,0.520955587,6980,188,3,2
44757,2014/03/31,2012/08/22,511,4,0.9,4040,511,4,0
44758,2014/03/31,2007/02/26,160,3,0.589777778,6165,160,0,3
44759,2014/03/31,2006/08/18,311,3,0.57546692,6318,311,0,3
44760,2014/03/31,2008/06/25,136,6,0.8072795909999999,4503,136,5,1
44761,2014/03/31,2010/08/31,312,6,0.72615861,5006,312,4,2
44762,2014/03/31,2009/12/05,282,4,0.479363049,7583,282,2,2
44763,2014/03/31,2009/10/17,516,3,1.0,3635,516,3,0
44764,2014/03/31,2010/11/29,80,7,0.507239743,7166,80,2,5
44765,2014/03/31,2007/08/08,715,2,0.875,4154,715,2,0
44766,2014/03/31,2007/05/15,618,4,0.85824085,4235,618,4,0
44767,2014/03/31,2012/11/07,45,5,0.608232636,5975,45,2,3
44768,2014/03/31,2011/08/01,170,4,0.52667971,6900,170,0,4
44769,2014/03/31,2012/01/27,50,4,0.808451613,4495,50,1,3
44770,2014/03/31,2013/02/05,138,3,0.8600923079999999,4225,138,0,3
44771,2014/03/31,2011/01/13,219,3,0.7108255090000001,5112,219,2,1
44772,2014/03/31,2008/05/15,210,5,0.551060055,6594,210,0,5
44773,2014/03/31,2012/08/08,593,2,0.863292944,4209,593,2,0
44774,2014/03/31,2006/11/26,191,4,0.7728993829999999,4701,191,2,2
44775,2014/03/31,2011/05/18,513,4,1.0,3633,513,4,0
44776,2014/03/31,2012/06/28,258,5,0.654,5555,258,2,3
44777,2014/03/31,2012/06/15,467,7,0.768379865,4728,467,7,0
44778,2014/03/31,2008/11/22,16,2,0.68,5342,16,0,2
44779,2014/03/31,2007/04/13,614,5,0.650842143,5581,614,5,0
44780,2014/03/31,2006/12/28,163,5,0.833483249,4358,163,2,3
44781,2014/03/31,2008/01/23,539,4,0.759736457,4781,539,4,0
44782,2014/03/31,2011/05/25,23,3,0.724532216,5013,23,0,3
44783,2014/03/31,2008/10/12,263,3,0.782231316,4643,263,2,1
44784,2014/03/31,2006/06/29,398,5,0.765858288,4742,398,5,0
44785,2014/03/31,2012/10/19,94,5,0.5201561379999999,6981,94,1,4
44786,2014/03/31,2006/04/29,401,3,0.8,4539,401,3,0
44787,2014/03/31,2013/02/26,7,3,0.803525116,4519,7,0,3
44788,2014/03/31,2009/11/10,367,4,0.438685514,8277,367,4,0
44789,2014/03/31,2011/10/22,135,2,0.727569138,4990,135,0,2
44790,2014/03/31,2012/05/11,172,4,0.569410289,6376,172,2,2
44791,2014/03/31,2011/07/15,135,4,0.480062153,7562,135,2,2
44792,2014/03/31,2007/10/21,74,7,0.817414997,4441,74,4,3
44793,2014/03/31,2007/05/10,328,2,0.55,6600,328,0,2
44794,2014/03/31,2007/09/06,311,4,0.48535232,7479,311,2,2
44795,2014/03/31,2012/04/17,18,5,0.592526934,6126,18,3,2
44796,2014/03/31,2010/12/19,670,4,0.921269036,3940,670,4,0
44797,2014/03/31,2005/04/12,483,5,0.7186930690000001,5050,483,5,0
44798,2014/03/31,2012/02/28,62,4,0.9725,3732,62,1,3
44799,2014/03/31,2011/11/14,446,5,0.659578335,5502,446,5,0
44800,2014/03/31,2011/12/03,676,3,0.540343955,6716,676,3,0
44801,2014/03/31,2007/09/22,148,6,0.527383721,6880,148,0,6
44802,2014/03/31,2012/06/13,38,5,0.688747153,5268,38,3,2
44803,2014/03/31,2007/06/27,673,3,0.903886398,4014,673,3,0
44804,2014/03/31,2010/11/19,9,8,0.570290789,6362,9,2,6
44805,2014/03/31,2006/08/17,634,2,0.682367877,5317,634,2,0
44806,2014/03/31,2011/12/05,369,2,1.0,3628,369,2,0
44807,2014/03/31,2010/07/22,245,4,0.425,8536,245,2,2
44808,2014/03/31,2012/07/19,249,4,0.425,8536,249,2,2
44809,2014/03/31,2010/05/03,45,2,0.875,4146,45,0,2
44810,2014/03/31,2011/01/13,348,6,0.7173422979999999,5057,348,5,1
44811,2014/03/31,2013/01/31,181,5,0.555151515,6534,181,1,4
44812,2014/03/31,2011/07/07,174,4,0.662557545,5474,174,2,2
44813,2014/03/31,2011/02/04,24,4,0.624523851,5807,24,0,4
44814,2014/03/31,2009/03/07,139,5,0.814347631,4453,139,4,1
44815,2014/03/31,2012/04/20,208,2,0.668917174,5421,208,1,1
44816,2014/03/31,2010/05/11,477,4,0.761125105,4764,477,4,0
44817,2014/03/31,2011/08/18,620,2,0.7552176629999999,4801,620,2,0
44818,2014/03/31,2012/03/25,76,5,0.954105263,3800,76,2,3
44819,2014/03/31,2008/07/28,105,5,0.723460387,5011,105,2,3
44820,2014/03/31,2006/06/24,413,3,0.774295173,4682,413,3,0
44821,2014/03/31,2008/11/15,382,4,0.6625,5472,382,4,0
44822,2014/03/31,2012/07/19,419,5,0.885164835,4095,419,5,0
44823,2014/03/31,2007/10/11,167,5,0.599130579,6050,167,3,2
44824,2014/03/31,2009/08/01,398,7,0.7857142859999999,4613,398,7,0
44825,2014/03/31,2012/08/10,41,6,0.64966123,5579,41,2,4
44826,2014/03/31,2011/12/16,67,3,0.597768431,6063,67,1,2
44827,2014/03/31,2007/07/05,4,4,0.555177696,6528,4,0,4
44828,2014/03/31,2013/01/17,209,5,0.955874439,3791,209,1,4
44829,2014/03/31,2008/07/11,221,6,0.409481297,8849,221,1,5
44830,2014/03/31,2012/07/05,375,5,0.34261535600000004,10576,375,5,0
44831,2014/03/31,2012/04/16,338,5,0.841430562,4306,338,4,1
44832,2014/03/31,2009/09/04,200,3,0.923333333,3924,200,2,1
44833,2014/03/31,2012/08/27,27,3,0.789524847,4588,27,0,3
44834,2014/03/31,2011/12/02,83,4,0.685003782,5288,83,0,4
44835,2014/03/31,2011/08/29,21,8,0.4046067920000001,8952,21,2,6
44836,2014/03/31,2012/12/26,401,4,0.6987844879999999,5183,401,4,0
44837,2014/03/31,2011/04/27,77,6,0.429865875,8425,77,3,3
44838,2014/03/31,2009/03/19,45,2,0.885,4092,45,0,2
44839,2014/03/31,2009/09/08,198,6,0.836926277,4327,198,3,3
44840,2014/03/31,2013/03/12,303,4,0.711152789,5092,303,1,3
44841,2014/03/31,2007/06/10,284,4,0.768476231,4712,284,0,4
44842,2014/03/31,2013/03/14,8,2,0.512818298,7061,8,1,1
44843,2014/03/31,2011/08/11,220,4,0.71108209,5092,220,3,1
44844,2014/03/31,2009/10/29,177,2,0.933384893,3879,177,1,1
44845,2014/03/31,2007/11/25,161,4,0.818390597,4424,161,0,4
44846,2014/03/31,2013/02/12,68,4,0.8144971879999999,4445,68,0,4
44847,2014/03/31,2012/06/29,554,4,0.829986245,4362,554,4,0
44848,2014/03/31,2012/12/27,35,6,0.5486255489999999,6599,35,3,3
44849,2014/03/31,2012/08/02,594,3,0.692208413,5230,594,3,0
44850,2014/03/31,2012/01/02,481,7,0.193546145,18702,481,7,0
44851,2014/03/31,2009/11/06,440,3,0.758190197,4774,440,3,0
44852,2014/03/31,2011/12/09,434,3,0.8275148609999999,4374,434,3,0
44853,2014/03/31,2011/12/24,11,25,0.7868,4600,11,13,12
44854,2014/03/31,2008/10/26,22,5,0.663092708,5458,22,1,4
44855,2014/03/31,2009/08/30,565,2,0.972849462,3720,565,2,0
44856,2014/03/31,2010/07/04,34,6,0.7447972829999999,4859,34,0,6
44857,2014/03/31,2012/08/03,547,3,0.4,9047,547,3,0
44858,2014/03/31,2010/09/04,145,8,0.837246645,4322,145,6,2
44859,2014/03/31,2010/11/11,523,3,0.74511944,4856,523,3,0
44860,2014/03/31,2009/07/18,99,6,0.433473104,8347,99,1,5
44861,2014/03/31,2012/09/30,164,3,0.386666667,9357,164,1,2
44862,2014/03/31,2009/11/01,458,2,1.5,2412,458,2,0
44863,2014/03/31,2007/07/06,278,4,0.89949279,4022,278,2,2
44864,2014/03/31,2007/09/08,142,5,0.764912244,4729,142,3,2
44865,2014/03/31,2008/10/27,344,3,0.651865201,5549,344,2,1
44866,2014/03/31,2010/11/23,145,5,0.716089883,5051,145,1,4
44867,2014/03/31,2012/06/14,148,4,0.603593124,5992,148,3,1
44868,2014/03/31,2011/11/01,145,4,0.6753352009999999,5355,145,3,1
44869,2014/03/31,2007/06/22,5,5,0.689091082,5248,5,1,4
44870,2014/03/31,2013/02/12,20,8,0.40109472,9016,20,2,6
44871,2014/03/31,2012/12/26,109,4,0.8717888140000001,4148,109,0,4
44872,2014/03/31,2011/12/16,693,3,0.7794783359999999,4639,693,3,0
44873,2014/03/31,2012/09/03,404,3,1.025163028,3527,404,3,0
44874,2014/03/31,2012/10/24,70,6,0.634563005,5698,70,2,4
44875,2014/03/31,2008/04/17,174,6,0.566711599,6380,174,2,4
44876,2014/03/31,2008/07/16,119,4,0.8872294479999999,4075,119,0,4
44877,2014/03/31,2012/04/10,26,6,0.720201235,5019,26,5,1
44878,2014/03/31,2008/03/08,17,3,0.846123596,4272,17,0,3
44879,2014/03/31,2008/07/15,321,3,0.8666666670000001,4170,321,1,2
44880,2014/03/31,2007/10/09,208,4,0.729495357,4954,208,2,2
44881,2014/03/31,2005/06/09,342,5,0.906395786,3987,342,4,1
44882,2014/03/31,2013/03/17,12,6,0.490557969,7366,12,0,6
44883,2014/03/31,2004/12/07,629,7,0.402691408,8973,629,7,0
44884,2014/03/31,2007/01/21,94,5,0.476291853,7586,94,0,5
44885,2014/03/31,2011/09/20,2,4,0.8098924009999999,4461,2,1,3
44886,2014/03/31,2012/06/26,342,3,0.533333333,6774,342,2,1
44887,2014/03/31,2011/10/23,50,8,0.438253063,8243,50,4,4
44888,2014/03/31,2008/03/20,23,3,0.638700495,5656,23,0,3
44889,2014/03/31,2010/10/18,121,5,0.641915763,5627,121,0,5
44890,2014/03/31,2011/06/07,222,5,0.8080425059999999,4470,222,4,1
44891,2014/03/31,2012/02/06,50,5,0.632012248,5715,50,0,5
44892,2014/03/31,2010/04/22,119,5,0.522389355,6914,119,4,1
44893,2014/03/31,2013/02/26,17,5,0.637991521,5661,17,0,5
44894,2014/03/31,2006/02/26,37,6,0.444377999,8127,37,0,6
44895,2014/03/31,2013/01/15,26,7,0.5890734089999999,6130,26,2,5
44896,2014/03/31,2010/10/18,16,5,0.774,4665,16,0,5
44897,2014/03/31,2008/12/11,285,4,0.927400462,3893,285,0,4
44898,2014/03/31,2006/12/20,16,9,0.46,7848,16,0,9
44899,2014/03/31,2009/03/28,155,5,0.713002173,5063,155,3,2
44900,2014/03/31,2012/09/26,32,5,0.777462847,4643,32,4,1
44901,2014/03/31,2006/08/15,78,2,0.635,5684,78,1,1
44902,2014/03/31,2007/08/01,17,8,0.3775,9560,17,3,5
44903,2014/03/31,2013/02/26,62,3,0.56125972,6430,62,2,1
44904,2014/03/31,2009/09/24,47,4,0.679378765,5312,47,1,3
44905,2014/03/31,2012/01/16,345,4,0.6785821740000001,5318,345,2,2
44906,2014/03/31,2007/08/25,179,5,0.670628136,5381,179,1,4
44907,2014/03/31,2012/10/16,275,5,0.6170673729999999,5848,275,0,5
44908,2014/03/31,2009/03/15,241,3,0.6539470820000001,5518,241,1,2
44909,2014/03/31,2010/09/26,207,4,0.8510828029999999,4239,207,0,4
44910,2014/03/31,2012/11/28,411,2,0.892000495,4044,411,2,0
44911,2014/03/31,2005/10/07,53,2,0.675,5344,53,0,2
44912,2014/03/31,2012/08/28,122,2,0.675,5344,122,0,2
44913,2014/03/31,2012/04/26,155,3,1.2273494390000002,2939,155,1,2
44914,2014/03/31,2005/08/22,99,5,0.560898772,6431,99,3,2
44915,2014/03/31,2011/08/30,170,4,0.602245784,5989,170,0,4
44916,2014/03/31,2005/07/03,2,3,0.589131003,6122,2,0,3
44917,2014/03/31,2012/06/04,86,6,0.713314873,5056,86,5,1
44918,2014/03/31,2007/12/14,396,3,0.717366222,5027,396,3,0
44919,2014/03/31,2009/03/16,98,6,0.5344072320000001,6748,98,3,3
44920,2014/03/31,2010/12/20,105,5,0.50584514,7129,105,0,5
44921,2014/03/31,2008/04/01,19,6,0.587314332,6140,19,4,2
44922,2014/03/31,2012/04/24,694,2,0.675,5342,694,2,0
44923,2014/03/31,2010/08/08,543,2,0.675,5342,543,2,0
44924,2014/03/31,2012/11/12,220,4,0.7518181820000001,4796,220,2,2
44925,2014/03/31,2012/11/20,15,3,0.746507246,4830,15,0,3
44926,2014/03/31,2011/04/03,134,5,0.591081967,6100,134,3,2
44927,2014/03/31,2011/03/21,96,4,0.56779685,6350,96,3,1
44928,2014/03/31,2012/06/16,90,6,0.574933822,6271,90,1,5
44929,2014/03/31,2012/08/11,584,4,0.6500540929999999,5546,584,4,0
44930,2014/03/31,2012/08/10,599,2,0.8,4506,599,2,0
44931,2014/03/31,2013/02/13,20,4,0.488552453,7378,20,1,3
44932,2014/03/31,2005/11/30,384,2,1.100610687,3275,384,2,0
44933,2014/03/31,2010/04/07,95,6,0.803663322,4485,95,1,5
44934,2014/03/31,2009/02/17,494,7,0.477813867,7543,494,7,0
44935,2014/03/31,2011/09/07,282,3,0.6519663529999999,5528,282,2,1
44936,2014/03/31,2012/05/30,349,6,0.702661337,5129,349,4,2
44937,2014/03/31,2012/11/07,34,4,0.665672331,5414,34,1,3
44938,2014/03/31,2013/03/26,182,12,0.434486376,8294,182,1,11
44939,2014/03/31,2009/12/23,591,2,0.726951785,4957,591,2,0
44940,2014/03/31,2012/05/13,190,3,0.45417696,7934,190,2,1
44941,2014/03/31,2008/12/16,432,4,0.7547968159999999,4774,432,4,0
44942,2014/03/31,2009/05/30,561,3,0.729352227,4940,561,3,0
44943,2014/03/31,2012/04/28,188,6,0.5699367089999999,6320,188,5,1
44944,2014/03/31,2013/01/21,12,7,0.491428571,7329,12,2,5
44945,2014/03/31,2013/02/04,228,4,0.825676295,4362,228,2,2
44946,2014/03/31,2010/04/03,87,5,0.436716382,8247,87,3,2
44947,2014/03/31,2013/03/10,119,4,0.66769188,5394,119,0,4
44948,2014/03/31,2008/10/25,46,8,0.534787645,6734,46,4,4
44949,2014/03/31,2007/06/09,65,3,0.801332888,4494,65,0,3
44950,2014/03/31,2010/03/18,1,7,0.99096863,3634,1,6,1
44951,2014/03/31,2012/03/15,2,3,0.582242885,6184,2,0,3
44952,2014/03/31,2007/08/13,96,3,0.83,4338,96,0,3
44953,2014/03/31,2012/03/14,555,3,0.785620772,4583,555,3,0
44954,2014/03/31,2005/11/05,110,2,0.636172469,5659,110,1,1
44955,2014/03/31,2007/06/21,417,2,0.8,4500,417,2,0
44956,2014/03/31,2009/09/18,417,2,0.8,4500,417,2,0
44957,2014/03/31,2011/01/14,176,3,0.637019996,5651,176,1,2
44958,2014/03/31,2012/09/01,201,7,0.699102738,5149,201,6,1
44959,2014/03/31,2013/03/15,121,6,0.671077554,5364,121,0,6
44960,2014/03/31,2010/11/29,50,4,0.7984316770000001,4508,50,2,2
44961,2014/03/31,2011/06/01,487,2,0.775,4644,487,2,0
44962,2014/03/31,2012/09/13,522,2,0.775,4644,522,2,0
44963,2014/03/31,2008/06/25,375,4,0.720212127,4997,375,4,0
44964,2014/03/31,2008/06/30,28,5,0.631451132,5699,28,2,3
44965,2014/03/31,2010/09/14,141,6,0.53772116,6692,141,5,1
44966,2014/03/31,2012/11/29,402,4,0.6880856759999999,5229,402,4,0
44967,2014/03/31,2009/03/02,231,2,0.545,6600,231,0,2
44968,2014/03/31,2009/12/26,156,4,0.751089998,4789,156,1,3
44969,2014/03/31,2013/01/20,109,4,0.6789241220000001,5298,109,2,2
44970,2014/03/31,2012/08/01,48,3,0.458252007,7849,48,0,3
44971,2014/03/31,2011/03/30,32,5,0.590228131,6093,32,1,4
44972,2014/03/31,2011/11/29,109,5,0.640427427,5615,109,4,1
44973,2014/03/31,2006/09/26,93,5,0.739001233,4866,93,0,5
44974,2014/03/31,2012/03/29,584,4,0.61762281,5822,584,4,0
44975,2014/03/31,2007/10/12,383,5,0.4748910320000001,7571,383,5,0
44976,2014/03/31,2009/11/26,222,6,0.738082529,4871,222,5,1
44977,2014/03/31,2008/10/30,271,4,0.74337469,4836,271,2,2
44978,2014/03/31,2009/02/13,136,2,0.605,5942,136,0,2
44979,2014/03/31,2011/12/12,141,2,0.605,5942,141,0,2
44980,2014/03/31,2011/12/06,172,4,1.043489115,3445,172,2,2
44981,2014/03/31,2010/11/07,363,5,0.508523129,7069,363,3,2
44982,2014/03/31,2008/12/11,108,2,1.111180835,3235,108,0,2
44983,2014/03/31,2012/05/11,365,3,0.870573989,4129,365,2,1
44984,2014/03/31,2012/07/03,549,3,0.796245016,4514,549,3,0
44985,2014/03/31,2008/06/10,337,6,0.793935042,4526,337,4,2
44986,2014/03/31,2011/08/04,247,4,0.609033898,5900,247,0,4
44987,2014/03/31,2013/03/15,187,3,0.7111042940000001,5053,187,0,3
44988,2014/03/31,2012/09/06,166,5,0.6974145959999999,5152,166,1,4
44989,2014/03/31,2005/07/13,477,3,0.7702036440000001,4665,477,3,0
44990,2014/03/31,2012/10/06,259,6,0.70044843,5129,259,4,2
44991,2014/03/31,2012/03/06,269,5,0.81,4435,269,4,1
44992,2014/03/31,2011/06/29,100,5,0.77,4665,100,3,2
44993,2014/03/31,2011/12/22,4,3,0.7629587940000001,4708,4,2,1
44994,2014/03/31,2006/06/28,172,4,0.609021702,5898,172,0,4
44995,2014/03/31,2007/10/28,693,2,0.975448126,3682,693,2,0
44996,2014/03/31,2011/07/19,164,2,0.615,5840,164,0,2
44997,2014/03/31,2012/08/21,321,7,0.6793077359999999,5287,321,6,1
44998,2014/03/31,2008/01/12,4,4,0.6525,5504,4,0,4
44999,2014/03/31,2012/10/05,12,3,0.851805028,4216,12,2,1
45000,2014/03/31,2012/10/18,24,6,0.35651742299999994,10073,24,2,4
45001,2014/03/31,2011/09/21,216,6,0.712808654,5038,216,4,2
45002,2014/03/31,2012/09/02,569,2,0.7,5130,569,2,0
45003,2014/03/31,2010/11/08,68,3,0.586573015,6122,68,0,3
45004,2014/03/31,2011/09/28,613,2,0.525,6840,613,2,0
45005,2014/03/31,2007/05/19,227,5,0.476918581,7529,227,1,4
45006,2014/03/31,2013/02/11,99,6,0.660629255,5435,99,2,4
45007,2014/03/31,2013/01/02,52,3,0.46533437,7716,52,1,2
45008,2014/03/31,2011/08/14,172,7,0.463274839,7750,172,3,4
45009,2014/03/31,2011/05/09,326,3,0.8074673859999999,4446,326,2,1
45010,2014/03/31,2012/10/08,438,6,0.62389642,5754,438,6,0
45011,2014/03/31,2012/09/21,121,2,0.859798802,4175,121,0,2
45012,2014/03/31,2012/05/15,44,4,0.862829327,4160,44,1,3
45013,2014/03/31,2008/11/01,471,6,0.5836721420000001,6149,471,6,0
45014,2014/03/31,2005/12/01,27,6,0.921666667,3894,27,0,6
45015,2014/03/31,2007/05/05,38,7,0.421611842,8512,38,2,5
45016,2014/03/31,2012/11/05,70,7,0.818578923,4384,70,4,3
45017,2014/03/31,2012/12/11,200,4,0.652097038,5503,200,0,4
45018,2014/03/31,2009/09/30,632,4,0.536856673,6684,632,4,0
45019,2014/03/31,2012/04/11,69,7,0.677752172,5294,69,0,7
45020,2014/03/31,2013/01/15,219,2,0.6812037209999999,5267,219,1,1
45021,2014/03/31,2011/11/10,628,5,0.841022035,4266,628,5,0
45022,2014/03/31,2006/03/28,172,5,0.641218945,5595,172,3,2
45023,2014/03/31,2006/09/01,274,5,0.548394986,6542,274,4,1
45024,2014/03/31,2010/02/22,326,4,0.702182423,5109,326,3,1
45025,2014/03/31,2009/03/23,216,2,0.785,4570,216,0,2
45026,2014/03/31,2010/03/26,605,2,0.754046668,4757,605,2,0
45027,2014/03/31,2011/11/21,395,2,0.575,6238,395,2,0
45028,2014/03/31,2012/02/13,596,4,0.765059727,4688,596,4,0
45029,2014/03/31,2008/04/29,511,3,0.71290002,5031,511,3,0
45030,2014/03/31,2009/08/06,216,5,0.961769912,3729,216,2,3
45031,2014/03/31,2009/07/12,179,5,0.692349421,5180,179,3,2
45032,2014/03/31,2013/03/13,7,3,0.672339708,5334,7,0,3
45033,2014/03/31,2012/08/16,510,4,0.784565741,4571,510,4,0
45034,2014/03/31,2010/10/07,395,4,0.5875,6104,395,4,0
45035,2014/03/31,2012/10/16,60,4,0.852612934,4206,60,1,3
45036,2014/03/31,2009/09/11,81,3,0.5735908510000001,6252,81,2,1
45037,2014/03/31,2008/06/19,9,3,0.569917355,6292,9,1,2
45038,2014/03/31,2011/08/27,116,3,0.693531915,5170,116,1,2
45039,2014/03/31,2012/06/09,658,3,0.54974701,6522,658,3,0
45040,2014/03/31,2012/08/25,175,3,1.112743637,3222,175,2,1
45041,2014/03/31,2007/09/17,34,2,0.67,5351,34,0,2
45042,2014/03/31,2011/12/06,238,4,0.557567652,6430,238,1,3
45043,2014/03/31,2005/06/27,41,2,1.4759530669999998,2429,41,0,2
45044,2014/03/31,2009/04/26,78,5,0.458567409,7818,78,3,2
45045,2014/03/31,2008/06/14,381,2,1.5,2390,381,2,0
45046,2014/03/31,2013/03/30,212,6,0.446948011,8021,212,1,5
45047,2014/03/31,2013/03/08,4,4,0.49533232,7237,4,0,4
45048,2014/03/31,2011/10/23,39,5,0.527921944,6790,39,0,5
45049,2014/03/31,2005/03/23,19,3,0.874869417,4097,19,1,2
45050,2014/03/31,2012/08/24,301,4,0.904890179,3961,301,3,1
45051,2014/03/31,2011/09/29,435,3,0.549777573,6519,435,3,0
45052,2014/03/31,2012/11/10,357,5,0.583024239,6147,357,4,1
45053,2014/03/31,2007/06/13,70,3,0.7433257259999999,4820,70,0,3
45054,2014/03/31,2010/04/06,27,4,0.96,3732,27,0,4
45055,2014/03/31,2010/04/23,70,7,0.630022863,5686,70,2,5
45056,2014/03/31,2011/04/24,6,6,0.522561634,6855,6,0,6
45057,2014/03/31,2012/05/28,16,4,0.7925,4520,16,1,3
45058,2014/03/31,2013/01/28,253,4,0.521149425,6873,253,1,3
45059,2014/03/31,2009/02/15,27,2,0.754366049,4748,27,1,1
45060,2014/03/31,2005/05/15,108,4,0.948292295,3777,108,2,2
45061,2014/03/31,2006/04/30,346,7,0.721660286,4963,346,6,1
45062,2014/03/31,2012/09/18,557,2,0.725,4940,557,2,0
45063,2014/03/31,2012/04/04,527,3,0.933333333,3837,527,3,0
45064,2014/03/31,2005/11/30,222,3,0.86858113,4123,222,0,3
45065,2014/03/31,2012/06/26,31,6,0.8508220479999999,4209,31,4,2
45066,2014/03/31,2011/10/21,118,2,0.63,5684,118,0,2
45067,2014/03/31,2008/11/06,448,5,0.689012892,5197,448,5,0
45068,2014/03/31,2009/02/12,487,3,0.8567121320000001,4179,487,3,0
45069,2014/03/31,2010/08/31,103,5,0.6173771339999999,5799,103,1,4
45070,2014/03/31,2008/09/24,108,3,0.606666667,5901,108,2,1
45071,2014/03/31,2012/05/24,674,3,0.7603653359999999,4708,674,3,0
45072,2014/03/31,2012/03/27,92,7,0.552345317,6481,92,5,2
45073,2014/03/31,2012/11/13,501,2,0.6,5966,501,2,0
45074,2014/03/31,2012/10/20,47,3,0.700193662,5112,47,1,2
45075,2014/03/31,2009/11/16,298,6,0.7438050709999999,4812,298,4,2
45076,2014/03/31,2013/02/08,37,7,0.6606608820000001,5417,37,1,6
45077,2014/03/31,2006/03/30,359,3,0.756116628,4733,359,2,1
45078,2014/03/31,2011/08/23,431,5,0.813503069,4399,431,5,0
45079,2014/03/31,2011/08/29,324,5,0.46981355,7616,324,3,2
45080,2014/03/31,2008/01/20,14,5,0.644564943,5551,14,2,3
45081,2014/03/31,2006/04/12,73,5,0.707403599,5057,73,0,5
45082,2014/03/31,2008/04/04,65,2,0.8845919879999999,4044,65,0,2
45083,2014/03/31,2012/12/01,334,5,0.718521495,4978,334,3,2
45084,2014/03/31,2010/06/15,194,3,0.7587059820000001,4714,194,2,1
45085,2014/03/31,2011/07/27,17,7,0.526888627,6788,17,4,3
45086,2014/03/31,2012/02/23,468,4,0.80190583,4460,468,4,0
45087,2014/03/31,2013/02/13,35,3,0.721440387,4957,35,0,3
45088,2014/03/31,2013/01/20,156,4,0.662125532,5401,156,0,4
45089,2014/03/31,2010/07/06,281,6,0.461666667,7746,281,4,2
45090,2014/03/31,2010/06/23,214,3,0.74453883,4803,214,0,3
45091,2014/03/31,2009/09/27,130,5,1.026268657,3484,130,0,5
45092,2014/03/31,2011/01/13,50,6,0.737672787,4847,50,2,4
45093,2014/03/31,2012/07/08,222,4,0.885,4040,222,1,3
45094,2014/03/31,2008/11/03,86,6,0.7036488879999999,5081,86,2,4
45095,2014/03/31,2012/02/04,502,6,0.7755314529999999,4610,502,6,0
45096,2014/03/31,2009/01/01,30,5,0.549508146,6506,30,0,5
45097,2014/03/31,2009/06/01,380,4,0.629640719,5678,380,4,0
45098,2014/03/31,2009/06/16,100,6,0.866630303,4125,100,0,6
45099,2014/03/31,2009/11/24,217,5,0.442152134,8085,217,4,1
45100,2014/03/31,2012/05/18,643,4,0.6043617920000001,5915,643,4,0
45101,2014/03/31,2011/04/11,346,6,1.0,3574,346,5,1
45102,2014/03/31,2012/07/19,218,4,0.924286084,3866,218,3,1
45103,2014/03/31,2012/01/22,10,4,0.585084329,6107,10,2,2
45104,2014/03/31,2008/01/28,577,2,0.8440822109999999,4233,577,2,0
45105,2014/03/31,2010/07/06,185,10,0.652,5480,185,9,1
45106,2014/03/31,2006/11/21,46,3,0.580648464,6153,46,1,2
45107,2014/03/31,2012/02/20,322,4,0.5191368789999999,6882,322,2,2
45108,2014/03/31,2012/02/22,9,6,0.605920963,5896,9,2,4
45109,2014/03/31,2010/08/20,488,3,0.888656716,4020,488,3,0
45110,2014/03/31,2009/07/18,176,4,0.6425,5560,176,0,4
45111,2014/03/31,2012/09/06,188,7,0.534933353,6677,188,4,3
45112,2014/03/31,2013/01/21,5,3,0.540726722,6605,5,0,3
45113,2014/03/31,2008/06/29,214,2,1.340131332,2665,214,0,2
45114,2014/03/31,2012/05/09,690,2,0.65,5494,690,2,0
45115,2014/03/31,2012/05/10,386,3,0.681142694,5242,386,3,0
45116,2014/03/31,2010/04/13,399,5,0.515968208,6920,399,5,0
45117,2014/03/31,2006/08/28,307,5,0.739498757,4828,307,2,3
45118,2014/03/31,2011/07/01,540,3,0.496053911,7197,540,3,0
45119,2014/03/31,2007/04/27,581,2,0.820689655,4350,581,2,0
45120,2014/03/31,2008/03/03,359,4,1.197986577,2980,359,3,1
45121,2014/03/31,2012/07/19,347,4,0.534516322,6678,347,3,1
45122,2014/03/31,2008/10/17,13,4,0.642753467,5553,13,0,4
45123,2014/03/31,2008/04/18,613,5,0.957146688,3729,613,5,0
45124,2014/03/31,2012/11/06,11,5,0.846527514,4216,11,3,2
45125,2014/03/31,2009/01/23,356,3,1.5,2379,356,1,2
45126,2014/03/31,2007/06/19,111,6,0.516867034,6904,111,4,2
45127,2014/03/31,2011/04/10,355,5,0.88,4055,355,3,2
45128,2014/03/31,2009/09/24,168,5,0.636526935,5606,168,2,3
45129,2014/03/31,2007/06/28,106,4,0.728530012,4898,106,1,3
45130,2014/03/31,2012/10/08,166,3,0.583333333,6117,166,1,2
45131,2014/03/31,2011/07/20,186,5,0.699006661,5104,186,3,2
45132,2014/03/31,2010/04/15,203,5,0.383209452,9310,203,2,3
45133,2014/03/31,2008/09/27,14,4,1.2925,2760,14,0,4
45134,2014/03/31,2010/01/13,41,6,0.7838409140000001,4551,41,0,6
45135,2014/03/31,2010/06/23,425,7,0.6604795410000001,5401,425,7,0
45136,2014/03/31,2012/01/03,138,4,0.731517637,4876,138,1,3
45137,2014/03/31,2011/01/29,469,2,0.8128532359999999,4388,469,2,0
45138,2014/03/31,2011/02/16,492,2,0.85,4196,492,2,0
45139,2014/03/31,2012/07/13,619,2,0.85,4196,619,2,0
45140,2014/03/31,2012/12/18,34,3,0.73688843,4840,34,2,1
45141,2014/03/31,2011/12/15,345,4,1.065113501,3348,345,3,1
45142,2014/03/31,2007/08/25,65,5,0.590571476,6037,65,3,2
45143,2014/03/31,2011/06/18,574,2,0.6,5942,574,2,0
45144,2014/03/31,2012/09/22,217,2,1.117968015,3189,217,1,1
45145,2014/03/31,2011/06/20,592,2,0.6,5942,592,2,0
45146,2014/03/31,2008/06/25,122,4,0.425535395,8377,122,2,2
45147,2014/03/31,2012/10/23,282,3,0.8803161270000001,4049,282,1,2
45148,2014/03/31,2011/03/21,156,3,0.8029375990000001,4439,156,2,1
45149,2014/03/31,2012/08/13,419,8,0.613973122,5804,419,8,0
45150,2014/03/31,2012/04/06,245,2,1.287809902,2767,245,0,2
45151,2014/03/31,2005/02/25,224,4,0.8536320079999999,4174,224,1,3
45152,2014/03/31,2011/12/14,653,4,0.8981598190000001,3967,653,4,0
45153,2014/03/31,2012/02/21,451,3,1.0,3563,451,3,0
45154,2014/03/31,2009/09/12,5,2,0.7441738040000001,4787,5,0,2
45155,2014/03/31,2011/12/11,520,3,0.810350318,4396,520,3,0
45156,2014/03/31,2011/08/31,9,3,0.935916973,3806,9,2,1
45157,2014/03/31,2012/04/30,696,2,1.0,3562,696,2,0
45158,2014/03/31,2010/10/10,100,5,0.536888755,6634,100,2,3
45159,2014/03/31,2012/03/28,686,4,0.384683517,9258,686,4,0
45160,2014/03/31,2013/03/14,305,5,0.518,6875,305,4,1
45161,2014/03/31,2013/03/07,140,4,0.700952756,5080,140,1,3
45162,2014/03/31,2011/01/24,206,7,0.4300495170000001,8280,206,4,3
45163,2014/03/31,2005/12/23,314,4,0.418309445,8512,314,0,4
45164,2014/03/31,2011/05/09,246,4,0.876538651,4062,246,0,4
45165,2014/03/31,2006/11/25,151,7,0.460956758,7724,151,2,5
45166,2014/03/31,2012/01/13,44,4,0.8711402009999999,4087,44,3,1
45167,2014/03/31,2009/03/27,418,4,0.5,7120,418,4,0
45168,2014/03/31,2006/11/08,319,2,1.0,3560,319,0,2
45169,2014/03/31,2010/03/16,478,3,0.593432239,5999,478,3,0
45170,2014/03/31,2007/12/24,591,2,1.0,3560,591,2,0
45171,2014/03/31,2010/04/20,143,4,0.8556730770000001,4160,143,3,1
45172,2014/03/31,2008/09/16,94,2,0.8679639109999999,4101,94,0,2
45173,2014/03/31,2011/09/12,168,3,0.884922924,4022,168,1,2
45174,2014/03/31,2009/07/25,219,3,0.8159261809999999,4362,219,2,1
45175,2014/03/31,2012/06/23,455,4,0.6735427709999999,5284,455,4,0
45176,2014/03/31,2012/02/16,582,3,0.8520474140000001,4176,582,3,0
45177,2014/03/31,2006/12/26,21,3,0.89153345,3991,21,0,3
45178,2014/03/31,2009/08/20,381,2,1.064572113,3342,381,2,0
45179,2014/03/31,2011/09/17,198,7,0.6766356029999999,5258,198,1,6
45180,2014/03/31,2007/04/21,256,5,0.613188556,5802,256,3,2
45181,2014/03/31,2010/11/20,366,4,0.8,4447,366,3,1
45182,2014/03/31,2011/10/19,237,3,0.7307908790000001,4868,237,0,3
45183,2014/03/31,2013/02/24,279,3,0.8441955390000001,4214,279,2,1
45184,2014/03/31,2010/05/01,173,3,0.755609601,4708,173,0,3
45185,2014/03/31,2011/07/02,488,3,0.945111583,3764,488,3,0
45186,2014/03/31,2012/07/27,109,7,0.523136765,6800,109,3,4
45187,2014/03/31,2013/01/21,275,6,0.321695007,11056,275,3,3
45188,2014/03/31,2013/03/03,144,3,0.763333333,4659,144,0,3
45189,2014/03/31,2010/04/29,17,4,0.518395044,6860,17,0,4
45190,2014/03/31,2005/09/05,312,3,1.0,3556,312,2,1
45191,2014/03/31,2012/06/08,401,4,0.7430004179999999,4786,401,4,0
45192,2014/03/31,2008/01/25,206,5,0.7447663940000001,4773,206,1,4
45193,2014/03/31,2013/03/02,250,5,0.610535898,5822,250,2,3
45194,2014/03/31,2013/03/15,43,4,0.612192559,5806,43,2,2
45195,2014/03/31,2009/02/13,343,5,0.793736043,4478,343,4,1
45196,2014/03/31,2012/07/04,309,2,0.5495747639999999,6467,309,1,1
45197,2014/03/31,2008/07/10,704,3,0.642086721,5535,704,3,0
45198,2014/03/31,2012/11/06,484,3,0.4998945,7109,484,3,0
45199,2014/03/31,2006/11/05,438,5,0.696940577,5099,438,5,0
45200,2014/03/31,2010/10/06,145,2,0.697972893,5091,145,1,1
45201,2014/03/31,2011/09/26,319,2,0.8676434679999999,4095,319,1,1
45202,2014/03/31,2012/11/05,506,2,0.55,6460,506,2,0
45203,2014/03/31,2011/01/07,19,6,0.542329415,6551,19,0,6
45204,2014/03/31,2011/05/07,19,5,0.739386056,4805,19,3,2
45205,2014/03/31,2013/03/21,200,5,0.786345728,4518,200,2,3
45206,2014/03/31,2008/05/06,48,3,0.819875375,4333,48,0,3
45207,2014/03/31,2008/09/28,249,2,0.625,5684,249,0,2
45208,2014/03/31,2006/03/12,247,2,0.625,5684,247,0,2
45209,2014/03/31,2011/10/18,463,2,0.625,5684,463,2,0
45210,2014/03/31,2011/12/07,247,2,0.625,5684,247,0,2
45211,2014/03/31,2013/01/21,195,8,0.448151653,7926,195,4,4
45212,2014/03/31,2006/07/23,68,7,0.722493897,4916,68,0,7
45213,2014/03/31,2009/03/27,114,7,0.49384733,7192,114,0,7
45214,2014/03/31,2010/01/20,63,3,0.57,6231,63,0,3
45215,2014/03/31,2012/11/16,32,6,0.567776179,6255,32,0,6
45216,2014/03/31,2009/07/28,115,2,0.605,5870,115,0,2
45217,2014/03/31,2012/08/17,92,3,0.7341596029999999,4837,92,0,3
45218,2014/03/31,2008/07/14,9,4,0.814597385,4359,9,0,4
45219,2014/03/31,2013/03/06,76,5,0.843618437,4209,76,2,3
45220,2014/03/31,2010/09/08,237,3,0.659979554,5380,237,1,2
45221,2014/03/31,2009/10/21,25,8,0.563577778,6300,25,2,6
45222,2014/03/31,2006/10/20,12,3,0.663759581,5349,12,0,3
45223,2014/03/31,2011/11/06,458,3,1.0,3550,458,3,0
45224,2014/03/31,2011/09/27,382,4,0.75302291,4714,382,4,0
45225,2014/03/31,2008/04/05,163,5,0.586705241,6049,163,1,4
45226,2014/03/31,2011/03/15,234,3,0.867277615,4092,234,2,1
45227,2014/03/31,2010/02/03,3,2,0.859803732,4127,3,0,2
45228,2014/03/31,2010/02/15,139,5,0.56026054,6333,139,2,3
45229,2014/03/31,2006/08/03,95,3,0.601871077,5895,95,0,3
45230,2014/03/31,2012/11/30,375,5,0.7106270029999999,4992,375,5,0
45231,2014/03/31,2012/04/28,431,3,0.6333333329999999,5601,431,3,0
45232,2014/03/31,2006/04/17,86,4,0.639019996,5551,86,3,1
45233,2014/03/31,2010/09/28,612,7,0.420597652,8433,612,7,0
45234,2014/03/31,2010/05/06,73,5,0.5027455710000001,7055,73,0,5
45235,2014/03/31,2011/08/25,537,5,0.750327904,4727,537,5,0
45236,2014/03/31,2011/03/11,142,3,0.483874488,7330,142,0,3
45237,2014/03/31,2005/10/28,27,6,0.911279877,3891,27,5,1
45238,2014/03/31,2005/05/08,105,4,0.60117667,5898,105,0,4
45239,2014/03/31,2012/06/01,630,5,0.725092025,4890,630,5,0
45240,2014/03/31,2012/02/21,358,4,0.95,3732,358,3,1
45241,2014/03/31,2013/01/19,253,3,0.971331507,3650,253,2,1
45242,2014/03/31,2010/08/22,171,4,0.856362319,4140,171,3,1
45243,2014/03/31,2013/01/24,322,3,0.6966299859999999,5089,322,0,3
45244,2014/03/31,2012/11/17,487,3,1.0,3545,487,3,0
45245,2014/03/31,2010/10/15,133,4,0.472666667,7500,133,0,4
45246,2014/03/31,2012/01/09,193,3,0.615859972,5756,193,2,1
45247,2014/03/31,2010/04/28,145,3,0.903333333,3924,145,0,3
45248,2014/03/31,2007/10/31,93,2,0.664299906,5335,93,0,2
45249,2014/03/31,2012/09/04,28,4,0.559954179,6329,28,2,2
45250,2014/03/31,2011/12/15,47,4,0.638371465,5551,47,0,4
45251,2014/03/31,2011/04/20,36,8,0.765,4632,36,2,6
45252,2014/03/31,2010/10/21,325,6,0.6163419729999999,5749,325,4,2
45253,2014/03/31,2011/12/02,16,6,0.544673328,6505,16,4,2
45254,2014/03/31,2008/05/10,226,3,0.646885156,5477,226,2,1
45255,2014/03/31,2010/06/24,545,4,0.65252395,5428,545,4,0
45256,2014/03/31,2011/01/01,492,4,0.7905803570000001,4480,492,4,0
45257,2014/03/31,2011/03/24,251,2,0.67,5286,251,0,2
45258,2014/03/31,2012/01/16,191,4,0.594118437,5961,191,2,2
45259,2014/03/31,2013/03/19,208,3,0.85148353,4159,208,1,2
45260,2014/03/31,2010/01/04,221,5,0.905112474,3912,221,1,4
45261,2014/03/31,2005/07/20,109,4,0.610693343,5798,109,2,2
45262,2014/03/31,2013/02/04,401,3,0.6,5901,401,3,0
45263,2014/03/31,2011/01/14,634,2,0.9,3934,634,2,0
45264,2014/03/31,2007/03/09,525,2,0.9,3934,525,2,0
45265,2014/03/31,2012/05/07,692,2,0.9,3934,692,2,0
45266,2014/03/31,2011/12/28,399,4,0.45,7868,399,4,0
45267,2014/03/31,2010/12/03,430,2,0.9,3934,430,2,0
45268,2014/03/31,2007/04/20,522,2,0.9,3934,522,2,0
45269,2014/03/31,2013/01/01,80,2,0.9,3934,80,0,2
45270,2014/03/31,2010/03/05,533,2,0.9,3934,533,2,0
45271,2014/03/31,2012/12/21,145,3,0.6,5901,145,1,2
45272,2014/03/31,2008/03/18,190,2,1.04,3404,190,0,2
45273,2014/03/31,2012/10/04,33,5,0.742033543,4770,33,0,5
45274,2014/03/31,2012/06/22,460,5,0.349644374,10123,460,5,0
45275,2014/03/31,2010/08/19,21,5,0.505757359,6998,21,1,4
45276,2014/03/31,2011/03/25,158,5,0.889673203,3978,158,2,3
45277,2014/03/31,2008/12/08,307,4,0.6693209760000001,5287,307,2,2
45278,2014/03/31,2013/03/16,132,6,0.535741105,6605,132,1,5
45279,2014/03/31,2011/12/09,4,4,0.748405245,4728,4,0,4
45280,2014/03/31,2011/12/07,4,6,0.717999188,4928,4,2,4
45281,2014/03/31,2008/07/23,236,5,0.7003008709999999,5052,236,2,3
45282,2014/03/31,2010/08/12,368,6,0.515578549,6862,368,6,0
45283,2014/03/31,2012/06/13,128,7,0.5012980020000001,7057,128,5,2
45284,2014/03/31,2010/12/16,12,10,0.399891476,8846,12,5,5
45285,2014/03/31,2012/10/05,96,7,0.381079509,9282,96,5,2
45286,2014/03/31,2009/11/11,339,6,0.908333333,3894,339,4,2
45287,2014/03/31,2013/03/27,343,2,0.8893638420000001,3977,343,1,1
45288,2014/03/31,2011/09/20,328,5,0.55,6430,328,4,1
45289,2014/03/31,2008/03/27,472,8,0.6224432320000001,5681,472,8,0
45290,2014/03/31,2012/07/13,9,4,0.742231787,4763,9,1,3
45291,2014/03/31,2013/01/01,296,4,0.932770449,3790,296,1,3
45292,2014/03/31,2007/08/18,263,5,0.5525242260000001,6398,263,2,3
45293,2014/03/31,2013/01/12,76,2,0.7793320109999999,4536,76,1,1
45294,2014/03/31,2009/05/23,228,3,0.573333333,6165,228,0,3
45295,2014/03/31,2009/09/29,274,4,0.53107438,6655,274,0,4
45296,2014/03/31,2012/07/06,2,4,0.471423426,7496,2,1,3
45297,2014/03/31,2012/10/02,11,5,0.705410262,5009,11,2,3
45298,2014/03/31,2012/12/29,184,4,0.7128813559999999,4956,184,2,2
45299,2014/03/31,2012/10/16,169,2,0.923177424,3827,169,1,1
45300,2014/03/31,2007/01/07,217,6,0.638871609,5530,217,4,2
45301,2014/03/31,2012/09/12,561,2,0.7,5047,561,2,0
45302,2014/03/31,2012/09/12,561,2,0.7,5047,561,2,0
45303,2014/03/31,2012/05/11,71,4,0.774466126,4561,71,3,1
45304,2014/03/31,2008/04/03,92,4,0.7537387959999999,4686,92,1,3
45305,2014/03/31,2013/03/16,302,5,0.360871564,9787,302,2,3
45306,2014/03/31,2012/04/24,635,6,0.7767319109999999,4547,635,6,0
45307,2014/03/31,2004/12/16,647,3,0.591384796,5972,647,3,0
45308,2014/03/31,2006/09/27,239,4,0.752381764,4694,239,0,4
45309,2014/03/31,2010/12/23,578,3,0.9,3924,578,3,0
45310,2014/03/31,2011/05/08,49,3,0.983333333,3591,49,1,2
45311,2014/03/31,2013/01/02,289,3,0.819851405,4307,289,1,2
45312,2014/03/31,2010/01/12,261,2,0.535,6600,261,1,1
45313,2014/03/31,2011/07/08,306,4,0.532659526,6629,306,3,1
45314,2014/03/31,2006/10/15,62,2,0.85,4154,62,0,2
45315,2014/03/31,2005/04/14,317,2,0.85,4154,317,0,2
45316,2014/03/31,2010/11/25,72,2,0.85,4154,72,0,2
45317,2014/03/31,2011/06/18,394,3,0.566666667,6231,394,3,0
45318,2014/03/31,2012/09/02,276,4,0.490326344,7201,276,2,2
45319,2014/03/31,2005/02/01,37,3,1.4797443419999998,2386,37,2,1
45320,2014/03/31,2011/08/23,99,3,0.6247496020000001,5651,99,0,3
45321,2014/03/31,2012/01/25,56,4,0.701833002,5030,56,2,2
45322,2014/03/31,2010/12/13,191,8,0.401410052,8794,191,5,3
45323,2014/03/31,2007/06/20,16,4,0.603308836,5851,16,0,4
45324,2014/03/31,2013/01/27,170,6,0.846489209,4170,170,1,5
45325,2014/03/31,2010/11/24,229,5,0.7509489359999999,4700,229,2,3
45326,2014/03/31,2007/09/05,101,4,0.759662075,4646,101,0,4
45327,2014/03/31,2010/10/22,163,4,0.6566139529999999,5375,163,0,4
45328,2014/03/31,2006/06/20,299,2,0.685,5152,299,0,2
45329,2014/03/31,2013/02/16,285,3,0.8882431409999999,3973,285,1,2
45330,2014/03/31,2012/07/03,85,7,0.559793749,6303,85,3,4
45331,2014/03/31,2012/09/12,28,5,0.418,8440,28,2,3
45332,2014/03/31,2009/01/13,69,3,0.6930451870000001,5090,69,0,3
45333,2014/03/31,2012/08/25,581,2,0.625,5644,581,2,0
45334,2014/03/31,2013/02/01,265,5,0.641938126,5495,265,2,3
45335,2014/03/31,2012/06/17,207,5,0.636481415,5542,207,3,2
45336,2014/03/31,2008/10/24,413,5,0.725452489,4862,413,5,0
45337,2014/03/31,2009/07/19,97,3,0.789693238,4466,97,0,3
45338,2014/03/31,2006/06/04,668,4,0.7847129509999999,4494,668,4,0
45339,2014/03/31,2005/11/10,119,3,0.655328006,5381,119,2,1
45340,2014/03/31,2007/06/20,214,2,0.8446227540000001,4175,214,0,2
45341,2014/03/31,2007/06/20,244,4,0.661001125,5334,244,2,2
45342,2014/03/31,2012/09/05,295,3,0.7464958709999999,4723,295,2,1
45343,2014/03/31,2012/09/23,293,6,0.723220513,4875,293,4,2
45344,2014/03/31,2012/12/31,28,4,0.396005392,8902,28,2,2
45345,2014/03/31,2013/02/22,333,3,0.726964323,4849,333,1,2
45346,2014/03/31,2012/09/27,123,4,0.908515464,3880,123,2,2
45347,2014/03/31,2011/09/03,612,3,0.572705118,6155,612,3,0
45348,2014/03/31,2011/11/08,465,6,0.624180981,5647,465,6,0
45349,2014/03/31,2007/11/01,39,7,0.442054434,7973,39,5,2
45350,2014/03/31,2010/05/03,41,8,0.436826971,8068,41,0,8
45351,2014/03/31,2009/09/01,363,4,0.849746805,4147,363,3,1
45352,2014/03/31,2005/06/08,228,4,0.3,11746,228,0,4
45353,2014/03/31,2012/11/11,93,7,0.555345942,6345,93,2,5
45354,2014/03/31,2012/10/18,122,6,0.6687265139999999,5269,122,1,5
45355,2014/03/31,2012/05/23,51,4,0.497724255,7079,51,0,4
45356,2014/03/31,2012/06/14,388,2,0.65,5420,388,2,0
45357,2014/03/31,2013/03/09,387,2,0.65,5420,387,2,0
45358,2014/03/31,2012/06/14,339,2,0.65,5420,339,0,2
45359,2014/03/31,2013/02/01,32,3,0.8666666670000001,4065,32,0,3
45360,2014/03/31,2008/04/23,333,2,0.65,5420,333,0,2
45361,2014/03/31,2013/03/19,376,2,0.65,5420,376,2,0
45362,2014/03/31,2012/12/27,224,4,0.672542955,5238,224,3,1
45363,2014/03/31,2005/10/27,29,5,0.47106713,7478,29,1,4
45364,2014/03/31,2006/11/14,493,4,1.0,3522,493,4,0
45365,2014/03/31,2004/12/17,223,4,0.933937947,3771,223,1,3
45366,2014/03/31,2012/08/07,82,6,0.532403628,6615,82,4,2
45367,2014/03/31,2013/01/07,47,5,0.632002872,5572,47,2,3
45368,2014/03/31,2013/01/16,438,3,0.5005970999999999,7034,438,3,0
45369,2014/03/31,2013/01/30,402,2,0.825,4268,402,2,0
45370,2014/03/31,2008/10/04,49,5,0.7265889390000001,4846,49,0,5
45371,2014/03/31,2010/10/12,165,5,0.579295821,6078,165,2,3
45372,2014/03/31,2012/12/12,186,3,0.92,3827,186,0,3
45373,2014/03/31,2012/03/26,407,2,0.775677462,4539,407,2,0
45374,2014/03/31,2011/11/07,26,4,0.699658188,5032,26,1,3
45375,2014/03/31,2012/12/05,199,3,0.629924852,5589,199,1,2
45376,2014/03/31,2006/04/03,305,3,0.6147642329999999,5726,305,1,2
45377,2014/03/31,2010/09/14,247,4,0.616023801,5714,247,2,2
45378,2014/03/31,2013/02/16,36,5,0.7198854570000001,4889,36,2,3
45379,2014/03/31,2008/04/25,311,3,0.6907654559999999,5095,311,1,2
45380,2014/03/31,2012/03/17,78,3,0.622215347,5656,78,1,2
45381,2014/03/31,2005/09/24,5,6,0.500159181,7036,5,0,6
45382,2014/03/31,2006/11/26,488,6,0.685183022,5136,488,6,0
45383,2014/03/31,2012/09/20,554,2,0.75,4692,554,2,0
45384,2014/03/31,2011/08/17,529,5,0.506091772,6952,529,5,0
45385,2014/03/31,2009/04/15,21,7,0.626651229,5614,21,1,6
45386,2014/03/31,2009/09/22,14,4,0.787894737,4465,14,3,1
45387,2014/03/31,2012/05/29,256,5,0.6337362639999999,5551,256,3,2
45388,2014/03/31,2012/11/16,79,3,0.577597701,6090,79,0,3
45389,2014/03/31,2011/01/15,361,5,0.7747797359999999,4540,361,4,1
45390,2014/03/31,2012/02/08,189,4,0.753528278,4668,189,3,1
45391,2014/03/31,2006/03/08,161,7,0.859218177,4093,161,3,4
45392,2014/03/31,2011/02/25,537,3,0.501025787,7019,537,3,0
45393,2014/03/31,2013/03/28,172,6,0.450477899,7805,172,0,6
45394,2014/03/31,2011/08/13,136,2,0.898849399,3911,136,1,1
45395,2014/03/31,2011/01/14,118,5,0.7457000420000001,4714,118,3,2
45396,2014/03/31,2007/11/27,125,4,0.565283049,6218,125,0,4
45397,2014/03/31,2006/03/13,384,5,0.424710005,8276,384,5,0
45398,2014/03/31,2004/12/28,171,5,0.6604115770000001,5321,171,1,4
45399,2014/03/31,2012/05/21,5,5,0.711595788,4938,5,0,5
45400,2014/03/31,2011/06/11,493,3,0.6,5856,493,3,0
45401,2014/03/31,2012/01/31,222,3,0.58,6057,222,0,3
45402,2014/03/31,2005/11/26,636,4,0.587261785,5982,636,4,0
45403,2014/03/31,2011/02/17,30,11,0.487566967,7205,30,9,2
45404,2014/03/31,2010/09/06,125,7,0.818671638,4291,125,4,3
45405,2014/03/31,2007/12/20,236,9,0.658414246,5335,236,1,8
45406,2014/03/31,2008/08/16,230,2,0.92,3818,230,0,2
45407,2014/03/31,2011/09/20,145,5,0.6729986590000001,5219,145,3,2
45408,2014/03/31,2010/09/29,401,5,0.62,5665,401,5,0
45409,2014/03/31,2012/06/16,71,6,0.713581877,4922,71,5,1
45410,2014/03/31,2006/10/01,14,6,0.681801592,5151,14,2,4
45411,2014/03/31,2006/09/14,35,2,0.7164300290000001,4902,35,0,2
45412,2014/03/31,2010/02/02,661,3,0.630943396,5565,661,3,0
45413,2014/03/31,2012/04/26,39,4,0.883075956,3976,39,2,2
45414,2014/03/31,2011/07/31,409,3,0.587910248,5972,409,3,0
45415,2014/03/31,2008/05/09,159,5,0.643504399,5456,159,1,4
45416,2014/03/31,2010/09/14,276,5,0.930646872,3772,276,3,2
45417,2014/03/31,2009/02/22,242,3,0.684535881,5128,242,2,1
45418,2014/03/31,2009/06/06,137,4,0.539532739,6506,137,2,2
45419,2014/03/31,2010/10/13,144,5,0.910547341,3855,144,2,3
45420,2014/03/31,2005/04/29,113,2,0.845,4154,113,0,2
45421,2014/03/31,2012/08/12,590,2,0.45,7800,590,2,0
45422,2014/03/31,2011/05/15,363,3,0.75,4680,363,2,1
45423,2014/03/31,2007/08/31,62,5,0.648512565,5412,62,2,3
45424,2014/03/31,2012/12/06,81,6,0.62020675,5659,81,5,1
45425,2014/03/31,2011/12/24,35,3,0.540443486,6494,35,2,1
45426,2014/03/31,2013/01/14,108,4,0.61141115,5740,108,0,4
45427,2014/03/31,2011/09/29,379,5,0.89871959,3905,379,5,0
45428,2014/03/31,2011/10/16,213,4,0.6751288959999999,5198,213,2,2
45429,2014/03/31,2007/03/29,3,10,0.462970976,7580,3,4,6
45430,2014/03/31,2005/06/21,48,3,0.567976691,6178,48,0,3
45431,2014/03/31,2007/11/23,321,3,0.567140779,6187,321,2,1
45432,2014/03/31,2011/01/06,103,3,0.8752506859999999,4009,103,0,3
45433,2014/03/31,2005/05/11,175,2,0.92,3814,175,0,2
45434,2014/03/31,2010/02/06,74,4,0.645712183,5434,74,2,2
45435,2014/03/31,2011/07/16,603,3,0.8432588320000001,4161,603,3,0
45436,2014/03/31,2011/06/16,164,7,0.576593262,6085,164,2,5
45437,2014/03/31,2006/03/22,331,8,0.530761083,6609,331,7,1
45438,2014/03/31,2012/04/08,296,2,0.681507674,5147,296,1,1
45439,2014/03/31,2011/09/24,84,6,0.407778424,8602,84,0,6
45440,2014/03/31,2007/05/16,15,4,0.5174992620000001,6778,15,0,4
45441,2014/03/31,2011/09/08,418,5,0.45470573,7714,418,5,0
45442,2014/03/31,2008/07/16,214,3,0.8992923079999999,3900,214,0,3
45443,2014/03/31,2012/12/29,456,2,0.6739573320000001,5203,456,2,0
45444,2014/03/31,2008/07/24,75,6,0.5599760460000001,6262,75,4,2
45445,2014/03/31,2011/03/27,523,6,0.536087754,6541,523,6,0
45446,2014/03/31,2005/07/28,495,4,0.7881096879999999,4449,495,4,0
45447,2014/03/31,2008/07/09,25,3,0.6701070339999999,5232,25,1,2
45448,2014/03/31,2008/08/25,77,4,0.5928204260000001,5914,77,0,4
45449,2014/03/31,2012/02/01,22,4,0.903825728,3879,22,2,2
45450,2014/03/31,2013/03/29,117,6,0.5422304720000001,6465,117,1,5
45451,2014/03/31,2012/10/17,440,2,0.739089184,4743,440,2,0
45452,2014/03/31,2009/11/16,570,4,0.81599162,4296,570,4,0
45453,2014/03/31,2007/11/15,234,2,0.7734797,4532,234,1,1
45454,2014/03/31,2013/02/15,48,4,0.782625586,4479,48,2,2
45455,2014/03/31,2011/03/01,477,5,0.645771923,5428,477,5,0
45456,2014/03/31,2010/07/17,572,3,0.671632497,5219,572,3,0
45457,2014/03/31,2009/05/15,14,5,0.498797495,7027,14,0,5
45458,2014/03/31,2012/12/14,19,4,0.637511822,5498,19,0,4
45459,2014/03/31,2013/01/01,346,3,0.474461893,7387,346,0,3
45460,2014/03/31,2007/10/23,404,6,0.4916666670000001,7128,404,6,0
45461,2014/03/31,2011/02/18,12,4,0.7863046890000001,4457,12,2,2
45462,2014/03/31,2012/12/04,123,5,0.5884500420000001,5955,123,2,3
45463,2014/03/31,2007/03/18,17,5,0.377888493,9273,17,0,5
45464,2014/03/31,2009/06/28,86,8,0.404141869,8670,86,3,5
45465,2014/03/31,2013/03/16,46,3,0.860643577,4071,46,1,2
45466,2014/03/31,2011/11/16,226,2,0.94172043,3720,226,1,1
45467,2014/03/31,2010/12/29,242,2,0.48,7298,242,0,2
45468,2014/03/31,2008/10/29,1,3,0.32,10947,1,1,2
45469,2014/03/31,2008/03/01,94,4,0.811387538,4317,94,0,4
45470,2014/03/31,2010/04/10,45,5,0.788251182,4443,45,2,3
45471,2014/03/31,2007/11/23,83,6,0.6790963740000001,5157,83,5,1
45472,2014/03/31,2005/01/01,490,3,0.6742491340000001,5194,490,3,0
45473,2014/03/31,2011/01/13,50,6,0.511274639,6849,50,5,1
45474,2014/03/31,2013/01/24,5,4,0.7624891109999999,4592,5,3,1
45475,2014/03/31,2012/04/23,23,4,0.81900117,4275,23,1,3
45476,2014/03/31,2010/01/15,437,4,0.796201956,4397,437,4,0
45477,2014/03/31,2007/09/12,274,4,0.498274979,7026,274,3,1
45478,2014/03/31,2012/06/12,466,4,0.728705246,4804,466,4,0
45479,2014/03/31,2010/10/28,45,3,0.742264631,4716,45,0,3
45480,2014/03/31,2012/09/13,145,5,0.618121137,5663,145,1,4
45481,2014/03/31,2012/10/02,119,4,0.51389517,6811,119,2,2
45482,2014/03/31,2012/01/14,213,4,0.805311853,4345,213,3,1
45483,2014/03/31,2008/06/06,110,4,0.595844687,5872,110,1,3
45484,2014/03/31,2008/09/09,187,7,0.374991961,9329,187,5,2
45485,2014/03/31,2011/09/13,107,2,0.578010575,6052,107,0,2
45486,2014/03/31,2013/03/02,102,5,0.49540575,7061,102,1,4
45487,2014/03/31,2005/10/29,14,2,0.675,5182,14,0,2
45488,2014/03/31,2011/07/02,302,2,0.71,4926,302,0,2
45489,2014/03/31,2008/10/04,220,4,0.499485861,7002,220,0,4
45490,2014/03/31,2011/01/20,530,3,0.619100726,5649,530,3,0
45491,2014/03/31,2009/08/26,30,4,0.830643705,4210,30,3,1
45492,2014/03/31,2008/06/12,23,4,0.89960638,3887,23,0,4
45493,2014/03/31,2012/08/06,124,2,1.146828468,3049,124,0,2
45494,2014/03/31,2012/10/16,132,5,0.634345065,5512,132,1,4
45495,2014/03/31,2012/11/21,467,4,0.533282489,6556,467,4,0
45496,2014/03/31,2011/11/18,242,4,0.613986653,5694,242,2,2
45497,2014/03/31,2007/01/15,75,2,0.735,4756,75,0,2
45498,2014/03/31,2010/07/31,228,4,0.965379729,3621,228,2,2
45499,2014/03/31,2010/09/23,154,3,0.719693226,4857,154,0,3
45500,2014/03/31,2008/01/15,88,7,0.414100225,8441,88,4,3
45501,2014/03/31,2011/05/15,112,5,0.707258195,4942,112,2,3
45502,2014/03/31,2006/06/26,15,3,0.65016183,5376,15,0,3
45503,2014/03/31,2011/06/14,147,3,0.92,3799,147,0,3
45504,2014/03/31,2012/11/12,380,2,1.125,3106,380,2,0
45505,2014/03/31,2013/02/28,73,5,0.663032258,5270,73,1,4
45506,2014/03/31,2012/10/15,209,2,0.585963441,5963,209,1,1
45507,2014/03/31,2012/06/24,49,5,0.555677481,6288,49,3,2
45508,2014/03/31,2011/12/31,44,4,0.63577798,5495,44,2,2
45509,2014/03/31,2011/11/07,536,2,0.85,4110,536,2,0
45510,2014/03/31,2012/04/06,230,6,0.7568110920000001,4616,230,2,4
45511,2014/03/31,2009/10/02,691,2,0.8532242309999999,4094,691,2,0
45512,2014/03/31,2012/12/15,156,3,0.657136406,5315,156,2,1
45513,2014/03/31,2010/04/15,140,4,0.658973585,5300,140,0,4
45514,2014/03/31,2009/07/17,139,5,0.548013494,6373,139,2,3
45515,2014/03/31,2009/08/12,520,3,0.696628765,5013,520,3,0
45516,2014/03/31,2012/09/25,111,5,0.569765051,6129,111,3,2
45517,2014/03/31,2006/03/07,494,2,1.5,2328,494,2,0
45518,2014/03/31,2013/03/03,141,3,0.832589413,4194,141,0,3
45519,2014/03/31,2011/11/28,487,2,0.867312469,4026,487,2,0
45520,2014/03/31,2008/02/22,22,2,0.746576866,4677,22,0,2
45521,2014/03/31,2010/03/01,44,5,0.412,8475,44,3,2
45522,2014/03/31,2010/09/07,204,7,0.8614285709999999,4053,204,0,7
45523,2014/03/31,2009/07/09,91,7,0.8614285709999999,4053,91,5,2
45524,2014/03/31,2009/10/01,107,3,0.666037772,5242,107,1,2
45525,2014/03/31,2013/02/05,266,3,0.6195794139999999,5635,266,2,1
45526,2014/03/31,2012/08/07,524,4,0.8099535959999999,4310,524,4,0
45527,2014/03/31,2012/12/28,186,5,0.7010986140000001,4979,186,2,3
45528,2014/03/31,2012/08/23,153,4,0.755709028,4619,153,2,2
45529,2014/03/31,2012/08/10,216,5,0.548104585,6368,216,3,2
45530,2014/03/31,2010/08/11,615,3,0.71709472,4867,615,3,0
45531,2014/03/31,2008/03/31,24,6,0.566816631,6157,24,2,4
45532,2014/03/31,2011/12/28,375,4,0.881014895,3961,375,4,0
45533,2014/03/31,2011/12/16,165,3,0.56,6231,165,0,3
45534,2014/03/31,2012/07/30,320,5,0.41,8510,320,3,2
45535,2014/03/31,2012/07/22,31,6,0.536934441,6498,31,2,4
45536,2014/03/31,2011/01/29,32,6,0.4382301220000001,7961,32,2,4
45537,2014/03/31,2008/08/01,402,5,0.566147355,6162,402,5,0
45538,2014/03/31,2009/03/28,41,3,0.903725389,3860,41,1,2
45539,2014/03/31,2012/05/23,224,2,0.979051361,3563,224,1,1
45540,2014/03/31,2012/07/11,229,4,0.673615295,5178,229,2,2
45541,2014/03/31,2012/01/11,650,3,1.013040953,3443,650,3,0
45542,2014/03/31,2011/03/07,28,3,0.74,4713,28,0,3
45543,2014/03/31,2011/11/02,369,2,0.8909555440000001,3914,369,2,0
45544,2014/03/31,2012/01/12,5,4,0.7875,4428,5,0,4
45545,2014/03/31,2007/05/16,39,6,0.56015743,6225,39,5,1
45546,2014/03/31,2012/02/16,589,3,0.56966182,6121,589,3,0
45547,2014/03/31,2012/11/02,242,4,0.71744856,4860,242,2,2
45548,2014/03/31,2011/04/21,142,5,0.756647135,4608,142,1,4
45549,2014/03/31,2010/07/14,662,5,0.62933213,5540,662,5,0
45550,2014/03/31,2011/12/03,624,3,0.732611893,4759,624,3,0
45551,2014/03/31,2012/12/14,415,4,0.8,4358,415,4,0
45552,2014/03/31,2010/11/17,532,2,0.6,5810,532,2,0
45553,2014/03/31,2010/11/17,208,5,0.683521569,5100,208,1,4
45554,2014/03/31,2011/05/17,83,4,0.857495695,4065,83,1,3
45555,2014/03/31,2007/08/22,24,5,0.497320588,7009,24,3,2
45556,2014/03/31,2011/03/01,76,7,0.86,4053,76,3,4
45557,2014/03/31,2012/12/30,413,2,0.789053656,4417,413,2,0
45558,2014/03/31,2012/07/15,529,6,0.480410808,7254,529,6,0
45559,2014/03/31,2013/01/28,77,11,0.787338455,4426,77,2,9
45560,2014/03/31,2012/03/05,2,4,0.8918965959999999,3907,2,3,1
45561,2014/03/31,2012/12/30,79,4,0.8625,4040,79,2,2
45562,2014/03/31,2012/11/09,498,3,0.7014596340000001,4967,498,3,0
45563,2014/03/31,2005/06/04,268,5,0.432286884,8059,268,4,1
45564,2014/03/31,2012/06/02,300,5,0.495047606,7037,300,3,2
45565,2014/03/31,2012/11/10,107,8,0.662753044,5256,107,4,4
45566,2014/03/31,2009/10/22,341,6,0.716687243,4860,341,4,2
45567,2014/03/31,2011/10/16,284,4,0.5846022160000001,5958,284,2,2
45568,2014/03/31,2013/03/09,388,2,0.75,4644,388,2,0
45569,2014/03/31,2013/02/03,421,2,0.75,4644,421,2,0
45570,2014/03/31,2012/11/27,489,2,0.75,4644,489,2,0
45571,2014/03/31,2012/12/10,467,2,0.75,4644,467,2,0
45572,2014/03/31,2011/04/25,365,2,0.75,4644,365,1,1
45573,2014/03/31,2013/02/17,401,2,0.75,4644,401,2,0
45574,2014/03/31,2012/11/27,488,2,0.75,4644,488,2,0
45575,2014/03/31,2012/12/06,481,2,0.75,4644,481,2,0
45576,2014/03/31,2012/02/05,559,2,0.75,4644,559,2,0
45577,2014/03/31,2013/02/17,401,2,0.75,4644,401,2,0
45578,2014/03/31,2013/01/28,426,2,0.75,4644,426,2,0
45579,2014/03/31,2011/09/24,130,2,0.727397117,4787,130,1,1
45580,2014/03/31,2013/02/09,70,3,0.59,5901,70,2,1
45581,2014/03/31,2012/03/10,439,4,0.657958412,5290,439,4,0
45582,2014/03/31,2006/03/19,8,3,0.726462116,4791,8,0,3
45583,2014/03/31,2011/07/03,161,4,0.585047907,5949,161,2,2
45584,2014/03/31,2013/03/15,375,2,0.5846379979999999,5953,375,2,0
45585,2014/03/31,2011/02/04,168,5,0.611398454,5692,168,1,4
45586,2014/03/31,2012/06/22,60,5,0.4567594170000001,7619,60,2,3
45587,2014/03/31,2008/09/26,328,6,0.63983269,5439,328,1,5
45588,2014/03/31,2012/07/21,542,2,0.63319687,5496,542,2,0
45589,2014/03/31,2011/11/27,22,5,0.564181258,6168,22,2,3
45590,2014/03/31,2009/07/16,223,5,0.506061664,6876,223,3,2
45591,2014/03/31,2010/04/15,256,4,0.598470932,5814,256,3,1
45592,2014/03/31,2008/01/31,370,3,0.8087866109999999,4302,370,3,0
45593,2014/03/31,2010/07/20,462,5,0.832555635,4179,462,5,0
45594,2014/03/31,2012/08/22,299,3,0.8531338890000001,4078,299,0,3
45595,2014/03/31,2007/07/24,668,2,0.6762830479999999,5144,668,2,0
45596,2014/03/31,2011/07/27,59,3,0.965409381,3603,59,1,2
45597,2014/03/31,2005/08/20,7,6,0.63845815,5448,7,2,4
45598,2014/03/31,2012/09/07,392,3,0.566666667,6138,392,3,0
45599,2014/03/31,2013/01/31,360,2,0.85,4092,360,1,1
45600,2014/03/31,2006/04/29,505,4,0.8285135779999999,4198,505,4,0
45601,2014/03/31,2006/01/04,648,2,0.675,5152,648,2,0
45602,2014/03/31,2013/02/13,141,4,0.473388238,7346,141,1,3
45603,2014/03/31,2012/09/30,549,2,0.764745986,4547,549,2,0
45604,2014/03/31,2012/07/27,274,6,0.662086824,5252,274,2,4
45605,2014/03/31,2007/01/14,172,5,0.936,3715,172,0,5
45606,2014/03/31,2012/05/24,14,5,0.8433664809999999,4123,14,1,4
45607,2014/03/31,2012/06/24,207,2,0.984371461,3532,207,1,1
45608,2014/03/31,2013/01/05,144,7,0.763551505,4553,144,2,5
45609,2014/03/31,2010/12/29,58,3,0.476599945,7294,58,0,3
45610,2014/03/31,2011/07/15,404,6,0.74482537,4667,404,6,0
45611,2014/03/31,2009/09/09,361,3,0.865107018,4018,361,2,1
45612,2014/03/31,2008/11/03,55,5,0.484664621,7171,55,2,3
45613,2014/03/31,2010/07/05,498,2,0.612729196,5672,498,2,0
45614,2014/03/31,2011/05/07,287,3,0.788577263,4407,287,2,1
45615,2014/03/31,2012/04/12,326,7,0.440089919,7896,326,6,1
45616,2014/03/31,2012/12/20,390,2,0.52770691,6585,390,2,0
45617,2014/03/31,2007/02/10,106,4,0.459740672,7558,106,0,4
45618,2014/03/31,2012/09/26,502,5,0.814295758,4267,502,5,0
45619,2014/03/31,2010/08/11,424,5,0.592715797,5862,424,5,0
45620,2014/03/31,2007/06/24,222,2,0.8616319440000001,4032,222,0,2
45621,2014/03/31,2010/02/27,690,4,0.641906874,5412,690,4,0
45622,2014/03/31,2008/04/04,467,6,1.0,3474,467,6,0
45623,2014/03/31,2008/02/06,207,3,0.6512635920000001,5334,207,0,3
45624,2014/03/31,2013/02/05,365,2,0.65,5344,365,1,1
45625,2014/03/31,2010/11/29,107,2,0.65,5344,107,1,1
45626,2014/03/31,2008/11/10,58,5,0.848636697,4093,58,0,5
45627,2014/03/31,2006/10/16,34,5,0.912851511,3805,34,4,1
45628,2014/03/31,2011/10/05,399,4,0.805671538,4311,399,4,0
45629,2014/03/31,2011/03/02,598,5,0.728439597,4768,598,5,0
45630,2014/03/31,2012/09/01,494,5,0.709095549,4898,494,5,0
45631,2014/03/31,2011/08/08,13,3,0.924426404,3757,13,0,3
45632,2014/03/31,2011/08/29,268,4,0.339328774,10235,268,2,2
45633,2014/03/31,2007/03/01,584,5,0.735876245,4719,584,5,0
45634,2014/03/31,2012/07/27,604,2,0.763624368,4547,604,2,0
45635,2014/03/31,2012/10/13,191,2,0.92,3774,191,0,2
45636,2014/03/31,2006/05/21,363,5,0.665095785,5220,363,4,1
45637,2014/03/31,2006/08/07,117,3,0.537596779,6458,117,1,2
45638,2014/03/31,2011/08/14,198,4,0.787043754,4411,198,0,4
45639,2014/03/31,2006/12/15,8,5,0.612796117,5665,8,3,2
45640,2014/03/31,2005/04/16,185,5,0.62175712,5583,185,3,2
45641,2014/03/31,2012/02/06,650,3,0.65,5340,650,3,0
45642,2014/03/31,2012/02/23,184,3,0.8771796820000001,3957,184,1,2
45643,2014/03/31,2009/10/11,410,2,1.0,3471,410,2,0
45644,2014/03/31,2011/08/01,492,5,0.7785217590000001,4458,492,5,0
45645,2014/03/31,2009/01/16,26,5,0.904480063,3837,26,0,5
45646,2014/03/31,2005/10/03,115,6,0.635359824,5461,115,1,5
45647,2014/03/31,2012/07/17,618,2,0.973814202,3563,618,2,0
45648,2014/03/31,2010/10/11,234,7,0.548864104,6321,234,3,4
45649,2014/03/31,2011/08/10,2,8,0.474784453,7307,2,6,2
45650,2014/03/31,2012/04/20,74,6,0.690898227,5021,74,3,3
45651,2014/03/31,2012/07/05,562,4,0.913856691,3796,562,4,0
45652,2014/03/31,2008/05/27,377,3,0.662392591,5237,377,3,0
45653,2014/03/31,2012/09/19,16,5,0.592365096,5856,16,1,4
45654,2014/03/31,2010/11/06,195,5,0.533672308,6500,195,1,4
45655,2014/03/31,2011/06/13,120,5,0.558501047,6211,120,3,2
45656,2014/03/31,2011/11/30,196,3,0.969695275,3577,196,1,2
45657,2014/03/31,2007/05/04,105,2,0.835,4154,105,0,2
45658,2014/03/31,2007/06/04,57,2,0.835,4154,57,0,2
45659,2014/03/31,2011/05/09,306,3,0.754984763,4594,306,2,1
45660,2014/03/31,2013/01/26,25,6,0.585547864,5923,25,3,3
45661,2014/03/31,2008/11/26,15,5,0.483434625,7174,15,0,5
45662,2014/03/31,2007/04/24,333,2,0.7753185779999999,4473,333,1,1
45663,2014/03/31,2011/05/09,73,5,0.698980044,4961,73,1,4
45664,2014/03/31,2012/03/21,167,4,0.954735683,3632,167,2,2
45665,2014/03/31,2006/12/19,74,6,0.654245283,5300,74,5,1
45666,2014/03/31,2008/04/01,5,12,0.459687127,7543,5,8,4
45667,2014/03/31,2010/11/13,32,4,0.744133934,4659,32,0,4
45668,2014/03/31,2010/03/31,723,2,0.475,7298,723,2,0
45669,2014/03/31,2013/01/13,432,2,0.475,7298,432,2,0
45670,2014/03/31,2012/03/10,564,3,0.8833333329999999,3924,564,3,0
45671,2014/03/31,2010/03/22,188,4,0.8264592270000001,4194,188,2,2
45672,2014/03/31,2010/11/17,147,3,0.820975841,4222,147,0,3
45673,2014/03/31,2010/07/21,345,4,0.5479999999999999,6325,345,1,3
45674,2014/03/31,2011/11/08,327,5,0.61628734,5624,327,4,1
45675,2014/03/31,2012/01/10,217,4,0.6696213289999999,5176,217,3,1
45676,2014/03/31,2012/10/21,318,3,0.83651943,4143,318,1,2
45677,2014/03/31,2007/01/22,279,3,0.598101484,5794,279,2,1
45678,2014/03/31,2008/08/31,197,4,0.61193537,5663,197,1,3
45679,2014/03/31,2012/05/12,591,3,0.916962159,3779,591,3,0
45680,2014/03/31,2010/10/01,330,4,0.595156304,5822,330,0,4
45681,2014/03/31,2013/01/29,411,2,0.8544759559999999,4055,411,2,0
45682,2014/03/31,2010/06/14,29,7,0.84318569,4109,29,3,4
45683,2014/03/31,2010/04/18,155,4,0.574926983,6026,155,1,3
45684,2014/03/31,2010/01/30,14,6,0.420598519,8237,14,4,2
45685,2014/03/31,2012/12/15,165,3,0.894459076,3873,165,1,2
45686,2014/03/31,2009/08/03,48,4,0.752727075,4602,48,0,4
45687,2014/03/31,2012/12/30,197,3,0.697089958,4969,197,1,2
45688,2014/03/31,2011/09/23,26,5,0.456537498,7587,26,0,5
45689,2014/03/31,2007/06/10,531,3,0.66379839,5218,531,3,0
45690,2014/03/31,2012/07/17,296,5,0.969110241,3574,296,2,3
45691,2014/03/31,2012/09/12,503,3,0.683540557,5067,503,3,0
45692,2014/03/31,2012/06/29,470,3,0.736089267,4705,470,3,0
45693,2014/03/31,2013/01/20,104,3,0.778597122,4448,104,1,2
45694,2014/03/31,2011/01/13,19,5,0.520360685,6654,19,0,5
45695,2014/03/31,2012/12/25,45,3,0.7396795559999999,4681,45,0,3
45696,2014/03/31,2013/02/10,138,7,0.637156791,5434,138,1,6
45697,2014/03/31,2010/11/29,56,4,0.834873402,4147,56,0,4
45698,2014/03/31,2012/06/27,58,3,0.675816904,5123,58,1,2
45699,2014/03/31,2012/06/25,174,3,0.75,4616,174,1,2
45700,2014/03/31,2013/03/01,169,5,0.91902575,3767,169,0,5
45701,2014/03/31,2009/07/05,49,2,0.88,3934,49,0,2
45702,2014/03/31,2012/04/30,59,2,0.88,3934,59,0,2
45703,2014/03/31,2010/12/01,648,4,0.894906929,3868,648,4,0
45704,2014/03/31,2009/11/27,168,2,1.303181476,2656,168,0,2
45705,2014/03/31,2008/02/01,15,6,0.415,8340,15,0,6
45706,2014/03/31,2009/12/22,213,7,0.579504354,5972,213,4,3
45707,2014/03/31,2012/10/30,10,4,0.714698472,4842,10,0,4
45708,2014/03/31,2010/08/23,9,4,0.905176563,3823,9,0,4
45709,2014/03/31,2013/01/26,46,5,0.85645297,4040,46,2,3
45710,2014/03/31,2013/03/07,28,8,0.441400868,7838,28,2,6
45711,2014/03/31,2011/09/01,302,4,0.804948813,4298,302,3,1
45712,2014/03/31,2012/08/25,116,5,0.795141347,4351,116,2,3
45713,2014/03/31,2012/12/13,367,3,0.610079365,5670,367,3,0
45714,2014/03/31,2007/06/29,154,5,0.7329370629999999,4719,154,2,3
45715,2014/03/31,2012/06/07,101,6,0.69117506,5004,101,4,2
45716,2014/03/31,2013/02/13,44,4,0.8371774390000001,4131,44,1,3
45717,2014/03/31,2006/07/14,135,2,0.784715226,4407,135,1,1
45718,2014/03/31,2012/07/01,260,3,0.359962523,9606,260,2,1
45719,2014/03/31,2008/07/31,225,3,1.03301464,3347,225,0,3
45720,2014/03/31,2012/04/21,346,3,0.361814567,9556,346,1,2
45721,2014/03/31,2013/01/16,248,3,0.7566666670000001,4569,248,1,2
45722,2014/03/31,2006/11/27,217,4,0.76946361,4493,217,1,3
45723,2014/03/31,2013/02/28,285,2,0.81,4268,285,1,1
45724,2014/03/31,2009/03/23,611,2,1.0,3457,611,2,0
45725,2014/03/31,2010/08/25,7,5,0.59181647,5841,7,3,2
45726,2014/03/31,2011/08/01,178,6,0.508550831,6797,178,3,3
45727,2014/03/31,2011/06/01,447,3,0.7717235990000001,4479,447,3,0
45728,2014/03/31,2009/09/17,10,6,0.540181307,6398,10,4,2
45729,2014/03/31,2009/02/14,676,3,0.8,4320,676,3,0
45730,2014/03/31,2012/05/11,523,5,0.7018684000000001,4924,523,5,0
45731,2014/03/31,2009/12/18,17,3,0.681921863,5068,17,1,2
45732,2014/03/31,2011/12/06,205,4,0.6531909260000001,5290,205,2,2
45733,2014/03/31,2011/01/06,286,4,0.534361949,6465,286,3,1
45734,2014/03/31,2010/01/05,1,7,0.8197508309999999,4214,1,2,5
45735,2014/03/31,2013/03/11,203,2,0.845,4088,203,0,2
45736,2014/03/31,2005/12/13,123,2,1.319323911,2618,123,1,1
45737,2014/03/31,2012/12/18,231,3,0.818790896,4218,231,1,2
45738,2014/03/31,2008/09/30,147,3,0.444687098,7766,147,0,3
45739,2014/03/31,2011/06/04,401,3,0.780537975,4424,401,3,0
45740,2014/03/31,2010/12/16,33,4,0.5271496179999999,6550,33,0,4
45741,2014/03/31,2011/12/27,239,5,0.564530739,6116,239,4,1
45742,2014/03/31,2005/06/04,193,6,0.762825895,4526,193,2,4
45743,2014/03/31,2012/10/17,351,4,0.925,3732,351,3,1
45744,2014/03/31,2013/01/18,392,4,0.925,3732,392,4,0
45745,2014/03/31,2012/09/07,66,4,0.843519062,4092,66,2,2
45746,2014/03/31,2013/01/14,48,4,0.6007641429999999,5745,48,2,2
45747,2014/03/31,2011/11/12,31,3,0.780325571,4423,31,1,2
45748,2014/03/31,2007/10/26,153,8,0.455383296,7579,153,6,2
45749,2014/03/31,2012/08/07,66,5,0.647400113,5331,66,1,4
45750,2014/03/31,2009/11/21,682,2,1.0,3451,682,2,0
45751,2014/03/31,2011/07/06,219,10,0.596,5790,219,8,2
45752,2014/03/31,2013/03/06,388,2,0.8,4313,388,2,0
45753,2014/03/31,2012/08/24,527,5,0.835221496,4131,527,5,0
45754,2014/03/31,2010/12/30,148,5,0.506111193,6817,148,2,3
45755,2014/03/31,2012/12/27,380,4,0.77200716,4469,380,4,0
45756,2014/03/31,2010/12/06,368,5,1.0,3450,368,5,0
45757,2014/03/31,2007/02/06,111,2,0.8291204040000001,4161,111,0,2
45758,2014/03/31,2006/06/27,101,2,0.8291204040000001,4161,101,0,2
45759,2014/03/31,2012/03/18,24,3,0.55142743,6256,24,2,1
45760,2014/03/31,2012/11/11,249,3,0.730847458,4720,249,2,1
45761,2014/03/31,2012/09/05,174,3,0.673214286,5124,174,2,1
45762,2014/03/31,2010/02/25,148,8,0.598518133,5763,148,3,5
45763,2014/03/31,2013/03/29,148,5,0.422976453,8154,148,1,4
45764,2014/03/31,2011/09/27,29,3,0.718949343,4797,29,0,3
45765,2014/03/31,2011/03/23,94,3,0.526560782,6548,94,0,3
45766,2014/03/31,2011/06/01,148,6,0.6400241320000001,5387,148,4,2
45767,2014/03/31,2008/09/26,31,2,0.8786391440000001,3924,31,0,2
45768,2014/03/31,2012/05/19,399,6,0.533870218,6457,399,6,0
45769,2014/03/31,2012/03/07,437,5,0.85,4055,437,5,0
45770,2014/03/31,2007/06/29,162,8,0.66375,5192,162,3,5
45771,2014/03/31,2010/01/27,125,6,0.69157937,4983,125,3,3
45772,2014/03/31,2010/12/13,97,3,0.7528468429999999,4577,97,0,3
45773,2014/03/31,2012/08/30,134,3,0.6366666670000001,5412,134,1,2
45774,2014/03/31,2010/12/21,48,5,0.843274596,4086,48,2,3
45775,2014/03/31,2013/02/22,169,3,0.73951921,4659,169,0,3
45776,2014/03/31,2012/12/26,3,4,0.444469101,7751,3,2,2
45777,2014/03/31,2012/07/18,209,3,0.714707469,4820,209,2,1
45778,2014/03/31,2011/07/19,149,3,0.722165618,4770,149,1,2
45779,2014/03/31,2012/11/30,258,4,0.7369875909999999,4674,258,2,2
45780,2014/03/31,2013/01/23,160,4,0.784092875,4393,160,1,3
45781,2014/03/31,2013/02/24,144,5,0.534,6450,144,2,3
45782,2014/03/31,2005/09/08,124,4,0.471046225,7312,124,1,3
45783,2014/03/31,2011/02/06,21,3,0.756315327,4554,21,0,3
45784,2014/03/31,2011/10/09,481,3,0.766014235,4496,481,3,0
45785,2014/03/31,2007/08/19,485,4,0.5,6888,485,4,0
45786,2014/03/31,2013/01/30,400,2,1.0,3444,400,2,0
45787,2014/03/31,2009/06/27,328,3,0.7447664359999999,4624,328,1,2
45788,2014/03/31,2012/10/11,245,6,0.904570528,3807,245,5,1
45789,2014/03/31,2008/07/04,417,4,0.792908128,4343,417,4,0
45790,2014/03/31,2013/03/03,186,4,0.836985902,4114,186,1,3
45791,2014/03/31,2013/02/27,242,3,0.98,3513,242,0,3
45792,2014/03/31,2006/07/23,191,3,0.92,3742,191,0,3
45793,2014/03/31,2012/08/28,106,6,0.5579513779999999,6170,106,0,6
45794,2014/03/31,2010/04/22,151,5,0.7986983759999999,4310,151,1,4
45795,2014/03/31,2010/08/20,645,3,0.583333333,5901,645,3,0
45796,2014/03/31,2012/03/14,3,3,0.7487709379999999,4597,3,1,2
45797,2014/03/31,2011/09/11,645,3,0.59386646,5796,645,3,0
45798,2014/03/31,2010/04/11,498,6,0.586671212,5867,498,6,0
45799,2014/03/31,2006/03/01,185,5,0.671821199,5123,185,1,4
45800,2014/03/31,2005/05/08,174,6,0.913850239,3766,174,0,6
45801,2014/03/31,2012/03/29,175,3,0.6466666670000001,5322,175,1,2
45802,2014/03/31,2010/09/15,119,6,0.666024773,5167,119,2,4
45803,2014/03/31,2011/01/14,282,5,0.483741917,7114,282,2,3
45804,2014/03/31,2011/12/23,303,4,0.8225,4184,303,2,2
45805,2014/03/31,2011/12/16,43,6,0.619782061,5552,43,0,6
45806,2014/03/31,2008/08/09,567,3,0.922272849,3731,567,3,0
45807,2014/03/31,2006/06/14,163,5,0.52627256,6538,163,2,3
45808,2014/03/31,2012/10/09,269,5,0.6722821409999999,5118,269,4,1
45809,2014/03/31,2010/05/02,487,3,0.573250583,6002,487,3,0
45810,2014/03/31,2011/06/28,385,3,0.656285769,5242,385,3,0
45811,2014/03/31,2012/09/15,34,4,0.682424122,5041,34,2,2
45812,2014/03/31,2008/07/28,433,5,0.750600044,4583,433,5,0
45813,2014/03/31,2012/04/22,703,2,1.0,3440,703,2,0
45814,2014/03/31,2009/05/08,541,5,0.643693862,5344,541,5,0
45815,2014/03/31,2010/10/17,139,6,0.588685607,5843,139,3,3
45816,2014/03/31,2010/09/10,318,5,0.6801463320000001,5057,318,3,2
45817,2014/03/31,2007/05/26,509,4,0.708403708,4855,509,4,0
45818,2014/03/31,2009/09/18,5,7,0.848571429,4053,5,3,4
45819,2014/03/31,2009/01/13,321,4,0.8580963070000001,4008,321,1,3
45820,2014/03/31,2012/11/08,184,4,0.793734133,4333,184,3,1
45821,2014/03/31,2013/03/04,210,6,0.416670705,8254,210,1,5
45822,2014/03/31,2008/03/25,169,5,0.662,5195,169,0,5
45823,2014/03/31,2012/07/05,249,4,0.540182218,6366,249,3,1
45824,2014/03/31,2010/07/11,21,4,0.603966274,5693,21,2,2
45825,2014/03/31,2012/12/19,106,4,0.902401575,3810,106,2,2
45826,2014/03/31,2005/04/23,47,2,0.56,6138,47,0,2
45827,2014/03/31,2010/12/29,120,3,0.548027742,6272,120,2,1
45828,2014/03/31,2012/11/10,245,2,0.713399751,4818,245,0,2
45829,2014/03/31,2012/01/16,569,2,0.826165865,4160,569,2,0
45830,2014/03/31,2006/05/23,37,6,0.86,3996,37,0,6
45831,2014/03/31,2007/11/19,329,6,0.471327664,7291,329,3,3
45832,2014/03/31,2007/07/02,122,2,0.52940533,6491,122,0,2
45833,2014/03/31,2007/04/25,80,7,0.541384906,6347,80,4,3
45834,2014/03/31,2012/09/12,435,4,0.6773408240000001,5073,435,4,0
45835,2014/03/31,2009/10/04,385,6,0.6744503340000001,5094,385,6,0
45836,2014/03/31,2010/08/07,156,4,0.461034622,7452,156,3,1
45837,2014/03/31,2011/08/03,45,4,0.6193725210000001,5546,45,0,4
45838,2014/03/31,2012/06/19,516,6,0.579534334,5927,516,6,0
45839,2014/03/31,2011/08/20,489,4,0.410070439,8376,489,4,0
45840,2014/03/31,2011/10/08,666,5,0.723551717,4747,666,5,0
45841,2014/03/31,2011/03/03,428,5,0.791553353,4339,428,5,0
45842,2014/03/31,2009/10/27,510,5,0.637316756,5389,510,5,0
45843,2014/03/31,2012/12/01,354,3,0.7458197609999999,4605,354,2,1
45844,2014/03/31,2012/08/15,21,4,0.673147785,5102,21,1,3
45845,2014/03/31,2013/02/28,28,7,0.458464824,7491,28,0,7
45846,2014/03/31,2006/07/10,233,2,0.91,3774,233,0,2
45847,2014/03/31,2012/07/08,101,2,0.7306787229999999,4700,101,1,1
45848,2014/03/31,2009/07/22,210,5,0.5820000000000001,5900,210,2,3
45849,2014/03/31,2009/07/17,528,3,1.5,2289,528,3,0
45850,2014/03/31,2007/12/27,112,5,0.676408589,5076,112,4,1
45851,2014/03/31,2009/12/21,206,4,0.92,3732,206,0,4
45852,2014/03/31,2012/11/26,194,5,0.8082999759999999,4247,194,3,2
45853,2014/03/31,2011/01/04,338,6,0.4129707620000001,8311,338,3,3
45854,2014/03/31,2009/08/01,142,4,0.796802879,4307,142,0,4
45855,2014/03/31,2012/04/08,336,2,0.55,6238,336,1,1
45856,2014/03/31,2010/07/30,406,2,0.55,6238,406,2,0
45857,2014/03/31,2012/10/23,250,5,0.583378677,5881,250,2,3
45858,2014/03/31,2010/09/10,21,5,0.7937436370000001,4322,21,1,4
45859,2014/03/31,2010/04/24,81,3,1.41,2433,81,0,3
45860,2014/03/31,2006/07/30,537,2,0.75,4574,537,2,0
45861,2014/03/31,2012/09/28,126,4,0.582322186,5891,126,1,3
45862,2014/03/31,2010/03/04,486,2,0.575,5966,486,2,0
45863,2014/03/31,2012/12/13,458,4,0.4,8576,458,4,0
45864,2014/03/31,2012/12/02,78,4,0.712999376,4811,78,1,3
45865,2014/03/31,2011/08/16,587,4,0.875,3920,587,4,0
45866,2014/03/31,2010/09/01,430,3,0.792238392,4329,430,3,0
45867,2014/03/31,2010/11/09,132,6,0.49564966,6919,132,2,4
45868,2014/03/31,2012/04/21,703,2,0.8601203909999999,3987,703,2,0
45869,2014/03/31,2011/07/05,558,2,1.0,3429,558,2,0
45870,2014/03/31,2012/04/18,635,3,0.5755078060000001,5957,635,3,0
45871,2014/03/31,2012/10/16,3,5,0.531345319,6452,3,0,5
45872,2014/03/31,2011/05/23,251,4,0.72625,4720,251,3,1
45873,2014/03/31,2012/11/19,71,5,0.628816731,5451,71,2,3
45874,2014/03/31,2005/01/12,1,7,0.54274901,6315,1,1,6
45875,2014/03/31,2012/08/22,38,6,0.340686879,10060,38,1,5
45876,2014/03/31,2012/08/14,1,3,0.724243449,4732,1,0,3
45877,2014/03/31,2007/05/01,592,3,0.55,6231,592,3,0
45878,2014/03/31,2008/03/06,469,3,0.55,6231,469,3,0
45879,2014/03/31,2005/03/13,527,3,1.0,3427,527,3,0
45880,2014/03/31,2013/02/14,106,4,0.7661368209999999,4473,106,2,2
45881,2014/03/31,2012/04/09,71,5,0.8101371159999999,4230,71,1,4
45882,2014/03/31,2008/11/04,117,5,0.692163636,4950,117,2,3
45883,2014/03/31,2007/08/17,667,2,1.0,3426,667,2,0
45884,2014/03/31,2012/07/20,621,2,1.0,3426,621,2,0
45885,2014/03/31,2011/05/05,41,4,0.6037381039999999,5674,41,0,4
45886,2014/03/31,2011/11/26,410,3,0.6733634759999999,5087,410,3,0
45887,2014/03/31,2006/05/16,60,2,0.851653406,4022,60,0,2
45888,2014/03/31,2009/02/27,200,2,0.8425830259999999,4065,200,0,2
45889,2014/03/31,2013/02/28,4,6,0.5551904679999999,6169,4,1,5
45890,2014/03/31,2009/12/26,404,4,0.908689308,3769,404,4,0
45891,2014/03/31,2006/01/21,9,4,0.8927789359999999,3836,9,3,1
45892,2014/03/31,2012/02/04,266,2,0.85,4029,266,1,1
45893,2014/03/31,2009/01/06,269,3,0.570828471,5999,269,2,1
45894,2014/03/31,2007/06/27,134,4,0.548329864,6245,134,3,1
45895,2014/03/31,2013/03/29,181,2,0.49,6988,181,0,2
45896,2014/03/31,2011/10/24,119,2,0.49,6988,119,0,2
45897,2014/03/31,2011/01/13,58,2,0.87,3934,58,0,2
45898,2014/03/31,2012/05/29,493,6,0.694338474,4928,493,6,0
45899,2014/03/31,2011/04/28,204,7,0.5303875370000001,6451,204,5,2
45900,2014/03/31,2009/01/12,369,3,0.667180187,5128,369,3,0
45901,2014/03/31,2012/03/22,143,6,0.476100751,7186,143,3,3
45902,2014/03/31,2010/01/01,227,6,0.6263731229999999,5462,227,4,2
45903,2014/03/31,2007/10/29,104,4,0.655769599,5217,104,0,4
45904,2014/03/31,2012/08/10,481,2,1.0,3421,481,2,0
45905,2014/03/31,2005/08/03,515,2,0.8459198809999999,4044,515,2,0
45906,2014/03/31,2013/03/29,179,5,0.821498559,4164,179,0,5
45907,2014/03/31,2012/08/06,601,3,0.699223222,4892,601,3,0
45908,2014/03/31,2012/08/08,194,7,0.346177512,9881,194,3,4
45909,2014/03/31,2013/03/25,223,2,0.8451989129999999,4047,223,1,1
45910,2014/03/31,2011/01/24,82,7,0.7559116020000001,4525,82,2,5
45911,2014/03/31,2012/07/01,265,9,0.511120741,6692,265,7,2
45912,2014/03/31,2012/08/31,325,3,0.58039199,5893,325,1,2
45913,2014/03/31,2012/05/11,466,7,0.627205208,5453,466,7,0
45914,2014/03/31,2013/02/25,8,4,0.782898352,4368,8,1,3
45915,2014/03/31,2012/05/31,71,4,0.615814875,5553,71,2,2
45916,2014/03/31,2012/07/27,11,2,1.015320665,3368,11,0,2
45917,2014/03/31,2010/06/20,121,6,0.598583683,5712,121,3,3
45918,2014/03/31,2012/02/05,66,6,0.7504609309999999,4556,66,1,5
45919,2014/03/31,2012/06/19,231,6,0.39942757,8560,231,4,2
45920,2014/03/31,2006/02/24,376,3,0.653536609,5231,376,3,0
45921,2014/03/31,2007/10/13,115,3,0.75278573,4541,115,2,1
45922,2014/03/31,2007/08/17,480,4,0.6839235690000001,4998,480,4,0
45923,2014/03/31,2007/02/27,151,3,0.8988272420000001,3803,151,1,2
45924,2014/03/31,2009/02/08,421,3,0.8381559590000001,4078,421,3,0
45925,2014/03/31,2012/05/21,58,5,0.716647096,4769,58,3,2
45926,2014/03/31,2009/09/21,355,5,0.780785926,4377,355,4,1
45927,2014/03/31,2012/10/18,13,5,0.544626176,6273,13,2,3
45928,2014/03/31,2012/12/25,221,3,0.811463183,4210,221,0,3
45929,2014/03/31,2012/04/21,101,9,0.654444444,5220,101,4,5
45930,2014/03/31,2012/11/30,70,7,0.7792427009999999,4384,70,6,1
45931,2014/03/31,2011/07/19,358,2,0.875,3904,358,1,1
45932,2014/03/31,2007/11/10,130,7,0.436581033,7824,130,4,3
45933,2014/03/31,2008/03/07,263,3,0.738790828,4623,263,0,3
45934,2014/03/31,2010/10/30,553,2,0.85,4018,553,2,0
45935,2014/03/31,2013/03/18,375,2,0.545384861,6262,375,2,0
45936,2014/03/31,2011/10/28,196,2,0.63,5420,196,0,2
45937,2014/03/31,2008/10/05,128,3,0.5223420529999999,6537,128,2,1
45938,2014/03/31,2012/08/18,456,2,0.8,4268,456,2,0
45939,2014/03/31,2013/01/27,419,2,0.8,4268,419,2,0
45940,2014/03/31,2007/08/08,624,2,0.8,4268,624,2,0
45941,2014/03/31,2005/02/04,454,2,0.8,4268,454,2,0
45942,2014/03/31,2009/07/09,516,3,0.6092255529999999,5604,516,3,0
45943,2014/03/31,2004/12/25,413,3,0.822056345,4153,413,3,0
45944,2014/03/31,2011/09/09,562,4,0.679663548,5023,562,4,0
45945,2014/03/31,2008/07/30,172,9,0.619573503,5510,172,3,6
45946,2014/03/31,2008/07/26,101,2,1.41,2421,101,0,2
45947,2014/03/31,2007/04/07,14,3,0.700778074,4871,14,0,3
45948,2014/03/31,2011/08/26,113,2,0.832353085,4101,113,0,2
45949,2014/03/31,2012/09/07,310,3,0.7,4876,310,1,2
45950,2014/03/31,2010/06/01,232,4,0.724274194,4712,232,1,3
45951,2014/03/31,2011/03/08,582,5,0.693789388,4919,582,5,0
45952,2014/03/31,2011/05/28,243,4,0.63232166,5397,243,2,2
45953,2014/03/31,2012/04/20,305,5,0.483650794,7056,305,1,4
45954,2014/03/31,2011/09/29,17,5,0.711137974,4798,17,3,2
45955,2014/03/31,2012/04/13,450,4,0.755848471,4514,450,4,0
45956,2014/03/31,2012/11/20,59,3,0.54843755,6221,59,1,2
45957,2014/03/31,2011/10/15,404,4,0.774659401,4404,404,4,0
45958,2014/03/31,2008/05/27,504,3,0.511403509,6669,504,3,0
45959,2014/03/31,2012/06/28,641,2,0.6,5684,641,2,0
45960,2014/03/31,2009/08/04,600,2,0.6,5684,600,2,0
45961,2014/03/31,2009/10/30,398,2,0.6,5684,398,2,0
45962,2014/03/31,2012/04/05,246,3,0.7276905020000001,4685,246,0,3
45963,2014/03/31,2012/11/21,342,5,0.400088018,8521,342,2,3
45964,2014/03/31,2009/10/05,60,3,0.725496914,4699,60,0,3
45965,2014/03/31,2004/12/01,75,7,0.568545697,5996,75,5,2
45966,2014/03/31,2012/10/10,98,2,0.883844957,3857,98,0,2
45967,2014/03/31,2007/01/19,210,2,0.8429599409999999,4044,210,0,2
45968,2014/03/31,2012/12/15,466,2,0.799636406,4263,466,2,0
45969,2014/03/31,2008/05/23,250,3,0.559153543,6096,250,2,1
45970,2014/03/31,2011/09/16,17,16,0.41963802,8122,17,5,11
45971,2014/03/31,2011/02/04,241,2,0.982496397,3469,241,1,1
45972,2014/03/31,2012/02/13,508,4,0.761394102,4476,508,4,0
45973,2014/03/31,2012/06/04,4,3,0.727979064,4681,4,0,3
45974,2014/03/31,2012/05/03,240,3,0.7317307279999999,4657,240,0,3
45975,2014/03/31,2012/10/16,310,4,0.615739068,5534,310,1,3
45976,2014/03/31,2007/04/29,135,4,0.663422897,5136,135,2,2
45977,2014/03/31,2006/05/16,153,4,0.6831054529999999,4988,153,2,2
45978,2014/03/31,2013/02/20,305,3,0.636025761,5357,305,2,1
45979,2014/03/31,2012/06/23,614,4,0.844177403,4036,614,4,0
45980,2014/03/31,2012/03/15,639,4,0.5257870370000001,6480,639,4,0
45981,2014/03/31,2012/10/16,332,3,0.6694635489999999,5089,332,1,2
45982,2014/03/31,2005/06/03,297,7,0.476353468,7152,297,3,4
45983,2014/03/31,2006/10/16,117,4,0.85,4008,117,3,1
45984,2014/03/31,2011/12/14,348,3,0.446441678,7630,348,2,1
45985,2014/03/31,2008/10/08,102,2,0.82,4154,102,0,2
45986,2014/03/31,2008/12/24,37,2,0.82,4154,37,0,2
45987,2014/03/31,2012/07/27,240,5,0.590029447,5773,240,1,4
45988,2014/03/31,2008/07/15,5,4,0.603818472,5641,5,1,3
45989,2014/03/31,2008/08/05,335,4,0.637231057,5345,335,3,1
45990,2014/03/31,2005/09/17,75,2,0.92073263,3699,75,0,2
45991,2014/03/31,2011/02/02,29,3,0.7195520809999999,4733,29,2,1
45992,2014/03/31,2010/05/25,170,3,0.90694008,3755,170,1,2
45993,2014/03/31,2008/10/19,428,4,0.9125,3732,428,4,0
45994,2014/03/31,2013/02/20,180,2,0.835,4078,180,1,1
45995,2014/03/31,2011/08/04,416,7,0.530350467,6420,416,7,0
45996,2014/03/31,2011/05/06,695,2,0.8,4256,695,2,0
45997,2014/03/31,2012/12/27,43,5,0.639399061,5325,43,1,4
45998,2014/03/31,2011/10/15,325,5,0.731082242,4657,325,3,2
45999,2014/03/31,2008/01/03,20,5,0.633232887,5376,20,4,1
46000,2014/03/31,2011/02/17,39,5,0.648417143,5250,39,2,3
46001,2014/03/31,2012/07/12,623,2,0.756466667,4500,623,2,0
46002,2014/03/31,2011/09/10,251,2,0.790359879,4307,251,1,1
46003,2014/03/31,2010/08/21,397,2,1.0,3404,397,2,0
46004,2014/03/31,2012/03/31,206,4,0.759796875,4480,206,0,4
46005,2014/03/31,2012/11/26,22,5,0.469437319,7251,22,0,5
46006,2014/03/31,2010/10/25,37,5,0.560120125,6077,37,2,3
46007,2014/03/31,2011/04/27,495,3,0.742701287,4583,495,3,0
46008,2014/03/31,2010/11/27,100,6,0.508635684,6692,100,0,6
46009,2014/03/31,2012/02/02,216,5,0.748,4550,216,1,4
46010,2014/03/31,2008/08/23,49,5,0.597660695,5694,49,1,4
46011,2014/03/31,2010/07/01,5,4,0.616564595,5519,5,0,4
46012,2014/03/31,2007/07/10,628,4,0.8112780159999999,4194,628,4,0
46013,2014/03/31,2010/01/31,508,4,0.63836773,5330,508,4,0
46014,2014/03/31,2010/10/11,384,5,0.57746945,5892,384,5,0
46015,2014/03/31,2012/07/31,43,3,0.8507951990000001,3999,43,0,3
46016,2014/03/31,2012/11/08,225,5,0.8768814429999999,3880,225,4,1
46017,2014/03/31,2011/06/22,164,4,0.89247639,3812,164,2,2
46018,2014/03/31,2012/08/13,186,3,0.651981602,5218,186,1,2
46019,2014/03/31,2011/01/27,696,2,0.725,4692,696,2,0
46020,2014/03/31,2007/04/22,310,5,0.659215116,5160,310,1,4
46021,2014/03/31,2011/10/09,592,3,0.74070122,4592,592,3,0
46022,2014/03/31,2011/07/17,80,4,0.512077687,6642,80,2,2
46023,2014/03/31,2011/01/11,236,6,0.504479383,6742,236,5,1
46024,2014/03/31,2010/04/01,8,7,0.443258178,7673,8,1,6
46025,2014/03/31,2012/01/27,702,3,0.8666666670000001,3924,702,3,0
46026,2014/03/31,2012/07/28,340,3,0.8666666670000001,3924,340,2,1
46027,2014/03/31,2012/05/15,361,3,0.8666666670000001,3924,361,2,1
46028,2014/03/31,2005/10/14,3,6,0.807068597,4213,3,0,6
46029,2014/03/31,2012/07/03,13,5,0.832735734,4083,13,1,4
46030,2014/03/31,2010/07/05,453,3,0.579432322,5866,453,3,0
46031,2014/03/31,2013/03/06,24,5,0.571063687,5951,24,1,4
46032,2014/03/31,2009/05/14,357,4,0.876399278,3877,357,2,2
46033,2014/03/31,2012/09/22,517,2,0.8526474279999999,3985,517,2,0
46034,2014/03/31,2013/03/07,199,3,0.8556408959999999,3971,199,2,1
46035,2014/03/31,2008/01/08,582,3,0.615034395,5524,582,3,0
46036,2014/03/31,2012/03/31,643,5,0.548667636,6192,643,5,0
46037,2014/03/31,2013/03/20,167,3,0.6776939959999999,5013,167,0,3
46038,2014/03/31,2006/01/28,222,3,0.741097295,4584,222,2,1
46039,2014/03/31,2010/07/11,498,5,0.78,4355,498,5,0
46040,2014/03/31,2008/01/26,1,7,0.6580337079999999,5162,1,0,7
46041,2014/03/31,2010/02/09,296,3,0.8495347670000001,3998,296,1,2
46042,2014/03/31,2007/09/02,124,3,0.610097,5567,124,0,3
46043,2014/03/31,2011/05/13,675,3,0.959164078,3541,675,3,0
46044,2014/03/31,2011/08/23,187,3,0.819990343,4142,187,2,1
46045,2014/03/31,2011/05/25,678,3,0.917148258,3703,678,3,0
46046,2014/03/31,2012/08/28,56,3,1.214175903,2797,56,2,1
46047,2014/03/31,2008/07/18,165,4,0.625267906,5431,165,2,2
46048,2014/03/31,2012/01/21,45,3,0.69771728,4867,45,0,3
46049,2014/03/31,2012/10/12,381,4,0.6320923310000001,5372,381,4,0
46050,2014/03/31,2011/06/05,3,5,0.8535595779999999,3978,3,0,5
46051,2014/03/31,2010/11/13,677,4,0.8917257679999999,3807,677,4,0
46052,2014/03/31,2012/09/09,61,4,0.585303448,5800,61,2,2
46053,2014/03/31,2012/10/19,135,6,0.483098491,7026,135,3,3
46054,2014/03/31,2013/02/16,160,4,0.8313054129999999,4083,160,1,3
46055,2014/03/31,2007/08/20,518,5,0.5357774270000001,6335,518,5,0
46056,2014/03/31,2009/07/08,132,3,0.6474856920000001,5242,132,1,2
46057,2014/03/31,2008/07/13,82,5,0.516442483,6572,82,1,4
46058,2014/03/31,2010/09/30,8,2,1.41,2407,8,0,2
46059,2014/03/31,2012/08/23,233,6,0.423700375,8010,233,4,2
46060,2014/03/31,2008/06/14,299,4,0.859404913,3949,299,3,1
46061,2014/03/31,2012/03/13,363,3,0.964364876,3519,363,1,2
46062,2014/03/31,2005/09/28,206,2,0.465,7298,206,0,2
46063,2014/03/31,2006/04/18,205,2,0.465,7298,205,0,2
46064,2014/03/31,2010/09/14,168,5,0.6774825309999999,5009,168,2,3
46065,2014/03/31,2012/04/19,303,6,0.642183952,5284,303,4,2
46066,2014/03/31,2012/09/13,80,4,0.6720083179999999,5049,80,0,4
46067,2014/03/31,2009/12/09,516,5,0.77428115,4382,516,5,0
46068,2014/03/31,2010/11/17,259,5,0.609958648,5562,259,3,2
46069,2014/03/31,2010/01/19,78,4,0.803529133,4222,78,1,3
46070,2014/03/31,2011/07/05,196,6,0.474013415,7156,196,0,6
46071,2014/03/31,2006/02/16,120,6,0.8869717570000001,3824,120,3,3
46072,2014/03/31,2009/09/21,184,4,0.60717329,5586,184,3,1
46073,2014/03/31,2008/05/01,83,4,0.8166674690000001,4153,83,1,3
46074,2014/03/31,2012/08/01,563,3,0.6896299309999999,4918,563,3,0
46075,2014/03/31,2007/03/15,216,3,0.599591584,5656,216,0,3
46076,2014/03/31,2012/07/06,213,5,0.7101591620000001,4775,213,4,1
46077,2014/03/31,2008/10/29,498,3,0.550926076,6155,498,3,0
46078,2014/03/31,2009/11/20,141,3,0.55,6165,141,1,2
46079,2014/03/31,2008/02/03,177,2,0.874649123,3876,177,1,1
46080,2014/03/31,2008/03/06,44,4,0.5,6780,44,0,4
46081,2014/03/31,2013/02/16,402,2,1.0,3390,402,2,0
46082,2014/03/31,2007/05/14,214,4,0.713210604,4753,214,2,2
46083,2014/03/31,2007/10/09,251,10,0.6720559079999999,5044,251,7,3
46084,2014/03/31,2012/03/09,331,2,0.521878368,6495,331,0,2
46085,2014/03/31,2006/08/12,4,5,0.75423676,4494,4,0,5
46086,2014/03/31,2011/08/21,118,3,0.83238762,4071,118,2,1
46087,2014/03/31,2013/01/01,135,2,0.731571675,4632,135,0,2
46088,2014/03/31,2011/01/24,45,5,0.8704187,3893,45,4,1
46089,2014/03/31,2012/08/10,476,3,0.70736952,4790,476,3,0
46090,2014/03/31,2010/05/20,25,3,0.914960843,3703,25,0,3
46091,2014/03/31,2007/09/04,11,3,0.74,4578,11,0,3
46092,2014/03/31,2012/10/17,436,2,0.625,5420,436,2,0
46093,2014/03/31,2012/09/14,563,2,0.625,5420,563,2,0
46094,2014/03/31,2012/09/30,517,2,0.625,5420,517,2,0
46095,2014/03/31,2013/02/07,417,2,0.625,5420,417,2,0
46096,2014/03/31,2008/04/17,334,2,0.625,5420,334,0,2
46097,2014/03/31,2010/03/01,73,5,0.580639356,5834,73,0,5
46098,2014/03/31,2012/09/27,116,4,0.570852713,5934,116,3,1
46099,2014/03/31,2011/02/01,501,3,0.656561349,5159,501,3,0
46100,2014/03/31,2010/11/17,127,4,0.800929298,4229,127,0,4
46101,2014/03/31,2009/07/08,218,6,0.515,6576,218,1,5
46102,2014/03/31,2013/03/12,39,5,0.662339136,5113,39,1,4
46103,2014/03/31,2013/02/14,397,4,0.519777437,6515,397,4,0
46104,2014/03/31,2010/06/23,421,3,0.923649755,3666,421,3,0
46105,2014/03/31,2008/03/08,43,4,0.7110415790000001,4762,43,3,1
46106,2014/03/31,2009/01/27,77,2,0.815,4154,77,0,2
46107,2014/03/31,2012/09/19,198,7,0.44017683,7691,198,2,5
46108,2014/03/31,2013/01/05,49,4,0.757971339,4466,49,1,3
46109,2014/03/31,2012/05/26,622,2,1.0,3385,622,2,0
46110,2014/03/31,2007/08/17,1,5,0.502097612,6741,1,2,3
46111,2014/03/31,2013/01/12,116,6,0.78198244,4328,116,2,4
46112,2014/03/31,2012/09/26,175,6,0.45,7520,175,2,4
46113,2014/03/31,2010/03/22,141,4,0.4097142170000001,8258,141,2,2
46114,2014/03/31,2013/03/13,114,4,0.583945461,5794,114,0,4
46115,2014/03/31,2006/11/10,99,3,0.573333333,5901,99,0,3
46116,2014/03/31,2012/12/05,192,4,0.96,3524,192,2,2
46117,2014/03/31,2007/07/11,654,3,0.654849013,5166,654,3,0
46118,2014/03/31,2010/11/19,115,6,0.51591734,6557,115,4,2
46119,2014/03/31,2010/12/01,167,4,0.542974318,6230,167,2,2
46120,2014/03/31,2008/07/31,611,7,0.593872893,5696,611,7,0
46121,2014/03/31,2009/10/16,28,4,0.710628151,4760,28,2,2
46122,2014/03/31,2008/02/01,313,3,0.593004909,5704,313,0,3
46123,2014/03/31,2012/09/30,270,3,0.7577016129999999,4464,270,2,1
46124,2014/03/31,2009/09/01,8,3,0.822261123,4113,8,2,1
46125,2014/03/31,2008/03/18,555,2,0.672573588,5028,555,2,0
46126,2014/03/31,2011/03/12,64,9,0.814034665,4154,64,1,8
46127,2014/03/31,2012/04/13,602,6,0.8330746490000001,4059,602,6,0
46128,2014/03/31,2013/01/04,122,3,0.795678983,4249,122,1,2
46129,2014/03/31,2012/07/20,437,4,0.862669048,3919,437,4,0
46130,2014/03/31,2011/10/15,5,3,0.773622426,4370,5,1,2
46131,2014/03/31,2009/11/07,410,3,0.777449402,4348,410,3,0
46132,2014/03/31,2011/02/10,167,4,0.537563613,6288,167,0,4
46133,2014/03/31,2006/05/02,348,6,0.7261925229999999,4654,348,4,2
46134,2014/03/31,2008/10/30,44,3,0.7496273290000001,4508,44,0,3
46135,2014/03/31,2006/09/26,3,5,0.504,6705,3,0,5
46136,2014/03/31,2008/10/25,5,3,0.5255521,6430,5,0,3
46137,2014/03/31,2012/07/27,141,2,0.876144672,3857,141,1,1
46138,2014/03/31,2006/10/23,221,3,0.91825,3680,221,2,1
46139,2014/03/31,2012/08/29,442,3,0.7735805859999999,4368,442,3,0
46140,2014/03/31,2006/08/05,45,3,0.816157005,4140,45,0,3
46141,2014/03/31,2012/09/23,9,5,0.726826592,4648,9,3,2
46142,2014/03/31,2013/02/15,190,5,0.458289242,7371,190,2,3
46143,2014/03/31,2007/09/16,119,3,0.707417801,4775,119,2,1
46144,2014/03/31,2010/05/28,284,3,0.7426978890000001,4548,284,2,1
46145,2014/03/31,2013/01/01,100,4,0.5375,6284,100,0,4
46146,2014/03/31,2010/05/07,48,5,0.8280485409999999,4079,48,4,1
46147,2014/03/31,2006/06/30,256,5,0.79602404,4243,256,4,1
46148,2014/03/31,2010/04/20,348,3,0.7,4825,348,2,1
46149,2014/03/31,2012/03/03,61,4,0.905,3732,61,2,2
46150,2014/03/31,2007/11/10,4,4,0.8379925559999999,4030,4,2,2
46151,2014/03/31,2012/02/18,147,5,0.408813559,8260,147,2,3
46152,2014/03/31,2012/01/17,105,2,0.817506053,4130,105,0,2
46153,2014/03/31,2013/01/15,14,4,0.7140757190000001,4728,14,1,3
46154,2014/03/31,2012/09/16,532,2,0.55,6138,532,2,0
46155,2014/03/31,2013/02/12,22,6,0.46594755,7245,22,1,5
46156,2014/03/31,2011/09/19,35,2,0.44,7672,35,1,1
46157,2014/03/31,2011/07/05,582,3,0.670274027,5036,582,3,0
46158,2014/03/31,2010/04/13,293,5,0.458044511,7369,293,3,2
46159,2014/03/31,2012/09/11,559,2,0.575,5870,559,2,0
46160,2014/03/31,2012/01/16,464,6,0.573102394,5889,464,6,0
46161,2014/03/31,2010/05/26,19,4,0.81063656,4163,19,0,4
46162,2014/03/31,2007/08/30,224,4,0.567301614,5948,224,2,2
46163,2014/03/31,2006/10/09,165,10,0.8170000000000001,4130,165,5,5
46164,2014/03/31,2013/01/02,430,2,0.799668168,4219,430,2,0
46165,2014/03/31,2009/08/14,28,6,0.473505965,7125,28,0,6
46166,2014/03/31,2008/08/11,217,4,0.835,4040,217,0,4
46167,2014/03/31,2007/03/20,428,4,0.5605350610000001,6018,428,4,0
46168,2014/03/31,2012/05/28,544,5,0.722781826,4666,544,5,0
46169,2014/03/31,2007/09/23,140,5,0.884,3815,140,2,3
46170,2014/03/31,2007/11/16,164,4,0.687687602,4904,164,2,2
46171,2014/03/31,2009/07/22,30,8,0.785,4296,30,1,7
46172,2014/03/31,2012/07/25,41,4,0.554634868,6080,41,1,3
46173,2014/03/31,2011/02/16,159,5,0.49986807,6746,159,0,5
46174,2014/03/31,2011/06/17,135,6,0.7105077959999999,4746,135,3,3
46175,2014/03/31,2012/09/25,233,5,0.8525840709999999,3955,233,3,2
46176,2014/03/31,2012/10/20,79,3,0.727957686,4632,79,2,1
46177,2014/03/31,2012/12/04,44,3,0.5428095310000001,6211,44,1,2
46178,2014/03/31,2011/04/01,708,2,0.85,3966,708,2,0
46179,2014/03/31,2011/05/01,590,2,0.85,3966,590,2,0
46180,2014/03/31,2008/04/11,111,4,0.619628676,5440,111,2,2
46181,2014/03/31,2012/08/14,127,3,0.5160333739999999,6532,127,0,3
46182,2014/03/31,2007/08/22,121,5,0.585235284,5759,121,0,5
46183,2014/03/31,2011/04/24,563,4,0.6751201920000001,4992,563,4,0
46184,2014/03/31,2005/06/19,271,7,0.442895256,7609,271,3,4
46185,2014/03/31,2010/02/18,2,5,0.558948416,6029,2,3,2
46186,2014/03/31,2007/02/19,193,3,0.768984482,4382,193,1,2
46187,2014/03/31,2010/04/14,39,3,0.819056879,4114,39,2,1
46188,2014/03/31,2012/01/19,78,5,0.614207073,5486,78,4,1
46189,2014/03/31,2012/01/24,70,4,0.5869895470000001,5740,70,0,4
46190,2014/03/31,2012/10/21,12,11,0.769584285,4378,12,1,10
46191,2014/03/31,2009/09/06,612,2,0.821956575,4099,612,2,0
46192,2014/03/31,2010/08/08,206,3,0.7242411870000001,4652,206,1,2
46193,2014/03/31,2013/02/12,150,5,0.681168621,4946,150,0,5
46194,2014/03/31,2011/01/04,576,4,0.620642962,5428,576,4,0
46195,2014/03/31,2010/12/20,29,6,0.438471951,7683,29,0,6
46196,2014/03/31,2009/11/24,127,3,0.816666667,4125,127,0,3
46197,2014/03/31,2011/10/17,394,3,0.816666667,4125,394,3,0
46198,2014/03/31,2012/12/26,120,5,0.7257897,4641,120,2,3
46199,2014/03/31,2007/01/18,427,4,0.944824684,3565,427,4,0
46200,2014/03/31,2007/07/27,75,4,0.9025,3732,75,0,4
46201,2014/03/31,2012/10/17,113,4,0.9025,3732,113,0,4
46202,2014/03/31,2009/01/15,512,3,0.91150203,3695,512,3,0
46203,2014/03/31,2009/10/10,598,4,0.6639787070000001,5072,598,4,0
46204,2014/03/31,2011/01/14,127,4,0.485742103,6933,127,1,3
46205,2014/03/31,2012/03/15,62,4,0.365134989,9223,62,0,4
46206,2014/03/31,2005/11/23,20,4,0.893259947,3770,20,0,4
46207,2014/03/31,2011/12/28,217,5,0.574378305,5863,217,0,5
46208,2014/03/31,2008/06/26,608,3,0.8629420809999999,3902,608,3,0
46209,2014/03/31,2008/07/10,707,2,0.752424581,4475,707,2,0
46210,2014/03/31,2011/01/13,354,2,0.725,4644,354,1,1
46211,2014/03/31,2013/03/02,162,2,0.725,4644,162,1,1
46212,2014/03/31,2012/09/28,28,4,0.7420828740000001,4537,28,1,3
46213,2014/03/31,2011/02/22,109,3,0.648464946,5192,109,0,3
46214,2014/03/31,2006/06/14,78,5,0.604119864,5573,78,0,5
46215,2014/03/31,2008/11/25,115,2,0.832011864,4046,115,0,2
46216,2014/03/31,2005/09/14,34,3,0.763278912,4410,34,0,3
46217,2014/03/31,2012/05/10,284,3,0.7333333329999999,4590,284,1,2
46218,2014/03/31,2011/04/04,97,6,0.755,4458,97,1,5
46219,2014/03/31,2011/04/21,600,4,0.728958198,4617,600,4,0
46220,2014/03/31,2008/03/16,178,2,0.476643535,7061,178,0,2
46221,2014/03/31,2008/11/21,32,7,0.706047,4766,32,1,6
46222,2014/03/31,2007/08/30,145,4,0.805378171,4178,145,1,3
46223,2014/03/31,2011/12/09,49,2,0.8967857140000001,3752,49,0,2
46224,2014/03/31,2005/05/02,277,2,0.81,4154,277,1,1
46225,2014/03/31,2010/01/15,258,2,0.81,4154,258,0,2
46226,2014/03/31,2012/05/01,595,2,0.825,4078,595,2,0
46227,2014/03/31,2013/03/23,312,4,0.797357194,4219,312,2,2
46228,2014/03/31,2011/12/14,146,6,0.471232838,7138,146,2,4
46229,2014/03/31,2012/03/08,108,5,0.7683074459999999,4378,108,0,5
46230,2014/03/31,2009/05/06,193,4,0.794613749,4233,193,2,2
46231,2014/03/31,2010/11/23,10,5,0.342,9835,10,0,5
46232,2014/03/31,2012/02/26,8,4,0.591537109,5686,8,0,4
46233,2014/03/31,2011/01/17,265,5,0.924,3640,265,3,2
46234,2014/03/31,2008/06/02,39,4,0.619392265,5430,39,0,4
46235,2014/03/31,2011/05/21,21,6,0.555,6060,21,5,1
46236,2014/03/31,2006/06/29,484,5,0.547590361,6142,484,5,0
46237,2014/03/31,2012/08/10,172,5,0.49649343,6773,172,3,2
46238,2014/03/31,2005/12/14,84,6,0.485857535,6921,84,0,6
46239,2014/03/31,2008/10/15,479,3,0.653029715,5149,479,3,0
46240,2014/03/31,2012/01/11,54,3,0.7103697440000001,4733,54,2,1
46241,2014/03/31,2012/03/19,456,2,0.6940545,4844,456,2,0
46242,2014/03/31,2009/07/20,157,5,0.631094425,5327,157,3,2
46243,2014/03/31,2011/03/20,688,5,0.645135291,5211,688,5,0
46244,2014/03/31,2005/06/21,90,3,0.665818974,5049,90,2,1
46245,2014/03/31,2013/03/06,152,3,0.856666667,3924,152,2,1
46246,2014/03/31,2006/07/11,138,4,0.485111143,6928,138,2,2
46247,2014/03/31,2011/04/07,32,4,0.656631497,5118,32,0,4
46248,2014/03/31,2012/11/29,410,4,0.7913801220000001,4246,410,4,0
46249,2014/03/31,2008/10/13,308,5,0.473994922,7089,308,3,2
46250,2014/03/31,2011/12/07,126,4,0.664817966,5054,126,1,3
46251,2014/03/31,2012/08/20,140,3,0.8144436359999999,4125,140,2,1
46252,2014/03/31,2009/04/08,269,4,0.5578728000000001,6022,269,2,2
46253,2014/03/31,2008/02/28,123,7,0.410290705,8187,123,2,5
46254,2014/03/31,2005/04/24,332,6,0.63942509,5253,332,4,2
46255,2014/03/31,2010/06/24,11,6,0.6414801379999999,5236,11,0,6
46256,2014/03/31,2012/07/24,104,3,0.722581756,4648,104,0,3
46257,2014/03/31,2012/03/08,203,2,0.887068146,3786,203,1,1
46258,2014/03/31,2007/09/15,15,5,0.8151432040000001,4120,15,0,5
46259,2014/03/31,2007/12/14,588,4,0.8856012659999999,3792,588,4,0
46260,2014/03/31,2010/04/06,305,4,0.986392479,3404,305,2,2
46261,2014/03/31,2008/12/01,101,2,1.156126033,2904,101,0,2
46262,2014/03/31,2012/12/30,362,3,0.476875,7040,362,2,1
46263,2014/03/31,2011/02/02,556,4,0.613262696,5474,556,4,0
46264,2014/03/31,2012/10/09,447,3,0.533333333,6294,447,3,0
46265,2014/03/31,2005/06/05,348,3,0.533333333,6294,348,2,1
46266,2014/03/31,2009/09/16,139,7,0.520463638,6449,139,0,7
46267,2014/03/31,2008/03/27,140,4,0.7923394709999999,4236,140,2,2
46268,2014/03/31,2010/04/08,417,6,0.556885681,6027,417,6,0
46269,2014/03/31,2012/04/19,81,4,0.723968939,4636,81,1,3
46270,2014/03/31,2012/08/03,208,2,0.58,5786,208,0,2
46271,2014/03/31,2010/09/03,606,3,0.663332674,5059,606,3,0
46272,2014/03/31,2012/02/05,63,4,0.618672566,5424,63,2,2
46273,2014/03/31,2007/03/26,270,3,0.8346417909999999,4020,270,1,2
46274,2014/03/31,2005/10/29,126,3,0.623411371,5382,126,1,2
46275,2014/03/31,2007/02/14,589,3,0.966637857,3471,589,3,0
46276,2014/03/31,2012/12/23,98,5,0.864921371,3879,98,3,2
46277,2014/03/31,2010/11/17,36,3,0.692416925,4845,36,1,2
46278,2014/03/31,2013/02/10,9,3,0.773333333,4338,9,0,3
46279,2014/03/31,2008/10/18,374,4,0.6718205490000001,4993,374,4,0
46280,2014/03/31,2010/02/11,448,3,0.5153402979999999,6509,448,3,0
46281,2014/03/31,2006/03/14,32,5,0.607657609,5520,32,1,4
46282,2014/03/31,2011/08/02,468,4,0.670371851,5002,468,4,0
46283,2014/03/31,2007/09/03,120,4,0.532869178,6291,120,2,2
46284,2014/03/31,2012/12/08,284,4,0.467849267,7165,284,1,3
46285,2014/03/31,2011/11/16,507,5,0.896243316,3740,507,5,0
46286,2014/03/31,2010/01/28,39,3,1.016666667,3297,39,0,3
46287,2014/03/31,2009/12/04,103,2,0.773176471,4335,103,1,1
46288,2014/03/31,2013/02/05,51,7,0.655878669,5110,51,0,7
46289,2014/03/31,2006/11/26,91,5,0.487356021,6876,91,2,3
46290,2014/03/31,2013/03/31,38,6,0.474626062,7060,38,0,6
46291,2014/03/31,2010/11/24,198,4,0.6670734620000001,5023,198,2,2
46292,2014/03/31,2007/04/28,185,3,0.935410385,3582,185,1,2
46293,2014/03/31,2011/09/23,147,3,0.63687892,5261,147,1,2
46294,2014/03/31,2011/09/25,57,2,0.785,4268,57,1,1
46295,2014/03/31,2013/03/12,349,4,0.78733255,4255,349,3,1
46296,2014/03/31,2013/01/22,125,2,0.8772008379999999,3819,125,0,2
46297,2014/03/31,2011/04/08,521,5,1.0,3350,521,5,0
46298,2014/03/31,2012/04/25,163,3,0.87558024,3826,163,0,3
46299,2014/03/31,2009/07/12,554,4,0.7256715770000001,4616,554,4,0
46300,2014/03/31,2008/01/23,245,3,0.889867163,3764,245,0,3
46301,2014/03/31,2006/05/27,133,5,0.596280933,5617,133,0,5
46302,2014/03/31,2008/10/19,131,6,0.628135784,5332,131,3,3
46303,2014/03/31,2012/08/24,569,4,0.6142791639999999,5452,569,4,0
46304,2014/03/31,2012/03/01,412,2,0.832256461,4024,412,2,0
46305,2014/03/31,2004/12/15,122,3,0.502005997,6670,122,0,3
46306,2014/03/31,2010/06/05,156,3,0.693514913,4828,156,0,3
46307,2014/03/31,2005/01/08,180,4,0.614706206,5446,180,2,2
46308,2014/03/31,2007/10/21,638,6,0.6547535210000001,5112,638,6,0
46309,2014/03/31,2009/10/31,23,5,0.691829268,4838,23,4,1
46310,2014/03/31,2012/01/21,306,5,0.8336363640000001,4015,306,4,1
46311,2014/03/31,2007/09/27,17,12,0.540019361,6198,17,7,5
46312,2014/03/31,2006/05/20,437,4,0.772420955,4333,437,4,0
46313,2014/03/31,2012/02/01,342,3,0.711187845,4706,342,2,1
46314,2014/03/31,2010/05/29,152,3,0.474515809,7053,152,1,2
46315,2014/03/31,2010/03/27,97,3,0.863643871,3875,97,0,3
46316,2014/03/31,2011/02/04,140,4,0.7408744740000001,4517,140,1,3
46317,2014/03/31,2009/12/21,191,6,0.584010471,5730,191,0,6
46318,2014/03/31,2009/07/01,204,3,1.228318649,2724,204,0,3
46319,2014/03/31,2010/08/08,209,4,0.6519602489999999,5132,209,3,1
46320,2014/03/31,2012/07/21,116,6,0.518549287,6452,116,1,5
46321,2014/03/31,2012/04/18,34,4,0.8435854770000001,3966,34,2,2
46322,2014/03/31,2008/04/08,36,3,0.661974674,5054,36,0,3
46323,2014/03/31,2012/02/27,314,2,0.758628118,4410,314,1,1
46324,2014/03/31,2013/01/11,440,2,1.05,3186,440,2,0
46325,2014/03/31,2006/12/13,172,4,0.888414343,3765,172,0,4
46326,2014/03/31,2012/04/04,98,3,0.724723727,4615,98,2,1
46327,2014/03/31,2007/09/13,65,4,0.445278924,7511,65,1,3
46328,2014/03/31,2006/03/31,342,3,1.1640097459999998,2873,342,2,1
46329,2014/03/31,2012/11/14,35,6,0.674633851,4957,35,2,4
46330,2014/03/31,2010/04/22,117,5,0.7729865929999999,4326,117,0,5
46331,2014/03/31,2010/11/20,501,2,0.85,3934,501,2,0
46332,2014/03/31,2010/05/12,590,2,0.85,3934,590,2,0
46333,2014/03/31,2012/06/28,598,3,0.206847705,16166,598,3,0
46334,2014/03/31,2013/01/16,10,3,0.566666667,5901,10,1,2
46335,2014/03/31,2012/08/10,529,2,0.85,3934,529,2,0
46336,2014/03/31,2011/02/11,402,2,0.85,3934,402,2,0
46337,2014/03/31,2008/01/25,696,2,0.85,3934,696,2,0
46338,2014/03/31,2012/07/17,620,2,0.85,3934,620,2,0
46339,2014/03/31,2013/01/01,9,2,0.85,3934,9,0,2
46340,2014/03/31,2006/03/02,12,4,0.6642956489999999,5033,12,2,2
46341,2014/03/31,2009/08/18,38,4,0.532892891,6274,38,1,3
46342,2014/03/31,2010/11/08,40,3,0.764504917,4373,40,1,2
46343,2014/03/31,2008/07/17,22,6,0.551666667,6060,22,0,6
46344,2014/03/31,2010/12/10,297,4,0.46799636,7142,297,1,3
46345,2014/03/31,2013/01/01,253,3,0.583217589,5731,253,1,2
46346,2014/03/31,2012/04/12,622,6,0.8583333329999999,3894,622,6,0
46347,2014/03/31,2012/04/26,512,4,0.799605263,4180,512,4,0
46348,2014/03/31,2007/03/11,14,5,0.719702842,4644,14,2,3
46349,2014/03/31,2011/04/07,168,6,0.571407078,5849,168,2,4
46350,2014/03/31,2012/02/27,34,3,0.766374685,4361,34,2,1
46351,2014/03/31,2009/09/20,34,4,0.647413793,5162,34,2,2
46352,2014/03/31,2011/12/03,184,3,0.625706796,5341,184,1,2
46353,2014/03/31,2009/09/17,67,3,1.41,2370,67,0,3
46354,2014/03/31,2008/06/10,259,3,0.870455848,3839,259,0,3
46355,2014/03/31,2007/07/25,483,5,0.786917098,4246,483,5,0
46356,2014/03/31,2008/06/06,22,11,0.735454545,4543,22,4,7
46357,2014/03/31,2007/10/20,54,2,0.898145161,3720,54,0,2
46358,2014/03/31,2011/05/05,150,4,0.7025,4756,150,1,3
46359,2014/03/31,2012/01/01,37,2,0.67,4986,37,0,2
46360,2014/03/31,2008/12/04,563,3,0.949573621,3518,563,3,0
46361,2014/03/31,2012/02/17,1,3,0.683355155,4888,1,1,2
46362,2014/03/31,2011/05/12,47,8,0.496011286,6734,47,5,3
46363,2014/03/31,2005/12/13,7,6,0.596666667,5598,7,5,1
46364,2014/03/31,2013/03/27,137,3,0.423333333,7890,137,0,3
46365,2014/03/31,2012/12/02,472,2,0.625,5344,472,2,0
46366,2014/03/31,2005/09/02,607,2,0.625,5344,607,2,0
46367,2014/03/31,2013/01/15,405,2,0.625,5344,405,2,0
46368,2014/03/31,2005/10/03,191,2,0.625,5344,191,0,2
46369,2014/03/31,2008/09/30,47,3,0.492913223,6776,47,0,3
46370,2014/03/31,2013/03/14,264,4,0.936762973,3565,264,1,3
46371,2014/03/31,2010/12/06,450,4,0.775993493,4303,450,4,0
46372,2014/03/31,2008/01/02,215,5,0.543824104,6140,215,3,2
46373,2014/03/31,2011/08/17,39,5,0.482645273,6918,39,2,3
46374,2014/03/31,2006/02/22,62,10,0.8706206,3835,62,6,4
46375,2014/03/31,2009/10/31,571,2,0.625,5342,571,2,0
46376,2014/03/31,2013/01/12,149,2,0.625,5342,149,0,2
46377,2014/03/31,2013/02/27,39,3,0.814307317,4100,39,1,2
46378,2014/03/31,2011/10/31,258,4,0.572560453,5831,258,3,1
46379,2014/03/31,2007/06/04,316,3,0.66210829,5042,316,2,1
46380,2014/03/31,2011/07/31,106,4,0.7649358390000001,4364,106,0,4
46381,2014/03/31,2011/02/01,20,4,0.505,6610,20,0,4
46382,2014/03/31,2010/01/08,198,4,0.5174279070000001,6450,198,1,3
46383,2014/03/31,2012/05/15,618,4,0.398305287,8379,618,4,0
46384,2014/03/31,2010/11/22,136,3,0.64,5214,136,0,3
46385,2014/03/31,2012/04/25,69,10,0.483592754,6900,69,6,4
46386,2014/03/31,2007/02/26,129,3,0.475451696,7018,129,2,1
46387,2014/03/31,2011/02/01,407,2,0.5948297379999999,5609,407,2,0
46388,2014/03/31,2011/07/28,16,4,0.614430939,5430,16,3,1
46389,2014/03/31,2010/05/14,327,3,0.42125,7920,327,1,2
46390,2014/03/31,2009/04/21,15,3,0.4866666670000001,6855,15,1,2
46391,2014/03/31,2012/01/04,103,5,0.5045220810000001,6612,103,3,2
46392,2014/03/31,2005/04/09,226,5,0.7804866640000001,4274,226,2,3
46393,2014/03/31,2012/02/25,518,3,0.74474213,4479,518,3,0
46394,2014/03/31,2009/11/02,373,7,0.7098318790000001,4699,373,7,0
46395,2014/03/31,2013/02/28,354,4,0.6375,5232,354,1,3
46396,2014/03/31,2012/08/15,588,2,0.55,6064,588,2,0
46397,2014/03/31,2010/11/08,8,2,0.614496038,5427,8,0,2
46398,2014/03/31,2012/10/16,530,2,0.7,4764,530,2,0
46399,2014/03/31,2005/07/09,80,4,0.90910578,3668,80,0,4
46400,2014/03/31,2011/06/25,360,3,0.6580521020000001,5067,360,2,1
46401,2014/03/31,2011/12/07,205,5,0.549774077,6064,205,3,2
46402,2014/03/31,2010/12/01,66,4,0.615200221,5419,66,0,4
46403,2014/03/31,2008/04/17,222,4,0.7632882990000001,4367,222,2,2
46404,2014/03/31,2012/10/08,237,6,0.782029564,4262,237,3,3
46405,2014/03/31,2010/10/14,425,4,0.825,4040,425,4,0
46406,2014/03/31,2010/10/22,123,3,0.653004115,5103,123,1,2
46407,2014/03/31,2008/07/21,431,3,0.7347298790000001,4535,431,3,0
46408,2014/03/31,2009/09/24,478,4,1.0,3332,478,4,0
46409,2014/03/31,2013/01/01,454,2,0.687951683,4843,454,2,0
46410,2014/03/31,2013/01/03,454,2,0.687951683,4843,454,2,0
46411,2014/03/31,2010/07/01,608,9,0.490351781,6794,608,9,0
46412,2014/03/31,2012/12/22,411,3,0.808936377,4118,411,3,0
46413,2014/03/31,2010/09/29,225,8,0.521057407,6393,225,5,3
46414,2014/03/31,2011/12/15,564,4,0.527200063,6318,564,4,0
46415,2014/03/31,2008/01/24,1,5,0.583193836,5711,1,2,3
46416,2014/03/31,2010/05/17,48,2,0.698787243,4766,48,0,2
46417,2014/03/31,2012/10/06,248,3,0.7252711829999999,4591,248,1,2
46418,2014/03/31,2010/10/26,120,4,0.660644841,5040,120,2,2
46419,2014/03/31,2010/10/29,89,6,0.7390899000000001,4505,89,0,6
46420,2014/03/31,2006/05/01,253,7,0.8857142859999999,3759,253,4,3
46421,2014/03/31,2013/02/05,204,6,0.35044000000000003,9500,204,1,5
46422,2014/03/31,2012/12/22,460,4,0.5031892379999999,6616,460,4,0
46423,2014/03/31,2010/02/24,80,2,0.78,4268,80,1,1
46424,2014/03/31,2008/12/07,262,9,0.911766639,3651,262,6,3
46425,2014/03/31,2007/09/26,14,5,0.920982291,3614,14,0,5
46426,2014/03/31,2009/08/28,124,3,0.967230456,3441,124,1,2
46427,2014/03/31,2012/07/10,108,4,0.798311346,4169,108,2,2
46428,2014/03/31,2006/11/23,24,4,0.605018182,5500,24,0,4
46429,2014/03/31,2005/08/17,448,3,0.8375409009999999,3973,448,3,0
46430,2014/03/31,2010/05/09,366,2,0.75,4436,366,1,1
46431,2014/03/31,2007/08/30,60,2,0.575,5786,60,0,2
46432,2014/03/31,2012/05/09,241,2,0.759048597,4383,241,0,2
46433,2014/03/31,2010/04/05,352,2,0.735984513,4520,352,1,1
46434,2014/03/31,2008/06/01,25,3,0.7666666670000001,4338,25,1,2
46435,2014/03/31,2011/03/04,374,3,0.7666666670000001,4338,374,3,0
46436,2014/03/31,2012/11/05,496,2,0.8509979529999999,3908,496,2,0
46437,2014/03/31,2012/03/24,154,3,0.572093583,5813,154,1,2
46438,2014/03/31,2013/01/01,5,3,0.737115939,4511,5,0,3
46439,2014/03/31,2006/10/01,9,3,0.578771105,5745,9,1,2
46440,2014/03/31,2013/03/08,85,4,0.475397484,6994,85,1,3
46441,2014/03/31,2006/12/08,63,4,0.700374974,4747,63,2,2
46442,2014/03/31,2010/12/12,390,6,0.553974338,6001,390,6,0
46443,2014/03/31,2012/01/28,245,6,0.505364853,6578,245,4,2
46444,2014/03/31,2007/08/01,212,3,0.563333333,5901,212,1,2
46445,2014/03/31,2007/08/08,14,2,0.845,3934,14,0,2
46446,2014/03/31,2008/10/04,164,2,0.845,3934,164,0,2
46447,2014/03/31,2013/01/20,1,2,0.845,3934,1,0,2
46448,2014/03/31,2005/08/12,269,3,0.563333333,5901,269,2,1
46449,2014/03/31,2011/11/04,36,7,0.720307692,4615,36,2,5
46450,2014/03/31,2012/08/04,210,2,1.155,2878,210,1,1
46451,2014/03/31,2006/05/24,554,2,0.766251729,4338,554,2,0
46452,2014/03/31,2007/04/09,99,2,0.618518794,5374,99,1,1
46453,2014/03/31,2011/10/15,172,2,0.499209973,6658,172,0,2
46454,2014/03/31,2012/03/01,369,3,0.603586996,5506,369,3,0
46455,2014/03/31,2009/08/21,14,2,0.8,4154,14,0,2
46456,2014/03/31,2012/08/15,400,4,0.4,8308,400,4,0
46457,2014/03/31,2012/08/28,402,2,0.8,4154,402,2,0
46458,2014/03/31,2010/02/23,644,2,0.8,4154,644,2,0
46459,2014/03/31,2007/10/10,476,2,0.8,4154,476,2,0
46460,2014/03/31,2012/09/18,402,2,0.8,4154,402,2,0
46461,2014/03/31,2008/03/21,357,3,0.832781955,3990,357,2,1
46462,2014/03/31,2012/01/12,187,6,0.320662034,10362,187,2,4
46463,2014/03/31,2007/11/29,331,3,0.856145323,3881,331,2,1
46464,2014/03/31,2010/05/04,194,2,1.165,2852,194,0,2
46465,2014/03/31,2009/08/04,555,3,0.449708948,7387,555,3,0
46466,2014/03/31,2010/02/01,114,4,0.7046139159999999,4714,114,1,3
46467,2014/03/31,2008/09/03,24,4,0.7045396690000001,4714,24,0,4
46468,2014/03/31,2012/03/06,264,3,0.65,5109,264,0,3
46469,2014/03/31,2011/07/24,185,3,0.742044693,4475,185,2,1
46470,2014/03/31,2010/07/26,216,3,0.7752089659999999,4283,216,2,1
46471,2014/03/31,2009/01/21,657,3,0.7600961540000001,4368,657,3,0
46472,2014/03/31,2008/04/12,577,4,1.0,3320,577,4,0
46473,2014/03/31,2006/09/28,284,2,0.774188433,4288,284,1,1
46474,2014/03/31,2012/04/09,579,5,0.813602941,4080,579,5,0
46475,2014/03/31,2008/11/16,374,5,0.940858844,3528,374,5,0
46476,2014/03/31,2011/05/17,20,5,0.506182706,6557,20,3,2
46477,2014/03/31,2009/08/24,551,2,0.8883832979999999,3736,551,2,0
46478,2014/03/31,2011/09/18,557,4,0.85624355,3876,557,4,0
46479,2014/03/31,2008/07/09,291,5,0.433865865,7649,291,2,3
46480,2014/03/31,2005/03/31,675,2,0.85,3904,675,2,0
46481,2014/03/31,2009/12/02,14,4,0.617087595,5377,14,1,3
46482,2014/03/31,2013/01/16,134,3,0.812765801,4082,134,1,2
46483,2014/03/31,2005/08/19,697,3,0.612573855,5416,697,3,0
46484,2014/03/31,2011/09/01,625,3,0.612573855,5416,625,3,0
46485,2014/03/31,2010/06/19,85,5,0.6755528409999999,4911,85,0,5
46486,2014/03/31,2005/08/05,632,3,0.685433884,4840,632,3,0
46487,2014/03/31,2012/07/18,594,2,0.45320399,7319,594,2,0
46488,2014/03/31,2009/12/27,12,4,0.934990133,3547,12,0,4
46489,2014/03/31,2005/01/13,514,6,0.644712286,5144,514,6,0
46490,2014/03/31,2008/08/22,86,5,0.511901822,6478,86,0,5
46491,2014/03/31,2011/03/30,152,4,0.881637862,3761,152,2,2
46492,2014/03/31,2012/10/19,330,2,1.0,3315,330,1,1
46493,2014/03/31,2011/12/19,387,3,0.810711665,4089,387,3,0
46494,2014/03/31,2009/02/08,206,3,0.639265188,5185,206,0,3
46495,2014/03/31,2008/05/25,41,3,0.795996638,4164,41,1,2
46496,2014/03/31,2013/01/18,28,6,0.5183015329999999,6394,28,1,5
46497,2014/03/31,2008/04/02,108,5,0.525332911,6308,108,0,5
46498,2014/03/31,2012/05/30,205,4,0.597989533,5541,205,2,2
46499,2014/03/31,2012/02/18,296,2,0.62,5344,296,0,2
46500,2014/03/31,2013/02/22,69,4,0.515999066,6421,69,0,4
46501,2014/03/31,2012/11/27,146,5,0.7031196940000001,4712,146,3,2
46502,2014/03/31,2005/09/24,296,4,0.6343174420000001,5223,296,3,1
46503,2014/03/31,2008/03/05,88,2,0.649541176,5100,88,1,1
46504,2014/03/31,2010/03/08,76,5,0.563665135,5877,76,3,2
46505,2014/03/31,2011/06/03,59,4,0.5775,5736,59,0,4
46506,2014/03/31,2011/01/24,23,4,0.667641605,4961,23,0,4
46507,2014/03/31,2012/05/29,137,4,0.8368115209999999,3958,137,1,3
46508,2014/03/31,2007/06/25,148,4,0.696969697,4752,148,3,1
46509,2014/03/31,2006/03/31,1,4,0.7155704409999999,4628,1,3,1
46510,2014/03/31,2012/04/18,113,4,0.627557324,5277,113,1,3
46511,2014/03/31,2011/09/03,38,3,0.860600312,3848,38,0,3
46512,2014/03/31,2004/11/16,224,3,0.571325052,5796,224,2,1
46513,2014/03/31,2009/03/01,11,2,0.77,4300,11,0,2
46514,2014/03/31,2010/12/01,239,6,0.5767979089999999,5740,239,5,1
46515,2014/03/31,2010/10/28,102,5,0.7000761259999999,4729,102,2,3
46516,2014/03/31,2010/11/16,584,2,1.242213884,2665,584,2,0
46517,2014/03/31,2013/01/15,356,3,0.685705407,4827,356,1,2
46518,2014/03/31,2009/09/08,257,4,0.909035979,3641,257,3,1
46519,2014/03/31,2010/04/10,195,5,0.693294931,4774,195,2,3
46520,2014/03/31,2011/07/28,441,3,0.6574692089999999,5034,441,3,0
46521,2014/03/31,2011/10/16,103,3,0.7409021709999999,4467,103,2,1
46522,2014/03/31,2011/03/30,473,3,0.8,4137,473,3,0
46523,2014/03/31,2008/11/17,383,3,0.638546893,5182,383,3,0
46524,2014/03/31,2005/04/11,3,5,0.476385889,6945,3,0,5
46525,2014/03/31,2011/11/07,162,3,0.7346746609999999,4503,162,1,2
46526,2014/03/31,2013/03/06,72,3,0.585100814,5654,72,0,3
46527,2014/03/31,2011/09/20,637,4,0.921191869,3591,637,4,0
46528,2014/03/31,2006/05/15,255,3,0.959396752,3448,255,2,1
46529,2014/03/31,2007/06/11,10,3,0.68063786,4860,10,0,3
46530,2014/03/31,2010/08/28,701,3,0.872987596,3789,701,3,0
46531,2014/03/31,2009/03/26,43,4,0.699156627,4731,43,1,3
46532,2014/03/31,2011/08/29,695,2,0.775,4268,695,2,0
46533,2014/03/31,2011/08/09,397,2,0.775,4268,397,2,0
46534,2014/03/31,2012/12/28,455,2,0.775,4268,455,2,0
46535,2014/03/31,2013/03/21,125,3,0.685199917,4827,125,0,3
46536,2014/03/31,2010/05/28,85,4,0.516343482,6405,85,1,3
46537,2014/03/31,2012/03/14,420,3,0.663154201,4987,420,3,0
46538,2014/03/31,2010/10/02,75,6,0.820930983,4028,75,4,2
46539,2014/03/31,2009/07/31,494,3,0.8086818290000001,4089,494,3,0
46540,2014/03/31,2005/10/06,459,4,0.591334287,5591,459,4,0
46541,2014/03/31,2007/06/16,71,8,0.5938818029999999,5567,71,3,5
46542,2014/03/31,2012/01/25,98,4,0.917856746,3602,98,0,4
46543,2014/03/31,2010/11/29,14,3,0.6343600079999999,5211,14,0,3
46544,2014/03/31,2012/07/14,188,2,1.273545279,2595,188,1,1
46545,2014/03/31,2010/07/11,318,5,0.578571429,5712,318,2,3
46546,2014/03/31,2012/04/09,432,3,0.5532898039999999,5973,432,3,0
46547,2014/03/31,2012/09/15,18,4,0.795905588,4152,18,3,1
46548,2014/03/31,2008/06/16,86,3,0.838085214,3943,86,2,1
46549,2014/03/31,2012/10/01,162,4,0.434154513,7611,162,1,3
46550,2014/03/31,2013/02/28,61,2,0.71,4654,61,1,1
46551,2014/03/31,2006/08/25,49,3,0.722043269,4576,49,0,3
46552,2014/03/31,2011/04/30,74,3,0.659624676,5009,74,0,3
46553,2014/03/31,2009/05/20,250,4,0.59,5600,250,0,4
46554,2014/03/31,2012/10/01,226,4,0.670450487,4928,226,3,1
46555,2014/03/31,2011/01/25,51,6,0.402583476,8206,51,2,4
46556,2014/03/31,2012/04/23,367,3,0.730289631,4523,367,3,0
46557,2014/03/31,2010/11/08,131,5,0.666481631,4954,131,1,4
46558,2014/03/31,2009/05/30,43,2,0.751844682,4391,43,0,2
46559,2014/03/31,2010/04/11,131,4,0.887419355,3720,131,1,3
46560,2014/03/31,2011/11/23,106,3,0.62528888,5279,106,2,1
46561,2014/03/31,2011/09/26,114,3,0.53803586,6135,114,0,3
46562,2014/03/31,2011/01/21,567,3,0.75,4401,567,3,0
46563,2014/03/31,2008/07/24,1,6,0.955,3456,1,1,5
46564,2014/03/31,2012/07/23,477,4,0.408105602,8087,477,4,0
46565,2014/03/31,2009/07/21,334,6,0.95,3474,334,4,2
46566,2014/03/31,2012/10/23,519,2,0.5,6600,519,2,0
46567,2014/03/31,2008/01/14,247,3,0.832510724,3963,247,2,1
46568,2014/03/31,2013/01/26,89,5,0.418876333,7876,89,0,5
46569,2014/03/31,2011/03/11,195,4,0.7482218190000001,4409,195,3,1
46570,2014/03/31,2007/04/20,338,5,0.480034924,6872,338,4,1
46571,2014/03/31,2012/07/31,453,4,0.679423275,4855,453,4,0
46572,2014/03/31,2007/07/27,471,4,0.71257291,4629,471,4,0
46573,2014/03/31,2007/01/10,647,2,0.775,4256,647,2,0
46574,2014/03/31,2010/05/11,18,4,0.736738888,4477,18,0,4
46575,2014/03/31,2012/10/27,2,6,0.8241429290000001,4002,2,1,5
46576,2014/03/31,2012/06/11,462,5,0.616255605,5352,462,5,0
46577,2014/03/31,2011/08/25,94,3,0.7913075820000001,4168,94,1,2
46578,2014/03/31,2011/07/21,128,4,0.561474293,5874,128,2,2
46579,2014/03/31,2008/03/07,16,3,0.988330836,3337,16,2,1
46580,2014/03/31,2010/11/20,620,2,0.8,4122,620,2,0
46581,2014/03/31,2008/05/15,12,3,0.488274841,6753,12,2,1
46582,2014/03/31,2010/11/29,475,5,0.6050100939999999,5449,475,5,0
46583,2014/03/31,2007/02/21,121,7,0.619631579,5320,121,3,4
46584,2014/03/31,2009/02/27,276,7,0.627161339,5256,276,6,1
46585,2014/03/31,2011/10/30,387,5,0.51616818,6386,387,5,0
46586,2014/03/31,2011/10/19,554,3,0.961832507,3427,554,3,0
46587,2014/03/31,2011/02/13,75,3,0.84,3924,75,2,1
46588,2014/03/31,2010/01/13,168,9,0.902717064,3651,168,5,4
46589,2014/03/31,2010/02/10,664,2,0.908434399,3628,664,2,0
46590,2014/03/31,2013/01/01,20,6,0.5644912639999999,5838,20,0,6
46591,2014/03/31,2012/04/15,234,4,0.6835407590000001,4821,234,2,2
46592,2014/03/31,2009/02/19,124,3,0.6935781940000001,4751,124,0,3
46593,2014/03/31,2013/02/16,404,2,0.45,7322,404,2,0
46594,2014/03/31,2009/01/03,138,3,0.52,6336,138,0,3
46595,2014/03/31,2005/02/07,301,4,0.457021778,7209,301,2,2
46596,2014/03/31,2008/04/18,74,2,1.321853933,2492,74,0,2
46597,2014/03/31,2012/09/07,397,8,0.54,6100,397,8,0
46598,2014/03/31,2012/12/17,142,5,0.8875478309999999,3711,142,2,3
46599,2014/03/31,2008/10/08,360,6,0.628751432,5238,360,5,1
46600,2014/03/31,2007/04/18,100,5,0.5421102879999999,6075,100,3,2
46601,2014/03/31,2011/04/06,280,2,0.788033022,4179,280,0,2
46602,2014/03/31,2010/10/22,710,2,0.925,3560,710,2,0
46603,2014/03/31,2012/01/09,634,3,0.6166666670000001,5340,634,3,0
46604,2014/03/31,2007/09/07,147,5,0.455131324,7234,147,1,4
46605,2014/03/31,2008/07/07,296,3,0.423005268,7783,296,2,1
46606,2014/03/31,2008/05/07,284,4,0.8379231359999999,3929,284,2,2
46607,2014/03/31,2008/06/10,50,5,0.635354179,5181,50,1,4
46608,2014/03/31,2007/06/25,18,3,0.8373619940000001,3931,18,0,3
46609,2014/03/31,2010/05/25,611,5,0.971274712,3389,611,5,0
46610,2014/03/31,2009/08/14,405,5,0.75943701,4334,405,5,0
46611,2014/03/31,2011/02/12,519,4,0.64108882,5134,519,4,0
46612,2014/03/31,2011/06/07,39,7,0.8442688559999999,3898,39,0,7
46613,2014/03/31,2012/01/16,336,4,0.7625,4316,336,3,1
46614,2014/03/31,2009/07/01,2,2,0.7402632170000001,4445,2,0,2
46615,2014/03/31,2010/11/17,260,2,0.72,4570,260,0,2
46616,2014/03/31,2010/06/15,276,5,0.660706827,4980,276,4,1
46617,2014/03/31,2008/08/22,12,3,0.640103113,5140,12,0,3
46618,2014/03/31,2011/11/02,678,3,0.783333333,4200,678,3,0
46619,2014/03/31,2012/10/14,397,3,0.779620853,4220,397,3,0
46620,2014/03/31,2012/01/22,72,4,0.479172735,6866,72,1,3
46621,2014/03/31,2012/12/12,207,4,0.738065964,4457,207,2,2
46622,2014/03/31,2012/04/07,526,5,0.422217944,7791,526,5,0
46623,2014/03/31,2012/08/01,103,10,0.485150442,6780,103,5,5
46624,2014/03/31,2008/07/08,170,4,0.54469692,6038,170,0,4
46625,2014/03/31,2012/09/23,289,3,0.932052154,3528,289,2,1
46626,2014/03/31,2005/05/01,696,2,0.8,4110,696,2,0
46627,2014/03/31,2012/10/07,357,3,1.5,2192,357,1,2
46628,2014/03/31,2011/10/31,377,3,0.809453471,4062,377,3,0
46629,2014/03/31,2010/01/05,208,4,0.877243863,3748,208,2,2
46630,2014/03/31,2007/07/16,29,5,0.541660626,6070,29,2,3
46631,2014/03/31,2013/02/15,255,2,0.961072786,3421,255,1,1
46632,2014/03/31,2012/04/29,314,5,0.889048134,3698,314,3,2
46633,2014/03/31,2012/10/25,513,2,0.45,7306,513,2,0
46634,2014/03/31,2009/07/29,24,3,0.7478821659999999,4396,24,0,3
46635,2014/03/31,2012/08/27,236,3,0.622643939,5280,236,1,2
46636,2014/03/31,2009/08/17,596,3,0.6185136410000001,5315,596,3,0
46637,2014/03/31,2007/06/09,624,3,0.6185136410000001,5315,624,3,0
46638,2014/03/31,2006/04/14,1,10,0.608777778,5400,1,6,4
46639,2014/03/31,2008/01/04,101,3,0.526133163,6248,101,0,3
46640,2014/03/31,2011/12/11,268,5,0.5754814429999999,5712,268,3,2
46641,2014/03/31,2010/09/09,192,5,0.520278613,6317,192,2,3
46642,2014/03/31,2005/12/15,135,4,0.525419664,6255,135,3,1
46643,2014/03/31,2012/02/06,229,2,0.75,4382,229,0,2
46644,2014/03/31,2008/12/30,50,2,0.8968422490000001,3664,50,0,2
46645,2014/03/31,2011/05/05,587,4,0.652741359,5034,587,4,0
46646,2014/03/31,2013/03/27,281,3,0.7051878090000001,4659,281,2,1
46647,2014/03/31,2011/03/16,201,6,0.668926899,4911,201,3,3
46648,2014/03/31,2013/02/02,91,4,0.582023388,5644,91,0,4
46649,2014/03/31,2007/08/08,38,2,0.835,3934,38,0,2
46650,2014/03/31,2005/12/15,171,2,0.835,3934,171,0,2
46651,2014/03/31,2010/09/15,5,2,0.835,3934,5,0,2
46652,2014/03/31,2008/11/10,253,2,0.835,3934,253,0,2
46653,2014/03/31,2011/07/12,161,2,1.037069782,3167,161,0,2
46654,2014/03/31,2011/12/27,476,4,0.943464522,3481,476,4,0
46655,2014/03/31,2012/12/25,34,4,0.594183101,5527,34,2,2
46656,2014/03/31,2008/07/04,233,5,0.983468104,3339,233,3,2
46657,2014/03/31,2012/10/07,227,4,0.86003143,3818,227,2,2
46658,2014/03/31,2009/01/26,34,3,0.811265135,4047,34,0,3
46659,2014/03/31,2009/01/06,31,5,0.7287857940000001,4505,31,0,5
46660,2014/03/31,2009/12/12,192,7,0.522182281,6287,192,4,3
46661,2014/03/31,2013/03/03,304,2,0.785,4182,304,0,2
46662,2014/03/31,2008/10/22,132,4,0.81978022,4004,132,0,4
46663,2014/03/31,2009/08/13,107,3,0.569413602,5764,107,0,3
46664,2014/03/31,2010/01/05,50,3,0.793333333,4137,50,1,2
46665,2014/03/31,2013/02/21,50,3,0.793333333,4137,50,1,2
46666,2014/03/31,2011/04/14,42,4,0.853761707,3844,42,1,3
46667,2014/03/31,2006/12/07,222,2,0.7767218929999999,4225,222,1,1
46668,2014/03/31,2007/06/23,21,5,0.499718288,6567,21,1,4
46669,2014/03/31,2005/03/24,284,5,0.510892106,6423,284,4,1
46670,2014/03/31,2012/03/23,662,2,0.55,5966,662,2,0
46671,2014/03/31,2008/11/14,384,5,0.689296218,4760,384,5,0
46672,2014/03/31,2012/04/07,328,5,0.671245908,4888,328,4,1
46673,2014/03/31,2007/06/23,493,4,0.6011359470000001,5458,493,4,0
46674,2014/03/31,2009/01/08,105,5,0.8167562859999999,4017,105,1,4
46675,2014/03/31,2006/12/19,250,4,0.879991953,3728,250,0,4
46676,2014/03/31,2012/03/12,48,3,0.898545604,3651,48,1,2
46677,2014/03/31,2013/03/21,317,4,0.684017932,4796,317,2,2
46678,2014/03/31,2010/03/13,81,5,0.809790175,4051,81,2,3
46679,2014/03/31,2005/10/31,209,4,0.520493494,6302,209,0,4
46680,2014/03/31,2013/03/25,225,4,0.630545944,5202,225,1,3
46681,2014/03/31,2012/02/22,123,4,0.657718067,4987,123,0,4
46682,2014/03/31,2010/11/05,464,5,0.7350963690000001,4462,464,5,0
46683,2014/03/31,2008/04/27,23,7,0.782215597,4193,23,0,7
46684,2014/03/31,2010/11/18,157,2,0.785578443,4175,157,0,2
46685,2014/03/31,2010/03/08,85,5,0.373234323,8787,85,2,3
46686,2014/03/31,2012/02/12,41,3,0.49,6693,41,2,1
46687,2014/03/31,2012/05/18,645,3,0.7177062809999999,4569,645,3,0
46688,2014/03/31,2013/03/20,57,4,0.605,5420,57,1,3
46689,2014/03/31,2009/06/18,33,4,0.516911556,6343,33,2,2
46690,2014/03/31,2008/04/15,3,7,0.397296085,8251,3,4,3
46691,2014/03/31,2012/09/13,83,5,0.6974085109999999,4700,83,2,3
46692,2014/03/31,2010/12/20,579,7,0.720488019,4549,579,7,0
46693,2014/03/31,2010/08/30,258,5,0.636282275,5151,258,1,4
46694,2014/03/31,2007/01/23,514,6,0.841666667,3894,514,6,0
46695,2014/03/31,2007/10/16,66,5,0.557912836,5874,66,2,3
46696,2014/03/31,2012/09/19,60,3,0.532365556,6155,60,0,3
46697,2014/03/31,2012/10/04,188,6,0.8338941209999999,3929,188,0,6
46698,2014/03/31,2011/08/08,38,3,0.63443261,5164,38,0,3
46699,2014/03/31,2011/02/15,83,8,0.3916029170000001,8366,83,1,7
46700,2014/03/31,2013/03/24,189,3,0.28,11700,189,0,3
46701,2014/03/31,2011/01/16,427,3,0.6152704729999999,5324,427,3,0
46702,2014/03/31,2010/05/25,315,4,0.81262714,4031,315,3,1
46703,2014/03/31,2012/10/08,144,4,0.572351913,5723,144,3,1
46704,2014/03/31,2007/07/15,380,2,0.525,6238,380,2,0
46705,2014/03/31,2010/03/24,261,4,0.571114405,5734,261,1,3
46706,2014/03/31,2008/06/26,591,4,0.5239520000000001,6250,591,4,0
46707,2014/03/31,2011/04/10,34,3,0.637806778,5134,34,2,1
46708,2014/03/31,2012/06/21,212,5,0.71597857,4573,212,0,5
46709,2014/03/31,2007/11/17,312,4,0.9375,3492,312,3,1
46710,2014/03/31,2012/12/08,374,2,0.8,4092,374,2,0
46711,2014/03/31,2008/07/15,633,4,0.689749263,4746,633,4,0
46712,2014/03/31,2010/02/11,59,2,0.58,5644,59,0,2
46713,2014/03/31,2012/02/18,10,2,0.58,5644,10,0,2
46714,2014/03/31,2009/03/05,187,3,0.5843323810000001,5602,187,1,2
46715,2014/03/31,2010/12/11,94,5,0.4955222520000001,6606,94,2,3
46716,2014/03/31,2012/06/02,125,3,0.7840287429999999,4175,125,1,2
46717,2014/03/31,2010/09/08,76,5,0.5223683370000001,6266,76,4,1
46718,2014/03/31,2008/08/31,6,5,0.577729921,5665,6,2,3
46719,2014/03/31,2009/12/28,58,4,0.560982173,5834,58,3,1
46720,2014/03/31,2009/08/14,1,6,0.684699728,4779,1,0,6
46721,2014/03/31,2010/08/10,200,4,0.837297851,3908,200,1,3
46722,2014/03/31,2012/11/20,27,11,0.830909091,3938,27,4,7
46723,2014/03/31,2011/11/21,720,3,1.0,3272,720,3,0
46724,2014/03/31,2008/07/12,294,5,0.444780421,7355,294,3,2
46725,2014/03/31,2012/01/13,298,5,0.774236686,4225,298,4,1
46726,2014/03/31,2012/07/24,260,5,0.620557769,5271,260,3,2
46727,2014/03/31,2012/08/20,12,5,0.7350247190000001,4450,12,4,1
46728,2014/03/31,2007/02/24,152,3,0.633359799,5164,152,0,3
46729,2014/03/31,2004/11/03,469,3,0.658200845,4969,469,3,0
46730,2014/03/31,2012/06/01,465,4,0.501995395,6515,465,4,0
46731,2014/03/31,2011/09/21,43,5,0.577081348,5667,43,3,2
46732,2014/03/31,2005/11/01,261,3,0.934842767,3498,261,1,2
46733,2014/03/31,2007/04/18,329,3,0.833333333,3924,329,2,1
46734,2014/03/31,2011/02/21,629,2,1.25,2616,629,2,0
46735,2014/03/31,2013/03/16,23,5,0.502767528,6504,23,2,3
46736,2014/03/31,2012/08/10,349,4,0.910075146,3593,349,3,1
46737,2014/03/31,2012/08/29,75,4,0.819100701,3992,75,1,3
46738,2014/03/31,2006/07/02,593,4,0.693361612,4715,593,4,0
46739,2014/03/31,2008/08/31,21,3,0.5164765370000001,6329,21,0,3
46740,2014/03/31,2010/11/04,220,4,0.591932271,5522,220,2,2
46741,2014/03/31,2012/05/16,681,2,0.6736397359999999,4852,681,2,0
46742,2014/03/31,2011/10/07,36,4,0.47323342,6906,36,1,3
46743,2014/03/31,2011/06/07,139,5,0.398789506,8195,139,4,1
46744,2014/03/31,2012/01/25,470,4,0.6074163570000001,5380,470,4,0
46745,2014/03/31,2012/12/17,427,3,0.685946683,4764,427,3,0
46746,2014/03/31,2006/02/25,658,3,0.7567855490000001,4318,658,3,0
46747,2014/03/31,2009/03/12,319,4,0.705440415,4632,319,1,3
46748,2014/03/31,2013/03/15,370,3,0.55782824,5857,370,3,0
46749,2014/03/31,2010/07/01,124,5,0.6783177570000001,4815,124,0,5
46750,2014/03/31,2010/04/04,12,3,0.508340856,6425,12,1,2
46751,2014/03/31,2012/03/01,72,4,0.508497587,6423,72,2,2
46752,2014/03/31,2007/06/20,127,4,0.6841139509999999,4774,127,0,4
46753,2014/03/31,2011/03/07,242,5,0.478493773,6825,242,4,1
46754,2014/03/31,2011/06/12,34,5,0.634451137,5147,34,3,2
46755,2014/03/31,2011/10/17,314,2,0.75,4354,314,0,2
46756,2014/03/31,2012/05/22,677,2,0.75,4354,677,2,0
46757,2014/03/31,2008/08/23,28,2,0.797231445,4096,28,0,2
46758,2014/03/31,2010/01/06,25,2,0.83,3934,25,0,2
46759,2014/03/31,2006/07/05,62,2,0.83,3934,62,0,2
46760,2014/03/31,2012/09/15,426,2,1.280392157,2550,426,2,0
46761,2014/03/31,2012/01/18,242,3,0.67691893,4823,242,1,2
46762,2014/03/31,2010/04/02,49,6,0.439784425,7422,49,0,6
46763,2014/03/31,2012/12/06,278,2,0.818015038,3990,278,1,1
46764,2014/03/31,2007/05/14,5,4,0.691334463,4721,5,0,4
46765,2014/03/31,2009/12/25,499,4,0.7067453440000001,4618,499,4,0
46766,2014/03/31,2011/12/15,48,2,0.975109053,3347,48,0,2
46767,2014/03/31,2011/08/11,50,7,0.376232419,8674,50,1,6
46768,2014/03/31,2012/12/12,19,4,0.740674081,4406,19,2,2
46769,2014/03/31,2011/11/02,47,5,0.61759084,5284,47,2,3
46770,2014/03/31,2006/04/04,394,5,0.660042476,4944,394,5,0
46771,2014/03/31,2009/03/03,115,5,0.6277549060000001,5198,115,2,3
46772,2014/03/31,2013/02/07,266,2,0.813710723,4010,266,0,2
46773,2014/03/31,2013/01/31,73,5,0.337040595,9681,73,1,4
46774,2014/03/31,2010/02/24,184,4,0.6371118920000001,5121,184,3,1
46775,2014/03/31,2012/05/01,547,2,0.8,4078,547,2,0
46776,2014/03/31,2012/05/01,540,2,0.8,4078,540,2,0
46777,2014/03/31,2012/05/01,553,2,0.8,4078,553,2,0
46778,2014/03/31,2012/05/01,538,2,0.8,4078,538,2,0
46779,2014/03/31,2012/10/17,506,2,0.8,4078,506,2,0
46780,2014/03/31,2012/03/22,49,22,0.805909091,4048,49,11,11
46781,2014/03/31,2012/11/13,60,3,0.679697854,4799,60,2,1
46782,2014/03/31,2011/10/08,699,3,0.952014011,3426,699,3,0
46783,2014/03/31,2009/11/05,230,6,0.667335789,4887,230,3,3
46784,2014/03/31,2007/06/15,171,3,0.825259428,3951,171,2,1
46785,2014/03/31,2010/09/30,87,9,0.661111111,4932,87,4,5
46786,2014/03/31,2005/03/05,611,3,0.562112069,5800,611,3,0
46787,2014/03/31,2007/08/18,505,4,0.597982392,5452,505,4,0
46788,2014/03/31,2012/09/01,157,5,0.551537811,5911,157,3,2
46789,2014/03/31,2008/04/17,64,2,0.822396569,3964,64,0,2
46790,2014/03/31,2012/02/14,87,4,0.5902317579999999,5523,87,3,1
46791,2014/03/31,2013/03/09,363,5,0.7761428570000001,4200,363,4,1
46792,2014/03/31,2013/01/06,35,5,0.561106903,5809,35,1,4
46793,2014/03/31,2009/07/16,307,4,0.5266968329999999,6188,307,2,2
46794,2014/03/31,2012/11/21,28,5,0.676182573,4820,28,3,2
46795,2014/03/31,2011/03/27,149,3,0.664313086,4906,149,0,3
46796,2014/03/31,2012/11/16,112,3,0.71,4590,112,0,3
46797,2014/03/31,2006/03/08,128,3,0.8237664309999999,3956,128,0,3
46798,2014/03/31,2011/10/22,70,3,0.696962567,4675,70,2,1
46799,2014/03/31,2012/10/14,214,4,0.592619134,5498,214,3,1
46800,2014/03/31,2013/01/10,67,2,0.555,5870,67,0,2
46801,2014/03/31,2012/07/26,159,5,0.716,4550,159,1,4
46802,2014/03/31,2011/07/21,30,4,0.67968913,4793,30,1,3
46803,2014/03/31,2012/10/24,156,3,0.83,3924,156,2,1
46804,2014/03/31,2012/08/15,188,6,0.415,7848,188,5,1
46805,2014/03/31,2012/02/18,215,5,0.589117221,5528,215,4,1
46806,2014/03/31,2012/07/02,121,2,0.577690261,5637,121,1,1
46807,2014/03/31,2006/01/05,24,6,0.648665339,5020,24,4,2
46808,2014/03/31,2012/12/04,78,4,0.805182987,4044,78,1,3
46809,2014/03/31,2010/06/17,10,4,0.595212066,5470,10,0,4
46810,2014/03/31,2011/01/05,175,5,0.784714389,4149,175,1,4
46811,2014/03/31,2009/01/02,519,3,0.600913621,5418,519,3,0
46812,2014/03/31,2013/01/07,83,4,0.662780945,4912,83,2,2
46813,2014/03/31,2010/10/22,56,5,0.868383569,3749,56,4,1
46814,2014/03/31,2005/10/16,198,2,0.765651458,4252,198,0,2
46815,2014/03/31,2010/09/11,502,6,0.918307475,3545,502,6,0
46816,2014/03/31,2010/01/16,491,3,0.833333333,3906,491,3,0
46817,2014/03/31,2012/09/17,108,2,0.7822422490000001,4161,108,1,1
46818,2014/03/31,2012/11/03,99,3,0.619037657,5258,99,0,3
46819,2014/03/31,2007/11/01,362,3,0.473548669,6873,362,2,1
46820,2014/03/31,2012/07/28,15,5,0.4351176470000001,7480,15,4,1
46821,2014/03/31,2010/09/01,99,5,0.8690520690000001,3745,99,1,4
46822,2014/03/31,2010/01/31,427,2,1.402197329,2321,427,2,0
46823,2014/03/31,2010/02/20,72,4,0.692705407,4698,72,1,3
46824,2014/03/31,2009/09/11,623,2,0.8059187720000001,4038,623,2,0
46825,2014/03/31,2012/05/22,35,5,0.606,5370,35,1,4
46826,2014/03/31,2013/03/05,182,4,0.711997812,4570,182,0,4
46827,2014/03/31,2008/10/01,171,5,0.399819366,8138,171,2,3
46828,2014/03/31,2009/10/09,88,4,0.5517381720000001,5897,88,2,2
46829,2014/03/31,2008/05/17,137,4,0.6325,5144,137,0,4
46830,2014/03/31,2012/04/01,664,2,0.886750273,3668,664,2,0
46831,2014/03/31,2007/01/09,73,5,0.591463903,5499,73,1,4
46832,2014/03/31,2008/11/19,12,5,0.343398796,9471,12,0,5
46833,2014/03/31,2005/08/18,391,2,0.6,5420,391,2,0
46834,2014/03/31,2009/12/17,683,2,0.6,5420,683,2,0
46835,2014/03/31,2012/09/25,552,2,0.6,5420,552,2,0
46836,2014/03/31,2008/11/04,35,4,0.604301115,5380,35,2,2
46837,2014/03/31,2011/06/28,564,3,0.940167727,3458,564,3,0
46838,2014/03/31,2006/03/23,48,8,0.249652127,13022,48,5,3
46839,2014/03/31,2012/08/07,600,2,0.7,4644,600,2,0
46840,2014/03/31,2012/08/26,580,2,0.7,4644,580,2,0
46841,2014/03/31,2012/10/09,536,2,0.7,4644,536,2,0
46842,2014/03/31,2012/04/09,563,4,0.85362395,3808,563,4,0
46843,2014/03/31,2007/11/01,14,5,0.6403684000000001,5076,14,2,3
46844,2014/03/31,2012/11/02,17,6,0.58053581,5599,17,4,2
46845,2014/03/31,2013/01/14,6,10,0.415146251,7829,6,0,10
46846,2014/03/31,2008/03/26,363,4,0.624740484,5202,363,3,1
46847,2014/03/31,2011/10/16,395,3,0.611382879,5315,395,3,0
46848,2014/03/31,2007/01/02,5,7,0.413163784,7864,5,4,3
46849,2014/03/31,2012/07/14,587,2,0.917278374,3542,587,2,0
46850,2014/03/31,2012/01/20,657,3,0.6712603309999999,4840,657,3,0
46851,2014/03/31,2012/02/07,170,5,0.735316885,4418,170,2,3
46852,2014/03/31,2008/11/08,537,3,0.849973836,3822,537,3,0
46853,2014/03/31,2008/07/11,317,2,0.6386747939999999,5086,317,1,1
46854,2014/03/31,2009/10/12,497,4,0.74964228,4333,497,4,0
46855,2014/03/31,2011/12/05,311,4,0.501451513,6476,311,1,3
46856,2014/03/31,2012/08/28,153,3,0.587017354,5532,153,0,3
46857,2014/03/31,2012/10/30,35,4,0.59,5504,35,0,4
46858,2014/03/31,2008/11/26,77,5,0.670066034,4846,77,4,1
46859,2014/03/31,2010/09/13,114,7,0.5446971979999999,5961,114,3,4
46860,2014/03/31,2008/03/21,309,6,0.484083793,6707,309,5,1
46861,2014/03/31,2011/08/23,535,3,0.8487843140000001,3825,535,3,0
46862,2014/03/31,2011/12/23,257,4,0.6841622759999999,4745,257,3,1
46863,2014/03/31,2011/08/31,393,2,0.67496361,4809,393,2,0
46864,2014/03/31,2008/02/21,192,3,0.696666667,4659,192,2,1
46865,2014/03/31,2005/08/02,556,3,0.55,5901,556,3,0
46866,2014/03/31,2009/08/18,568,4,0.725044683,4476,568,4,0
46867,2014/03/31,2009/10/21,318,2,0.575,5644,318,0,2
46868,2014/03/31,2012/07/01,508,6,0.833333333,3894,508,6,0
46869,2014/03/31,2007/11/20,104,3,0.7261132240000001,4469,104,2,1
46870,2014/03/31,2013/03/07,122,2,0.712710301,4553,122,1,1
46871,2014/03/31,2006/06/08,106,7,0.686742857,4725,106,4,3
46872,2014/03/31,2013/03/23,187,2,0.71,4570,187,1,1
46873,2014/03/31,2010/12/29,240,3,0.620876387,5226,240,0,3
46874,2014/03/31,2006/01/25,20,4,0.849819277,3818,20,3,1
46875,2014/03/31,2013/01/24,124,2,0.790401949,4105,124,1,1
46876,2014/03/31,2012/09/01,158,5,0.668662407,4852,158,3,2
46877,2014/03/31,2013/03/11,318,3,0.6768829540000001,4793,318,2,1
46878,2014/03/31,2007/01/21,8,3,0.477506623,6794,8,2,1
46879,2014/03/31,2012/09/17,506,4,1.0,3244,506,4,0
46880,2014/03/31,2008/06/03,63,5,0.6597498470000001,4917,63,2,3
46881,2014/03/31,2010/11/28,254,5,0.63283652,5126,254,3,2
46882,2014/03/31,2012/07/25,9,5,0.604864814,5363,9,0,5
46883,2014/03/31,2006/08/15,27,2,0.5760735220000001,5631,27,0,2
46884,2014/03/31,2010/10/29,599,3,0.67089969,4835,599,3,0
46885,2014/03/31,2008/03/25,273,2,0.52,6238,273,0,2
46886,2014/03/31,2013/02/27,36,5,0.624773647,5191,36,1,4
46887,2014/03/31,2005/01/05,3,4,0.916832579,3536,3,0,4
46888,2014/03/31,2010/08/01,294,3,0.883537749,3669,294,2,1
46889,2014/03/31,2010/06/17,33,6,0.514301126,6303,33,2,4
46890,2014/03/31,2008/01/12,40,2,0.713070832,4546,40,0,2
46891,2014/03/31,2009/09/18,270,3,0.990709046,3272,270,2,1
46892,2014/03/31,2013/03/07,233,8,0.8925,3632,233,0,8
46893,2014/03/31,2007/09/11,302,3,0.6874846240000001,4715,302,2,1
46894,2014/03/31,2012/07/24,482,3,0.8779523290000001,3692,482,3,0
46895,2014/03/31,2010/05/01,88,5,0.755714619,4289,88,3,2
46896,2014/03/31,2008/07/02,109,3,0.47931677,6762,109,2,1
46897,2014/03/31,2011/11/05,520,4,0.60955426,5317,520,4,0
46898,2014/03/31,2010/08/02,84,5,0.645206052,5023,84,1,4
46899,2014/03/31,2012/05/01,695,2,0.921034679,3518,695,2,0
46900,2014/03/31,2012/05/01,695,2,0.921034679,3518,695,2,0
46901,2014/03/31,2005/08/04,13,5,0.63433242,5108,13,1,4
46902,2014/03/31,2012/08/03,32,2,0.78,4154,32,0,2
46903,2014/03/31,2007/10/11,382,7,0.597528587,5422,382,7,0
46904,2014/03/31,2012/01/09,249,2,0.91,3560,249,0,2
46905,2014/03/31,2010/12/20,180,3,0.8647811,3746,180,0,3
46906,2014/03/31,2006/09/19,189,3,0.3,10798,189,0,3
46907,2014/03/31,2008/05/27,6,2,1.12,2892,6,0,2
46908,2014/03/31,2010/10/25,204,3,0.613553703,5279,204,2,1
46909,2014/03/31,2013/01/01,112,4,0.427553795,7575,112,2,2
46910,2014/03/31,2008/11/16,377,4,0.69660142,4649,377,4,0
46911,2014/03/31,2011/07/06,36,6,0.451666667,7170,36,0,6
46912,2014/03/31,2012/11/08,262,4,0.7052559359999999,4591,262,1,3
46913,2014/03/31,2012/11/20,328,5,0.73,4435,328,3,2
46914,2014/03/31,2011/06/07,434,5,0.6867840479999999,4714,434,5,0
46915,2014/03/31,2007/05/25,92,5,0.792916973,4083,92,2,3
46916,2014/03/31,2011/07/12,214,4,0.5119228339999999,6324,214,2,2
46917,2014/03/31,2006/12/21,255,3,0.8031059290000001,4031,255,2,1
46918,2014/03/31,2012/09/27,412,3,0.8270567190000001,3914,412,3,0
46919,2014/03/31,2012/04/15,172,2,0.435,7440,172,0,2
46920,2014/03/31,2007/06/07,81,2,0.632478014,5117,81,1,1
46921,2014/03/31,2008/12/03,562,3,0.847120419,3820,562,3,0
46922,2014/03/31,2009/09/29,452,5,0.871270867,3714,452,5,0
46923,2014/03/31,2008/09/28,230,4,0.832645394,3886,230,1,3
46924,2014/03/31,2012/11/21,35,5,0.6156088279999999,5256,35,0,5
46925,2014/03/31,2008/05/02,86,4,0.507186079,6379,86,1,3
46926,2014/03/31,2008/07/18,151,3,0.519893942,6223,151,0,3
46927,2014/03/31,2007/09/06,126,5,0.748094357,4324,126,0,5
46928,2014/03/31,2012/05/27,672,2,0.75,4313,672,2,0
46929,2014/03/31,2011/11/15,619,2,0.75,4313,619,2,0
46930,2014/03/31,2010/10/01,562,2,0.886191781,3650,562,2,0
46931,2014/03/31,2013/02/12,93,4,0.5008609479999999,6458,93,0,4
46932,2014/03/31,2011/07/04,70,4,0.767357058,4215,70,1,3
46933,2014/03/31,2010/05/11,67,2,0.764082211,4233,67,0,2
46934,2014/03/31,2013/02/07,417,2,0.80004948,4042,417,2,0
46935,2014/03/31,2012/12/08,114,5,0.6658546129999999,4856,114,3,2
46936,2014/03/31,2012/06/12,140,3,0.757859822,4266,140,0,3
46937,2014/03/31,2008/12/22,485,5,0.475971731,6792,485,5,0
46938,2014/03/31,2008/12/17,471,9,0.78331718,4127,471,9,0
46939,2014/03/31,2012/01/17,141,3,0.8267212279999999,3910,141,2,1
46940,2014/03/31,2012/11/17,464,3,0.601824614,5371,464,3,0
46941,2014/03/31,2012/06/13,222,4,0.522341629,6188,222,3,1
46942,2014/03/31,2011/03/27,74,2,0.833439917,3878,74,0,2
46943,2014/03/31,2008/09/14,127,2,0.605,5342,127,0,2
46944,2014/03/31,2010/09/14,6,2,0.605,5342,6,0,2
46945,2014/03/31,2012/02/10,146,6,0.451248255,7162,146,2,4
46946,2014/03/31,2006/09/17,23,4,0.7280175720000001,4439,23,0,4
46947,2014/03/31,2006/01/12,532,3,0.796745562,4056,532,3,0
46948,2014/03/31,2010/09/15,221,5,0.683638671,4727,221,0,5
46949,2014/03/31,2004/11/20,213,8,0.567364355,5695,213,1,7
46950,2014/03/31,2011/07/09,164,2,0.77,4196,164,0,2
46951,2014/03/31,2010/07/29,52,7,0.798125,4048,52,2,5
46952,2014/03/31,2011/01/13,345,4,0.540883978,5973,345,3,1
46953,2014/03/31,2012/09/21,67,6,0.7675504870000001,4209,67,0,6
46954,2014/03/31,2012/04/09,692,2,0.55,5873,692,2,0
46955,2014/03/31,2011/04/11,302,3,0.8212712940000001,3933,302,0,3
46956,2014/03/31,2012/07/06,196,5,0.521883988,6189,196,1,4
46957,2014/03/31,2011/02/03,214,4,0.615881007,5244,214,2,2
46958,2014/03/31,2012/11/23,212,6,0.435619099,7414,212,0,6
46959,2014/03/31,2011/11/17,4,4,0.698307027,4625,4,0,4
46960,2014/03/31,2009/10/01,121,6,0.5716194689999999,5650,121,3,3
46961,2014/03/31,2007/01/11,18,3,0.95,3399,18,1,2
46962,2014/03/31,2011/05/18,621,4,1.0,3229,621,4,0
46963,2014/03/31,2007/09/01,174,3,0.67,4819,174,0,3
46964,2014/03/31,2009/09/01,201,6,0.7281529090000001,4434,201,4,2
46965,2014/03/31,2007/10/18,529,2,0.55,5870,529,2,0
46966,2014/03/31,2007/10/24,32,5,0.8081151440000001,3995,32,3,2
46967,2014/03/31,2007/07/22,94,3,0.554024369,5827,94,2,1
46968,2014/03/31,2011/02/25,123,4,0.865,3732,123,0,4
46969,2014/03/31,2005/11/15,61,3,0.679566316,4750,61,0,3
46970,2014/03/31,2012/07/10,141,9,0.554023344,5826,141,7,2
46971,2014/03/31,2012/01/05,72,4,0.760879302,4242,72,1,3
46972,2014/03/31,2012/10/20,396,4,0.725770182,4447,396,4,0
46973,2014/03/31,2010/02/09,116,4,0.6910877940000001,4670,116,3,1
46974,2014/03/31,2011/06/24,209,4,0.560938641,5753,209,2,2
46975,2014/03/31,2012/12/08,115,4,0.7758547729999999,4159,115,3,1
46976,2014/03/31,2013/03/14,94,5,0.600437291,5374,94,0,5
46977,2014/03/31,2007/06/10,195,3,0.866840408,3722,195,0,3
46978,2014/03/31,2005/07/14,519,4,0.625,5162,519,4,0
46979,2014/03/31,2009/03/18,30,7,0.71782154,4494,30,3,4
46980,2014/03/31,2009/02/04,66,2,0.82,3934,66,0,2
46981,2014/03/31,2008/12/06,665,4,0.650352823,4960,665,4,0
46982,2014/03/31,2010/07/13,501,3,0.866424926,3723,501,3,0
46983,2014/03/31,2010/04/26,434,4,0.448838018,7186,434,4,0
46984,2014/03/31,2013/02/02,132,8,0.406177582,7940,132,2,6
46985,2014/03/31,2010/10/22,611,2,0.75,4300,611,2,0
46986,2014/03/31,2011/10/21,628,3,1.0,3225,628,3,0
46987,2014/03/31,2011/09/02,145,2,0.874689449,3687,145,1,1
46988,2014/03/31,2009/08/01,2,3,0.793333333,4065,2,2,1
46989,2014/03/31,2013/01/23,13,2,0.821740571,3924,13,1,1
46990,2014/03/31,2012/06/05,207,6,0.7864649909999999,4099,207,5,1
46991,2014/03/31,2011/04/13,13,4,0.661779922,4871,13,0,4
46992,2014/03/31,2009/03/26,340,4,0.971226273,3319,340,1,3
46993,2014/03/31,2008/03/30,75,3,0.58543044,5506,75,0,3
46994,2014/03/31,2012/05/04,58,4,0.551720301,5842,58,2,2
46995,2014/03/31,2010/04/06,336,4,0.705505692,4568,336,3,1
46996,2014/03/31,2011/03/17,84,4,0.584253082,5516,84,3,1
46997,2014/03/31,2011/08/10,339,3,0.763240171,4222,339,2,1
46998,2014/03/31,2012/08/21,133,3,0.5033333329999999,6402,133,1,2
46999,2014/03/31,2008/06/30,199,3,0.77560183,4154,199,2,1
47000,2014/03/31,2007/11/10,166,5,0.665665289,4840,166,0,5
47001,2014/03/31,2009/01/25,126,3,1.000149022,3221,126,0,3
47002,2014/03/31,2011/11/30,225,2,0.835,3858,225,0,2
47003,2014/03/31,2012/12/01,184,3,0.750694477,4291,184,1,2
47004,2014/03/31,2012/11/04,306,6,0.613056719,5254,306,3,3
47005,2014/03/31,2009/08/21,459,4,0.420702717,7656,459,4,0
47006,2014/03/31,2007/02/26,203,3,0.983150183,3276,203,1,2
47007,2014/03/31,2012/03/07,700,2,0.825,3904,700,2,0
47008,2014/03/31,2007/04/22,168,3,0.743833718,4330,168,0,3
47009,2014/03/31,2005/05/18,58,3,0.825208814,3903,58,2,1
47010,2014/03/31,2009/08/24,101,3,0.777356988,4143,101,1,2
47011,2014/03/31,2012/02/20,2,4,0.907876481,3546,2,2,2
47012,2014/03/31,2011/12/10,91,10,0.556,5790,91,2,8
47013,2014/03/31,2007/12/12,175,6,0.506858762,6351,175,4,2
47014,2014/03/31,2010/03/28,616,6,0.843553459,3816,616,6,0
47015,2014/03/31,2012/03/12,488,4,0.8625,3732,488,4,0
47016,2014/03/31,2011/10/19,445,4,0.8625,3732,445,4,0
47017,2014/03/31,2012/10/10,111,2,0.699558792,4601,111,0,2
47018,2014/03/31,2010/07/13,516,3,0.7585670520000001,4243,516,3,0
47019,2014/03/31,2012/03/11,70,2,1.228385496,2620,70,0,2
47020,2014/03/31,2009/11/04,163,2,0.883919253,3641,163,0,2
47021,2014/03/31,2011/11/05,86,4,0.702836864,4579,86,2,2
47022,2014/03/31,2009/07/09,187,5,0.741010822,4343,187,2,3
47023,2014/03/31,2010/05/29,512,2,0.958593983,3357,512,2,0
47024,2014/03/31,2012/03/16,377,5,0.732494878,4393,377,5,0
47025,2014/03/31,2013/01/01,356,3,0.438751023,7334,356,0,3
47026,2014/03/31,2013/03/23,109,3,0.902617845,3564,109,0,3
47027,2014/03/31,2008/03/13,10,3,0.5915171020000001,5438,10,2,1
47028,2014/03/31,2012/07/21,104,4,0.6052314639999999,5314,104,0,4
47029,2014/03/31,2010/03/23,36,4,0.7505694279999999,4285,36,2,2
47030,2014/03/31,2013/03/15,34,4,0.760773598,4227,34,1,3
47031,2014/03/31,2008/10/28,501,3,0.646061885,4977,501,3,0
47032,2014/03/31,2012/04/20,117,4,0.755481673,4256,117,0,4
47033,2014/03/31,2009/03/12,223,3,0.623818393,5154,223,0,3
47034,2014/03/31,2011/11/30,6,8,0.64843687,4958,6,0,8
47035,2014/03/31,2008/04/25,223,3,0.857766809,3748,223,0,3
47036,2014/03/31,2011/11/22,60,5,0.966596512,3326,60,4,1
47037,2014/03/31,2013/03/24,221,3,0.8313421259999999,3867,221,1,2
47038,2014/03/31,2006/07/03,37,3,1.1272019640000002,2852,37,0,3
47039,2014/03/31,2012/12/26,451,2,0.8,4018,451,2,0
47040,2014/03/31,2009/08/20,74,5,0.6920000000000001,4645,74,1,4
47041,2014/03/31,2006/08/14,156,3,0.797617275,4029,156,2,1
47042,2014/03/31,2007/03/01,501,4,0.8335667959999999,3855,501,4,0
47043,2014/03/31,2009/02/18,224,4,0.54869877,5856,224,2,2
47044,2014/03/31,2012/10/24,521,2,1.05,3060,521,2,0
47045,2014/03/31,2012/09/06,550,3,0.923275862,3480,550,3,0
47046,2014/03/31,2010/12/06,292,3,0.933457292,3442,292,1,2
47047,2014/03/31,2013/03/13,7,5,0.376921633,8524,7,0,5
47048,2014/03/31,2007/11/05,68,2,0.7694970059999999,4175,68,0,2
47049,2014/03/31,2011/02/02,637,3,0.8163405340000001,3935,637,3,0
47050,2014/03/31,2008/12/27,491,3,0.796182449,4034,491,3,0
47051,2014/03/31,2012/04/16,397,4,0.613087056,5238,397,4,0
47052,2014/03/31,2007/06/28,314,2,0.65,4940,314,0,2
47053,2014/03/31,2012/07/10,133,3,1.146666667,2799,133,2,1
47054,2014/03/31,2011/08/22,241,4,0.825695909,3887,241,3,1
47055,2014/03/31,2012/12/15,11,5,0.622587779,5155,11,2,3
47056,2014/03/31,2012/09/04,566,3,0.866936791,3702,566,3,0
47057,2014/03/31,2012/09/04,566,3,0.866936791,3702,566,3,0
47058,2014/03/31,2008/09/30,85,3,0.666789944,4813,85,2,1
47059,2014/03/31,2008/08/28,304,4,0.466589125,6878,304,2,2
47060,2014/03/31,2009/08/29,124,2,0.707313203,4537,124,0,2
47061,2014/03/31,2009/10/23,139,7,0.491881036,6523,139,5,2
47062,2014/03/31,2010/09/08,252,6,0.750858881,4273,252,5,1
47063,2014/03/31,2011/10/13,310,6,0.5090844179999999,6302,310,2,4
47064,2014/03/31,2012/09/05,45,7,0.357025042,8985,45,4,3
47065,2014/03/31,2007/12/14,125,3,0.768306587,4175,125,1,2
47066,2014/03/31,2012/08/11,249,5,0.739009217,4340,249,0,5
47067,2014/03/31,2010/03/09,195,3,0.722885482,4436,195,2,1
47068,2014/03/31,2010/03/16,14,3,1.277525896,2510,14,1,2
47069,2014/03/31,2012/10/17,107,6,0.43656501,7345,107,1,5
47070,2014/03/31,2012/08/16,53,2,1.14315508,2805,53,0,2
47071,2014/03/31,2010/12/07,666,2,0.6,5344,666,2,0
47072,2014/03/31,2011/08/31,390,4,0.592570689,5411,390,4,0
47073,2014/03/31,2009/08/06,76,5,0.8772120379999999,3655,76,4,1
47074,2014/03/31,2008/12/05,72,2,0.815,3934,72,0,2
47075,2014/03/31,2011/07/12,98,3,0.543333333,5901,98,2,1
47076,2014/03/31,2008/07/11,9,3,0.5953611879999999,5385,9,1,2
47077,2014/03/31,2012/06/05,596,2,0.6,5342,596,2,0
47078,2014/03/31,2006/05/23,354,4,0.3,10684,354,2,2
47079,2014/03/31,2006/01/22,712,2,0.6,5342,712,2,0
47080,2014/03/31,2008/12/02,471,4,0.711634103,4504,471,4,0
47081,2014/03/31,2013/01/19,310,4,0.8625,3716,310,3,1
47082,2014/03/31,2010/01/02,560,2,0.6290480860000001,5095,560,2,0
47083,2014/03/31,2007/12/26,595,3,0.7,4578,595,3,0
47084,2014/03/31,2011/08/01,56,4,0.8175,3920,56,3,1
47085,2014/03/31,2013/03/28,102,2,0.792415925,4044,102,1,1
47086,2014/03/31,2011/08/07,259,8,0.334149546,9589,259,7,1
47087,2014/03/31,2011/09/04,325,3,0.6,5340,325,1,2
47088,2014/03/31,2013/03/05,366,2,0.9,3560,366,1,1
47089,2014/03/31,2007/08/28,160,7,0.857791165,3735,160,2,5
47090,2014/03/31,2006/11/08,333,5,0.5860252420000001,5467,333,3,2
47091,2014/03/31,2010/05/24,276,3,0.703807118,4552,276,1,2
47092,2014/03/31,2012/07/27,159,5,0.951776589,3366,159,2,3
47093,2014/03/31,2013/01/07,21,3,0.647723413,4946,21,2,1
47094,2014/03/31,2008/01/14,506,3,0.9006466120000001,3557,506,3,0
47095,2014/03/31,2010/02/26,622,5,0.606341094,5283,622,5,0
47096,2014/03/31,2011/07/31,338,4,0.552215517,5800,338,2,2
47097,2014/03/31,2008/05/27,71,3,0.754805562,4243,71,0,3
47098,2014/03/31,2006/06/10,191,4,0.67,4780,191,2,2
47099,2014/03/31,2010/07/05,147,3,0.910053993,3519,147,0,3
47100,2014/03/31,2009/12/09,117,4,0.492308993,6505,117,0,4
47101,2014/03/31,2012/06/28,111,5,0.949931771,3371,111,2,3
47102,2014/03/31,2013/02/13,406,2,0.675,4744,406,2,0
47103,2014/03/31,2011/01/12,430,4,0.782156815,4094,430,4,0
47104,2014/03/31,2012/08/21,38,4,0.646436503,4953,38,1,3
47105,2014/03/31,2010/01/29,543,3,0.466530672,6863,543,3,0
47106,2014/03/31,2009/12/12,682,2,0.7,4574,682,2,0
47107,2014/03/31,2008/11/17,307,4,0.597183361,5361,307,3,1
47108,2014/03/31,2012/02/27,57,2,0.7744242859999999,4134,57,1,1
47109,2014/03/31,2012/07/05,2,4,0.6557066779999999,4882,2,1,3
47110,2014/03/31,2006/10/31,469,2,0.75,4268,469,2,0
47111,2014/03/31,2005/01/07,581,2,0.75,4268,581,2,0
47112,2014/03/31,2007/12/18,518,2,0.75,4268,518,2,0
47113,2014/03/31,2010/09/15,488,2,0.75,4268,488,2,0
47114,2014/03/31,2010/11/11,710,2,0.75,4268,710,2,0
47115,2014/03/31,2006/05/23,427,2,0.75,4268,427,2,0
47116,2014/03/31,2009/03/07,676,2,0.75,4268,676,2,0
47117,2014/03/31,2009/02/10,673,2,0.75,4268,673,2,0
47118,2014/03/31,2012/10/18,529,2,0.75,4268,529,2,0
47119,2014/03/31,2006/01/05,589,2,0.75,4268,589,2,0
47120,2014/03/31,2013/01/03,449,2,0.75,4268,449,2,0
47121,2014/03/31,2010/09/25,457,2,0.75,4268,457,2,0
47122,2014/03/31,2010/10/25,240,2,0.75,4268,240,0,2
47123,2014/03/31,2010/11/01,399,2,0.75,4268,399,2,0
47124,2014/03/31,2012/08/31,578,2,0.75,4268,578,2,0
47125,2014/03/31,2006/12/15,583,4,0.671209897,4769,583,4,0
47126,2014/03/31,2008/11/07,390,2,0.75,4268,390,2,0
47127,2014/03/31,2011/05/18,647,2,0.75,4268,647,2,0
47128,2014/03/31,2012/06/09,660,2,0.75,4268,660,2,0
47129,2014/03/31,2012/11/11,497,2,0.75,4268,497,2,0
47130,2014/03/31,2012/12/23,463,2,0.75,4268,463,2,0
47131,2014/03/31,2012/05/29,593,3,0.629003734,5089,593,3,0
47132,2014/03/31,2013/02/08,177,5,0.49913613,6413,177,0,5
47133,2014/03/31,2008/10/25,180,6,0.553547829,5781,180,4,2
47134,2014/03/31,2009/09/10,50,2,1.436216338,2228,50,1,1
47135,2014/03/31,2009/07/12,112,5,0.809855733,3951,112,1,4
47136,2014/03/31,2012/01/24,419,3,0.431969758,7407,419,3,0
47137,2014/03/31,2012/11/09,437,2,0.684113748,4677,437,2,0
47138,2014/03/31,2011/06/10,11,3,0.442103081,7237,11,0,3
47139,2014/03/31,2008/06/08,453,3,0.50792983,6299,453,3,0
47140,2014/03/31,2012/11/22,359,3,0.716241325,4467,359,1,2
47141,2014/03/31,2012/03/18,275,5,0.872716858,3666,275,2,3
47142,2014/03/31,2013/03/19,125,2,0.7,4570,125,0,2
47143,2014/03/31,2012/04/30,545,2,0.7,4570,545,2,0
47144,2014/03/31,2011/01/09,604,3,0.466666667,6855,604,3,0
47145,2014/03/31,2010/04/18,632,4,0.836069002,3826,632,4,0
47146,2014/03/31,2012/12/03,370,2,0.726789366,4401,370,2,0
47147,2014/03/31,2010/10/10,35,2,0.77,4154,35,0,2
47148,2014/03/31,2010/12/20,236,2,0.77,4154,236,0,2
47149,2014/03/31,2006/09/01,154,2,0.77,4154,154,0,2
47150,2014/03/31,2010/06/24,266,2,0.77,4154,266,0,2
47151,2014/03/31,2008/05/13,26,3,0.5096780879999999,6275,26,0,3
47152,2014/03/31,2009/10/30,6,5,0.705960265,4530,6,2,3
47153,2014/03/31,2011/01/24,137,4,0.469594714,6810,137,1,3
47154,2014/03/31,2012/09/19,395,2,0.85,3762,395,2,0
47155,2014/03/31,2005/09/04,518,2,0.85,3762,518,2,0
47156,2014/03/31,2011/08/10,298,5,0.4505608,7097,298,3,2
47157,2014/03/31,2012/06/30,411,4,0.97542709,3278,411,4,0
47158,2014/03/31,2009/10/15,47,3,0.800911824,3992,47,1,2
47159,2014/03/31,2010/04/29,550,2,1.0,3197,550,2,0
47160,2014/03/31,2013/03/24,110,5,0.790984905,4041,110,0,5
47161,2014/03/31,2012/10/27,217,4,0.6335698710000001,5045,217,1,3
47162,2014/03/31,2013/03/01,20,6,0.92,3474,20,1,5
47163,2014/03/31,2011/01/19,659,2,0.665652989,4801,659,2,0
47164,2014/03/31,2008/02/14,243,4,0.566687356,5639,243,3,1
47165,2014/03/31,2012/12/08,18,5,0.611346853,5227,18,0,5
47166,2014/03/31,2012/04/04,721,2,0.920628061,3471,721,2,0
47167,2014/03/31,2011/06/14,168,4,0.476638317,6702,168,0,4
47168,2014/03/31,2012/08/10,597,4,0.906942078,3522,597,4,0
47169,2014/03/31,2013/01/01,23,4,0.63126087,5060,23,0,4
47170,2014/03/31,2011/07/14,339,4,0.589987068,5413,339,3,1
47171,2014/03/31,2013/01/23,13,4,0.623014046,5126,13,2,2
47172,2014/03/31,2012/05/15,662,3,0.8468575970000001,3771,662,3,0
47173,2014/03/31,2012/09/04,127,4,0.923978588,3456,127,0,4
47174,2014/03/31,2012/09/26,34,5,0.464609341,6873,34,0,5
47175,2014/03/31,2010/11/09,12,2,1.104045643,2892,12,1,1
47176,2014/03/31,2013/01/31,113,6,0.550765913,5797,113,3,3
47177,2014/03/31,2008/09/03,565,3,0.7330884040000001,4355,565,3,0
47178,2014/03/31,2010/03/15,283,3,0.8686965990000001,3675,283,2,1
47179,2014/03/31,2013/02/18,27,3,0.667280518,4784,27,0,3
47180,2014/03/31,2012/04/05,725,2,0.75,4256,725,2,0
47181,2014/03/31,2011/03/30,390,3,0.916657094,3482,390,3,0
47182,2014/03/31,2011/11/27,168,3,0.786525382,4058,168,2,1
47183,2014/03/31,2010/09/08,3,4,0.747244205,4271,3,3,1
47184,2014/03/31,2011/07/01,8,7,0.425678271,7497,8,2,5
47185,2014/03/31,2008/04/18,350,3,0.7773934229999999,4105,350,1,2
47186,2014/03/31,2007/12/17,382,4,0.6684541270000001,4774,382,4,0
47187,2014/03/31,2005/05/29,5,6,0.5331328320000001,5985,5,4,2
47188,2014/03/31,2011/01/01,500,3,0.817606356,3902,500,3,0
47189,2014/03/31,2009/05/09,110,7,0.584496152,5458,110,6,1
47190,2014/03/31,2007/05/20,149,6,0.749666275,4255,149,3,3
47191,2014/03/31,2011/09/09,36,7,0.848571429,3759,36,4,3
47192,2014/03/31,2010/07/26,622,4,0.5073655739999999,6286,622,4,0
47193,2014/03/31,2008/08/11,154,2,0.845,3774,154,0,2
47194,2014/03/31,2011/12/05,70,2,0.76,4196,70,1,1
47195,2014/03/31,2009/10/21,184,2,0.76,4196,184,0,2
47196,2014/03/31,2009/03/13,14,6,0.473137982,6740,14,2,4
47197,2014/03/31,2013/02/10,54,3,0.6828394,4670,54,1,2
47198,2014/03/31,2013/01/13,51,3,0.640321285,4980,51,0,3
47199,2014/03/31,2012/12/26,227,3,0.7114413209999999,4482,227,0,3
47200,2014/03/31,2008/10/05,87,2,0.78,4088,87,0,2
47201,2014/03/31,2010/04/09,139,4,0.7175,4444,139,0,4
47202,2014/03/31,2012/05/29,517,4,0.413875909,7704,517,4,0
47203,2014/03/31,2011/04/14,44,4,0.64180153,4968,44,1,3
47204,2014/03/31,2006/05/04,24,6,0.360633484,8840,24,0,6
47205,2014/03/31,2010/07/15,140,3,0.693797606,4595,140,2,1
47206,2014/03/31,2011/09/14,201,5,0.816536885,3904,201,0,5
47207,2014/03/31,2009/12/24,49,2,0.767416326,4153,49,0,2
47208,2014/03/31,2011/08/14,76,3,0.598621337,5324,76,0,3
47209,2014/03/31,2007/09/30,109,2,0.7371963909999999,4323,109,1,1
47210,2014/03/31,2010/02/22,467,5,0.769944431,4139,467,5,0
47211,2014/03/31,2008/07/26,291,2,0.81,3934,291,0,2
47212,2014/03/31,2013/01/01,112,3,0.74818502,4259,112,0,3
47213,2014/03/31,2008/12/16,97,3,0.8449085120000001,3771,97,2,1
47214,2014/03/31,2012/08/22,504,5,0.63715,5000,504,5,0
47215,2014/03/31,2011/05/02,199,6,0.6362053129999999,5007,199,3,3
47216,2014/03/31,2012/08/06,485,4,0.76260474,4177,485,4,0
47217,2014/03/31,2006/10/13,492,5,0.7428521459999999,4288,492,5,0
47218,2014/03/31,2011/11/18,551,5,0.7,4550,551,5,0
47219,2014/03/31,2012/05/25,290,3,0.67848104,4694,290,2,1
47220,2014/03/31,2008/04/06,80,6,0.916666667,3474,80,2,4
47221,2014/03/31,2011/10/17,345,6,0.916666667,3474,345,4,2
47222,2014/03/31,2012/08/19,576,4,0.640623742,4970,576,4,0
47223,2014/03/31,2006/12/03,76,5,0.815473873,3904,76,2,3
47224,2014/03/31,2011/11/30,159,3,0.440622837,7225,159,1,2
47225,2014/03/31,2013/03/17,56,2,0.903582174,3523,56,0,2
47226,2014/03/31,2012/10/16,356,2,1.0,3183,356,1,1
47227,2014/03/31,2010/06/29,536,2,0.595268375,5347,536,2,0
47228,2014/03/31,2013/01/04,402,2,0.8,3978,402,2,0
47229,2014/03/31,2012/07/21,585,2,0.8,3978,585,2,0
47230,2014/03/31,2012/04/04,681,4,0.544262015,5847,681,4,0
47231,2014/03/31,2009/03/31,161,6,0.487887151,6522,161,3,3
47232,2014/03/31,2012/05/08,691,2,0.925,3440,691,2,0
47233,2014/03/31,2011/02/11,332,2,1.0,3182,332,0,2
47234,2014/03/31,2013/03/27,177,4,0.7724666179999999,4119,177,1,3
47235,2014/03/31,2012/12/11,47,4,0.862689805,3688,47,0,4
47236,2014/03/31,2012/02/01,82,4,0.721603538,4409,82,1,3
47237,2014/03/31,2009/11/24,118,3,0.60401367,5267,118,2,1
47238,2014/03/31,2012/03/10,13,5,0.91282066,3485,13,0,5
47239,2014/03/31,2011/01/04,47,9,0.50629099,6282,47,2,7
47240,2014/03/31,2012/03/23,548,3,0.800931755,3971,548,3,0
47241,2014/03/31,2013/02/02,213,3,0.31363313600000003,10140,213,1,2
47242,2014/03/31,2012/05/17,85,3,0.676758885,4699,85,1,2
47243,2014/03/31,2011/03/12,671,4,0.8,3975,671,4,0
47244,2014/03/31,2006/08/17,27,3,0.831692388,3823,27,1,2
47245,2014/03/31,2012/05/29,130,5,0.53115269,5986,130,0,5
47246,2014/03/31,2011/04/18,366,2,0.942882562,3372,366,1,1
47247,2014/03/31,2010/07/24,197,2,0.775463415,4100,197,1,1
47248,2014/03/31,2009/10/20,91,4,0.8518997859999999,3732,91,0,4
47249,2014/03/31,2010/07/16,245,4,0.98,3244,245,3,1
47250,2014/03/31,2012/01/09,606,4,0.8476799999999999,3750,606,4,0
47251,2014/03/31,2011/10/11,10,10,0.569795626,5578,10,4,6
47252,2014/03/31,2011/05/31,23,3,0.699874477,4541,23,0,3
47253,2014/03/31,2006/05/09,114,3,0.68937744,4610,114,1,2
47254,2014/03/31,2013/02/16,393,3,1.0,3178,393,3,0
47255,2014/03/31,2011/09/08,46,5,0.548400345,5795,46,2,3
47256,2014/03/31,2009/08/18,88,2,0.765,4154,88,0,2
47257,2014/03/31,2012/03/07,347,3,0.8875698320000001,3580,347,2,1
47258,2014/03/31,2012/11/02,230,4,0.703049347,4519,230,2,2
47259,2014/03/31,2005/08/26,16,2,1.41,2253,16,0,2
47260,2014/03/31,2012/12/27,117,6,0.474986543,6688,117,2,4
47261,2014/03/31,2012/08/16,249,4,0.7634438840000001,4161,249,3,1
47262,2014/03/31,2013/01/12,209,3,0.936503538,3392,209,1,2
47263,2014/03/31,2008/05/26,600,2,0.920370907,3451,600,2,0
47264,2014/03/31,2007/04/08,450,2,0.920370907,3451,450,2,0
47265,2014/03/31,2013/01/03,231,6,0.4153740520000001,7646,231,0,6
47266,2014/03/31,2012/07/25,593,2,0.65064536,4881,593,2,0
47267,2014/03/31,2013/03/29,59,4,0.683555747,4646,59,1,3
47268,2014/03/31,2010/06/13,193,3,0.8660158170000001,3667,193,1,2
47269,2014/03/31,2007/03/01,516,2,0.893947072,3552,516,2,0
47270,2014/03/31,2011/08/06,275,3,0.6892120690000001,4607,275,1,2
47271,2014/03/31,2011/12/08,238,7,0.6393596460000001,4966,238,0,7
47272,2014/03/31,2011/05/17,387,2,0.676865672,4690,387,2,0
47273,2014/03/31,2009/08/28,65,6,0.669924019,4738,65,5,1
47274,2014/03/31,2013/01/19,23,4,0.590305003,5377,23,0,4
47275,2014/03/31,2006/11/13,251,5,0.92,3450,251,0,5
47276,2014/03/31,2007/07/19,338,3,0.919733411,3451,338,2,1
47277,2014/03/31,2012/07/20,613,2,0.85,3734,613,2,0
47278,2014/03/31,2010/08/19,205,3,0.950383348,3339,205,1,2
47279,2014/03/31,2007/05/22,15,2,0.8374874640000001,3789,15,0,2
47280,2014/03/31,2007/02/08,186,6,0.71052172,4466,186,4,2
47281,2014/03/31,2008/04/13,241,3,0.542975702,5844,241,2,1
47282,2014/03/31,2012/04/16,711,3,0.472087487,6721,711,3,0
47283,2014/03/31,2005/03/14,543,2,0.8,3966,543,2,0
47284,2014/03/31,2010/07/13,49,4,0.8575,3700,49,0,4
47285,2014/03/31,2007/02/16,63,4,0.667014298,4756,63,0,4
47286,2014/03/31,2007/06/05,458,4,0.476814971,6653,458,4,0
47287,2014/03/31,2008/06/03,157,4,0.621375122,5105,157,3,1
47288,2014/03/31,2005/03/12,429,3,0.627562327,5054,429,3,0
47289,2014/03/31,2009/10/11,106,4,0.532420682,5957,106,1,3
47290,2014/03/31,2006/01/19,13,3,0.69,4596,13,0,3
47291,2014/03/31,2010/10/05,490,2,0.8,3964,490,2,0
47292,2014/03/31,2012/01/01,50,5,0.6906970159999999,4591,50,2,3
47293,2014/03/31,2011/01/13,70,2,0.759446707,4175,70,0,2
47294,2014/03/31,2011/04/25,6,4,0.579157837,5474,6,0,4
47295,2014/03/31,2011/11/12,26,8,0.5939040839999999,5338,26,2,6
47296,2014/03/31,2007/05/20,508,3,0.598386183,5298,508,3,0
47297,2014/03/31,2012/07/14,597,2,0.80956333,3916,597,2,0
47298,2014/03/31,2007/10/07,410,2,1.0,3170,410,2,0
47299,2014/03/31,2013/03/07,387,2,1.0,3170,387,2,0
47300,2014/03/31,2006/01/12,122,5,0.669604985,4734,122,2,3
47301,2014/03/31,2011/06/26,15,4,0.6625,4784,15,2,2
47302,2014/03/31,2009/09/18,287,5,0.838449735,3780,287,4,1
47303,2014/03/31,2009/11/27,307,4,0.684312244,4631,307,2,2
47304,2014/03/31,2008/04/23,134,2,0.928473484,3413,134,0,2
47305,2014/03/31,2012/01/12,496,3,0.7333333329999999,4320,496,3,0
47306,2014/03/31,2012/09/17,301,3,0.712654668,4445,301,2,1
47307,2014/03/31,2009/06/27,165,6,0.585734098,5408,165,3,3
47308,2014/03/31,2010/09/27,500,3,0.397359177,7971,500,3,0
47309,2014/03/31,2012/02/27,615,2,0.675,4692,615,2,0
47310,2014/03/31,2010/09/23,520,4,0.561542553,5640,520,4,0
47311,2014/03/31,2010/05/22,122,5,0.533277198,5938,122,3,2
47312,2014/03/31,2013/03/12,7,2,0.5173305020000001,6121,7,0,2
47313,2014/03/31,2012/08/06,241,5,0.57520436,5505,241,4,1
47314,2014/03/31,2013/03/24,125,5,0.44383095,7134,125,1,4
47315,2014/03/31,2012/12/03,255,2,0.906986537,3491,255,0,2
47316,2014/03/31,2012/10/22,291,3,0.789187438,4012,291,2,1
47317,2014/03/31,2009/11/07,510,3,0.8268477409999999,3829,510,3,0
47318,2014/03/31,2012/08/22,452,4,0.429720375,7367,452,4,0
47319,2014/03/31,2011/10/27,36,3,0.732965964,4319,36,0,3
47320,2014/03/31,2011/10/27,583,3,0.923665013,3427,583,3,0
47321,2014/03/31,2006/10/08,23,9,0.610106014,5188,23,3,6
47322,2014/03/31,2012/02/23,168,3,0.485292855,6522,168,0,3
47323,2014/03/31,2005/10/11,509,2,0.913568129,3464,509,2,0
47324,2014/03/31,2012/08/01,262,2,0.579300622,5462,262,0,2
47325,2014/03/31,2007/03/02,500,3,0.7683584259999999,4118,500,3,0
47326,2014/03/31,2009/09/16,310,2,1.0,3164,310,1,1
47327,2014/03/31,2012/08/30,448,3,0.619522224,5107,448,3,0
47328,2014/03/31,2009/01/07,513,3,0.67414234,4693,513,3,0
47329,2014/03/31,2008/10/11,137,3,0.908529581,3482,137,2,1
47330,2014/03/31,2010/08/08,37,5,0.650384457,4864,37,1,4
47331,2014/03/31,2009/05/30,240,2,0.58,5454,240,0,2
47332,2014/03/31,2011/05/24,604,3,0.923292469,3426,604,3,0
47333,2014/03/31,2011/01/14,163,4,0.602721037,5248,163,1,3
47334,2014/03/31,2011/02/03,48,8,0.5410451589999999,5846,48,5,3
47335,2014/03/31,2009/05/01,287,4,0.5700036039999999,5549,287,3,1
47336,2014/03/31,2012/03/11,286,6,0.8924181720000001,3544,286,1,5
47337,2014/03/31,2012/02/22,116,4,0.895926346,3530,116,3,1
47338,2014/03/31,2011/10/16,192,2,0.795,3978,192,0,2
47339,2014/03/31,2008/05/22,652,2,0.535082078,5909,652,2,0
47340,2014/03/31,2011/06/01,196,3,0.8213691870000001,3849,196,0,3
47341,2014/03/31,2012/07/28,356,4,0.666055626,4746,356,3,1
47342,2014/03/31,2009/04/09,55,5,0.733208072,4311,55,2,3
47343,2014/03/31,2013/02/02,313,5,0.428990228,7368,313,2,3
47344,2014/03/31,2010/02/12,237,4,0.722629172,4374,237,2,2
47345,2014/03/31,2012/10/16,190,6,0.443333333,7128,190,4,2
47346,2014/03/31,2011/01/25,195,2,0.7773087329999999,4065,195,0,2
47347,2014/03/31,2012/12/02,130,3,0.788801498,4005,130,1,2
47348,2014/03/31,2011/03/04,634,3,0.930975538,3393,634,3,0
47349,2014/03/31,2011/02/15,47,2,0.875228595,3609,47,0,2
47350,2014/03/31,2012/08/17,257,3,0.8084412590000001,3907,257,2,1
47351,2014/03/31,2011/11/04,176,6,0.765889913,4124,176,4,2
47352,2014/03/31,2006/10/27,253,3,0.622344828,5075,253,1,2
47353,2014/03/31,2007/09/20,160,3,0.493333333,6402,160,2,1
47354,2014/03/31,2009/12/05,649,3,0.714340647,4421,649,3,0
47355,2014/03/31,2011/04/12,279,5,0.671384223,4703,279,3,2
47356,2014/03/31,2007/06/27,80,2,0.76,4154,80,0,2
47357,2014/03/31,2010/04/20,12,5,0.648252567,4870,12,0,5
47358,2014/03/31,2010/09/09,549,2,0.598691447,5273,549,2,0
47359,2014/03/31,2007/11/01,121,2,1.443374486,2187,121,1,1
47360,2014/03/31,2011/01/20,13,4,0.649905291,4857,13,0,4
47361,2014/03/31,2012/05/30,40,5,0.475913752,6632,40,2,3
47362,2014/03/31,2013/02/26,251,2,0.934905213,3376,251,0,2
47363,2014/03/31,2011/03/13,49,3,0.751266365,4201,49,2,1
47364,2014/03/31,2012/04/10,296,3,0.6763951990000001,4666,296,1,2
47365,2014/03/31,2012/07/07,467,3,0.5366349260000001,5881,467,3,0
47366,2014/03/31,2010/06/18,229,3,0.747918938,4219,229,2,1
47367,2014/03/31,2012/05/25,521,2,0.944165171,3342,521,2,0
47368,2014/03/31,2013/01/29,76,4,0.474691544,6646,76,0,4
47369,2014/03/31,2012/08/04,449,4,0.7632954270000001,4133,449,4,0
47370,2014/03/31,2012/04/04,648,5,0.720733379,4377,648,5,0
47371,2014/03/31,2008/05/21,104,2,0.555,5684,104,0,2
47372,2014/03/31,2006/11/03,170,4,0.582869549,5412,170,3,1
47373,2014/03/31,2006/10/23,289,5,0.608707063,5182,289,4,1
47374,2014/03/31,2013/02/28,203,4,0.370224178,8520,203,0,4
47375,2014/03/31,2009/08/05,110,3,0.617201566,5110,110,2,1
47376,2014/03/31,2008/08/09,119,4,0.501088338,6294,119,3,1
47377,2014/03/31,2012/07/07,436,3,0.616227042,5118,436,3,0
47378,2014/03/31,2010/02/08,198,4,0.463794118,6800,198,2,2
47379,2014/03/31,2006/11/01,350,4,0.820848516,3842,350,3,1
47380,2014/03/31,2008/05/17,594,3,0.733178331,4301,594,3,0
47381,2014/03/31,2012/02/02,179,2,0.69,4570,179,1,1
47382,2014/03/31,2008/03/06,345,4,0.695281147,4535,345,2,2
47383,2014/03/31,2008/08/23,211,4,0.983800312,3205,211,3,1
47384,2014/03/31,2011/01/09,69,9,0.759015407,4154,69,0,9
47385,2014/03/31,2013/03/08,168,4,0.695094797,4536,168,0,4
47386,2014/03/31,2007/07/04,481,3,0.459555394,6860,481,3,0
47387,2014/03/31,2012/05/22,147,2,0.589992514,5343,147,1,1
47388,2014/03/31,2012/04/01,151,4,0.811944874,3882,151,1,3
47389,2014/03/31,2010/09/30,35,2,0.59,5342,35,1,1
47390,2014/03/31,2008/09/08,1,3,0.563288651,5595,1,2,1
47391,2014/03/31,2009/06/05,380,6,0.55,5730,380,6,0
47392,2014/03/31,2013/03/18,156,3,0.55,5730,156,0,3
47393,2014/03/31,2012/01/01,44,3,0.539267625,5844,44,0,3
47394,2014/03/31,2010/06/29,643,4,0.827890173,3806,643,4,0
47395,2014/03/31,2006/03/09,91,8,0.6651552270000001,4735,91,0,8
47396,2014/03/31,2012/08/21,50,5,0.7300579509999999,4314,50,1,4
47397,2014/03/31,2010/11/07,191,4,0.818440748,3848,191,1,3
47398,2014/03/31,2006/06/22,76,3,0.858345598,3669,76,0,3
47399,2014/03/31,2012/10/29,93,4,0.729328393,4318,93,3,1
47400,2014/03/31,2011/11/08,289,4,0.683854506,4605,289,3,1
47401,2014/03/31,2010/11/10,116,3,0.464150943,6784,116,0,3
47402,2014/03/31,2008/05/26,164,4,0.7298562820000001,4314,164,1,3
47403,2014/03/31,2012/07/27,1,4,0.6707626760000001,4694,1,1,3
47404,2014/03/31,2010/03/01,86,5,0.483940978,6506,86,1,4
47405,2014/03/31,2007/08/08,131,3,0.573900838,5486,131,0,3
47406,2014/03/31,2011/03/03,226,6,0.600814885,5240,226,0,6
47407,2014/03/31,2009/06/26,14,5,0.689776463,4563,14,0,5
47408,2014/03/31,2013/03/21,22,4,0.8230779290000001,3824,22,1,3
47409,2014/03/31,2006/11/26,138,4,0.633510467,4968,138,1,3
47410,2014/03/31,2010/11/19,317,2,0.8,3934,317,1,1
47411,2014/03/31,2011/12/16,466,2,0.8,3934,466,2,0
47412,2014/03/31,2013/01/31,424,2,0.8,3934,424,2,0
47413,2014/03/31,2011/11/24,684,2,0.8,3934,684,2,0
47414,2014/03/31,2009/12/10,495,4,0.4,7868,495,4,0
47415,2014/03/31,2006/06/08,308,2,0.8,3934,308,0,2
47416,2014/03/31,2010/11/10,73,2,0.8,3934,73,0,2
47417,2014/03/31,2011/09/18,278,4,0.572634643,5496,278,2,2
47418,2014/03/31,2009/11/24,55,5,0.436803609,7205,55,1,4
47419,2014/03/31,2012/04/02,402,4,0.718985607,4377,402,4,0
47420,2014/03/31,2011/10/23,265,2,0.75,4196,265,0,2
47421,2014/03/31,2010/04/05,3,8,0.40975,7680,3,0,8
47422,2014/03/31,2005/11/15,210,4,0.614849551,5118,210,3,1
47423,2014/03/31,2009/05/08,95,3,0.583667223,5391,95,0,3
47424,2014/03/31,2012/03/13,127,6,0.734115726,4286,127,2,4
47425,2014/03/31,2010/12/27,101,3,0.926231969,3397,101,0,3
47426,2014/03/31,2010/10/02,420,3,0.7333333329999999,4290,420,3,0
47427,2014/03/31,2010/07/04,594,2,1.0,3146,594,2,0
47428,2014/03/31,2008/04/18,598,2,1.0,3146,598,2,0
47429,2014/03/31,2007/04/11,5,5,0.568756102,5531,5,0,5
47430,2014/03/31,2012/08/20,243,2,0.68152546,4615,243,1,1
47431,2014/03/31,2004/12/11,22,3,0.70173137,4482,22,1,2
47432,2014/03/31,2012/09/08,188,5,0.910836953,3453,188,3,2
47433,2014/03/31,2013/01/09,78,2,0.445370344,7061,78,1,1
47434,2014/03/31,2009/11/28,131,4,0.768214024,4093,131,1,3
47435,2014/03/31,2011/05/19,70,3,0.727487274,4322,70,1,2
47436,2014/03/31,2007/10/17,373,2,0.960061069,3275,373,2,0
47437,2014/03/31,2009/01/16,618,4,0.695454545,4521,618,4,0
47438,2014/03/31,2008/08/11,18,4,0.376802493,8344,18,0,4
47439,2014/03/31,2007/11/26,403,2,1.212027756,2594,403,2,0
47440,2014/03/31,2009/12/25,718,2,1.461506276,2151,718,2,0
47441,2014/03/31,2011/08/21,364,4,0.606697549,5181,364,3,1
47442,2014/03/31,2006/12/31,66,2,0.748723202,4198,66,1,1
47443,2014/03/31,2012/11/27,180,4,0.5184658529999999,6062,180,1,3
47444,2014/03/31,2011/03/23,340,6,0.6,5238,340,4,2
47445,2014/03/31,2009/02/09,30,4,0.6477102229999999,4852,30,0,4
47446,2014/03/31,2006/01/09,49,2,0.8160659570000001,3851,49,0,2
47447,2014/03/31,2005/11/25,128,3,0.526666667,5967,128,1,2
47448,2014/03/31,2011/08/26,401,6,0.821796548,3824,401,6,0
47449,2014/03/31,2010/03/21,221,5,0.585701771,5365,221,4,1
47450,2014/03/31,2011/09/09,330,6,0.964395335,3258,330,5,1
47451,2014/03/31,2010/07/09,430,3,0.684360706,4591,430,3,0
47452,2014/03/31,2009/08/19,298,5,0.636,4940,298,4,1
47453,2014/03/31,2012/08/05,225,5,0.563174973,5578,225,3,2
47454,2014/03/31,2011/06/03,333,3,0.475666263,6604,333,2,1
47455,2014/03/31,2012/02/16,67,4,0.7775,4040,67,0,4
47456,2014/03/31,2012/03/17,4,3,0.747143197,4204,4,1,2
47457,2014/03/31,2012/09/02,558,4,0.662951235,4737,558,4,0
47458,2014/03/31,2012/04/20,174,3,0.36477175,8609,174,0,3
47459,2014/03/31,2006/02/20,173,4,0.643345626,4881,173,1,3
47460,2014/03/31,2012/09/04,323,5,0.533486239,5886,323,4,1
47461,2014/03/31,2005/06/25,150,4,0.995251981,3155,150,1,3
47462,2014/03/31,2005/12/10,364,4,0.738823529,4250,364,3,1
47463,2014/03/31,2009/07/31,518,5,0.69,4550,518,5,0
47464,2014/03/31,2006/12/06,60,3,0.5669785079999999,5537,60,0,3
47465,2014/03/31,2012/07/24,201,3,0.795779468,3945,201,2,1
47466,2014/03/31,2008/06/07,5,7,0.6876845559999999,4565,5,0,7
47467,2014/03/31,2007/12/16,103,3,0.61134372,5135,103,0,3
47468,2014/03/31,2012/11/13,235,2,0.635453441,4940,235,0,2
47469,2014/03/31,2011/06/08,68,4,0.635425101,4940,68,0,4
47470,2014/03/31,2010/06/11,422,5,0.821193093,3822,422,5,0
47471,2014/03/31,2011/05/18,508,3,0.783670412,4005,508,3,0
47472,2014/03/31,2005/10/19,253,4,0.761006305,4124,253,3,1
47473,2014/03/31,2012/11/20,311,6,0.434639889,7220,311,4,2
47474,2014/03/31,2010/08/23,131,4,0.85927437,3652,131,0,4
47475,2014/03/31,2011/08/27,240,3,0.723333333,4338,240,2,1
47476,2014/03/31,2008/05/08,45,3,0.93026979,3373,45,1,2
47477,2014/03/31,2008/10/02,471,3,0.748663803,4191,471,3,0
47478,2014/03/31,2007/10/25,14,4,0.73561313,4265,14,1,3
47479,2014/03/31,2011/01/09,221,5,0.798239186,3930,221,0,5
47480,2014/03/31,2012/11/30,135,2,0.495388503,6332,135,1,1
47481,2014/03/31,2012/09/24,215,4,0.822159895,3815,215,3,1
47482,2014/03/31,2012/06/29,116,4,0.707523122,4433,116,1,3
47483,2014/03/31,2013/01/01,356,2,0.575,5454,356,1,1
47484,2014/03/31,2013/03/24,344,3,0.387974762,8083,344,1,2
47485,2014/03/31,2007/03/22,493,3,0.579560155,5411,493,3,0
47486,2014/03/31,2012/06/10,139,5,0.9164173,3422,139,3,2
47487,2014/03/31,2013/01/11,424,4,0.508579306,6166,424,4,0
47488,2014/03/31,2012/04/19,705,5,0.907874928,3454,705,5,0
47489,2014/03/31,2011/06/20,240,3,0.5664125720000001,5536,240,2,1
47490,2014/03/31,2009/09/25,245,3,0.709337104,4420,245,0,3
47491,2014/03/31,2013/02/19,231,2,0.675,4644,231,1,1
47492,2014/03/31,2011/09/11,198,6,0.612420868,5118,198,4,2
47493,2014/03/31,2007/05/27,44,7,0.8280951120000001,3785,44,5,2
47494,2014/03/31,2012/10/07,296,4,0.65201373,4807,296,3,1
47495,2014/03/31,2012/04/14,345,4,0.972146402,3224,345,2,2
47496,2014/03/31,2009/09/24,39,5,0.755578592,4148,39,0,5
47497,2014/03/31,2010/09/18,217,3,0.6883549309999999,4553,217,0,3
47498,2014/03/31,2012/08/20,499,2,0.897751361,3491,499,2,0
47499,2014/03/31,2013/01/23,3,3,0.482602402,6494,3,2,1
47500,2014/03/31,2007/05/26,322,3,0.57451879,5455,322,1,2
47501,2014/03/31,2011/01/13,493,3,0.8068743559999999,3884,493,3,0
47502,2014/03/31,2012/07/05,624,2,0.9,3482,624,2,0
47503,2014/03/31,2012/07/04,624,2,0.9,3482,624,2,0
47504,2014/03/31,2012/07/05,624,2,0.9,3482,624,2,0
47505,2014/03/31,2006/01/10,337,3,0.640183861,4895,337,1,2
47506,2014/03/31,2012/04/06,7,7,0.433815589,7223,7,3,4
47507,2014/03/31,2011/11/09,26,4,0.788859517,3972,26,1,3
47508,2014/03/31,2011/03/23,275,4,0.970294209,3229,275,2,2
47509,2014/03/31,2012/09/25,255,3,0.731857043,4281,255,2,1
47510,2014/03/31,2011/01/10,83,2,0.6217483629999999,5039,83,0,2
47511,2014/03/31,2008/02/08,503,2,1.22991755,2547,503,2,0
47512,2014/03/31,2006/01/19,445,3,0.678912007,4614,445,3,0
47513,2014/03/31,2011/12/01,34,7,0.772857143,4053,34,2,5
47514,2014/03/31,2009/11/17,95,3,0.729275902,4295,95,1,2
47515,2014/03/31,2009/01/03,588,4,0.6463268679999999,4846,588,4,0
47516,2014/03/31,2012/01/09,244,2,0.8296582779999999,3775,244,1,1
47517,2014/03/31,2012/02/07,526,3,0.914928425,3423,526,3,0
47518,2014/03/31,2012/07/29,350,6,0.890981508,3515,350,4,2
47519,2014/03/31,2012/12/18,74,3,0.527533693,5936,74,0,3
47520,2014/03/31,2007/04/19,351,3,0.570743711,5486,351,2,1
47521,2014/03/31,2008/04/17,302,2,0.685,4570,302,0,2
47522,2014/03/31,2013/03/01,118,4,0.85740274,3650,118,1,3
47523,2014/03/31,2006/02/08,49,5,0.58,5395,49,2,3
47524,2014/03/31,2010/11/25,47,6,0.951666667,3288,47,2,4
47525,2014/03/31,2008/07/11,215,3,0.8021225329999999,3901,215,2,1
47526,2014/03/31,2010/11/29,48,6,0.396960162,7882,48,4,2
47527,2014/03/31,2009/09/29,27,6,0.7366917820000001,4247,27,3,3
47528,2014/03/31,2012/04/12,130,2,0.784339433,3989,130,1,1
47529,2014/03/31,2013/02/27,4,3,0.715940503,4370,4,0,3
47530,2014/03/31,2008/06/08,160,8,0.86125,3632,160,0,8
47531,2014/03/31,2006/03/10,117,3,0.527604588,5928,117,0,3
47532,2014/03/31,2010/09/15,231,2,0.795,3934,231,0,2
47533,2014/03/31,2007/09/26,258,2,0.795,3934,258,0,2
47534,2014/03/31,2007/01/10,614,4,0.5625,5560,614,4,0
47535,2014/03/31,2012/11/26,167,4,0.5625,5560,167,2,2
47536,2014/03/31,2011/07/27,495,3,0.537302405,5820,495,3,0
47537,2014/03/31,2011/12/12,360,5,0.478131213,6539,360,4,1
47538,2014/03/31,2010/06/12,319,4,0.435971273,7171,319,1,3
47539,2014/03/31,2012/03/15,445,4,0.8504624590000001,3676,445,4,0
47540,2014/03/31,2011/08/02,193,5,0.539110191,5799,193,3,2
47541,2014/03/31,2009/08/31,31,4,0.5975,5232,31,1,3
47542,2014/03/31,2010/09/09,426,2,0.73056789,4279,426,2,0
47543,2014/03/31,2008/07/26,176,3,0.638368389,4897,176,1,2
47544,2014/03/31,2009/11/27,396,5,0.742494062,4210,396,5,0
47545,2014/03/31,2008/07/17,361,3,0.334780979,9337,361,2,1
47546,2014/03/31,2009/04/11,255,6,0.647070393,4830,255,4,2
47547,2014/03/31,2010/10/30,486,3,1.0,3125,486,3,0
47548,2014/03/31,2009/07/21,40,5,0.486,6430,40,3,2
47549,2014/03/31,2012/10/12,160,3,0.703023622,4445,160,2,1
47550,2014/03/31,2011/06/04,72,3,0.7228521859999999,4323,72,2,1
47551,2014/03/31,2010/04/04,2,6,0.817105126,3824,2,4,2
47552,2014/03/31,2010/12/28,84,6,0.740322275,4220,84,3,3
47553,2014/03/31,2013/03/09,14,5,0.728384239,4289,14,0,5
47554,2014/03/31,2011/01/13,429,3,0.45,6942,429,3,0
47555,2014/03/31,2012/04/13,66,5,0.813019261,3842,66,1,4
47556,2014/03/31,2009/12/23,463,5,0.437260255,7143,463,5,0
47557,2014/03/31,2010/12/28,345,2,0.8,3904,345,0,2
47558,2014/03/31,2012/01/15,522,2,0.8,3904,522,2,0
47559,2014/03/31,2013/01/30,136,4,0.639209988,4886,136,1,3
47560,2014/03/31,2011/05/18,35,4,0.549823944,5680,35,0,4
47561,2014/03/31,2008/03/14,338,3,0.7069504190000001,4417,338,2,1
47562,2014/03/31,2006/11/18,86,6,0.482616692,6470,86,5,1
47563,2014/03/31,2011/01/13,67,3,0.8266851999999999,3777,67,0,3
47564,2014/03/31,2012/10/02,66,5,0.8663596,3604,66,0,5
47565,2014/03/31,2012/04/01,49,7,0.502857143,6209,49,3,4
47566,2014/03/31,2009/03/14,317,6,0.499871918,6246,317,4,2
47567,2014/03/31,2007/10/18,583,2,1.0,3122,583,2,0
47568,2014/03/31,2012/04/01,684,3,0.7590080229999999,4113,684,3,0
47569,2014/03/31,2007/07/16,141,2,0.7374722420000001,4233,141,1,1
47570,2014/03/31,2010/04/18,49,4,0.5675,5500,49,2,2
47571,2014/03/31,2012/10/20,364,2,0.754387237,4137,364,1,1
47572,2014/03/31,2011/08/01,354,2,0.873956875,3571,354,0,2
47573,2014/03/31,2010/11/04,348,4,0.6365973070000001,4902,348,2,2
47574,2014/03/31,2010/03/22,516,5,0.599807766,5202,516,5,0
47575,2014/03/31,2011/01/13,162,4,0.697240223,4475,162,3,1
47576,2014/03/31,2005/10/23,72,2,0.693085981,4501,72,0,2
47577,2014/03/31,2009/09/18,207,5,0.5702285189999999,5470,207,1,4
47578,2014/03/31,2005/04/11,254,3,0.741054882,4209,254,1,2
47579,2014/03/31,2012/01/11,218,3,0.382793324,8148,218,2,1
47580,2014/03/31,2011/09/14,428,2,0.5,6238,428,2,0
47581,2014/03/31,2010/11/17,422,2,0.5,6238,422,2,0
47582,2014/03/31,2009/08/22,45,3,0.6133333329999999,5085,45,1,2
47583,2014/03/31,2010/12/14,221,3,0.930937313,3350,221,1,2
47584,2014/03/31,2012/08/17,310,3,0.928431081,3359,310,2,1
47585,2014/03/31,2005/03/10,199,6,0.484315888,6439,199,4,2
47586,2014/03/31,2011/05/29,292,4,0.7043550940000001,4427,292,2,2
47587,2014/03/31,2012/06/14,264,4,0.6311943320000001,4940,264,2,2
47588,2014/03/31,2007/05/01,68,6,0.522471929,5967,68,3,3
47589,2014/03/31,2009/02/24,344,3,0.6813770490000001,4575,344,1,2
47590,2014/03/31,2005/10/03,347,5,0.5863148979999999,5316,347,4,1
47591,2014/03/31,2006/11/02,6,4,0.575,5420,6,0,4
47592,2014/03/31,2008/05/07,16,2,0.87168951,3575,16,0,2
47593,2014/03/31,2011/08/29,470,2,0.625,4986,470,2,0
47594,2014/03/31,2007/11/21,339,2,0.625,4986,339,1,1
47595,2014/03/31,2008/06/18,14,2,0.625,4986,14,0,2
47596,2014/03/31,2012/10/12,11,7,0.438571429,7105,11,5,2
47597,2014/03/31,2011/10/26,43,3,0.6956709090000001,4479,43,0,3
47598,2014/03/31,2013/03/13,335,2,0.9,3462,335,1,1
47599,2014/03/31,2009/07/06,113,4,0.57264841,5441,113,1,3
47600,2014/03/31,2010/03/26,129,3,0.602083092,5175,129,2,1
47601,2014/03/31,2011/09/01,311,3,0.5,6231,311,2,1
47602,2014/03/31,2012/07/13,624,2,0.75,4154,624,2,0
47603,2014/03/31,2013/02/15,400,2,0.75,4154,400,2,0
47604,2014/03/31,2011/05/31,330,2,0.75,4154,330,0,2
47605,2014/03/31,2011/06/22,695,2,0.75,4154,695,2,0
47606,2014/03/31,2012/07/13,624,2,0.75,4154,624,2,0
47607,2014/03/31,2007/01/13,9,3,0.721166667,4320,9,0,3
47608,2014/03/31,2007/04/20,475,3,0.922445958,3377,475,3,0
47609,2014/03/31,2011/11/14,111,4,0.692780249,4496,111,2,2
47610,2014/03/31,2012/12/13,96,3,0.546060659,5704,96,0,3
47611,2014/03/31,2008/05/22,378,6,0.404973992,7690,378,6,0
47612,2014/03/31,2011/10/12,525,3,0.904501888,3443,525,3,0
47613,2014/03/31,2012/09/13,233,3,0.8807013570000001,3536,233,2,1
47614,2014/03/31,2012/07/21,99,5,0.686810763,4534,99,3,2
47615,2014/03/31,2006/04/16,86,6,0.626025332,4974,86,1,5
47616,2014/03/31,2012/01/20,66,4,0.617550575,5042,66,1,3
47617,2014/03/31,2009/12/03,215,5,0.57108584,5452,215,2,3
47618,2014/03/31,2009/09/09,119,5,0.748050949,4161,119,1,4
47619,2014/03/31,2007/05/29,244,3,1.118024425,2784,244,2,1
47620,2014/03/31,2012/08/22,375,4,0.658451449,4727,375,4,0
47621,2014/03/31,2010/05/20,12,6,0.57,5460,12,2,4
47622,2014/03/31,2008/03/02,30,2,0.455,6840,30,0,2
47623,2014/03/31,2011/10/15,338,4,0.974906015,3192,338,2,2
47624,2014/03/31,2012/06/11,340,4,0.710781179,4378,340,3,1
47625,2014/03/31,2012/05/13,117,4,0.580537313,5360,117,3,1
47626,2014/03/31,2012/03/01,75,4,1.094015471,2844,75,0,4
47627,2014/03/31,2013/02/02,42,4,0.721588958,4311,42,1,3
47628,2014/03/31,2008/04/23,168,2,0.916752137,3393,168,0,2
47629,2014/03/31,2007/09/04,490,2,0.715386385,4348,490,2,0
47630,2014/03/31,2013/02/27,254,3,0.783648274,3969,254,1,2
47631,2014/03/31,2009/04/29,114,4,0.65120603,4776,114,2,2
47632,2014/03/31,2006/09/22,359,4,0.62146283,5004,359,2,2
47633,2014/03/31,2010/09/16,615,4,0.594267151,5233,615,4,0
47634,2014/03/31,2012/11/08,251,4,0.890799198,3491,251,0,4
47635,2014/03/31,2007/08/03,2,5,0.731123913,4253,2,4,1
47636,2014/03/31,2011/04/14,113,9,0.413984822,7511,113,6,3
47637,2014/03/31,2013/03/16,286,3,0.384568955,8085,286,1,2
47638,2014/03/31,2011/10/26,355,2,0.963166047,3228,355,1,1
47639,2014/03/31,2005/08/07,333,2,1.0,3109,333,1,1
47640,2014/03/31,2008/05/31,344,3,0.8171924290000001,3804,344,2,1
47641,2014/03/31,2008/02/27,149,4,0.566254327,5489,149,2,2
47642,2014/03/31,2011/04/24,27,2,0.925859398,3357,27,0,2
47643,2014/03/31,2012/05/26,225,2,0.79,3934,225,1,1
47644,2014/03/31,2011/02/19,86,4,0.395,7868,86,2,2
47645,2014/03/31,2011/09/25,415,3,0.853791209,3640,415,3,0
47646,2014/03/31,2007/11/16,139,3,0.499386148,6223,139,1,2
47647,2014/03/31,2008/10/25,499,2,0.882089129,3523,499,2,0
47648,2014/03/31,2012/10/29,165,3,0.603179348,5152,165,1,2
47649,2014/03/31,2008/11/23,167,2,0.9004636340000001,3451,167,1,1
47650,2014/03/31,2010/01/27,66,3,0.644054726,4824,66,2,1
47651,2014/03/31,2013/01/22,96,5,0.565769441,5491,96,1,4
47652,2014/03/31,2010/11/06,149,2,0.599930475,5178,149,0,2
47653,2014/03/31,2005/05/01,573,3,0.7054508290000001,4403,573,3,0
47654,2014/03/31,2012/01/25,638,2,1.0,3106,638,2,0
47655,2014/03/31,2013/02/16,53,4,0.60994894,5092,53,1,3
47656,2014/03/31,2007/03/02,394,5,0.694499106,4472,394,5,0
47657,2014/03/31,2009/08/05,566,6,0.794512663,3909,566,6,0
47658,2014/03/31,2013/03/02,15,3,0.759290954,4090,15,0,3
47659,2014/03/31,2012/08/14,75,5,0.946780488,3280,75,3,2
47660,2014/03/31,2011/12/24,91,2,0.72,4313,91,0,2
47661,2014/03/31,2010/02/15,179,5,0.514114238,6040,179,2,3
47662,2014/03/31,2005/04/15,714,2,0.877437129,3539,714,2,0
47663,2014/03/31,2011/07/15,359,2,0.7,4436,359,0,2
47664,2014/03/31,2007/10/01,268,4,0.513904336,6042,268,3,1
47665,2014/03/31,2012/02/08,537,3,1.5,2070,537,3,0
47666,2014/03/31,2013/03/30,97,5,0.527609176,5885,97,1,4
47667,2014/03/31,2008/01/15,4,2,0.895010089,3469,4,0,2
47668,2014/03/31,2010/01/01,1,3,0.587915168,5281,1,0,3
47669,2014/03/31,2010/11/14,62,4,0.7414545020000001,4187,62,3,1
47670,2014/03/31,2009/04/03,178,3,0.78118772,3974,178,2,1
47671,2014/03/31,2008/04/04,220,2,0.717100947,4329,220,0,2
47672,2014/03/31,2011/10/10,660,2,0.55,5644,660,2,0
47673,2014/03/31,2005/06/22,35,3,0.769048563,4036,35,1,2
47674,2014/03/31,2009/02/23,117,2,0.65676259,4726,117,1,1
47675,2014/03/31,2009/08/19,541,3,0.624602536,4969,541,3,0
47676,2014/03/31,2012/02/06,452,2,0.825,3762,452,2,0
47677,2014/03/31,2011/10/18,17,5,0.573135734,5415,17,0,5
47678,2014/03/31,2008/03/25,234,3,0.710173913,4370,234,0,3
47679,2014/03/31,2012/06/26,16,3,0.8979774309999999,3456,16,0,3
47680,2014/03/31,2005/10/20,138,3,0.702430964,4418,138,2,1
47681,2014/03/31,2011/09/20,142,2,0.923864245,3359,142,0,2
47682,2014/03/31,2013/01/31,54,5,0.8321480290000001,3729,54,3,2
47683,2014/03/31,2011/05/09,649,2,1.0,3103,649,2,0
47684,2014/03/31,2006/02/25,73,4,0.912051734,3402,73,1,3
47685,2014/03/31,2006/10/31,344,2,0.8,3878,344,0,2
47686,2014/03/31,2012/07/20,362,4,0.616362011,5033,362,2,2
47687,2014/03/31,2012/11/20,339,2,0.608266327,5099,339,1,1
47688,2014/03/31,2009/07/01,23,6,0.461074933,6726,23,2,4
47689,2014/03/31,2011/11/28,151,3,0.690220343,4493,151,0,3
47690,2014/03/31,2011/06/13,321,3,0.667046677,4649,321,0,3
47691,2014/03/31,2010/05/14,90,2,0.813078133,3814,90,1,1
47692,2014/03/31,2009/07/30,93,4,0.871073034,3560,93,2,2
47693,2014/03/31,2011/11/08,430,2,1.0,3101,430,2,0
47694,2014/03/31,2012/04/24,52,2,0.669309303,4633,52,0,2
47695,2014/03/31,2011/05/08,664,2,0.8,3876,664,2,0
47696,2014/03/31,2012/12/17,232,2,0.628053474,4937,232,1,1
47697,2014/03/31,2006/03/26,550,3,0.953321033,3252,550,3,0
47698,2014/03/31,2012/11/01,191,3,0.518598193,5978,191,1,2
47699,2014/03/31,2011/02/06,113,5,0.474,6540,113,4,1
47700,2014/03/31,2007/01/18,24,6,0.476108125,6511,24,2,4
47701,2014/03/31,2010/02/09,90,5,0.31638562800000003,9797,90,3,2
47702,2014/03/31,2012/11/07,309,2,0.898145465,3451,309,1,1
47703,2014/03/31,2013/03/16,376,2,1.3082313209999998,2369,376,2,0
47704,2014/03/31,2012/05/03,508,2,0.875487426,3539,508,2,0
47705,2014/03/31,2012/10/14,521,4,1.0,3098,521,4,0
47706,2014/03/31,2007/06/13,57,4,0.522598279,5927,57,0,4
47707,2014/03/31,2011/07/11,175,3,0.7743425,4000,175,0,3
47708,2014/03/31,2006/04/17,261,3,0.7628029559999999,4060,261,2,1
47709,2014/03/31,2013/01/20,165,3,0.8338583740000001,3714,165,1,2
47710,2014/03/31,2013/03/20,10,5,0.6945211929999999,4459,10,0,5
47711,2014/03/31,2012/03/13,157,2,0.66,4692,157,0,2
47712,2014/03/31,2012/03/20,68,3,0.7422507190000001,4172,68,2,1
47713,2014/03/31,2007/04/19,283,5,0.7332346670000001,4223,283,3,2
47714,2014/03/31,2011/02/08,59,4,0.547985841,5650,59,2,2
47715,2014/03/31,2008/10/23,182,3,0.599548799,5164,182,0,3
47716,2014/03/31,2004/12/27,478,5,0.48,6450,478,5,0
47717,2014/03/31,2013/01/18,288,3,1.229023422,2519,288,0,3
47718,2014/03/31,2012/01/02,73,5,0.61,5075,73,2,3
47719,2014/03/31,2010/04/18,31,4,0.5571701170000001,5555,31,3,1
47720,2014/03/31,2011/09/10,46,5,0.518,5975,46,2,3
47721,2014/03/31,2008/02/19,79,2,0.7413077840000001,4175,79,1,1
47722,2014/03/31,2012/03/03,17,6,0.583689174,5302,17,2,4
47723,2014/03/31,2012/11/23,87,5,0.566626991,5461,87,3,2
47724,2014/03/31,2010/08/19,646,3,0.483333333,6402,646,3,0
47725,2014/03/31,2008/06/08,49,3,0.572163462,5408,49,0,3
47726,2014/03/31,2012/05/31,472,5,0.383188854,8075,472,5,0
47727,2014/03/31,2012/03/06,473,2,0.783105543,3951,473,2,0
47728,2014/03/31,2005/09/01,223,5,0.605706735,5108,223,4,1
47729,2014/03/31,2012/08/19,36,4,0.52940794,5844,36,2,2
47730,2014/03/31,2012/12/11,27,3,0.669013841,4624,27,1,2
47731,2014/03/31,2008/04/13,361,6,0.766072313,4038,361,5,1
47732,2014/03/31,2011/06/25,439,5,0.567161716,5454,439,5,0
47733,2014/03/31,2012/03/30,52,6,0.421166939,7344,52,4,2
47734,2014/03/31,2006/12/18,281,2,0.517450226,5977,281,1,1
47735,2014/03/31,2010/04/17,559,2,0.6261186470000001,4939,559,2,0
47736,2014/03/31,2013/02/25,121,3,0.556576674,5556,121,0,3
47737,2014/03/31,2012/05/14,300,2,0.961713841,3215,300,1,1
47738,2014/03/31,2012/02/24,30,4,0.4736320470000001,6528,30,1,3
47739,2014/03/31,2007/05/14,256,7,0.667559922,4631,256,2,5
47740,2014/03/31,2011/10/12,203,2,0.810973242,3812,203,0,2
47741,2014/03/31,2012/10/21,191,3,0.584243054,5291,191,2,1
47742,2014/03/31,2010/03/19,119,4,0.442358329,6988,119,1,3
47743,2014/03/31,2007/07/11,327,2,0.6,5152,327,0,2
47744,2014/03/31,2006/07/01,51,8,0.492775387,6273,51,0,8
47745,2014/03/31,2007/09/10,472,5,0.588230257,5255,472,5,0
47746,2014/03/31,2010/09/04,151,4,0.722723872,4277,151,2,2
47747,2014/03/31,2012/11/02,265,3,0.602988685,5126,265,2,1
47748,2014/03/31,2012/03/16,197,3,0.558720174,5532,197,0,3
47749,2014/03/31,2012/03/16,198,3,0.7538024390000001,4100,198,2,1
47750,2014/03/31,2005/10/13,218,4,0.5454500529999999,5666,218,2,2
47751,2014/03/31,2011/11/28,469,5,0.749393792,4124,469,5,0
47752,2014/03/31,2012/05/09,688,3,0.7405343879999999,4173,688,3,0
47753,2014/03/31,2008/08/20,439,4,0.634637503,4869,439,4,0
47754,2014/03/31,2006/01/16,11,5,0.5214208570000001,5926,11,1,4
47755,2014/03/31,2005/07/12,251,3,0.684639929,4513,251,2,1
47756,2014/03/31,2007/12/28,52,3,0.906324435,3409,52,0,3
47757,2014/03/31,2013/01/01,93,4,0.7460975609999999,4141,93,0,4
47758,2014/03/31,2005/08/16,165,4,0.621456447,4971,165,3,1
47759,2014/03/31,2005/10/16,233,4,0.7173223409999999,4306,233,2,2
47760,2014/03/31,2007/03/23,30,9,0.612425144,5043,30,2,7
47761,2014/03/31,2013/03/10,118,2,0.665,4644,118,1,1
47762,2014/03/31,2009/08/10,81,2,0.785,3934,81,0,2
47763,2014/03/31,2012/08/22,115,2,0.785,3934,115,1,1
47764,2014/03/31,2012/01/27,188,3,0.599382764,5152,188,0,3
47765,2014/03/31,2008/04/25,130,3,0.930949653,3317,130,1,2
47766,2014/03/31,2005/02/20,50,3,0.790552995,3906,50,2,1
47767,2014/03/31,2012/02/21,247,4,0.8478555740000001,3642,247,0,4
47768,2014/03/31,2012/03/27,328,6,0.5021548220000001,6149,328,5,1
47769,2014/03/31,2010/09/23,30,2,0.77,4010,30,0,2
47770,2014/03/31,2013/03/25,196,4,0.94279084,3275,196,1,3
47771,2014/03/31,2013/03/26,157,2,0.415,7440,157,0,2
47772,2014/03/31,2007/11/30,65,4,0.790437788,3906,65,2,2
47773,2014/03/31,2004/11/15,130,3,0.6676794979999999,4624,130,2,1
47774,2014/03/31,2012/12/09,472,2,0.49900598,6187,472,2,0
47775,2014/03/31,2012/05/03,594,4,0.886885952,3481,594,4,0
47776,2014/03/31,2012/06/28,640,2,0.725,4258,640,2,0
47777,2014/03/31,2008/05/11,39,3,0.8494881670000001,3634,39,1,2
47778,2014/03/31,2013/02/04,421,2,1.0,3087,421,2,0
47779,2014/03/31,2010/12/01,45,3,0.704257358,4383,45,1,2
47780,2014/03/31,2007/07/24,142,3,0.976198608,3162,142,0,3
47781,2014/03/31,2010/12/25,128,2,0.659908061,4677,128,0,2
47782,2014/03/31,2010/09/29,144,5,0.930473319,3317,144,0,5
47783,2014/03/31,2008/05/26,431,3,0.726005646,4251,431,3,0
47784,2014/03/31,2012/03/10,492,6,0.430079431,7176,492,6,0
47785,2014/03/31,2008/03/22,71,3,0.6025478329999999,5122,71,0,3
47786,2014/03/31,2013/03/08,352,4,0.677678964,4554,352,2,2
47787,2014/03/31,2012/10/03,489,3,0.712785863,4329,489,3,0
47788,2014/03/31,2012/05/03,696,2,0.640697674,4816,696,2,0
47789,2014/03/31,2009/08/25,315,2,0.7520360890000001,4101,315,0,2
47790,2014/03/31,2012/06/29,20,5,0.758669127,4065,20,2,3
47791,2014/03/31,2011/02/01,605,5,0.716662793,4303,605,5,0
47792,2014/03/31,2006/01/24,80,2,0.567964634,5429,80,1,1
47793,2014/03/31,2011/04/05,307,4,0.497788182,6194,307,3,1
47794,2014/03/31,2009/09/08,206,4,0.579132231,5324,206,1,3
47795,2014/03/31,2010/04/16,302,5,0.7425770709999999,4152,302,2,3
47796,2014/03/31,2010/01/31,180,6,0.43,7170,180,2,4
47797,2014/03/31,2006/02/17,112,4,0.528667467,5831,112,2,2
47798,2014/03/31,2013/02/26,49,3,1.04,2964,49,1,2
47799,2014/03/31,2011/09/08,557,3,1.5,2055,557,3,0
47800,2014/03/31,2013/01/25,426,2,0.45,6850,426,2,0
47801,2014/03/31,2011/01/29,263,3,0.679246364,4538,263,1,2
47802,2014/03/31,2005/04/18,67,3,0.906666667,3399,67,0,3
47803,2014/03/31,2012/07/11,616,2,0.525,5870,616,2,0
47804,2014/03/31,2012/07/11,616,2,0.525,5870,616,2,0
47805,2014/03/31,2012/11/07,239,4,0.569209165,5412,239,1,3
47806,2014/03/31,2007/01/04,41,4,0.605202358,5090,41,0,4
47807,2014/03/31,2011/04/01,79,3,0.6315747389999999,4877,79,1,2
47808,2014/03/31,2007/11/15,245,3,0.7715731459999999,3992,245,2,1
47809,2014/03/31,2011/11/29,150,2,0.936479173,3289,150,0,2
47810,2014/03/31,2009/09/20,474,4,0.55,5600,474,4,0
47811,2014/03/31,2006/12/04,151,3,0.587504769,5242,151,0,3
47812,2014/03/31,2011/06/12,347,3,0.665582451,4627,347,1,2
47813,2014/03/31,2008/10/25,108,4,0.834654378,3689,108,1,3
47814,2014/03/31,2012/10/27,140,2,0.7574268140000001,4065,140,1,1
47815,2014/03/31,2008/03/30,438,4,0.825,3732,438,4,0
47816,2014/03/31,2012/11/26,338,4,0.578088622,5326,338,2,2
47817,2014/03/31,2011/06/26,49,3,0.8370690590000001,3678,49,1,2
47818,2014/03/31,2008/11/06,48,2,0.65,4736,48,0,2
47819,2014/03/31,2006/06/22,145,4,0.515707824,5969,145,1,3
47820,2014/03/31,2011/07/09,502,2,0.8316941370000001,3701,502,2,0
47821,2014/03/31,2012/06/08,578,2,0.571182037,5389,578,2,0
47822,2014/03/31,2011/07/02,14,5,0.6940000000000001,4435,14,3,2
47823,2014/03/31,2006/11/01,39,3,0.599493572,5134,39,2,1
47824,2014/03/31,2009/08/25,88,5,0.448,6870,88,1,4
47825,2014/03/31,2010/10/26,215,6,0.686666667,4482,215,5,1
47826,2014/03/31,2012/03/10,139,4,0.824819083,3731,139,0,4
47827,2014/03/31,2012/04/30,228,2,0.760731768,4045,228,0,2
47828,2014/03/31,2010/04/16,537,2,0.73632448,4179,537,2,0
47829,2014/03/31,2006/11/21,227,6,0.535015652,5750,227,4,2
47830,2014/03/31,2008/05/10,534,5,0.7220422540000001,4260,534,5,0
47831,2014/03/31,2005/10/27,125,4,0.926889693,3318,125,3,1
47832,2014/03/31,2013/03/01,370,4,0.515643863,5964,370,4,0
47833,2014/03/31,2008/08/28,389,3,1.100250447,2795,389,3,0
47834,2014/03/31,2010/02/02,343,4,0.891763341,3448,343,3,1
47835,2014/03/31,2011/01/24,348,3,0.6568468279999999,4681,348,0,3
47836,2014/03/31,2012/05/27,90,4,0.90483814,3398,90,1,3
47837,2014/03/31,2011/08/17,223,4,0.766991018,4008,223,3,1
47838,2014/03/31,2008/07/22,186,4,0.531804498,5780,186,0,4
47839,2014/03/31,2013/03/05,377,2,1.175,2616,377,2,0
47840,2014/03/31,2008/03/04,84,2,0.765,4018,84,0,2
47841,2014/03/31,2013/02/10,78,5,0.383450599,8016,78,2,3
47842,2014/03/31,2010/12/14,3,8,0.514763021,5971,3,1,7
47843,2014/03/31,2011/08/01,13,5,0.901622177,3409,13,1,4
47844,2014/03/31,2010/11/26,471,4,0.6929650509999999,4435,471,4,0
47845,2014/03/31,2011/10/16,286,4,0.466764885,6584,286,0,4
47846,2014/03/31,2007/08/25,61,4,0.62270922,4935,61,3,1
47847,2014/03/31,2009/11/05,27,4,0.980210526,3135,27,3,1
47848,2014/03/31,2009/02/10,47,2,0.72,4268,47,0,2
47849,2014/03/31,2012/03/16,502,2,0.575,5344,502,2,0
47850,2014/03/31,2012/08/31,398,2,0.575,5344,398,2,0
47851,2014/03/31,2006/07/12,653,2,0.575,5344,653,2,0
47852,2014/03/31,2011/07/11,623,2,0.575,5344,623,2,0
47853,2014/03/31,2011/08/31,575,7,0.7181977559999999,4278,575,7,0
47854,2014/03/31,2012/12/07,479,2,0.575023395,5343,479,2,0
47855,2014/03/31,2010/07/26,331,2,0.55,5586,331,0,2
47856,2014/03/31,2007/03/08,697,2,0.55,5586,697,2,0
47857,2014/03/31,2012/03/24,574,2,0.55,5586,574,2,0
47858,2014/03/31,2010/10/11,241,3,0.530195029,5794,241,0,3
47859,2014/03/31,2010/01/05,169,5,0.92,3339,169,0,5
47860,2014/03/31,2010/04/07,49,5,0.8865079370000001,3465,49,2,3
47861,2014/03/31,2012/04/07,667,2,0.575,5342,667,2,0
47862,2014/03/31,2012/06/18,474,3,0.37103165,8278,474,3,0
47863,2014/03/31,2013/03/22,6,4,0.8402134059999999,3655,6,0,4
47864,2014/03/31,2007/08/11,350,3,0.588530088,5218,350,1,2
47865,2014/03/31,2007/11/05,90,4,0.45374409,6768,90,3,1
47866,2014/03/31,2010/08/10,327,2,0.45,6824,327,1,1
47867,2014/03/31,2013/01/29,170,3,0.607883587,5051,170,1,2
47868,2014/03/31,2008/02/28,160,3,0.4912,6250,160,2,1
47869,2014/03/31,2012/03/05,77,3,0.98428663,3119,77,2,1
47870,2014/03/31,2010/11/02,668,3,0.4895471220000001,6271,668,3,0
47871,2014/03/31,2008/09/04,23,3,0.740079556,4148,23,1,2
47872,2014/03/31,2008/01/28,156,3,0.7314152970000001,4197,156,2,1
47873,2014/03/31,2010/03/14,136,4,0.8225,3732,136,3,1
47874,2014/03/31,2013/03/31,236,3,0.36,8526,236,1,2
47875,2014/03/31,2011/06/29,233,3,0.508662579,6034,233,2,1
47876,2014/03/31,2010/02/27,35,5,0.8038632790000001,3818,35,1,4
47877,2014/03/31,2008/03/13,171,2,0.5,6138,171,0,2
47878,2014/03/31,2011/05/24,588,2,0.4,7672,588,2,0
47879,2014/03/31,2011/04/23,604,2,0.4,7672,604,2,0
47880,2014/03/31,2008/08/15,593,2,0.4,7672,593,2,0
47881,2014/03/31,2012/08/09,570,2,0.4,7672,570,2,0
47882,2014/03/31,2007/01/04,324,2,0.4,7672,324,0,2
47883,2014/03/31,2010/12/31,538,2,0.4,7672,538,2,0
47884,2014/03/31,2012/04/10,693,2,0.4,7672,693,2,0
47885,2014/03/31,2013/02/20,374,2,0.4,7672,374,2,0
47886,2014/03/31,2007/11/08,91,2,0.78,3934,91,1,1
47887,2014/03/31,2011/10/24,129,4,0.7461600190000001,4112,129,2,2
47888,2014/03/31,2012/12/23,13,4,0.510762444,6007,13,3,1
47889,2014/03/31,2010/02/04,630,2,1.5,2045,630,2,0
47890,2014/03/31,2008/05/05,12,6,0.593535217,5168,12,2,4
47891,2014/03/31,2010/07/17,140,2,0.836215921,3668,140,0,2
47892,2014/03/31,2012/04/15,620,4,0.969231985,3164,620,4,0
47893,2014/03/31,2012/02/24,463,5,0.488599426,6276,463,5,0
47894,2014/03/31,2010/09/19,228,3,0.871147727,3520,228,1,2
47895,2014/03/31,2013/03/17,78,3,0.276666667,11082,78,1,2
47896,2014/03/31,2010/07/28,600,3,0.691787004,4432,600,3,0
47897,2014/03/31,2011/07/01,640,2,0.525,5840,640,2,0
47898,2014/03/31,2010/12/13,149,2,0.7025068740000001,4364,149,1,1
47899,2014/03/31,2012/09/19,442,4,0.825,3716,442,4,0
47900,2014/03/31,2008/02/02,541,3,0.747816541,4099,541,3,0
47901,2014/03/31,2010/01/15,33,3,0.766608304,3998,33,0,3
47902,2014/03/31,2010/04/12,39,4,0.74010384,4141,39,3,1
47903,2014/03/31,2012/05/28,156,3,0.729155365,4203,156,1,2
47904,2014/03/31,2012/06/13,113,2,0.686338186,4465,113,1,1
47905,2014/03/31,2012/01/25,261,2,0.660562621,4639,261,0,2
47906,2014/03/31,2012/11/02,271,3,0.373390615,8205,271,1,2
47907,2014/03/31,2012/04/30,80,4,0.823540323,3720,80,2,2
47908,2014/03/31,2012/11/15,171,4,0.861020236,3558,171,2,2
47909,2014/03/31,2010/05/14,295,5,0.574021739,5336,295,1,4
47910,2014/03/31,2006/07/16,1,4,0.548194022,5587,1,1,3
47911,2014/03/31,2007/11/20,5,4,0.559163776,5477,5,0,4
47912,2014/03/31,2011/09/22,690,3,0.69639527,4397,690,3,0
47913,2014/03/31,2010/02/09,81,2,0.67,4570,81,0,2
47914,2014/03/31,2007/08/01,64,2,0.8856783340000001,3457,64,0,2
47915,2014/03/31,2012/10/10,42,9,0.334444444,9153,42,4,5
47916,2014/03/31,2011/01/17,298,3,0.734697552,4166,298,2,1
47917,2014/03/31,2011/03/04,553,3,0.784366991,3902,553,3,0
47918,2014/03/31,2007/09/24,448,5,0.867734619,3527,448,5,0
47919,2014/03/31,2011/07/31,190,6,0.386175394,7925,190,3,3
47920,2014/03/31,2012/11/21,26,3,0.949844817,3222,26,1,2
47921,2014/03/31,2009/07/08,305,9,0.808053868,3787,305,7,2
47922,2014/03/31,2011/03/02,104,4,0.523380089,5846,104,2,2
47923,2014/03/31,2011/02/02,245,3,0.524789022,5830,245,2,1
47924,2014/03/31,2006/07/10,195,3,0.7528075790000001,4064,195,0,3
47925,2014/03/31,2011/11/08,174,4,0.4925,6212,174,0,4
47926,2014/03/31,2012/03/09,4,4,0.847575506,3609,4,3,1
47927,2014/03/31,2010/04/08,243,3,0.668152031,4578,243,1,2
47928,2014/03/31,2010/09/30,2,13,0.630769231,4849,2,1,12
47929,2014/03/31,2012/07/21,155,6,0.8833333329999999,3462,155,1,5
47930,2014/03/31,2012/07/01,56,3,0.770463593,3969,56,1,2
47931,2014/03/31,2010/06/02,130,4,0.469995389,6506,130,0,4
47932,2014/03/31,2008/03/16,289,4,0.477507418,6403,289,3,1
47933,2014/03/31,2012/08/29,152,2,0.865628539,3532,152,0,2
47934,2014/03/31,2011/01/28,388,2,0.823155627,3714,388,2,0
47935,2014/03/31,2012/09/17,11,4,0.390883519,7821,11,3,1
47936,2014/03/31,2005/05/21,11,5,0.498307793,6134,11,0,5
47937,2014/03/31,2007/02/02,322,3,0.7404190890000001,4128,322,2,1
47938,2014/03/31,2010/04/07,657,4,1.0,3056,657,4,0
47939,2014/03/31,2006/05/25,431,5,0.591769946,5164,431,5,0
47940,2014/03/31,2012/11/22,104,3,0.700681036,4361,104,2,1
47941,2014/03/31,2010/01/23,519,3,0.573891811,5324,519,3,0
47942,2014/03/31,2013/03/02,396,2,0.6,5092,396,2,0
47943,2014/03/31,2006/03/23,43,3,0.517813559,5900,43,0,3
47944,2014/03/31,2012/08/10,599,2,0.7708554129999999,3963,599,2,0
47945,2014/03/31,2012/11/02,228,4,0.468515337,6520,228,0,4
47946,2014/03/31,2008/08/15,89,5,0.464940639,6570,89,1,4
47947,2014/03/31,2012/08/10,205,3,0.640492766,4769,205,1,2
47948,2014/03/31,2006/12/07,554,2,0.7253383990000001,4211,554,2,0
47949,2014/03/31,2011/09/17,340,4,0.527330801,5792,340,0,4
47950,2014/03/31,2011/12/19,249,4,0.659386874,4632,249,1,3
47951,2014/03/31,2012/09/18,199,2,0.964992101,3165,199,1,1
47952,2014/03/31,2008/09/17,354,5,0.824541037,3704,354,4,1
47953,2014/03/31,2013/01/25,125,2,0.77,3966,125,0,2
47954,2014/03/31,2012/09/15,326,5,0.559706691,5455,326,4,1
47955,2014/03/31,2006/11/29,176,2,0.735,4154,176,1,1
47956,2014/03/31,2008/03/10,163,2,0.549888329,5552,163,0,2
47957,2014/03/31,2010/03/17,228,6,0.829103748,3682,228,5,1
47958,2014/03/31,2011/11/04,276,2,0.7273576359999999,4197,276,0,2
47959,2014/03/31,2012/05/06,530,6,0.80218134,3805,530,6,0
47960,2014/03/31,2008/09/19,305,3,0.824277613,3703,305,2,1
47961,2014/03/31,2012/06/14,646,3,0.571233389,5343,646,3,0
47962,2014/03/31,2012/06/14,646,3,0.571233389,5343,646,3,0
47963,2014/03/31,2012/06/14,646,3,0.571233389,5343,646,3,0
47964,2014/03/31,2011/08/20,79,3,0.559801908,5452,79,2,1
47965,2014/03/31,2010/06/02,695,2,1.0,3052,695,2,0
47966,2014/03/31,2008/10/24,553,2,1.0,3052,553,2,0
47967,2014/03/31,2012/01/09,1,3,0.476666667,6402,1,2,1
47968,2014/03/31,2012/05/08,124,6,0.411364249,7418,124,4,2
47969,2014/03/31,2011/07/19,36,4,0.485098569,6290,36,1,3
47970,2014/03/31,2012/08/27,440,4,0.4889823720000001,6240,440,4,0
47971,2014/03/31,2012/12/12,35,5,0.470123267,6490,35,0,5
47972,2014/03/31,2009/10/21,411,2,1.255555556,2430,411,2,0
47973,2014/03/31,2010/07/30,269,3,1.09,2799,269,2,1
47974,2014/03/31,2010/07/25,519,3,0.8838017970000001,3451,519,3,0
47975,2014/03/31,2012/02/23,370,2,0.915076508,3333,370,2,0
47976,2014/03/31,2012/07/25,609,2,0.65,4692,609,2,0
47977,2014/03/31,2010/05/19,259,3,0.60389186,5049,259,2,1
47978,2014/03/31,2011/04/10,256,5,0.457736076,6661,256,3,2
47979,2014/03/31,2008/09/11,382,2,0.76376503,3992,382,2,0
47980,2014/03/31,2007/08/11,529,2,0.775,3934,529,2,0
47981,2014/03/31,2011/04/12,532,2,0.775,3934,532,2,0
47982,2014/03/31,2013/01/31,397,2,0.775,3934,397,2,0
47983,2014/03/31,2013/03/07,3,4,0.84992194,3587,3,1,3
47984,2014/03/31,2010/02/22,90,4,0.583410526,5225,90,1,3
47985,2014/03/31,2012/11/16,256,2,0.496245523,6142,256,1,1
47986,2014/03/31,2012/11/04,332,4,0.7267588840000001,4193,332,3,1
47987,2014/03/31,2011/08/03,260,3,0.557497256,5466,260,2,1
47988,2014/03/31,2009/12/06,163,5,0.520604818,5853,163,4,1
47989,2014/03/31,2010/03/08,500,2,0.875826387,3479,500,2,0
47990,2014/03/31,2010/09/11,218,2,0.85,3584,218,0,2
47991,2014/03/31,2013/01/08,226,3,0.798042453,3816,226,1,2
47992,2014/03/31,2012/08/29,196,3,0.8008521829999999,3802,196,0,3
47993,2014/03/31,2006/01/04,41,6,0.665316871,4576,41,0,6
47994,2014/03/31,2011/10/21,296,6,0.8190610709999999,3717,296,5,1
47995,2014/03/31,2005/02/24,255,7,0.369961113,8229,255,5,2
47996,2014/03/31,2006/10/12,221,4,0.490572119,6205,221,2,2
47997,2014/03/31,2008/12/05,82,5,0.6983000690000001,4359,82,4,1
47998,2014/03/31,2011/10/20,111,5,0.829122855,3671,111,3,2
47999,2014/03/31,2012/12/12,4,2,0.877880012,3467,4,1,1
48000,2014/03/31,2011/07/01,131,3,0.550374322,5530,131,0,3
48001,2014/03/31,2011/02/26,220,5,0.732855767,4153,220,4,1
48002,2014/03/31,2012/07/21,289,5,0.630993158,4823,289,2,3
48003,2014/03/31,2004/11/16,170,3,0.7990651259999999,3808,170,0,3
48004,2014/03/31,2010/06/20,72,5,0.740150815,4111,72,3,2
48005,2014/03/31,2008/02/17,7,4,0.703365696,4326,7,2,2
48006,2014/03/31,2011/07/09,109,3,0.6727039579999999,4523,109,2,1
48007,2014/03/31,2010/10/24,243,2,0.8263443779999999,3682,243,0,2
48008,2014/03/31,2008/08/30,90,2,0.755655738,4026,90,0,2
48009,2014/03/31,2011/12/02,266,4,0.595458994,5109,266,3,1
48010,2014/03/31,2012/09/19,327,3,0.72777512,4180,327,1,2
48011,2014/03/31,2009/10/31,9,5,0.604905548,5029,9,2,3
48012,2014/03/31,2011/01/13,455,5,0.57799734,5263,455,5,0
48013,2014/03/31,2005/02/23,206,3,0.7934063640000001,3834,206,2,1
48014,2014/03/31,2007/10/26,57,2,0.7956604759999999,3823,57,0,2
48015,2014/03/31,2012/12/13,441,4,0.639218159,4758,441,4,0
48016,2014/03/31,2011/03/28,177,2,0.6158505470000001,4938,177,0,2
48017,2014/03/31,2009/06/03,183,2,0.535,5684,183,0,2
48018,2014/03/31,2013/03/27,104,2,0.544065128,5589,104,1,1
48019,2014/03/31,2009/10/30,20,5,0.511015126,5950,20,1,4
48020,2014/03/31,2007/10/18,353,4,0.554156034,5486,353,3,1
48021,2014/03/31,2010/08/01,689,2,1.0,3040,689,2,0
48022,2014/03/31,2008/02/01,47,4,0.552337332,5502,47,1,3
48023,2014/03/31,2009/02/13,15,4,0.552501818,5500,15,2,2
48024,2014/03/31,2005/04/13,492,4,0.8125,3740,492,4,0
48025,2014/03/31,2011/01/13,93,3,0.69935328,4345,93,1,2
48026,2014/03/31,2007/09/14,525,2,0.75136004,4044,525,2,0
48027,2014/03/31,2013/03/23,170,4,0.7125750470000001,4264,170,2,2
48028,2014/03/31,2012/05/11,97,5,0.612864636,4957,97,2,3
48029,2014/03/31,2013/02/26,179,5,0.869195994,3495,179,1,4
48030,2014/03/31,2011/11/08,465,4,0.908916816,3342,465,4,0
48031,2014/03/31,2006/05/27,47,2,0.675,4500,47,0,2
48032,2014/03/31,2007/03/22,633,2,0.675,4500,633,2,0
48033,2014/03/31,2007/11/07,67,5,0.6021134020000001,5044,67,2,3
48034,2014/03/31,2007/06/22,628,3,0.900385414,3373,628,3,0
48035,2014/03/31,2013/03/26,294,3,0.693333333,4380,294,1,2
48036,2014/03/31,2012/09/01,295,4,0.7435577859999999,4084,295,3,1
48037,2014/03/31,2008/04/20,575,3,0.966666667,3141,575,3,0
48038,2014/03/31,2007/03/28,240,4,0.909041916,3340,240,2,2
48039,2014/03/31,2007/06/01,242,3,0.6459787229999999,4700,242,1,2
48040,2014/03/31,2010/05/13,88,2,0.903864245,3359,88,0,2
48041,2014/03/31,2012/12/14,257,6,0.646215411,4698,257,3,3
48042,2014/03/31,2012/02/27,282,3,0.960696203,3160,282,1,2
48043,2014/03/31,2009/09/27,480,3,0.711937148,4264,480,3,0
48044,2014/03/31,2012/10/11,520,3,0.549131693,5528,520,3,0
48045,2014/03/31,2012/08/26,231,10,0.5761769170000001,5268,231,7,3
48046,2014/03/31,2005/11/26,611,5,0.766464646,3960,611,5,0
48047,2014/03/31,2012/05/19,89,8,0.475267773,6386,89,3,5
48048,2014/03/31,2006/07/19,81,5,0.584211742,5195,81,0,5
48049,2014/03/31,2012/08/12,35,4,0.397370695,7637,35,3,1
48050,2014/03/31,2012/04/09,87,4,0.56695441,5352,87,3,1
48051,2014/03/31,2012/08/09,219,3,0.391615901,7748,219,0,3
48052,2014/03/31,2006/05/01,198,6,0.490638745,6184,198,2,4
48053,2014/03/31,2013/01/10,429,4,0.833287558,3641,429,4,0
48054,2014/03/31,2012/07/31,568,2,0.90919988,3337,568,2,0
48055,2014/03/31,2009/06/16,684,3,0.7444417179999999,4075,684,3,0
48056,2014/03/31,2011/03/29,155,10,0.412769084,7349,155,6,4
48057,2014/03/31,2012/06/01,664,3,0.849691877,3570,664,3,0
48058,2014/03/31,2010/10/06,79,2,0.765039092,3965,79,0,2
48059,2014/03/31,2012/07/20,186,2,0.766245579,3958,186,1,1
48060,2014/03/31,2009/10/09,309,3,0.7356623000000001,4122,309,1,2
48061,2014/03/31,2007/04/05,158,2,0.683856563,4434,158,1,1
48062,2014/03/31,2008/10/15,172,5,0.677121483,4478,172,4,1
48063,2014/03/31,2011/01/15,622,2,0.725,4182,622,2,0
48064,2014/03/31,2011/10/26,65,6,0.563945313,5376,65,3,3
48065,2014/03/31,2009/03/19,87,4,0.963355577,3147,87,2,2
48066,2014/03/31,2006/11/06,37,3,0.623066804,4865,37,2,1
48067,2014/03/31,2011/06/07,460,4,0.560399334,5409,460,4,0
48068,2014/03/31,2011/08/13,182,4,0.53743617,5640,182,1,3
48069,2014/03/31,2012/10/26,11,3,0.652687339,4644,11,1,2
48070,2014/03/31,2008/05/08,116,4,0.658212812,4605,116,0,4
48071,2014/03/31,2010/06/03,527,2,1.0,3031,527,2,0
48072,2014/03/31,2011/06/10,471,6,0.658913043,4600,471,6,0
48073,2014/03/31,2011/12/25,4,2,0.87824109,3451,4,1,1
48074,2014/03/31,2006/07/16,24,3,0.615638838,4923,24,0,3
48075,2014/03/31,2012/04/21,28,3,1.050620666,2884,28,2,1
48076,2014/03/31,2011/09/03,8,4,0.566514585,5348,8,0,4
48077,2014/03/31,2012/07/18,618,2,0.663803681,4564,618,2,0
48078,2014/03/31,2007/05/03,98,4,0.571569811,5300,98,0,4
48079,2014/03/31,2012/12/10,86,2,0.8949187590000001,3385,86,0,2
48080,2014/03/31,2006/11/10,44,2,0.77,3934,44,0,2
48081,2014/03/31,2008/09/11,390,3,0.832627817,3638,390,3,0
48082,2014/03/31,2012/01/01,172,4,0.512014875,5916,172,1,3
48083,2014/03/31,2006/06/09,161,3,0.84,3606,161,2,1
48084,2014/03/31,2011/01/28,210,4,0.584878331,5178,210,2,2
48085,2014/03/31,2009/07/20,189,4,0.738814345,4099,189,2,2
48086,2014/03/31,2007/08/24,278,3,0.677463087,4470,278,2,1
48087,2014/03/31,2012/11/25,80,2,0.78,3882,80,1,1
48088,2014/03/31,2011/08/10,639,2,0.644054456,4701,639,2,0
48089,2014/03/31,2010/12/13,480,2,0.725125749,4175,480,2,0
48090,2014/03/31,2012/05/23,194,5,0.272416307,11112,194,1,4
48091,2014/03/31,2012/01/07,287,3,0.540342735,5602,287,1,2
48092,2014/03/31,2012/12/25,25,3,0.8817244390000001,3433,25,0,3
48093,2014/03/31,2011/01/13,401,2,0.911183022,3322,401,2,0
48094,2014/03/31,2012/01/01,178,5,0.9,3363,178,3,2
48095,2014/03/31,2012/10/20,201,4,0.6952906040000001,4353,201,3,1
48096,2014/03/31,2011/12/17,167,2,0.905330541,3343,167,1,1
48097,2014/03/31,2012/05/02,15,5,0.398400474,7596,15,0,5
48098,2014/03/31,2006/02/19,459,5,0.57563249,5257,459,5,0
48099,2014/03/31,2010/01/15,272,6,0.8073505870000001,3748,272,4,2
48100,2014/03/31,2012/03/15,186,2,0.92,3289,186,0,2
48101,2014/03/31,2010/08/14,161,5,0.640387302,4725,161,4,1
48102,2014/03/31,2012/11/27,55,2,0.8212676440000001,3684,55,0,2
48103,2014/03/31,2011/11/18,9,4,0.608511665,4972,9,1,3
48104,2014/03/31,2010/07/20,344,3,0.682900677,4430,344,2,1
48105,2014/03/31,2006/05/16,15,10,0.5489999999999999,5510,15,0,10
48106,2014/03/31,2008/12/09,63,3,0.592053239,5109,63,0,3
48107,2014/03/31,2010/11/03,361,6,0.366630303,8250,361,3,3
48108,2014/03/31,2005/08/11,319,3,0.733365664,4124,319,1,2
48109,2014/03/31,2011/10/12,174,4,0.54,5600,174,1,3
48110,2014/03/31,2010/12/13,70,2,0.7242706590000001,4175,70,0,2
48111,2014/03/31,2006/06/06,501,2,0.726381547,4162,501,2,0
48112,2014/03/31,2005/10/22,9,3,0.658775332,4589,9,0,3
48113,2014/03/31,2012/10/21,366,2,0.524661576,5762,366,1,1
48114,2014/03/31,2012/11/20,87,2,0.515,5870,87,1,1
48115,2014/03/31,2010/11/20,165,3,0.652779097,4631,165,0,3
48116,2014/03/31,2010/03/13,202,4,0.81,3732,202,2,2
48117,2014/03/31,2011/07/29,168,4,0.563940299,5360,168,3,1
48118,2014/03/31,2013/01/19,64,3,0.6728450579999999,4492,64,1,2
48119,2014/03/31,2012/04/19,708,2,0.817473627,3697,708,2,0
48120,2014/03/31,2012/09/06,328,4,0.575209364,5254,328,2,2
48121,2014/03/31,2011/04/21,185,4,0.553603224,5459,185,0,4
48122,2014/03/31,2013/03/22,72,4,0.5875,5144,72,0,4
48123,2014/03/31,2013/01/15,228,2,0.55,5494,228,0,2
48124,2014/03/31,2007/10/01,138,6,0.426240655,7089,138,2,4
48125,2014/03/31,2011/06/01,5,6,0.593878514,5087,5,2,4
48126,2014/03/31,2009/03/19,176,4,0.618668578,4882,176,0,4
48127,2014/03/31,2010/06/12,276,3,0.721845124,4184,276,1,2
48128,2014/03/31,2012/11/11,320,4,0.438083841,6894,320,3,1
48129,2014/03/31,2012/06/25,236,6,0.6039052189999999,5001,236,5,1
48130,2014/03/31,2013/03/07,187,4,0.624175279,4838,187,1,3
48131,2014/03/31,2010/02/11,11,4,0.617890321,4887,11,1,3
48132,2014/03/31,2007/06/12,516,2,0.884734837,3413,516,2,0
48133,2014/03/31,2008/10/24,120,2,0.565,5344,120,1,1
48134,2014/03/31,2012/04/24,490,4,0.426033583,7087,490,4,0
48135,2014/03/31,2007/03/12,216,4,0.7733837090000001,3904,216,0,4
48136,2014/03/31,2011/11/11,542,2,0.8,3774,542,2,0
48137,2014/03/31,2010/06/29,458,3,0.7835452890000001,3853,458,3,0
48138,2014/03/31,2012/01/28,197,3,0.862542857,3500,197,2,1
48139,2014/03/31,2008/04/16,365,2,0.65,4644,365,1,1
48140,2014/03/31,2012/07/24,474,4,0.7344282240000001,4110,474,4,0
48141,2014/03/31,2010/11/27,173,4,0.450641983,6698,173,1,3
48142,2014/03/31,2005/08/20,33,5,0.477245414,6324,33,3,2
48143,2014/03/31,2005/06/23,8,5,0.565285634,5339,8,1,4
48144,2014/03/31,2007/11/05,460,5,0.664117518,4544,460,5,0
48145,2014/03/31,2010/11/09,165,2,0.74,4078,165,0,2
48146,2014/03/31,2007/05/14,69,6,0.569332075,5300,69,1,5
48147,2014/03/31,2005/07/03,637,2,1.3,2321,637,2,0
48148,2014/03/31,2011/03/14,127,4,0.776576577,3885,127,1,3
48149,2014/03/31,2009/10/20,390,3,0.671455598,4493,390,3,0
48150,2014/03/31,2007/11/30,6,3,0.76664803,3935,6,0,3
48151,2014/03/31,2008/03/05,113,2,0.775776749,3888,113,0,2
48152,2014/03/31,2012/02/16,171,8,0.65,4640,171,4,4
48153,2014/03/31,2008/08/30,272,2,0.7304310970000001,4129,272,1,1
48154,2014/03/31,2009/08/13,222,5,0.6557621220000001,4599,222,4,1
48155,2014/03/31,2005/07/23,329,4,0.85,3548,329,3,1
48156,2014/03/31,2010/04/05,27,3,0.799729515,3771,27,1,2
48157,2014/03/31,2009/03/02,300,3,0.6242670810000001,4830,300,0,3
48158,2014/03/31,2006/06/09,568,2,0.75,4020,568,2,0
48159,2014/03/31,2009/04/10,9,4,0.654982616,4602,9,1,3
48160,2014/03/31,2012/02/23,82,3,0.7855121190000001,3837,82,0,3
48161,2014/03/31,2012/05/31,551,3,0.782857143,3850,551,3,0
48162,2014/03/31,2007/07/10,219,3,0.84,3588,219,2,1
48163,2014/03/31,2012/05/03,693,2,0.961371611,3135,693,2,0
48164,2014/03/31,2006/08/07,30,3,0.7383243509999999,4082,30,1,2
48165,2014/03/31,2008/07/24,20,5,0.774130491,3893,20,0,5
48166,2014/03/31,2009/11/08,250,5,0.887361602,3396,250,4,1
48167,2014/03/31,2012/07/07,102,3,0.758454568,3973,102,1,2
48168,2014/03/31,2010/05/13,1,3,0.7000650559999999,4304,1,0,3
48169,2014/03/31,2009/07/15,126,6,0.5403533,5576,126,4,2
48170,2014/03/31,2010/11/02,44,2,0.890064993,3385,44,0,2
48171,2014/03/31,2011/04/27,318,3,0.58543529,5146,318,2,1
48172,2014/03/31,2012/10/26,521,2,0.8664365829999999,3477,521,2,0
48173,2014/03/31,2012/07/06,93,3,0.59,5106,93,1,2
48174,2014/03/31,2009/04/22,164,4,0.65943958,4568,164,2,2
48175,2014/03/31,2006/11/24,419,4,0.717778837,4196,419,4,0
48176,2014/03/31,2013/02/28,198,5,0.751809785,4006,198,1,4
48177,2014/03/31,2008/06/28,561,2,0.725,4154,561,2,0
48178,2014/03/31,2005/11/27,576,2,0.725,4154,576,2,0
48179,2014/03/31,2012/12/23,192,2,0.725,4154,192,1,1
48180,2014/03/31,2012/09/19,20,2,0.725,4154,20,0,2
48181,2014/03/31,2011/01/21,332,4,0.632143607,4763,332,2,2
48182,2014/03/31,2012/10/24,115,9,0.6245560170000001,4820,115,4,5
48183,2014/03/31,2007/09/18,340,3,0.716666667,4200,340,1,2
48184,2014/03/31,2007/07/01,332,3,0.568783069,5292,332,1,2
48185,2014/03/31,2010/08/13,211,6,0.741559497,4059,211,5,1
48186,2014/03/31,2010/10/25,69,4,0.676997301,4446,69,2,2
48187,2014/03/31,2012/11/03,390,2,0.8,3762,390,2,0
48188,2014/03/31,2011/08/15,477,2,0.8,3762,477,2,0
48189,2014/03/31,2006/04/20,6,3,0.51,5901,6,2,1
48190,2014/03/31,2006/05/15,86,2,0.765,3934,86,0,2
48191,2014/03/31,2005/01/20,247,5,0.617331282,4875,247,2,3
48192,2014/03/31,2005/10/15,86,4,0.767897423,3919,86,1,3
48193,2014/03/31,2009/01/01,168,3,0.623426559,4827,168,1,2
48194,2014/03/31,2011/04/29,683,2,0.79778632,3772,683,2,0
48195,2014/03/31,2011/10/26,161,4,0.874738372,3440,161,2,2
48196,2014/03/31,2011/04/24,97,5,0.719808612,4180,97,4,1
48197,2014/03/31,2009/08/30,418,2,0.6019207679999999,4998,418,2,0
48198,2014/03/31,2010/04/29,281,2,0.845,3560,281,0,2
48199,2014/03/31,2011/09/02,492,2,0.85,3539,492,2,0
48200,2014/03/31,2012/12/17,460,2,0.85,3539,460,2,0
48201,2014/03/31,2012/11/23,482,2,0.85,3539,482,2,0
48202,2014/03/31,2012/04/17,32,4,0.5946115829999999,5059,32,2,2
48203,2014/03/31,2010/03/12,45,2,0.555,5420,45,0,2
48204,2014/03/31,2009/08/08,485,2,0.636737934,4724,485,2,0
48205,2014/03/31,2010/04/30,529,5,1.098028478,2739,529,5,0
48206,2014/03/31,2012/09/11,151,5,0.761176917,3951,151,3,2
48207,2014/03/31,2011/07/05,216,5,0.554064861,5427,216,3,2
48208,2014/03/31,2012/02/12,617,4,0.48611156,6185,617,4,0
48209,2014/03/31,2010/11/19,79,2,0.7429058559999999,4047,79,0,2
48210,2014/03/31,2009/05/23,242,2,0.936479751,3210,242,0,2
48211,2014/03/31,2006/06/01,492,2,0.743199802,4044,492,2,0
48212,2014/03/31,2011/05/20,21,3,0.602638861,4987,21,0,3
48213,2014/03/31,2008/10/16,198,4,0.372811066,8061,198,2,2
48214,2014/03/31,2010/11/01,467,4,0.43948523,6838,467,4,0
48215,2014/03/31,2012/03/02,678,4,1.0,3005,678,4,0
48216,2014/03/31,2009/07/17,34,7,0.544260098,5521,34,2,5
48217,2014/03/31,2005/01/05,234,3,0.6951735309999999,4322,234,0,3
48218,2014/03/31,2013/03/19,7,13,0.398461538,7540,7,0,13
48219,2014/03/31,2007/10/11,190,4,0.7352422909999999,4086,190,1,3
48220,2014/03/31,2008/09/15,401,3,0.870724638,3450,401,3,0
48221,2014/03/31,2011/08/09,581,4,0.794656085,3780,581,4,0
48222,2014/03/31,2008/07/11,96,2,0.885,3394,96,0,2
48223,2014/03/31,2012/06/26,338,6,0.5191875539999999,5785,338,5,1
48224,2014/03/31,2011/09/10,282,4,0.747220702,4019,282,2,2
48225,2014/03/31,2008/10/31,205,2,0.943449576,3183,205,0,2
48226,2014/03/31,2011/08/08,512,4,0.433241956,6931,512,4,0
48227,2014/03/31,2008/09/06,11,5,0.43244995,6943,11,1,4
48228,2014/03/31,2012/07/03,300,5,0.646753555,4642,300,1,4
48229,2014/03/31,2012/09/29,178,5,0.489742251,6130,178,2,3
48230,2014/03/31,2007/03/04,531,4,0.6589223000000001,4556,531,4,0
48231,2014/03/31,2012/11/07,307,3,0.671243292,4472,307,2,1
48232,2014/03/31,2006/12/02,351,3,0.926450617,3240,351,2,1
48233,2014/03/31,2011/06/25,107,2,0.782869066,3834,107,0,2
48234,2014/03/31,2011/12/26,588,3,0.7755038759999999,3870,588,3,0
48235,2014/03/31,2008/03/31,1,2,0.8047948509999999,3729,1,0,2
48236,2014/03/31,2012/11/29,398,3,0.669433289,4482,398,3,0
48237,2014/03/31,2008/01/18,217,4,0.631125368,4754,217,2,2
48238,2014/03/31,2010/02/01,418,2,0.715430479,4193,418,2,0
48239,2014/03/31,2009/11/19,500,2,0.55,5454,500,2,0
48240,2014/03/31,2013/01/05,225,3,0.726666667,4128,225,0,3
48241,2014/03/31,2010/12/28,27,5,0.510929995,5871,27,1,4
48242,2014/03/31,2007/02/23,45,3,0.7605147059999999,3944,45,0,3
48243,2014/03/31,2007/06/20,445,3,0.448072901,6694,445,3,0
48244,2014/03/31,2011/02/20,179,5,0.805846319,3722,179,3,2
48245,2014/03/31,2012/08/28,528,3,1.0,2999,528,3,0
48246,2014/03/31,2011/01/22,318,3,1.0,2999,318,2,1
48247,2014/03/31,2008/05/19,184,3,0.91317905,3284,184,1,2
48248,2014/03/31,2007/03/25,18,4,0.912236082,3287,18,1,3
48249,2014/03/31,2009/11/24,204,4,0.545,5500,204,3,1
48250,2014/03/31,2013/03/20,328,2,0.661542706,4531,328,1,1
48251,2014/03/31,2012/03/19,213,5,0.41852095,7160,213,3,2
48252,2014/03/31,2011/12/27,181,5,0.573699024,5223,181,4,1
48253,2014/03/31,2009/10/12,151,4,0.714624374,4193,151,2,2
48254,2014/03/31,2013/02/25,48,3,0.867192475,3455,48,1,2
48255,2014/03/31,2008/01/23,533,3,0.648182605,4622,533,3,0
48256,2014/03/31,2013/02/10,30,4,0.579325082,5171,30,1,3
48257,2014/03/31,2009/12/12,7,2,0.649040087,4615,7,0,2
48258,2014/03/31,2009/10/19,91,4,0.727481176,4117,91,3,1
48259,2014/03/31,2011/09/28,187,5,0.7836185240000001,3822,187,0,5
48260,2014/03/31,2009/07/06,132,4,0.8025,3732,132,0,4
48261,2014/03/31,2005/04/08,198,3,0.627838574,4770,198,2,1
48262,2014/03/31,2012/04/20,712,2,0.875387314,3421,712,2,0
48263,2014/03/31,2011/11/29,613,2,1.05,2852,613,2,0
48264,2014/03/31,2007/07/01,157,2,0.824958678,3630,157,0,2
48265,2014/03/31,2009/10/04,466,4,0.761908397,3930,466,4,0
48266,2014/03/31,2012/04/06,686,3,0.653327515,4583,686,3,0
48267,2014/03/31,2012/11/01,515,2,1.0,2994,515,2,0
48268,2014/03/31,2007/12/19,490,4,0.6911241920000001,4332,490,4,0
48269,2014/03/31,2009/08/30,110,3,0.7236113129999999,4137,110,1,2
48270,2014/03/31,2012/07/10,380,3,0.664166852,4507,380,3,0
48271,2014/03/31,2011/08/11,245,4,0.648157211,4618,245,1,3
48272,2014/03/31,2012/12/09,325,4,0.502670474,5954,325,1,3
48273,2014/03/31,2012/10/22,38,4,0.9265386999999998,3230,38,1,3
48274,2014/03/31,2013/03/07,231,4,0.9225,3244,231,2,2
48275,2014/03/31,2012/05/16,94,5,0.738,4055,94,4,1
48276,2014/03/31,2012/05/11,398,3,0.462948639,6464,398,3,0
48277,2014/03/31,2009/06/17,113,4,0.6618579960000001,4521,113,1,3
48278,2014/03/31,2008/06/21,256,2,0.776967022,3851,256,1,1
48279,2014/03/31,2012/07/31,234,2,0.39,7672,234,1,1
48280,2014/03/31,2012/06/21,465,4,0.619857054,4827,465,4,0
48281,2014/03/31,2012/06/26,185,3,0.534271429,5600,185,2,1
48282,2014/03/31,2010/12/13,96,4,0.582590068,5135,96,0,4
48283,2014/03/31,2012/03/05,158,3,0.687980681,4348,158,1,2
48284,2014/03/31,2008/12/08,8,2,0.53,5644,8,0,2
48285,2014/03/31,2005/04/07,122,2,0.53,5644,122,0,2
48286,2014/03/31,2005/12/01,226,2,0.66,4532,226,1,1
48287,2014/03/31,2007/06/06,685,3,1.0,2991,685,3,0
48288,2014/03/31,2012/12/01,343,3,1.0,2991,343,2,1
48289,2014/03/31,2010/11/29,50,2,0.72,4154,50,0,2
48290,2014/03/31,2011/11/01,4,6,0.5612481229999999,5328,4,0,6
48291,2014/03/31,2012/01/12,3,10,0.7240000000000001,4130,3,3,7
48292,2014/03/31,2009/05/06,347,5,0.564567598,5296,347,4,1
48293,2014/03/31,2005/03/17,146,2,0.76,3934,146,0,2
48294,2014/03/31,2011/07/24,129,2,0.76,3934,129,0,2
48295,2014/03/31,2008/12/11,32,4,0.6553431270000001,4561,32,1,3
48296,2014/03/31,2011/07/18,200,3,0.681781478,4384,200,1,2
48297,2014/03/31,2011/11/19,81,4,0.402452195,7426,81,0,4
48298,2014/03/31,2012/08/27,284,5,0.578513069,5165,284,3,2
48299,2014/03/31,2010/03/04,319,3,0.4810417,6211,319,2,1
48300,2014/03/31,2009/11/11,402,2,0.7,4268,402,2,0
48301,2014/03/31,2008/06/08,173,4,0.695573923,4295,173,0,4
48302,2014/03/31,2008/08/09,139,6,0.425380891,7023,139,2,4
48303,2014/03/31,2006/02/23,151,3,0.973565841,3068,151,0,3
48304,2014/03/31,2012/05/12,585,2,0.7,4267,585,2,0
48305,2014/03/31,2012/01/22,412,3,0.730626223,4088,412,3,0
48306,2014/03/31,2010/11/25,4,4,0.6331927070000001,4717,4,1,3
48307,2014/03/31,2006/04/11,242,2,0.54728972,5457,242,1,1
48308,2014/03/31,2012/07/04,429,5,0.772271081,3866,429,5,0
48309,2014/03/31,2012/01/15,419,3,0.417318982,7154,419,3,0
48310,2014/03/31,2009/11/02,363,2,0.827154336,3609,363,1,1
48311,2014/03/31,2010/04/30,44,5,0.7145750540000001,4177,44,2,3
48312,2014/03/31,2011/01/04,349,5,0.857847082,3479,349,3,2
48313,2014/03/31,2012/12/24,4,4,0.8447127090000001,3533,4,0,4
48314,2014/03/31,2011/08/19,145,3,0.729806799,4089,145,1,2
48315,2014/03/31,2013/02/12,371,2,0.525,5684,371,2,0
48316,2014/03/31,2012/05/19,680,2,0.525,5684,680,2,0
48317,2014/03/31,2012/04/07,702,2,0.525,5684,702,2,0
48318,2014/03/31,2008/05/18,340,2,0.525,5684,340,0,2
48319,2014/03/31,2012/12/19,342,4,1.0,2984,342,2,2
48320,2014/03/31,2008/02/28,157,2,0.640543152,4658,157,1,1
48321,2014/03/31,2013/03/19,124,5,0.456690647,6533,124,0,5
48322,2014/03/31,2012/11/18,282,7,0.882698225,3380,282,4,3
48323,2014/03/31,2010/11/14,56,3,0.54602306,5464,56,0,3
48324,2014/03/31,2011/01/23,457,4,0.42645461,6995,457,4,0
48325,2014/03/31,2009/03/19,111,3,0.589766706,5058,111,0,3
48326,2014/03/31,2010/07/08,291,2,0.5,5966,291,1,1
48327,2014/03/31,2011/10/29,267,3,0.639245607,4666,267,1,2
48328,2014/03/31,2011/03/13,221,2,0.778772846,3830,221,1,1
48329,2014/03/31,2012/09/20,4,6,0.573006724,5205,4,5,1
48330,2014/03/31,2006/05/05,194,5,0.815303445,3658,194,0,5
48331,2014/03/31,2007/03/08,37,3,0.582063244,5123,37,0,3
48332,2014/03/31,2011/09/16,2,4,0.5887677729999999,5064,2,2,2
48333,2014/03/31,2010/12/20,202,3,0.805332253,3702,202,0,3
48334,2014/03/31,2012/11/05,345,3,0.729909403,4084,345,2,1
48335,2014/03/31,2007/10/27,554,2,0.620870652,4801,554,2,0
48336,2014/03/31,2013/01/23,198,3,0.69,4320,198,1,2
48337,2014/03/31,2011/06/05,46,5,0.577993019,5157,46,3,2
48338,2014/03/31,2008/01/08,350,3,0.51134843,5829,350,0,3
48339,2014/03/31,2011/10/01,678,2,0.7,4258,678,2,0
48340,2014/03/31,2011/10/18,219,3,0.61668322,4833,219,1,2
48341,2014/03/31,2012/02/26,101,5,0.582211369,5119,101,4,1
48342,2014/03/31,2009/08/17,376,3,0.6411574870000001,4648,376,3,0
48343,2014/03/31,2012/04/26,504,2,1.32033673,2257,504,2,0
48344,2014/03/31,2010/09/16,47,3,0.6466666670000001,4608,47,1,2
48345,2014/03/31,2013/01/15,351,4,0.7375,4040,351,3,1
48346,2014/03/31,2008/06/08,383,3,0.878101975,3393,383,3,0
48347,2014/03/31,2011/01/24,367,2,0.7,4256,367,2,0
48348,2014/03/31,2010/08/24,321,4,0.737243257,4041,321,1,3
48349,2014/03/31,2013/01/21,143,3,0.746292585,3992,143,0,3
48350,2014/03/31,2009/02/13,267,5,0.5098237210000001,5843,267,3,2
48351,2014/03/31,2007/05/09,490,3,0.64336933,4630,490,3,0
48352,2014/03/31,2013/01/19,39,5,0.442151128,6736,39,1,4
48353,2014/03/31,2005/06/16,319,5,0.5008745379999999,5946,319,0,5
48354,2014/03/31,2007/04/02,246,4,0.845359069,3523,246,1,3
48355,2014/03/31,2008/12/06,275,3,0.743468165,4005,275,2,1
48356,2014/03/31,2006/01/17,147,2,0.672445799,4428,147,1,1
48357,2014/03/31,2007/03/15,178,2,0.913051211,3261,178,0,2
48358,2014/03/31,2012/03/18,434,7,0.403941121,7371,434,7,0
48359,2014/03/31,2012/01/03,610,2,0.726018044,4101,610,2,0
48360,2014/03/31,2007/11/30,518,4,0.641573276,4640,518,4,0
48361,2014/03/31,2012/07/04,70,3,0.565304843,5265,70,2,1
48362,2014/03/31,2012/09/16,9,5,0.586725158,5072,9,2,3
48363,2014/03/31,2011/01/10,117,6,0.801675647,3712,117,2,4
48364,2014/03/31,2009/09/11,262,3,0.830737018,3582,262,2,1
48365,2014/03/31,2009/11/26,505,4,0.4875,6104,505,4,0
48366,2014/03/31,2009/11/15,266,3,0.805304465,3695,266,0,3
48367,2014/03/31,2012/07/01,227,5,0.498,5975,227,4,1
48368,2014/03/31,2012/04/11,56,2,0.959796774,3100,56,1,1
48369,2014/03/31,2010/05/06,674,3,1.063639614,2797,674,3,0
48370,2014/03/31,2008/12/21,82,2,0.895,3324,82,0,2
48371,2014/03/31,2007/08/09,373,2,0.75,3966,373,2,0
48372,2014/03/31,2009/06/20,683,2,0.75,3966,683,2,0
48373,2014/03/31,2009/10/03,725,2,0.75,3966,725,2,0
48374,2014/03/31,2013/03/27,216,4,0.5611547170000001,5300,216,0,4
48375,2014/03/31,2012/05/17,552,3,0.550518327,5402,552,3,0
48376,2014/03/31,2008/09/11,136,3,0.624098636,4765,136,1,2
48377,2014/03/31,2012/08/26,566,2,0.780036726,3812,566,2,0
48378,2014/03/31,2007/12/16,604,3,0.794840952,3741,604,3,0
48379,2014/03/31,2008/12/05,688,3,0.885701519,3357,688,3,0
48380,2014/03/31,2011/12/17,32,3,0.786998412,3778,32,0,3
48381,2014/03/31,2012/08/15,21,4,0.577405321,5149,21,2,2
48382,2014/03/31,2012/09/07,383,3,0.938166614,3169,383,3,0
48383,2014/03/31,2007/05/28,61,5,0.916,3245,61,0,5
48384,2014/03/31,2012/03/13,15,7,0.893686109,3326,15,4,3
48385,2014/03/31,2011/12/24,80,4,0.531798175,5589,80,1,3
48386,2014/03/31,2012/10/10,181,4,0.514922037,5772,181,2,2
48387,2014/03/31,2012/04/08,83,11,0.399090909,7447,83,5,6
48388,2014/03/31,2013/01/30,207,2,0.683126437,4350,207,1,1
48389,2014/03/31,2010/12/13,12,3,0.60316078,4926,12,0,3
48390,2014/03/31,2005/11/24,402,2,0.5,5942,402,2,0
48391,2014/03/31,2010/05/26,322,5,0.68390884,4344,322,2,3
48392,2014/03/31,2010/04/28,71,3,0.6723992759999999,4418,71,0,3
48393,2014/03/31,2012/01/25,363,6,0.606007752,4902,363,5,1
48394,2014/03/31,2013/03/16,145,2,0.65,4570,145,0,2
48395,2014/03/31,2012/11/23,376,2,0.65,4570,376,2,0
48396,2014/03/31,2012/07/14,615,2,0.65,4570,615,2,0
48397,2014/03/31,2006/12/03,615,2,0.65,4570,615,2,0
48398,2014/03/31,2013/02/06,232,4,0.7338043479999999,4048,232,1,3
48399,2014/03/31,2009/12/21,74,2,0.715,4154,74,0,2
48400,2014/03/31,2010/07/23,155,2,0.715,4154,155,0,2
48401,2014/03/31,2012/11/25,13,2,0.875,3394,13,0,2
48402,2014/03/31,2011/04/17,4,2,0.628113367,4728,4,1,1
48403,2014/03/31,2008/07/08,292,3,0.8369785790000001,3548,292,2,1
48404,2014/03/31,2010/08/17,32,4,0.735,4040,32,0,4
48405,2014/03/31,2008/04/08,284,6,0.445717502,6662,284,2,4
48406,2014/03/31,2012/12/05,388,3,0.54786861,5419,388,3,0
48407,2014/03/31,2007/06/26,216,4,0.493494016,6016,216,0,4
48408,2014/03/31,2012/04/07,256,2,0.7343161020000001,4043,256,1,1
48409,2014/03/31,2011/03/29,154,7,0.5356874770000001,5542,154,4,3
48410,2014/03/31,2013/03/11,183,4,0.539749091,5500,183,1,3
48411,2014/03/31,2010/10/21,648,4,0.366979849,8089,648,4,0
48412,2014/03/31,2010/11/17,86,9,0.867777778,3420,86,4,5
48413,2014/03/31,2012/07/30,543,2,0.882981256,3361,543,2,0
48414,2014/03/31,2011/03/08,529,3,0.577593926,5137,529,3,0
48415,2014/03/31,2006/06/24,406,3,0.685706032,4327,406,3,0
48416,2014/03/31,2010/11/29,81,2,0.76,3904,81,0,2
48417,2014/03/31,2013/03/14,170,3,0.67862763,4372,170,1,2
48418,2014/03/31,2012/11/02,121,3,0.791130667,3750,121,2,1
48419,2014/03/31,2007/12/21,20,2,1.41,2104,20,0,2
48420,2014/03/31,2009/01/23,52,3,0.7852302809999999,3778,52,2,1
48421,2014/03/31,2012/10/30,50,2,0.875,3390,50,0,2
48422,2014/03/31,2011/05/18,306,3,0.480753647,6170,306,1,2
48423,2014/03/31,2011/01/13,96,3,0.541680058,5476,96,1,2
48424,2014/03/31,2012/09/10,334,4,0.553470797,5359,334,2,2
48425,2014/03/31,2010/12/09,78,3,0.704501188,4210,78,2,1
48426,2014/03/31,2009/11/11,193,4,0.487213734,6087,193,1,3
48427,2014/03/31,2011/10/27,124,6,0.716136199,4141,124,3,3
48428,2014/03/31,2012/05/30,80,3,0.889175412,3335,80,1,2
48429,2014/03/31,2009/11/24,2,5,0.68,4360,2,3,2
48430,2014/03/31,2011/02/20,194,5,0.537000543,5521,194,1,4
48431,2014/03/31,2011/12/20,18,5,0.654450331,4530,18,1,4
48432,2014/03/31,2011/04/22,463,6,0.580962179,5103,463,6,0
48433,2014/03/31,2011/12/25,639,2,0.769670216,3851,639,2,0
48434,2014/03/31,2013/02/07,71,5,0.606614818,4886,71,2,3
48435,2014/03/31,2012/09/08,487,3,0.5994639970000001,4944,487,3,0
48436,2014/03/31,2013/02/23,137,4,0.493525396,6005,137,1,3
48437,2014/03/31,2007/09/06,490,2,0.8390713479999999,3532,490,2,0
48438,2014/03/31,2007/04/28,14,2,0.602449685,4919,14,0,2
48439,2014/03/31,2009/10/01,34,3,0.688052008,4307,34,2,1
48440,2014/03/31,2008/04/02,12,4,0.821086173,3609,12,2,2
48441,2014/03/31,2013/03/01,65,4,0.732573548,4045,65,0,4
48442,2014/03/31,2010/04/03,133,5,0.709064369,4179,133,4,1
48443,2014/03/31,2011/02/18,381,5,0.597891445,4956,381,5,0
48444,2014/03/31,2012/02/27,612,3,0.35,8466,612,3,0
48445,2014/03/31,2011/07/30,644,3,0.5355322610000001,5533,644,3,0
48446,2014/03/31,2011/11/30,334,3,0.7037292159999999,4210,334,2,1
48447,2014/03/31,2010/09/14,74,2,0.588282367,5036,74,1,1
48448,2014/03/31,2013/02/15,298,4,0.835,3548,298,2,2
48449,2014/03/31,2005/12/25,111,3,0.6363673470000001,4655,111,1,2
48450,2014/03/31,2008/03/24,247,2,0.538888485,5497,247,0,2
48451,2014/03/31,2012/05/02,82,5,0.442428678,6695,82,2,3
48452,2014/03/31,2012/10/29,402,4,1.0,2962,402,4,0
48453,2014/03/31,2008/09/12,78,9,0.516645735,5733,78,2,7
48454,2014/03/31,2008/01/26,102,3,0.497189861,5957,102,2,1
48455,2014/03/31,2008/07/30,15,4,0.608898026,4864,15,0,4
48456,2014/03/31,2009/07/18,97,5,0.570294627,5193,97,1,4
48457,2014/03/31,2010/11/29,101,4,0.735230884,4028,101,0,4
48458,2014/03/31,2007/02/11,108,3,0.935916561,3164,108,2,1
48459,2014/03/31,2013/03/01,70,5,0.586903865,5045,70,0,5
48460,2014/03/31,2010/03/01,210,4,0.758795489,3902,210,2,2
48461,2014/03/31,2012/03/15,157,3,0.686659708,4311,157,2,1
48462,2014/03/31,2008/05/09,308,3,0.786998139,3761,308,1,2
48463,2014/03/31,2008/06/04,84,3,0.783042328,3780,84,0,3
48464,2014/03/31,2008/02/10,180,6,0.346588594,8539,180,1,5
48465,2014/03/31,2012/10/31,26,4,0.7325,4040,26,2,2
48466,2014/03/31,2011/12/24,167,5,0.584324645,5064,167,2,3
48467,2014/03/31,2009/07/27,120,3,0.608724542,4861,120,0,3
48468,2014/03/31,2008/10/06,110,2,0.692461971,4273,110,0,2
48469,2014/03/31,2012/11/22,66,8,0.36612053,8081,66,2,6
48470,2014/03/31,2012/12/01,266,3,0.8807829709999999,3359,266,2,1
48471,2014/03/31,2012/07/18,317,3,0.6803357870000001,4348,317,1,2
48472,2014/03/31,2009/11/08,502,6,0.85,3480,502,6,0
48473,2014/03/31,2012/02/27,120,3,0.8769107620000001,3373,120,0,3
48474,2014/03/31,2008/01/07,226,2,0.92,3215,226,0,2
48475,2014/03/31,2012/12/18,353,4,0.575,5144,353,3,1
48476,2014/03/31,2011/10/05,487,4,0.8019251629999999,3688,487,4,0
48477,2014/03/31,2011/11/01,23,2,0.909031663,3253,23,0,2
48478,2014/03/31,2012/07/21,536,2,0.725,4078,536,2,0
48479,2014/03/31,2010/07/30,727,2,0.725,4078,727,2,0
48480,2014/03/31,2009/05/12,194,2,0.890228847,3321,194,0,2
48481,2014/03/31,2013/03/31,333,3,0.328640507,8996,333,1,2
48482,2014/03/31,2012/03/09,389,3,0.576521061,5128,389,3,0
48483,2014/03/31,2011/01/13,204,3,0.716666667,4125,204,0,3
48484,2014/03/31,2012/11/19,89,4,0.7698255209999999,3840,89,1,3
48485,2014/03/31,2010/11/20,23,4,0.565106098,5231,23,1,3
48486,2014/03/31,2010/02/06,335,4,0.597241867,4949,335,3,1
48487,2014/03/31,2011/07/27,320,3,0.68995098,4284,320,2,1
48488,2014/03/31,2012/12/29,57,2,1.06971046,2763,57,0,2
48489,2014/03/31,2011/05/26,563,5,0.927329777,3187,563,5,0
48490,2014/03/31,2011/09/07,7,6,0.787869901,3751,7,3,3
48491,2014/03/31,2011/03/13,254,2,0.598283053,4939,254,1,1
48492,2014/03/31,2012/05/19,551,3,0.648102654,4559,551,3,0
48493,2014/03/31,2011/10/24,141,4,0.983916084,3003,141,3,1
48494,2014/03/31,2012/06/22,402,2,1.206206615,2449,402,2,0
48495,2014/03/31,2011/09/01,367,3,0.633476303,4663,367,3,0
48496,2014/03/31,2012/03/24,111,6,0.70698899,4178,111,2,4
48497,2014/03/31,2011/10/31,348,4,0.585683125,5043,348,3,1
48498,2014/03/31,2011/04/11,87,2,0.7724901909999999,3823,87,0,2
48499,2014/03/31,2012/12/26,131,4,0.562721037,5248,131,2,2
48500,2014/03/31,2006/08/16,17,4,0.476709719,6194,17,1,3
48501,2014/03/31,2012/09/01,473,3,0.87898184,3359,473,3,0
48502,2014/03/31,2010/12/17,57,4,0.7109995179999999,4152,57,1,3
48503,2014/03/31,2012/06/10,528,2,1.0,2952,528,2,0
48504,2014/03/31,2012/04/23,346,4,0.648133509,4554,346,3,1
48505,2014/03/31,2009/05/23,11,5,0.581364979,5077,11,0,5
48506,2014/03/31,2011/03/15,104,5,0.7571857359999999,3898,104,1,4
48507,2014/03/31,2009/08/29,521,3,0.620063025,4760,521,3,0
48508,2014/03/31,2011/10/16,615,3,0.869051826,3396,615,3,0
48509,2014/03/31,2006/11/28,459,2,0.609962795,4838,459,2,0
48510,2014/03/31,2010/12/24,43,3,0.6333333329999999,4659,43,0,3
48511,2014/03/31,2010/08/15,511,2,0.75,3934,511,2,0
48512,2014/03/31,2008/11/19,258,2,0.75,3934,258,0,2
48513,2014/03/31,2008/11/15,198,2,0.75,3934,198,0,2
48514,2014/03/31,2011/03/21,640,2,0.75,3934,640,2,0
48515,2014/03/31,2011/12/12,415,2,0.75,3934,415,2,0
48516,2014/03/31,2012/11/02,354,2,0.75,3934,354,0,2
48517,2014/03/31,2008/03/08,598,2,0.75,3934,598,2,0
48518,2014/03/31,2012/06/08,500,2,0.75,3934,500,2,0
48519,2014/03/31,2012/07/10,243,2,0.75,3934,243,0,2
48520,2014/03/31,2011/11/10,638,3,0.5,5901,638,3,0
48521,2014/03/31,2013/03/25,330,3,0.5,5901,330,1,2
48522,2014/03/31,2012/09/09,561,2,0.75,3934,561,2,0
48523,2014/03/31,2011/02/28,168,2,0.75,3934,168,0,2
48524,2014/03/31,2006/05/10,250,2,0.75,3934,250,0,2
48525,2014/03/31,2012/07/21,618,2,0.725805658,4065,618,2,0
48526,2014/03/31,2006/07/31,643,3,0.6814622309999999,4329,643,3,0
48527,2014/03/31,2012/06/27,642,2,0.52617731,5606,642,2,0
48528,2014/03/31,2008/10/10,106,5,0.6865502790000001,4296,106,1,4
48529,2014/03/31,2012/09/15,373,3,0.68478059,4307,373,3,0
48530,2014/03/31,2011/02/23,173,2,0.71,4154,173,1,1
48531,2014/03/31,2010/01/17,44,4,0.583076315,5058,44,2,2
48532,2014/03/31,2012/05/01,477,2,1.0,2948,477,2,0
48533,2014/03/31,2006/02/05,340,3,0.8308906429999999,3548,340,2,1
48534,2014/03/31,2012/05/23,300,4,0.643572052,4580,300,3,1
48535,2014/03/31,2006/02/07,68,4,0.752607252,3916,68,0,4
48536,2014/03/31,2008/07/19,633,4,0.499330735,5902,633,4,0
48537,2014/03/31,2011/04/10,480,2,1.0,2947,480,2,0
48538,2014/03/31,2012/08/18,79,5,0.808427984,3645,79,2,3
48539,2014/03/31,2012/11/02,3,7,0.611053505,4822,3,4,3
48540,2014/03/31,2010/02/06,178,4,0.615382206,4788,178,2,2
48541,2014/03/31,2009/06/24,75,2,0.72,4092,75,0,2
48542,2014/03/31,2005/01/10,65,6,0.7940754720000001,3710,65,4,2
48543,2014/03/31,2006/10/12,167,3,0.8103823929999999,3635,167,2,1
48544,2014/03/31,2012/11/29,412,5,0.638915401,4610,412,5,0
48545,2014/03/31,2012/07/01,6,4,0.544032139,5414,6,1,3
48546,2014/03/31,2007/09/20,236,2,0.54,5454,236,0,2
48547,2014/03/31,2013/01/30,115,5,0.571850485,5150,115,2,3
48548,2014/03/31,2006/06/20,87,2,0.8443176609999999,3488,87,0,2
48549,2014/03/31,2008/01/06,40,2,0.87,3385,40,0,2
48550,2014/03/31,2011/06/20,124,5,0.6446234679999999,4568,124,1,4
48551,2014/03/31,2005/03/27,110,3,0.690922319,4261,110,0,3
48552,2014/03/31,2009/11/11,137,4,0.529167715,5563,137,1,3
48553,2014/03/31,2011/10/15,418,6,0.8930825240000001,3296,418,6,0
48554,2014/03/31,2008/10/29,13,6,0.653213493,4506,13,0,6
48555,2014/03/31,2011/10/14,79,2,0.945,3114,79,1,1
48556,2014/03/31,2011/02/23,584,2,0.85,3462,584,2,0
48557,2014/03/31,2008/08/12,160,6,0.687344078,4281,160,4,2
48558,2014/03/31,2012/07/05,50,4,0.558926672,5264,50,2,2
48559,2014/03/31,2011/09/20,152,3,0.92,3198,152,0,3
48560,2014/03/31,2012/10/13,321,4,0.80122549,3672,321,2,2
48561,2014/03/31,2007/11/10,51,4,0.5308336339999999,5542,51,3,1
48562,2014/03/31,2007/08/22,147,3,0.712952012,4126,147,1,2
48563,2014/03/31,2012/06/25,535,5,0.609395069,4827,535,5,0
48564,2014/03/31,2013/02/08,112,3,0.612433895,4803,112,0,3
48565,2014/03/31,2011/12/02,452,4,0.680745198,4321,452,4,0
48566,2014/03/31,2011/01/17,74,4,0.684993014,4294,74,3,1
48567,2014/03/31,2012/10/28,469,3,0.610491905,4818,469,3,0
48568,2014/03/31,2010/11/25,290,2,0.873566974,3367,290,0,2
48569,2014/03/31,2008/06/02,32,5,0.533216099,5516,32,2,3
48570,2014/03/31,2011/01/09,34,8,0.761335749,3863,34,6,2
48571,2014/03/31,2012/11/11,458,4,0.70794415,4154,458,4,0
48572,2014/03/31,2005/07/23,97,4,0.6335157260000001,4642,97,2,2
48573,2014/03/31,2010/12/19,204,5,0.81662316,3601,204,2,3
48574,2014/03/31,2013/03/26,14,4,0.413508649,7111,14,0,4
48575,2014/03/31,2011/11/27,354,5,0.598006915,4917,354,3,2
48576,2014/03/31,2012/06/13,263,5,0.686518795,4283,263,2,3
48577,2014/03/31,2011/07/04,529,3,1.0,2940,529,3,0
48578,2014/03/31,2006/06/19,263,2,0.611353712,4809,263,1,1
48579,2014/03/31,2007/03/12,355,3,0.7,4200,355,2,1
48580,2014/03/31,2012/05/01,557,2,0.75,3920,557,2,0
48581,2014/03/31,2012/07/27,426,5,0.557347364,5274,426,5,0
48582,2014/03/31,2010/02/07,689,2,0.55,5344,689,2,0
48583,2014/03/31,2012/09/20,477,3,0.3666666670000001,8016,477,3,0
48584,2014/03/31,2012/05/24,637,2,0.55,5344,637,2,0
48585,2014/03/31,2012/07/23,205,6,0.701302792,4191,205,2,4
48586,2014/03/31,2013/01/01,239,2,1.455,2020,239,0,2
48587,2014/03/31,2012/04/15,710,2,0.55,5343,710,2,0
48588,2014/03/31,2013/01/05,137,3,0.820837989,3580,137,1,2
48589,2014/03/31,2007/10/14,199,4,0.6826672859999999,4304,199,3,1
48590,2014/03/31,2010/11/15,229,2,0.879437294,3341,229,1,1
48591,2014/03/31,2007/06/20,26,3,0.479978762,6121,26,1,2
48592,2014/03/31,2011/05/24,583,3,0.523392125,5613,583,3,0
48593,2014/03/31,2012/05/14,36,5,0.827288088,3551,36,1,4
48594,2014/03/31,2009/04/01,106,2,0.707329641,4153,106,1,1
48595,2014/03/31,2008/03/20,709,2,0.7,4196,709,2,0
48596,2014/03/31,2011/08/28,598,2,0.7,4196,598,2,0
48597,2014/03/31,2013/02/14,49,2,0.735,3996,49,1,1
48598,2014/03/31,2007/11/22,76,6,0.8856272620000001,3316,76,0,6
48599,2014/03/31,2011/10/15,529,3,0.525630929,5587,529,3,0
48600,2014/03/31,2012/07/28,607,3,0.960333551,3058,607,3,0
48601,2014/03/31,2006/08/10,462,3,0.597203579,4917,462,3,0
48602,2014/03/31,2007/07/12,459,3,0.597203579,4917,459,3,0
48603,2014/03/31,2013/01/17,32,3,0.276521002,10618,32,0,3
48604,2014/03/31,2013/02/26,46,5,0.410389992,7154,46,1,4
48605,2014/03/31,2013/01/01,17,3,0.457481689,6417,17,0,3
48606,2014/03/31,2012/04/09,670,4,0.747542653,3927,670,4,0
48607,2014/03/31,2008/10/12,83,4,0.5403036999999999,5433,83,3,1
48608,2014/03/31,2010/06/23,290,4,0.718919912,4083,290,3,1
48609,2014/03/31,2012/05/24,669,2,0.5,5870,669,2,0
48610,2014/03/31,2012/05/08,563,2,0.5,5870,563,2,0
48611,2014/03/31,2011/06/10,669,2,0.5,5870,669,2,0
48612,2014/03/31,2012/09/06,14,4,0.8511745940000001,3448,14,2,2
48613,2014/03/31,2007/07/15,624,2,0.93346056,3144,624,2,0
48614,2014/03/31,2012/01/26,708,3,0.806042296,3641,708,3,0
48615,2014/03/31,2005/05/12,240,7,0.35502056600000004,8266,240,4,3
48616,2014/03/31,2007/07/28,44,5,0.72006135,4075,44,1,4
48617,2014/03/31,2007/06/19,296,3,0.561030593,5230,296,2,1
48618,2014/03/31,2010/11/25,304,4,0.603602139,4861,304,2,2
48619,2014/03/31,2012/06/20,574,3,1.0,2934,574,3,0
48620,2014/03/31,2011/04/24,5,2,0.742884274,3949,5,0,2
48621,2014/03/31,2007/11/11,139,2,0.92,3188,139,0,2
48622,2014/03/31,2012/06/29,151,5,0.580726733,5050,151,3,2
48623,2014/03/31,2006/06/01,44,2,0.625,4692,44,0,2
48624,2014/03/31,2010/05/14,5,2,0.5486190120000001,5344,5,0,2
48625,2014/03/31,2006/10/30,10,2,0.7485572009999999,3916,10,0,2
48626,2014/03/31,2011/06/02,395,4,0.672173813,4361,395,4,0
48627,2014/03/31,2009/12/25,125,3,0.924954244,3169,125,2,1
48628,2014/03/31,2011/09/12,39,2,0.669650446,4377,39,0,2
48629,2014/03/31,2008/05/07,32,2,0.967004289,3031,32,0,2
48630,2014/03/31,2008/04/14,245,4,0.855,3428,245,3,1
48631,2014/03/31,2012/04/25,166,5,0.597772792,4903,166,1,4
48632,2014/03/31,2008/07/05,21,2,0.745,3934,21,0,2
48633,2014/03/31,2012/12/06,121,3,0.582308762,5033,121,2,1
48634,2014/03/31,2011/11/22,440,3,0.39674428,7387,440,3,0
48635,2014/03/31,2008/09/08,598,3,0.6732077209999999,4352,598,3,0
48636,2014/03/31,2009/09/14,107,3,0.536775376,5458,107,1,2
48637,2014/03/31,2013/03/23,215,2,0.949024943,3087,215,1,1
48638,2014/03/31,2012/06/08,282,3,0.712190615,4113,282,0,3
48639,2014/03/31,2011/12/13,620,3,0.966666667,3030,620,3,0
48640,2014/03/31,2011/01/14,136,4,0.58,5050,136,0,4
48641,2014/03/31,2012/06/30,467,4,0.725,4040,467,4,0
48642,2014/03/31,2013/03/16,141,5,0.444792711,6585,141,1,4
48643,2014/03/31,2010/02/16,27,3,0.448943899,6524,27,2,1
48644,2014/03/31,2005/12/07,21,5,0.501609865,5839,21,1,4
48645,2014/03/31,2012/01/27,33,5,0.56,5230,33,1,4
48646,2014/03/31,2012/01/27,109,4,0.638056645,4590,109,0,4
48647,2014/03/31,2010/04/20,44,2,0.878676868,3333,44,0,2
48648,2014/03/31,2010/06/17,278,6,0.440922915,6642,278,5,1
48649,2014/03/31,2011/10/31,4,2,0.876536965,3341,4,1,1
48650,2014/03/31,2008/04/06,460,6,0.43262668,6769,460,6,0
48651,2014/03/31,2012/11/15,488,3,0.5626825520000001,5204,488,3,0
48652,2014/03/31,2008/06/02,462,3,1.0,2928,462,3,0
48653,2014/03/31,2011/01/28,610,2,0.75,3904,610,2,0
48654,2014/03/31,2007/11/18,510,2,0.756172521,3872,510,2,0
48655,2014/03/31,2011/04/18,310,5,0.5696730879999999,5139,310,4,1
48656,2014/03/31,2009/05/09,709,2,0.8544658490000001,3426,709,2,0
48657,2014/03/31,2011/05/20,95,6,0.7516666670000001,3894,95,3,3
48658,2014/03/31,2007/03/11,175,3,1.130865533,2588,175,1,2
48659,2014/03/31,2012/04/29,341,5,0.8066841229999999,3628,341,3,2
48660,2014/03/31,2010/06/22,422,4,0.7875,3716,422,4,0
48661,2014/03/31,2010/09/18,168,6,0.577985384,5063,168,5,1
48662,2014/03/31,2006/06/08,177,4,0.6675,4384,177,0,4
48663,2014/03/31,2006/09/13,79,3,0.765003922,3825,79,0,3
48664,2014/03/31,2012/05/14,594,3,0.6647205820000001,4402,594,3,0
48665,2014/03/31,2012/10/26,14,2,0.63,4644,14,0,2
48666,2014/03/31,2013/02/08,145,2,0.63,4644,145,0,2
48667,2014/03/31,2013/02/28,75,4,0.831167614,3520,75,1,3
48668,2014/03/31,2010/06/14,489,4,0.918492936,3185,489,4,0
48669,2014/03/31,2010/04/27,7,4,0.768400315,3807,7,1,3
48670,2014/03/31,2011/08/30,249,4,0.577742445,5063,249,0,4
48671,2014/03/31,2008/11/29,278,4,0.61744353,4737,278,0,4
48672,2014/03/31,2006/03/09,553,4,0.750320677,3898,553,4,0
48673,2014/03/31,2011/11/26,148,3,0.711047897,4113,148,0,3
48674,2014/03/31,2010/02/23,448,5,0.607372793,4815,448,5,0
48675,2014/03/31,2012/03/24,534,4,0.558761705,5233,534,4,0
48676,2014/03/31,2011/08/06,603,2,1.0,2924,603,2,0
48677,2014/03/31,2010/09/07,15,4,0.509216301,5742,15,2,2
48678,2014/03/31,2011/01/15,231,4,0.545200448,5363,231,2,2
48679,2014/03/31,2011/06/15,619,3,0.732781955,3990,619,3,0
48680,2014/03/31,2011/12/20,45,6,0.84,3480,45,3,3
48681,2014/03/31,2012/10/15,449,4,0.74434683,3927,449,4,0
48682,2014/03/31,2011/03/15,506,3,0.642091388,4552,506,3,0
48683,2014/03/31,2005/11/26,536,4,0.772002113,3786,536,4,0
48684,2014/03/31,2012/02/13,695,4,0.8647337279999999,3380,695,4,0
48685,2014/03/31,2010/04/20,219,2,0.8613675209999999,3393,219,0,2
48686,2014/03/31,2010/12/26,43,4,0.69284495,4218,43,3,1
48687,2014/03/31,2012/06/13,630,2,0.4,7306,630,2,0
48688,2014/03/31,2012/01/20,571,2,0.4,7306,571,2,0
48689,2014/03/31,2012/09/07,567,2,0.774145695,3775,567,2,0
48690,2014/03/31,2006/08/31,434,5,0.805956977,3626,434,5,0
48691,2014/03/31,2011/09/20,586,2,0.884160363,3305,586,2,0
48692,2014/03/31,2007/03/04,121,5,0.72380976,4037,121,2,3
48693,2014/03/31,2011/03/29,418,3,0.58769107,4972,418,3,0
48694,2014/03/31,2012/06/02,461,3,0.622894905,4691,461,3,0
48695,2014/03/31,2012/08/22,135,3,0.595451396,4907,135,2,1
48696,2014/03/31,2013/02/22,62,4,0.59263286,4930,62,0,4
48697,2014/03/31,2010/12/12,15,2,0.803288425,3637,15,1,1
48698,2014/03/31,2013/03/05,45,4,0.731642875,3993,45,0,4
48699,2014/03/31,2009/02/13,170,4,0.448761905,6510,170,0,4
48700,2014/03/31,2012/12/14,470,3,0.548105066,5330,470,3,0
48701,2014/03/31,2013/01/29,247,3,0.656154537,4452,247,1,2
48702,2014/03/31,2013/03/12,34,4,0.7468524670000001,3911,34,1,3
48703,2014/03/31,2012/07/06,634,2,0.526374121,5549,634,2,0
48704,2014/03/31,2012/03/04,669,5,0.690951029,4227,669,5,0
48705,2014/03/31,2007/05/09,191,4,0.791691515,3689,191,1,3
48706,2014/03/31,2011/07/27,377,5,0.5047528520000001,5786,377,5,0
48707,2014/03/31,2011/08/25,369,7,0.642857143,4543,369,7,0
48708,2014/03/31,2012/09/17,381,6,0.75,3894,381,6,0
48709,2014/03/31,2010/07/17,335,3,1.5,1947,335,2,1
48710,2014/03/31,2009/01/09,184,4,0.900135635,3244,184,1,3
48711,2014/03/31,2011/11/16,39,3,0.534412518,5464,39,0,3
48712,2014/03/31,2013/01/14,63,4,0.836604585,3490,63,0,4
48713,2014/03/31,2007/04/26,619,3,0.896407737,3257,619,3,0
48714,2014/03/31,2013/03/19,19,6,0.630777874,4628,19,0,6
48715,2014/03/31,2012/09/23,541,2,0.4,7298,541,2,0
48716,2014/03/31,2013/01/26,149,4,0.7225,4040,149,2,2
48717,2014/03/31,2011/08/29,337,4,0.575492902,5072,337,3,1
48718,2014/03/31,2008/05/22,74,3,1.41,2070,74,0,3
48719,2014/03/31,2010/08/22,99,3,0.567801556,5140,99,1,2
48720,2014/03/31,2013/02/09,97,4,0.740840315,3939,97,2,2
48721,2014/03/31,2007/03/29,189,4,0.638348283,4571,189,3,1
48722,2014/03/31,2012/11/03,79,5,0.504727556,5781,79,1,4
48723,2014/03/31,2011/12/23,231,3,0.707002665,4127,231,1,2
48724,2014/03/31,2013/02/15,78,4,0.733259613,3979,78,1,3
48725,2014/03/31,2011/01/04,18,5,0.5093261170000001,5728,18,3,2
48726,2014/03/31,2007/06/10,35,5,0.7802647770000001,3739,35,3,2
48727,2014/03/31,2010/03/08,185,6,0.457241379,6380,185,3,3
48728,2014/03/31,2007/08/26,4,6,0.540706209,5395,4,1,5
48729,2014/03/31,2008/10/11,197,3,0.699340686,4171,197,1,2
48730,2014/03/31,2012/01/17,45,4,0.755483035,3861,45,2,2
48731,2014/03/31,2005/10/21,213,3,0.7433333329999999,3924,213,1,2
48732,2014/03/31,2004/11/12,492,3,0.7104993909999999,4105,492,3,0
48733,2014/03/31,2008/07/28,165,2,0.715,4078,165,0,2
48734,2014/03/31,2011/05/30,709,2,0.775,3762,709,2,0
48735,2014/03/31,2007/07/20,702,2,0.775,3762,702,2,0
48736,2014/03/31,2012/11/15,291,3,0.573333333,5085,291,1,2
48737,2014/03/31,2012/11/27,280,2,0.38,7672,280,0,2
48738,2014/03/31,2012/10/28,343,3,0.595090835,4899,343,2,1
48739,2014/03/31,2007/12/11,276,5,0.516284095,5646,276,4,1
48740,2014/03/31,2012/10/26,520,2,0.725,4020,520,2,0
48741,2014/03/31,2013/01/04,188,2,0.77,3785,188,0,2
48742,2014/03/31,2007/10/12,108,4,0.586992951,4965,108,3,1
48743,2014/03/31,2013/03/16,80,4,0.5952573529999999,4896,80,0,4
48744,2014/03/31,2011/12/26,559,3,1.0,2914,559,3,0
48745,2014/03/31,2009/12/12,319,4,0.547491545,5322,319,2,2
48746,2014/03/31,2005/04/21,118,4,0.561630686,5188,118,0,4
48747,2014/03/31,2012/10/13,83,6,0.534418562,5452,83,2,4
48748,2014/03/31,2009/11/26,148,3,0.480121951,6068,148,2,1
48749,2014/03/31,2007/05/23,19,4,0.5375,5420,19,0,4
48750,2014/03/31,2009/12/14,31,5,0.6308207020000001,4618,31,2,3
48751,2014/03/31,2009/01/31,325,2,0.688164422,4233,325,1,1
48752,2014/03/31,2006/05/26,347,5,0.61,4775,347,4,1
48753,2014/03/31,2013/03/15,219,3,0.472557196,6163,219,0,3
48754,2014/03/31,2010/11/29,165,7,0.814129159,3577,165,2,5
48755,2014/03/31,2010/03/16,446,3,0.732662305,3974,446,3,0
48756,2014/03/31,2013/01/06,20,3,0.475958803,6117,20,1,2
48757,2014/03/31,2012/04/03,79,4,0.582043183,5002,79,3,1
48758,2014/03/31,2012/12/21,448,3,0.583309958,4991,448,3,0
48759,2014/03/31,2011/12/28,55,3,0.493333333,5901,55,1,2
48760,2014/03/31,2008/01/23,220,2,0.74,3934,220,0,2
48761,2014/03/31,2006/09/30,141,4,0.788661609,3691,141,3,1
48762,2014/03/31,2010/12/19,176,5,0.496383015,5864,176,3,2
48763,2014/03/31,2012/04/11,222,3,1.251358555,2326,222,2,1
48764,2014/03/31,2006/05/12,132,6,0.408333333,7128,132,0,6
48765,2014/03/31,2009/10/20,190,7,0.663144224,4389,190,4,3
48766,2014/03/31,2008/10/19,253,4,0.499869461,5822,253,0,4
48767,2014/03/31,2006/11/01,674,3,0.787604871,3695,674,3,0
48768,2014/03/31,2013/02/25,212,5,0.5773809520000001,5040,212,3,2
48769,2014/03/31,2012/08/18,431,4,0.60625,4800,431,4,0
48770,2014/03/31,2012/11/13,106,6,0.55753401,5219,106,3,3
48771,2014/03/31,2012/03/13,260,6,0.8042260920000001,3618,260,5,1
48772,2014/03/31,2006/03/05,171,4,0.907825273,3205,171,3,1
48773,2014/03/31,2009/07/09,154,4,0.700843373,4150,154,2,2
48774,2014/03/31,2012/10/13,64,3,0.597790339,4865,64,0,3
48775,2014/03/31,2008/02/06,351,2,0.7,4154,351,0,2
48776,2014/03/31,2008/03/31,589,3,0.466666667,6231,589,3,0
48777,2014/03/31,2009/09/10,590,2,0.7,4154,590,2,0
48778,2014/03/31,2011/08/18,627,2,0.7,4154,627,2,0
48779,2014/03/31,2005/10/18,607,2,0.7,4154,607,2,0
48780,2014/03/31,2011/11/02,381,2,0.7,4154,381,2,0
48781,2014/03/31,2010/04/10,701,2,0.7,4154,701,2,0
48782,2014/03/31,2011/11/20,414,2,0.7,4154,414,2,0
48783,2014/03/31,2008/05/10,720,2,0.7,4154,720,2,0
48784,2014/03/31,2006/03/10,5,4,0.8122067040000001,3580,5,1,3
48785,2014/03/31,2013/01/23,191,3,0.659147586,4411,191,2,1
48786,2014/03/31,2012/11/16,498,2,0.55,5286,498,2,0
48787,2014/03/31,2005/02/25,269,2,0.858874446,3385,269,1,1
48788,2014/03/31,2011/08/22,440,3,0.5103581460000001,5696,440,3,0
48789,2014/03/31,2011/11/13,26,10,0.812,3580,26,6,4
48790,2014/03/31,2007/10/20,110,4,0.435700794,6671,110,0,4
48791,2014/03/31,2012/08/24,579,2,0.600020644,4844,579,2,0
48792,2014/03/31,2012/08/11,592,2,0.600020644,4844,592,2,0
48793,2014/03/31,2012/07/31,603,2,0.600020644,4844,603,2,0
48794,2014/03/31,2012/08/24,579,2,0.600020644,4844,579,2,0
48795,2014/03/31,2012/08/18,585,2,0.600020644,4844,585,2,0
48796,2014/03/31,2012/08/07,596,2,0.600020644,4844,596,2,0
48797,2014/03/31,2012/08/07,596,2,0.600020644,4844,596,2,0
48798,2014/03/31,2012/09/02,570,2,0.600020644,4844,570,2,0
48799,2014/03/31,2012/09/02,570,2,0.600020644,4844,570,2,0
48800,2014/03/31,2012/09/02,570,2,0.600020644,4844,570,2,0
48801,2014/03/31,2012/07/31,603,2,0.600020644,4844,603,2,0
48802,2014/03/31,2012/08/02,601,2,0.600020644,4844,601,2,0
48803,2014/03/31,2012/08/11,592,2,0.600020644,4844,592,2,0
48804,2014/03/31,2012/08/07,596,2,0.600020644,4844,596,2,0
48805,2014/03/31,2012/08/24,579,2,0.600020644,4844,579,2,0
48806,2014/03/31,2012/07/31,603,2,0.600020644,4844,603,2,0
48807,2014/03/31,2012/08/11,592,2,0.600020644,4844,592,2,0
48808,2014/03/31,2012/09/02,570,2,0.600020644,4844,570,2,0
48809,2014/03/31,2011/01/14,3,4,0.565,5144,3,0,4
48810,2014/03/31,2012/07/17,58,3,0.828910439,3506,58,2,1
48811,2014/03/31,2012/04/22,38,5,0.681630307,4263,38,0,5
48812,2014/03/31,2007/03/13,415,2,0.729500377,3983,415,2,0
48813,2014/03/31,2010/12/06,269,3,0.941156463,3087,269,1,2
48814,2014/03/31,2008/02/01,69,5,0.666038514,4362,69,0,5
48815,2014/03/31,2012/05/26,400,2,0.9,3228,400,2,0
48816,2014/03/31,2009/09/16,31,2,0.8821567440000001,3292,31,0,2
48817,2014/03/31,2006/10/24,424,2,0.6066116570000001,4787,424,2,0
48818,2014/03/31,2007/05/04,113,4,0.692348593,4194,113,1,3
48819,2014/03/31,2012/12/08,80,4,0.5181477520000001,5604,80,2,2
48820,2014/03/31,2013/03/01,207,2,0.805668701,3604,207,0,2
48821,2014/03/31,2007/07/26,255,5,0.922523038,3147,255,4,1
48822,2014/03/31,2010/11/29,58,2,0.827065527,3510,58,0,2
48823,2014/03/31,2006/10/01,549,3,0.75,3870,549,3,0
48824,2014/03/31,2010/11/25,323,3,0.6975246340000001,4161,323,2,1
48825,2014/03/31,2011/08/21,278,4,0.7747730909999999,3746,278,3,1
48826,2014/03/31,2005/05/01,299,6,0.838266898,3462,299,5,1
48827,2014/03/31,2010/06/21,194,4,0.516368327,5620,194,3,1
48828,2014/03/31,2011/02/25,30,4,0.378547756,7664,30,1,3
48829,2014/03/31,2006/10/26,164,2,0.970933735,2988,164,1,1
48830,2014/03/31,2007/01/09,167,5,0.894,3245,167,3,2
48831,2014/03/31,2011/12/10,267,6,0.477511111,6075,267,5,1
48832,2014/03/31,2009/09/10,222,3,0.841427328,3447,222,2,1
48833,2014/03/31,2012/06/19,229,5,0.821084371,3532,229,4,1
48834,2014/03/31,2010/07/29,30,2,0.415,6988,30,1,1
48835,2014/03/31,2007/06/15,634,2,1.0,2900,634,2,0
48836,2014/03/31,2011/11/09,328,6,0.833333333,3480,328,5,1
48837,2014/03/31,2012/12/11,177,3,0.811864502,3572,177,2,1
48838,2014/03/31,2013/03/08,255,5,0.544883502,5322,255,3,2
48839,2014/03/31,2011/09/19,377,4,0.956713956,3031,377,4,0
48840,2014/03/31,2012/07/21,351,2,0.6118801429999999,4739,351,0,2
48841,2014/03/31,2007/06/06,85,2,0.736077685,3939,85,1,1
48842,2014/03/31,2012/10/12,28,4,0.6733255920000001,4306,28,0,4
48843,2014/03/31,2011/07/07,562,2,1.0,2899,562,2,0
48844,2014/03/31,2012/07/10,442,4,0.72875817,3978,442,4,0
48845,2014/03/31,2012/05/07,136,2,0.51,5684,136,0,2
48846,2014/03/31,2013/03/13,305,4,0.7125,4068,305,1,3
48847,2014/03/31,2011/06/22,294,3,0.6,4829,294,1,2
48848,2014/03/31,2011/11/29,117,8,0.7415536220000001,3907,117,2,6
48849,2014/03/31,2011/05/03,5,5,0.565173625,5126,5,3,2
48850,2014/03/31,2013/03/22,84,4,0.904467687,3203,84,0,4
48851,2014/03/31,2012/09/10,165,4,0.753407022,3845,165,3,1
48852,2014/03/31,2013/02/09,97,4,0.505,5736,97,0,4
48853,2014/03/31,2009/08/29,656,5,0.434257871,6670,656,5,0
48854,2014/03/31,2011/02/18,552,3,0.621491416,4660,552,3,0
48855,2014/03/31,2006/10/12,9,4,0.73278087,3952,9,1,3
48856,2014/03/31,2012/10/10,62,5,0.476451613,6076,62,1,4
48857,2014/03/31,2010/03/19,79,3,0.864635603,3348,79,2,1
48858,2014/03/31,2011/09/08,352,3,0.7136834320000001,4056,352,2,1
48859,2014/03/31,2010/11/19,48,3,0.714666667,4050,48,2,1
48860,2014/03/31,2012/03/15,531,4,0.665838509,4347,531,4,0
48861,2014/03/31,2011/09/15,164,3,0.799312345,3621,164,2,1
48862,2014/03/31,2011/08/29,247,5,0.548468827,5277,247,1,4
48863,2014/03/31,2012/11/08,21,7,0.484757119,5970,21,2,5
48864,2014/03/31,2011/04/09,521,5,0.786745514,3678,521,5,0
48865,2014/03/31,2010/09/29,93,6,0.798333333,3624,93,3,3
48866,2014/03/31,2005/10/20,229,2,0.911461878,3174,229,0,2
48867,2014/03/31,2012/06/29,112,4,0.968366254,2987,112,2,2
48868,2014/03/31,2012/05/08,417,3,0.450545171,6420,417,3,0
48869,2014/03/31,2010/10/21,194,3,0.597107762,4844,194,1,2
48870,2014/03/31,2013/01/01,200,4,0.773559775,3739,200,0,4
48871,2014/03/31,2007/11/05,381,4,0.775,3732,381,4,0
48872,2014/03/31,2012/06/13,657,2,1.0,2892,657,2,0
48873,2014/03/31,2006/07/21,473,2,1.0,2892,473,2,0
48874,2014/03/31,2007/11/29,331,2,1.0,2892,331,0,2
48875,2014/03/31,2009/12/18,549,2,1.0,2892,549,2,0
48876,2014/03/31,2010/02/05,390,2,1.0,2892,390,2,0
48877,2014/03/31,2012/04/24,703,2,1.0,2892,703,2,0
48878,2014/03/31,2008/01/04,562,2,0.8985239279999999,3218,562,2,0
48879,2014/03/31,2011/03/09,13,4,0.69336211,4170,13,0,4
48880,2014/03/31,2011/03/02,48,4,0.579298738,4991,48,2,2
48881,2014/03/31,2011/02/07,129,4,1.0025,2884,129,2,2
48882,2014/03/31,2011/07/25,703,3,0.862212944,3353,703,3,0
48883,2014/03/31,2011/09/22,476,5,0.35440112799999995,8157,476,5,0
48884,2014/03/31,2012/09/14,229,3,0.736666667,3924,229,2,1
48885,2014/03/31,2010/08/08,309,3,0.705,4100,309,2,1
48886,2014/03/31,2012/07/27,515,2,1.175,2460,515,2,0
48887,2014/03/31,2013/01/07,33,2,1.41,2050,33,0,2
48888,2014/03/31,2013/02/01,323,5,0.519380054,5565,323,0,5
48889,2014/03/31,2012/03/13,166,2,0.85,3400,166,1,1
48890,2014/03/31,2007/12/14,86,3,0.765131056,3777,86,0,3
48891,2014/03/31,2012/10/23,15,3,0.685297605,4217,15,0,3
48892,2014/03/31,2011/01/13,171,2,0.53610874,5389,171,0,2
48893,2014/03/31,2011/06/04,578,5,0.463494865,6232,578,5,0
48894,2014/03/31,2009/11/15,240,2,0.864286142,3341,240,1,1
48895,2014/03/31,2012/08/16,217,2,0.911739817,3167,217,1,1
48896,2014/03/31,2011/02/25,158,4,0.5521858860000001,5229,158,3,1
48897,2014/03/31,2012/04/28,74,4,0.637105031,4532,74,1,3
48898,2014/03/31,2013/02/07,229,4,0.446566125,6465,229,0,4
48899,2014/03/31,2006/03/16,33,2,0.695,4154,33,1,1
48900,2014/03/31,2013/03/19,134,3,0.476161966,6063,134,2,1
48901,2014/03/31,2013/02/11,330,3,0.699951503,4124,330,2,1
48902,2014/03/31,2008/08/08,397,5,0.419950524,6872,397,5,0
48903,2014/03/31,2010/12/23,315,6,0.579205138,4982,315,3,3
48904,2014/03/31,2012/04/17,350,3,0.412516083,6995,350,2,1
48905,2014/03/31,2009/10/06,78,4,0.582130751,4956,78,1,3
48906,2014/03/31,2013/02/26,16,4,0.647151189,4458,16,0,4
48907,2014/03/31,2005/04/19,603,2,1.0,2885,603,2,0
48908,2014/03/31,2013/02/02,384,3,0.8,3606,384,3,0
48909,2014/03/31,2011/05/17,3,5,0.426929111,6757,3,2,3
48910,2014/03/31,2006/12/04,345,2,0.720057414,4006,345,1,1
48911,2014/03/31,2012/07/25,152,3,0.537328614,5368,152,1,2
48912,2014/03/31,2012/09/17,150,2,0.791710129,3643,150,1,1
48913,2014/03/31,2012/11/25,213,3,0.686666667,4200,213,1,2
48914,2014/03/31,2010/01/26,292,4,0.81553733,3536,292,0,4
48915,2014/03/31,2012/10/16,491,3,0.900296597,3203,491,3,0
48916,2014/03/31,2006/09/13,242,3,0.974766734,2958,242,1,2
48917,2014/03/31,2008/02/24,634,4,0.62707699,4598,634,4,0
48918,2014/03/31,2010/12/22,99,4,0.454106158,6349,99,0,4
48919,2014/03/31,2012/05/12,221,4,0.4765415770000001,6049,221,1,3
48920,2014/03/31,2006/09/04,461,6,0.5236239779999999,5505,461,6,0
48921,2014/03/31,2011/10/28,207,5,0.524272463,5498,207,3,2
48922,2014/03/31,2005/10/10,39,5,0.414416966,6955,39,0,5
48923,2014/03/31,2010/04/07,4,2,0.916673028,3144,4,0,2
48924,2014/03/31,2009/05/01,547,3,0.436232213,6606,547,3,0
48925,2014/03/31,2008/08/17,169,4,0.680758327,4233,169,2,2
48926,2014/03/31,2012/01/02,343,2,0.8798778629999999,3275,343,1,1
48927,2014/03/31,2013/01/29,84,3,0.66180983,4354,84,2,1
48928,2014/03/31,2011/12/26,488,4,0.425,6780,488,4,0
48929,2014/03/31,2008/10/17,347,2,0.697844514,4129,347,1,1
48930,2014/03/31,2011/03/22,492,3,0.610661297,4718,492,3,0
48931,2014/03/31,2006/06/05,81,4,0.721530178,3993,81,0,4
48932,2014/03/31,2012/01/21,364,2,0.652105025,4418,364,1,1
48933,2014/03/31,2009/10/25,73,4,0.790395062,3645,73,1,3
48934,2014/03/31,2007/03/20,76,4,0.46564086,6187,76,2,2
48935,2014/03/31,2008/03/11,293,5,0.561797972,5128,293,3,2
48936,2014/03/31,2012/12/08,315,3,0.45,6402,315,2,1
48937,2014/03/31,2011/03/21,36,4,0.8289985609999999,3475,36,3,1
48938,2014/03/31,2007/02/12,199,3,0.7183615959999999,4010,199,1,2
48939,2014/03/31,2010/06/20,152,6,0.593440461,4854,152,0,6
48940,2014/03/31,2012/06/15,96,4,0.41853095,6882,96,3,1
48941,2014/03/31,2011/11/29,4,3,0.69337506,4154,4,2,1
48942,2014/03/31,2012/05/01,538,2,1.0,2880,538,2,0
48943,2014/03/31,2012/04/22,540,2,1.0,2880,540,2,0
48944,2014/03/31,2012/07/17,532,3,0.635060639,4535,532,3,0
48945,2014/03/31,2012/05/01,540,2,1.0,2880,540,2,0
48946,2014/03/31,2009/09/18,171,3,0.907070866,3175,171,2,1
48947,2014/03/31,2009/07/09,77,2,0.81746239,3523,77,0,2
48948,2014/03/31,2012/02/21,589,4,0.775,3716,589,4,0
48949,2014/03/31,2010/10/30,612,4,0.775,3716,612,4,0
48950,2014/03/31,2011/08/04,662,4,0.775,3716,662,4,0
48951,2014/03/31,2010/11/25,8,8,0.6451075270000001,4464,8,4,4
48952,2014/03/31,2008/08/30,357,6,0.987517147,2916,357,5,1
48953,2014/03/31,2012/12/26,43,4,0.400101445,7196,43,1,3
48954,2014/03/31,2012/09/22,455,6,0.475,6060,455,6,0
48955,2014/03/31,2009/08/09,201,2,0.904335533,3183,201,0,2
48956,2014/03/31,2008/01/29,543,2,1.0,2878,543,2,0
48957,2014/03/31,2012/09/06,570,2,1.0,2878,570,2,0
48958,2014/03/31,2005/08/05,626,2,1.0,2878,626,2,0
48959,2014/03/31,2007/07/15,613,2,1.0,2878,613,2,0
48960,2014/03/31,2007/06/09,237,3,0.7577672459999999,3798,237,1,2
48961,2014/03/31,2011/08/21,65,6,0.828333333,3474,65,4,2
48962,2014/03/31,2012/05/23,383,4,0.55,5232,383,4,0
48963,2014/03/31,2011/04/05,56,4,0.825,3488,56,0,4
48964,2014/03/31,2008/10/16,346,4,0.825,3488,346,3,1
48965,2014/03/31,2011/10/06,589,3,0.669941793,4295,589,3,0
48966,2014/03/31,2008/04/10,179,3,0.768688218,3743,179,2,1
48967,2014/03/31,2011/08/19,221,2,0.949570957,3030,221,1,1
48968,2014/03/31,2011/07/05,713,2,0.7,4110,713,2,0
48969,2014/03/31,2011/08/24,368,2,0.375,7672,368,2,0
48970,2014/03/31,2010/03/08,582,2,0.7,4110,582,2,0
48971,2014/03/31,2011/11/06,590,2,0.7,4110,590,2,0
48972,2014/03/31,2012/04/25,224,5,0.767176,3750,224,4,1
48973,2014/03/31,2013/03/12,209,6,0.761029101,3780,209,0,6
48974,2014/03/31,2012/04/11,61,3,0.678135314,4242,61,1,2
48975,2014/03/31,2006/02/19,3,2,0.711327893,4044,3,0,2
48976,2014/03/31,2012/02/18,15,5,0.758373319,3793,15,3,2
48977,2014/03/31,2011/06/20,165,3,0.524217241,5487,165,2,1
48978,2014/03/31,2007/09/23,220,4,0.396624379,7252,220,0,4
48979,2014/03/31,2009/07/01,14,4,0.592432544,4855,14,3,1
48980,2014/03/31,2006/05/10,377,3,0.92598197,3106,377,3,0
48981,2014/03/31,2007/09/09,284,2,0.966073228,2977,284,1,1
48982,2014/03/31,2012/07/25,95,6,0.35907853700000003,8009,95,2,4
48983,2014/03/31,2012/05/24,235,4,0.4175,6888,235,2,2
48984,2014/03/31,2012/11/21,48,4,0.689285714,4172,48,2,2
48985,2014/03/31,2010/01/07,38,3,0.830378285,3463,38,2,1
48986,2014/03/31,2012/05/01,304,5,0.639695217,4495,304,3,2
48987,2014/03/31,2012/02/13,230,2,0.8779572520000001,3275,230,1,1
48988,2014/03/31,2013/02/06,35,3,0.658262363,4368,35,2,1
48989,2014/03/31,2012/07/25,105,5,0.52316048,5496,105,4,1
48990,2014/03/31,2008/07/21,9,6,0.64577044,4452,9,3,3
48991,2014/03/31,2012/09/10,443,4,0.625636561,4595,443,4,0
48992,2014/03/31,2011/04/23,704,2,0.75,3833,704,2,0
48993,2014/03/31,2012/05/10,525,3,0.962491628,2986,525,3,0
48994,2014/03/31,2008/11/29,2,2,0.832778905,3451,2,1,1
48995,2014/03/31,2013/01/24,57,4,0.754846336,3807,57,2,2
48996,2014/03/31,2013/02/19,338,2,0.5,5747,338,1,1
48997,2014/03/31,2011/10/16,619,2,0.581562437,4941,619,2,0
48998,2014/03/31,2013/03/30,23,3,0.559663031,5134,23,1,2
48999,2014/03/31,2010/11/17,77,4,0.618445975,4646,77,1,3
49000,2014/03/31,2010/12/16,38,4,0.491395587,5847,38,2,2
49001,2014/03/31,2012/07/31,136,4,0.5546370660000001,5180,136,2,2
49002,2014/03/31,2008/03/22,290,2,0.845,3400,290,0,2
49003,2014/03/31,2007/05/19,1,6,0.8916666670000001,3222,1,1,5
49004,2014/03/31,2011/12/22,301,3,0.654396355,4390,301,2,1
49005,2014/03/31,2010/11/17,65,2,0.74,3882,65,0,2
49006,2014/03/31,2012/05/15,44,3,0.706666667,4065,44,0,3
49007,2014/03/31,2011/01/13,112,2,0.53,5420,112,0,2
49008,2014/03/31,2012/10/21,132,5,0.485577346,5915,132,0,5
49009,2014/03/31,2008/03/11,295,2,0.7838946509999999,3664,295,0,2
49010,2014/03/31,2007/05/26,103,4,0.585763818,4903,103,0,4
49011,2014/03/31,2010/02/08,270,4,0.365,7868,270,0,4
49012,2014/03/31,2010/10/15,646,4,0.963947633,2979,646,4,0
49013,2014/03/31,2011/10/09,105,4,0.536875467,5348,105,1,3
49014,2014/03/31,2008/06/25,607,3,0.77699594,3695,607,3,0
49015,2014/03/31,2012/06/23,28,5,0.8333439770000001,3445,28,2,3
49016,2014/03/31,2011/04/24,130,3,0.597340824,4806,130,0,3
49017,2014/03/31,2009/08/25,315,2,0.7,4101,315,0,2
49018,2014/03/31,2012/08/20,44,3,0.621828423,4616,44,0,3
49019,2014/03/31,2013/02/01,66,2,0.83,3458,66,1,1
49020,2014/03/31,2011/07/27,282,5,0.5829839529999999,4923,282,4,1
49021,2014/03/31,2011/07/18,562,4,0.641417076,4474,562,4,0
49022,2014/03/31,2007/11/18,678,2,0.7164419479999999,4005,678,2,0
49023,2014/03/31,2008/06/15,230,6,0.55777605,5144,230,1,5
49024,2014/03/31,2008/08/21,163,4,0.634899314,4519,163,1,3
49025,2014/03/31,2011/04/22,291,3,0.593207196,4836,291,0,3
49026,2014/03/31,2008/05/25,658,3,0.790057835,3631,658,3,0
49027,2014/03/31,2011/04/14,248,3,0.793746541,3614,248,0,3
49028,2014/03/31,2008/05/10,560,4,0.893598131,3210,560,4,0
49029,2014/03/31,2012/05/21,367,3,0.580107201,4944,367,3,0
49030,2014/03/31,2012/01/09,194,4,0.655842671,4373,194,3,1
49031,2014/03/31,2013/03/10,266,2,0.47,6102,266,1,1
49032,2014/03/31,2010/05/12,359,4,0.738198198,3885,359,3,1
49033,2014/03/31,2010/06/26,222,4,0.562463711,5098,222,3,1
49034,2014/03/31,2012/10/20,24,3,0.483759069,5927,24,2,1
49035,2014/03/31,2013/02/28,368,2,0.8,3584,368,2,0
49036,2014/03/31,2012/05/15,685,2,0.8,3584,685,2,0
49037,2014/03/31,2012/09/16,76,2,0.575,4986,76,0,2
49038,2014/03/31,2006/08/18,19,4,0.412713792,6946,19,0,4
49039,2014/03/31,2013/01/01,185,2,0.8134761629999999,3524,185,0,2
49040,2014/03/31,2011/12/05,604,3,0.760143198,3771,604,3,0
49041,2014/03/31,2008/12/12,140,3,0.626235525,4577,140,1,2
49042,2014/03/31,2013/01/28,32,2,0.42,6824,32,0,2
49043,2014/03/31,2011/10/09,241,4,0.969239094,2957,241,2,2
49044,2014/03/31,2012/10/11,287,5,0.570916335,5020,287,4,1
49045,2014/03/31,2006/06/14,87,4,0.519563089,5516,87,2,2
49046,2014/03/31,2012/05/08,90,3,0.534597015,5360,90,2,1
49047,2014/03/31,2013/03/16,188,4,0.77038989,3719,188,0,4
49048,2014/03/31,2012/01/13,27,2,0.708400099,4044,27,0,2
49049,2014/03/31,2006/06/12,302,4,0.675650943,4240,302,3,1
49050,2014/03/31,2009/11/15,271,5,0.803991019,3563,271,4,1
49051,2014/03/31,2005/09/02,305,3,0.672097607,4262,305,1,2
49052,2014/03/31,2007/09/27,269,2,0.702189262,4079,269,0,2
49053,2014/03/31,2013/02/03,416,2,0.8,3580,416,2,0
49054,2014/03/31,2012/10/11,178,2,0.947363546,3023,178,1,1
49055,2014/03/31,2012/09/07,20,4,0.760254845,3767,20,2,2
49056,2014/03/31,2012/11/09,138,5,0.502632965,5697,138,1,4
49057,2014/03/31,2012/08/22,79,3,0.795839355,3598,79,2,1
49058,2014/03/31,2013/01/14,318,4,0.6919526340000001,4138,318,2,2
49059,2014/03/31,2013/02/04,410,2,1.0,2863,410,2,0
49060,2014/03/31,2013/01/17,86,4,0.738164002,3878,86,0,4
49061,2014/03/31,2011/04/20,222,3,0.8321191859999999,3440,222,1,2
49062,2014/03/31,2010/12/29,1,4,0.526618215,5435,1,0,4
49063,2014/03/31,2011/11/07,40,3,1.47,1947,40,2,1
49064,2014/03/31,2010/09/28,481,4,0.759368365,3768,481,4,0
49065,2014/03/31,2012/08/01,441,3,0.6408286670000001,4465,441,3,0
49066,2014/03/31,2011/07/04,73,4,0.6296808979999999,4544,73,3,1
49067,2014/03/31,2012/09/13,557,4,0.52927303,5406,557,4,0
49068,2014/03/31,2012/05/25,538,4,0.66400557,4309,538,4,0
49069,2014/03/31,2010/01/04,359,5,0.558491118,5123,359,0,5
49070,2014/03/31,2012/11/03,403,3,0.770535955,3713,403,3,0
49071,2014/03/31,2011/06/08,134,4,0.647925255,4415,134,3,1
49072,2014/03/31,2005/05/18,7,2,0.8559425490000001,3342,7,1,1
49073,2014/03/31,2012/08/08,599,2,1.127957413,2536,599,2,0
49074,2014/03/31,2009/12/14,193,3,0.931906158,3069,193,2,1
49075,2014/03/31,2009/10/28,412,4,0.982697595,2910,412,4,0
49076,2014/03/31,2006/08/06,705,2,0.691225526,4137,705,2,0
49077,2014/03/31,2009/12/19,220,5,0.654163807,4371,220,4,1
49078,2014/03/31,2008/08/16,481,6,0.382873594,7468,481,6,0
49079,2014/03/31,2013/01/01,288,6,0.347168528,8236,288,2,4
49080,2014/03/31,2010/04/15,98,2,0.6691247370000001,4273,98,0,2
49081,2014/03/31,2010/02/11,120,3,0.680735889,4199,120,0,3
49082,2014/03/31,2006/07/02,114,4,0.377333333,7575,114,0,4
49083,2014/03/31,2006/12/22,201,4,0.610226302,4684,201,1,3
49084,2014/03/31,2011/06/12,191,3,0.423333333,6750,191,2,1
49085,2014/03/31,2010/05/21,55,2,0.921725806,3100,55,0,2
49086,2014/03/31,2005/06/08,266,5,0.88206854,3239,266,1,4
49087,2014/03/31,2011/06/13,550,2,1.0,2857,550,2,0
49088,2014/03/31,2009/10/20,93,3,0.320080672,8925,93,0,3
49089,2014/03/31,2010/02/18,411,5,0.7961538459999999,3588,411,5,0
49090,2014/03/31,2012/08/02,33,6,0.79034311,3614,33,0,6
49091,2014/03/31,2010/09/26,44,2,0.625,4570,44,0,2
49092,2014/03/31,2007/06/07,40,2,0.625,4570,40,0,2
49093,2014/03/31,2011/02/26,149,2,0.625,4570,149,0,2
49094,2014/03/31,2008/01/25,251,2,0.888398134,3215,251,1,1
49095,2014/03/31,2012/08/04,112,5,0.88,3245,112,2,3
49096,2014/03/31,2010/12/05,546,2,0.780631493,3658,546,2,0
49097,2014/03/31,2005/08/31,289,4,0.816209262,3498,289,3,1
49098,2014/03/31,2007/04/23,144,4,0.658049793,4338,144,2,2
49099,2014/03/31,2012/09/19,542,2,0.7,4078,542,2,0
49100,2014/03/31,2012/10/07,49,3,0.605329799,4715,49,1,2
49101,2014/03/31,2008/08/03,170,4,0.7696386190000001,3708,170,3,1
49102,2014/03/31,2005/04/07,47,6,0.317766147,8980,47,1,5
49103,2014/03/31,2008/05/19,533,3,0.668266979,4270,533,3,0
49104,2014/03/31,2009/07/21,6,3,0.684608925,4168,6,1,2
49105,2014/03/31,2004/11/20,405,3,0.664473684,4294,405,3,0
49106,2014/03/31,2013/03/18,121,2,0.58,4919,121,0,2
49107,2014/03/31,2012/02/04,551,5,0.411785508,6928,551,5,0
49108,2014/03/31,2012/09/08,420,2,0.825,3458,420,2,0
49109,2014/03/31,2012/07/27,611,2,0.825,3458,611,2,0
49110,2014/03/31,2012/07/27,611,2,0.825,3458,611,2,0
49111,2014/03/31,2009/11/28,161,3,0.633875556,4500,161,1,2
49112,2014/03/31,2011/07/09,554,2,0.725,3934,554,2,0
49113,2014/03/31,2011/08/29,338,2,0.725,3934,338,0,2
49114,2014/03/31,2011/03/29,513,2,0.725,3934,513,2,0
49115,2014/03/31,2013/02/19,396,2,0.725,3934,396,2,0
49116,2014/03/31,2009/01/31,345,2,0.725,3934,345,0,2
49117,2014/03/31,2005/08/02,402,2,0.725,3934,402,2,0
49118,2014/03/31,2008/04/30,283,2,0.725,3934,283,1,1
49119,2014/03/31,2010/08/13,661,3,0.483333333,5901,661,3,0
49120,2014/03/31,2008/02/17,376,2,0.725,3934,376,2,0
49121,2014/03/31,2012/11/07,264,3,0.726666667,3924,264,2,1
49122,2014/03/31,2011/08/23,107,3,0.600893572,4745,107,1,2
49123,2014/03/31,2008/07/25,280,2,1.105,2580,280,1,1
49124,2014/03/31,2012/12/01,290,5,0.593432556,4804,290,0,5
49125,2014/03/31,2010/01/31,631,3,0.528807271,5391,631,3,0
49126,2014/03/31,2011/03/23,114,4,0.7235532990000001,3940,114,3,1
49127,2014/03/31,2005/11/18,159,2,0.809179676,3523,159,0,2
49128,2014/03/31,2012/09/21,477,5,0.7209281740000001,3954,477,5,0
49129,2014/03/31,2012/10/16,396,3,0.783333333,3639,396,3,0
49130,2014/03/31,2009/10/02,380,3,0.8174361920000001,3487,380,3,0
49131,2014/03/31,2010/10/01,168,4,0.47545955,5995,168,1,3
49132,2014/03/31,2012/02/02,257,5,0.468491124,6084,257,4,1
49133,2014/03/31,2007/09/12,218,2,0.8163420220000001,3491,218,1,1
49134,2014/03/31,2012/05/30,386,7,0.30462319600000004,9355,386,7,0
49135,2014/03/31,2006/06/19,161,3,0.725222703,3929,161,1,2
49136,2014/03/31,2013/01/02,211,2,0.39,7306,211,1,1
49137,2014/03/31,2013/01/14,170,3,0.470381377,6057,170,2,1
49138,2014/03/31,2013/01/24,396,2,0.7,4070,396,2,0
49139,2014/03/31,2011/02/21,349,2,1.104614192,2579,349,1,1
49140,2014/03/31,2008/05/10,34,4,0.617997396,4609,34,2,2
49141,2014/03/31,2008/12/26,335,3,0.533333333,5340,335,2,1
49142,2014/03/31,2012/02/02,404,2,0.8,3560,404,2,0
49143,2014/03/31,2012/04/19,572,2,0.8,3560,572,2,0
49144,2014/03/31,2008/08/27,99,5,0.628,4535,99,0,5
49145,2014/03/31,2010/11/28,48,3,0.930343025,3061,48,2,1
49146,2014/03/31,2013/02/07,103,5,0.720027813,3955,103,0,5
49147,2014/03/31,2009/10/29,359,4,0.9,3164,359,2,2
49148,2014/03/31,2012/05/11,211,4,0.8072611279999999,3527,211,2,2
49149,2014/03/31,2007/11/24,159,3,0.38,7492,159,0,3
49150,2014/03/31,2011/09/19,717,2,0.676015198,4211,717,2,0
49151,2014/03/31,2008/06/17,12,4,0.5615446829999999,5069,12,2,2
49152,2014/03/31,2011/10/21,231,4,0.49288658,5775,231,2,2
49153,2014/03/31,2007/05/01,4,4,0.602614863,4723,4,0,4
49154,2014/03/31,2008/03/28,287,5,0.5807018979999999,4901,287,3,2
49155,2014/03/31,2010/02/18,14,9,0.51874043,5486,14,6,3
49156,2014/03/31,2010/11/25,284,4,0.913840719,3114,284,1,3
49157,2014/03/31,2009/03/15,286,4,0.517555475,5498,286,3,1
49158,2014/03/31,2011/08/01,572,2,0.525,5420,572,2,0
49159,2014/03/31,2007/09/08,182,3,0.694532585,4097,182,1,2
49160,2014/03/31,2009/12/22,427,4,0.877366636,3243,427,4,0
49161,2014/03/31,2009/11/08,206,3,0.5675802910000001,5013,206,0,3
49162,2014/03/31,2005/11/26,589,2,0.933125615,3049,589,2,0
49163,2014/03/31,2013/03/16,35,3,0.6431012660000001,4424,35,0,3
49164,2014/03/31,2004/11/11,454,4,0.564932486,5036,454,4,0
49165,2014/03/31,2008/02/20,165,2,0.833551128,3413,165,0,2
49166,2014/03/31,2010/01/04,247,4,0.502785437,5658,247,0,4
49167,2014/03/31,2008/09/06,71,4,0.412039397,6904,71,2,2
49168,2014/03/31,2010/12/04,383,4,0.637648509,4461,383,4,0
49169,2014/03/31,2013/03/17,330,2,0.800337648,3554,330,1,1
49170,2014/03/31,2011/10/02,77,4,0.597927265,4757,77,2,2
49171,2014/03/31,2011/10/13,76,4,0.555488281,5120,76,3,1
49172,2014/03/31,2012/10/11,523,3,0.584322992,4867,523,3,0
49173,2014/03/31,2013/01/04,27,4,0.463491443,6135,27,0,4
49174,2014/03/31,2010/06/12,380,4,0.523857775,5428,380,4,0
49175,2014/03/31,2006/06/20,140,3,0.539457408,5271,140,0,3
49176,2014/03/31,2010/07/20,464,3,0.653204686,4353,464,3,0
49177,2014/03/31,2007/10/24,208,4,0.561350444,5065,208,0,4
49178,2014/03/31,2012/03/18,164,4,0.525332594,5412,164,0,4
49179,2014/03/31,2007/11/09,602,2,0.702855377,4045,602,2,0
49180,2014/03/31,2012/04/19,25,3,0.780145445,3644,25,1,2
49181,2014/03/31,2008/10/16,391,2,0.8,3553,391,2,0
49182,2014/03/31,2012/11/28,235,3,0.571615044,4972,235,1,2
49183,2014/03/31,2013/01/27,403,2,0.5,5684,403,2,0
49184,2014/03/31,2010/12/09,352,2,0.5,5684,352,0,2
49185,2014/03/31,2008/01/26,309,5,0.56,5075,309,3,2
49186,2014/03/31,2008/04/18,563,2,0.5,5684,563,2,0
49187,2014/03/31,2012/06/28,643,2,0.392012691,7249,643,2,0
49188,2014/03/31,2013/03/14,14,2,0.8464879359999999,3357,14,1,1
49189,2014/03/31,2013/02/14,361,6,0.608297645,4670,361,4,2
49190,2014/03/31,2011/10/04,389,4,0.53425804,5317,389,4,0
49191,2014/03/31,2012/11/18,49,3,0.969385666,2930,49,2,1
49192,2014/03/31,2013/01/22,44,4,0.55,5164,44,2,2
49193,2014/03/31,2012/05/27,67,5,0.4012364,7077,67,3,2
49194,2014/03/31,2007/05/18,70,14,0.314299314,9034,70,9,5
49195,2014/03/31,2007/05/02,4,10,0.5443558279999999,5216,4,4,6
49196,2014/03/31,2011/12/31,275,3,0.813294185,3491,275,0,3
49197,2014/03/31,2010/07/08,81,8,0.551774538,5145,81,5,3
49198,2014/03/31,2005/10/08,43,4,0.424395276,6689,43,0,4
49199,2014/03/31,2010/06/29,277,2,0.75,3785,277,0,2
49200,2014/03/31,2007/08/06,593,3,0.65755154,4317,593,3,0
49201,2014/03/31,2011/07/19,519,2,0.920330739,3084,519,2,0
49202,2014/03/31,2013/01/20,160,2,0.665,4268,160,1,1
49203,2014/03/31,2007/07/04,64,4,0.458608597,6188,64,0,4
49204,2014/03/31,2013/01/01,422,2,0.6754582240000001,4201,422,2,0
49205,2014/03/31,2012/08/26,581,2,0.8,3547,581,2,0
49206,2014/03/31,2010/06/08,67,4,0.5037872870000001,5632,67,1,3
49207,2014/03/31,2009/10/01,540,3,0.435035265,6522,540,3,0
49208,2014/03/31,2010/01/19,297,3,0.754392449,3761,297,2,1
49209,2014/03/31,2011/11/09,402,4,0.643108139,4411,402,4,0
49210,2014/03/31,2006/07/01,23,5,0.600802796,4721,23,0,5
49211,2014/03/31,2012/11/07,210,4,0.697913386,4064,210,3,1
49212,2014/03/31,2007/04/24,513,3,0.76038874,3730,513,3,0
49213,2014/03/31,2007/08/31,266,6,0.464181669,6110,266,4,2
49214,2014/03/31,2007/08/01,626,3,1.0,2836,626,3,0
49215,2014/03/31,2005/09/09,235,2,0.735,3858,235,1,1
49216,2014/03/31,2012/05/13,206,4,0.96741044,2931,206,3,1
49217,2014/03/31,2009/04/19,106,3,0.923851417,3069,106,1,2
49218,2014/03/31,2005/03/03,441,4,0.508192901,5578,441,4,0
49219,2014/03/31,2013/01/04,276,3,0.659218605,4300,276,2,1
49220,2014/03/31,2012/09/30,463,4,0.609329321,4652,463,4,0
49221,2014/03/31,2009/01/09,78,3,0.700239625,4048,78,1,2
49222,2014/03/31,2008/10/23,296,5,0.660675991,4290,296,1,4
49223,2014/03/31,2010/07/16,624,4,0.665461376,4259,624,4,0
49224,2014/03/31,2012/07/24,601,2,0.475,5966,601,2,0
49225,2014/03/31,2012/06/25,168,2,1.21,2342,168,0,2
49226,2014/03/31,2008/06/09,348,3,0.8631434659999999,3283,348,0,3
49227,2014/03/31,2010/01/04,84,3,0.456265099,6209,84,0,3
49228,2014/03/31,2006/05/25,83,3,0.5677094189999999,4990,83,2,1
49229,2014/03/31,2009/09/08,242,2,0.856522528,3307,242,0,2
49230,2014/03/31,2013/01/18,74,3,0.833333333,3399,74,1,2
49231,2014/03/31,2011/09/20,48,2,0.72,3934,48,0,2
49232,2014/03/31,2011/01/13,129,2,0.72,3934,129,0,2
49233,2014/03/31,2011/01/03,45,2,0.72,3934,45,0,2
49234,2014/03/31,2013/03/17,202,2,0.72,3934,202,0,2
49235,2014/03/31,2013/01/22,176,2,0.72,3934,176,0,2
49236,2014/03/31,2008/06/19,293,2,0.72,3934,293,0,2
49237,2014/03/31,2009/12/16,4,3,0.48,5901,4,0,3
49238,2014/03/31,2011/09/20,197,3,0.45,6294,197,0,3
49239,2014/03/31,2012/07/05,614,2,0.675,4196,614,2,0
49240,2014/03/31,2011/01/02,47,5,0.754864072,3752,47,1,4
49241,2014/03/31,2010/04/15,213,5,0.499588993,5669,213,1,4
49242,2014/03/31,2010/08/22,160,4,0.658785764,4299,160,1,3
49243,2014/03/31,2012/11/28,267,4,0.6771999040000001,4182,267,0,4
49244,2014/03/31,2013/03/02,321,3,0.791061453,3580,321,1,2
49245,2014/03/31,2008/01/13,159,2,1.149780755,2463,159,0,2
49246,2014/03/31,2011/04/26,176,7,0.698571429,4053,176,6,1
49247,2014/03/31,2012/07/09,346,2,0.960705803,2947,346,0,2
49248,2014/03/31,2012/02/17,597,4,0.640208051,4422,597,4,0
49249,2014/03/31,2007/11/27,175,5,0.488507334,5795,175,3,2
49250,2014/03/31,2011/12/05,218,2,0.75,3774,218,0,2
49251,2014/03/31,2013/03/05,135,2,0.75,3774,135,0,2
49252,2014/03/31,2011/05/09,517,2,0.8,3538,517,2,0
49253,2014/03/31,2006/10/25,340,2,0.725,3904,340,0,2
49254,2014/03/31,2011/06/25,206,2,0.645009116,4388,206,0,2
49255,2014/03/31,2010/10/09,124,2,0.795,3560,124,0,2
49256,2014/03/31,2012/07/04,1,5,0.795220568,3559,1,2,3
49257,2014/03/31,2009/07/15,4,4,0.7057605990000001,4010,4,0,4
49258,2014/03/31,2011/03/03,246,2,0.67,4224,246,0,2
49259,2014/03/31,2011/09/09,94,5,0.532361242,5315,94,3,2
49260,2014/03/31,2012/01/04,260,5,0.82,3450,260,0,5
49261,2014/03/31,2012/09/08,191,3,0.872813946,3241,191,1,2
49262,2014/03/31,2006/06/15,344,2,0.75,3771,344,1,1
49263,2014/03/31,2011/03/15,339,6,0.586773859,4820,339,2,4
49264,2014/03/31,2008/03/25,472,3,0.632837324,4469,472,3,0
49265,2014/03/31,2012/03/15,251,4,0.7641448259999999,3701,251,2,2
49266,2014/03/31,2012/11/12,443,2,0.8,3535,443,2,0
49267,2014/03/31,2008/05/16,76,3,0.933333333,3030,76,2,1
49268,2014/03/31,2011/06/30,423,5,0.56,5050,423,5,0
49269,2014/03/31,2011/07/24,48,3,0.59762891,4732,48,1,2
49270,2014/03/31,2012/03/07,25,5,0.736504298,3839,25,0,5
49271,2014/03/31,2006/06/29,426,2,0.638637904,4427,426,2,0
49272,2014/03/31,2013/02/08,60,2,0.922938296,3063,60,1,1
49273,2014/03/31,2012/08/28,562,2,0.525055721,5384,562,2,0
49274,2014/03/31,2011/01/17,242,3,0.730832472,3868,242,1,2
49275,2014/03/31,2008/08/17,362,3,0.907447833,3115,362,2,1
49276,2014/03/31,2006/03/05,249,2,0.947265416,2984,249,1,1
49277,2014/03/31,2012/03/22,24,3,0.670543298,4215,24,2,1
49278,2014/03/31,2006/08/28,67,4,0.6222655220000001,4542,67,1,3
49279,2014/03/31,2012/08/15,137,3,0.549961082,5139,137,2,1
49280,2014/03/31,2011/07/06,600,3,0.452401153,6247,600,3,0
49281,2014/03/31,2007/12/17,201,3,0.72,3924,201,0,3
49282,2014/03/31,2008/12/20,218,3,0.576439502,4901,218,1,2
49283,2014/03/31,2006/06/19,499,3,0.7543124170000001,3745,499,3,0
49284,2014/03/31,2012/10/23,305,3,0.526703338,5363,305,1,2
49285,2014/03/31,2010/07/30,127,3,0.743918883,3797,127,1,2
49286,2014/03/31,2012/03/22,315,2,1.0,2824,315,1,1
49287,2014/03/31,2012/08/17,105,2,0.6087238629999999,4639,105,0,2
49288,2014/03/31,2009/07/16,4,4,0.530881745,5319,4,0,4
49289,2014/03/31,2011/12/17,161,6,0.6183333329999999,4566,161,3,3
49290,2014/03/31,2011/07/30,144,4,0.948887395,2975,144,1,3
49291,2014/03/31,2007/10/06,43,4,0.56277512,5016,43,2,2
49292,2014/03/31,2012/07/08,345,3,0.50722372,5565,345,2,1
49293,2014/03/31,2008/10/02,367,4,0.55,5132,367,4,0
49294,2014/03/31,2010/10/01,558,5,0.681622796,4141,558,5,0
49295,2014/03/31,2009/06/04,26,2,0.861859542,3275,26,1,1
49296,2014/03/31,2010/11/17,9,9,0.438900638,6431,9,3,6
49297,2014/03/31,2010/03/03,160,4,0.8757027609999999,3223,160,2,2
49298,2014/03/31,2009/04/17,525,4,0.72852349,3874,525,4,0
49299,2014/03/31,2012/01/23,540,3,0.612190889,4610,540,3,0
49300,2014/03/31,2012/07/17,246,2,0.55,5131,246,1,1
49301,2014/03/31,2004/11/25,194,2,0.5,5644,194,1,1
49302,2014/03/31,2007/11/01,80,3,0.7600296259999999,3713,80,1,2
49303,2014/03/31,2008/04/21,16,3,0.594175616,4749,16,0,3
49304,2014/03/31,2012/08/02,591,2,0.75,3762,591,2,0
49305,2014/03/31,2008/09/04,602,2,0.75,3762,602,2,0
49306,2014/03/31,2011/11/18,419,2,0.75,3762,419,2,0
49307,2014/03/31,2012/05/29,401,3,0.700124069,4030,401,3,0
49308,2014/03/31,2012/07/19,611,2,0.75,3762,611,2,0
49309,2014/03/31,2012/07/27,604,3,0.681352657,4140,604,3,0
49310,2014/03/31,2010/12/22,176,13,0.7997249790000001,3527,176,10,3
49311,2014/03/31,2012/10/31,97,5,0.608700626,4633,97,2,3
49312,2014/03/31,2009/01/25,424,2,1.0,2820,424,2,0
49313,2014/03/31,2010/04/01,266,3,0.819729651,3440,266,2,1
49314,2014/03/31,2012/04/24,89,2,0.43501697,6482,89,0,2
49315,2014/03/31,2013/01/13,174,2,1.064037736,2650,174,1,1
49316,2014/03/31,2012/09/29,52,4,0.652655093,4320,52,3,1
49317,2014/03/31,2011/12/23,1,4,0.612435368,4603,1,2,2
49318,2014/03/31,2010/11/25,467,3,0.717485365,3929,467,3,0
49319,2014/03/31,2011/09/30,174,4,0.32395701600000004,8701,174,1,3
49320,2014/03/31,2013/01/28,7,4,0.5375,5244,7,0,4
49321,2014/03/31,2008/09/01,291,3,0.465414465,6056,291,2,1
49322,2014/03/31,2012/10/12,40,5,0.608997407,4628,40,0,5
49323,2014/03/31,2011/08/19,585,2,0.633531924,4448,585,2,0
49324,2014/03/31,2007/04/21,171,3,0.7609505809999999,3703,171,0,3
49325,2014/03/31,2010/10/22,257,2,0.752014945,3747,257,1,1
49326,2014/03/31,2008/11/17,336,3,0.903366464,3119,336,2,1
49327,2014/03/31,2012/11/02,374,4,0.53721152,5243,374,4,0
49328,2014/03/31,2012/07/11,461,3,0.953775821,2953,461,3,0
49329,2014/03/31,2011/03/11,132,4,1.10015625,2560,132,3,1
49330,2014/03/31,2012/12/18,99,3,0.73,3858,99,0,3
49331,2014/03/31,2009/03/16,331,3,0.48496642,5807,331,2,1
49332,2014/03/31,2012/10/23,383,3,1.233333333,2283,383,3,0
49333,2014/03/31,2012/12/20,339,5,0.766943612,3671,339,4,1
49334,2014/03/31,2011/10/27,278,3,0.62711517,4489,278,2,1
49335,2014/03/31,2012/10/02,174,3,0.5212053320000001,5401,174,0,3
49336,2014/03/31,2012/12/09,80,5,0.49338475,5705,80,1,4
49337,2014/03/31,2011/01/15,607,2,0.725,3882,607,2,0
49338,2014/03/31,2010/07/31,278,2,0.558644303,5038,278,1,1
49339,2014/03/31,2007/10/05,278,3,0.791011804,3558,278,1,2
49340,2014/03/31,2005/12/30,3,3,0.669448145,4204,3,1,2
49341,2014/03/31,2011/04/09,642,2,0.7534939759999999,3735,642,2,0
49342,2014/03/31,2009/09/13,434,4,0.5560264770000001,5061,434,4,0
49343,2014/03/31,2006/03/07,319,6,0.743238246,3786,319,2,4
49344,2014/03/31,2011/02/03,658,4,0.633475912,4442,658,4,0
49345,2014/03/31,2004/11/26,419,2,1.248557479,2253,419,2,0
49346,2014/03/31,2011/06/28,161,8,0.60625,4640,161,4,4
49347,2014/03/31,2009/06/07,513,2,0.757377491,3714,513,2,0
49348,2014/03/31,2006/06/07,63,2,0.715,3934,63,0,2
49349,2014/03/31,2005/12/29,137,2,0.8,3516,137,0,2
49350,2014/03/31,2013/02/12,319,3,0.555550069,5063,319,0,3
49351,2014/03/31,2008/11/12,193,4,0.715105517,3933,193,0,4
49352,2014/03/31,2011/09/30,130,3,0.6798259609999999,4137,130,1,2
49353,2014/03/31,2011/07/16,330,3,0.63568038,4424,330,0,3
49354,2014/03/31,2011/09/29,110,3,0.716666667,3924,110,0,3
49355,2014/03/31,2011/12/29,341,5,0.43,6540,341,4,1
49356,2014/03/31,2006/10/30,465,4,0.5163239070000001,5446,465,4,0
49357,2014/03/31,2012/02/24,26,5,0.34,8270,26,2,3
49358,2014/03/31,2008/04/26,124,2,0.67,4196,124,0,2
49359,2014/03/31,2008/03/15,114,2,0.67,4196,114,0,2
49360,2014/03/31,2011/08/29,159,3,0.61380786,4580,159,2,1
49361,2014/03/31,2012/12/25,363,2,0.7,4016,363,1,1
49362,2014/03/31,2011/10/18,79,4,0.7464657459999999,3766,79,1,3
49363,2014/03/31,2008/11/27,67,2,0.630307175,4460,67,0,2
49364,2014/03/31,2012/04/09,571,4,1.0,2811,571,4,0
49365,2014/03/31,2008/08/16,8,3,0.653333333,4302,8,1,2
49366,2014/03/31,2007/09/16,70,5,0.942525151,2982,70,2,3
49367,2014/03/31,2012/08/14,38,10,0.384123838,7316,38,4,6
49368,2014/03/31,2011/11/14,149,4,0.494735915,5680,149,0,4
49369,2014/03/31,2012/08/02,1,11,0.4520592020000001,6216,1,4,7
49370,2014/03/31,2007/04/11,22,4,0.435717165,6449,22,0,4
49371,2014/03/31,2012/04/27,600,2,0.856907594,3279,600,2,0
49372,2014/03/31,2012/06/09,636,4,0.6896881909999999,4073,636,4,0
49373,2014/03/31,2007/11/14,105,3,0.604699677,4645,105,0,3
49374,2014/03/31,2006/03/01,69,2,0.89380331,3142,69,0,2
49375,2014/03/31,2005/01/29,134,5,0.808109353,3475,134,2,3
49376,2014/03/31,2006/05/31,243,4,0.640533759,4384,243,0,4
49377,2014/03/31,2005/01/26,8,2,0.7009560659999999,4006,8,0,2
49378,2014/03/31,2012/07/21,212,2,0.675,4160,212,0,2
49379,2014/03/31,2011/07/21,331,2,0.9,3120,331,1,1
49380,2014/03/31,2009/08/29,217,2,0.8578796209999999,3273,217,1,1
49381,2014/03/31,2012/05/05,696,2,1.26350135,2222,696,2,0
49382,2014/03/31,2009/01/05,162,3,0.871832298,3220,162,0,3
49383,2014/03/31,2006/03/30,661,3,0.711764706,3944,661,3,0
49384,2014/03/31,2011/06/23,155,2,0.45,6238,155,0,2
49385,2014/03/31,2008/01/24,664,2,0.45,6238,664,2,0
49386,2014/03/31,2007/10/12,461,5,0.426668187,6579,461,5,0
49387,2014/03/31,2011/02/04,371,2,0.468927497,5986,371,2,0
49388,2014/03/31,2011/01/19,208,4,0.644831151,4353,208,3,1
49389,2014/03/31,2012/10/22,319,3,0.716556038,3917,319,1,2
49390,2014/03/31,2008/03/23,110,3,0.596666667,4704,110,1,2
49391,2014/03/31,2012/10/29,306,3,0.654653604,4287,306,1,2
49392,2014/03/31,2012/02/07,18,3,0.486810061,5765,18,1,2
49393,2014/03/31,2012/12/16,452,4,0.449719551,6240,452,4,0
49394,2014/03/31,2011/07/10,301,4,0.596277093,4706,301,3,1
49395,2014/03/31,2008/08/29,628,2,0.838583383,3346,628,2,0
49396,2014/03/31,2005/12/20,300,4,0.596737558,4702,300,3,1
49397,2014/03/31,2009/06/13,525,3,0.8995832,3119,525,3,0
49398,2014/03/31,2005/04/21,94,10,0.512,5480,94,5,5
49399,2014/03/31,2007/04/17,102,3,0.8104332759999999,3462,102,0,3
49400,2014/03/31,2012/09/14,323,2,0.525,5344,323,1,1
49401,2014/03/31,2012/01/22,185,2,0.835,3360,185,0,2
49402,2014/03/31,2010/11/01,656,2,0.525,5344,656,2,0
49403,2014/03/31,2008/04/27,115,3,0.7392569170000001,3795,115,1,2
49404,2014/03/31,2012/08/09,86,4,0.559607022,5013,86,1,3
49405,2014/03/31,2010/08/07,414,3,0.9,3117,414,3,0
49406,2014/03/31,2007/04/09,549,2,1.0,2805,549,2,0
49407,2014/03/31,2013/02/06,147,4,0.6807985440000001,4120,147,0,4
49408,2014/03/31,2012/04/22,265,2,0.6812217629999999,4117,265,1,1
49409,2014/03/31,2009/06/03,4,4,0.523603435,5356,4,3,1
49410,2014/03/31,2004/12/31,137,5,0.568004861,4937,137,1,4
49411,2014/03/31,2007/02/13,3,3,0.941319235,2979,3,1,2
49412,2014/03/31,2012/10/16,385,3,0.8873417720000001,3160,385,3,0
49413,2014/03/31,2008/01/07,160,2,0.675,4154,160,0,2
49414,2014/03/31,2010/12/20,51,2,0.675,4154,51,0,2
49415,2014/03/31,2013/01/19,435,2,0.675,4154,435,2,0
49416,2014/03/31,2010/02/03,21,2,0.675,4154,21,0,2
49417,2014/03/31,2012/06/30,527,2,0.675,4154,527,2,0
49418,2014/03/31,2010/10/05,347,4,0.8041009459999999,3487,347,3,1
49419,2014/03/31,2006/09/11,147,5,0.40798021,6872,147,2,3
49420,2014/03/31,2011/07/04,638,4,0.483712905,5796,638,4,0
49421,2014/03/31,2013/03/05,328,4,0.8,3504,328,1,3
49422,2014/03/31,2012/11/20,175,6,0.87,3222,175,3,3
49423,2014/03/31,2011/11/07,445,4,0.530488266,5284,445,4,0
49424,2014/03/31,2007/10/07,22,4,0.642001832,4366,22,0,4
49425,2014/03/31,2012/07/04,403,5,0.7104435990000001,3945,403,5,0
49426,2014/03/31,2007/02/15,35,5,0.497156289,5637,35,0,5
49427,2014/03/31,2009/07/09,121,4,0.607183099,4615,121,3,1
49428,2014/03/31,2013/01/30,112,6,0.360901597,7764,112,2,4
49429,2014/03/31,2010/12/06,465,4,0.718093285,3902,465,4,0
49430,2014/03/31,2007/11/07,521,2,0.775491281,3613,521,2,0
49431,2014/03/31,2011/01/18,313,5,0.703087349,3984,313,1,4
49432,2014/03/31,2010/09/13,107,6,0.675914575,4144,107,0,6
49433,2014/03/31,2011/10/12,164,4,0.5,5600,164,2,2
49434,2014/03/31,2012/11/15,479,2,1.25,2240,479,2,0
49435,2014/03/31,2007/01/27,716,2,1.0,2800,716,2,0
49436,2014/03/31,2008/03/10,237,3,0.413333333,6774,237,1,2
49437,2014/03/31,2013/03/03,35,6,0.429098851,6525,35,1,5
49438,2014/03/31,2006/11/02,341,2,0.70117706,3993,341,1,1
49439,2014/03/31,2010/03/28,168,5,0.716901408,3905,168,2,3
49440,2014/03/31,2008/05/30,55,5,0.840678679,3330,55,1,4
49441,2014/03/31,2006/09/13,3,4,0.440908805,6349,3,0,4
49442,2014/03/31,2012/04/10,616,3,0.7,3999,616,3,0
49443,2014/03/31,2011/01/25,132,4,0.893155712,3134,132,1,3
49444,2014/03/31,2012/08/18,542,3,1.0,2799,542,3,0
49445,2014/03/31,2010/11/08,551,3,1.0,2799,551,3,0
49446,2014/03/31,2011/09/11,397,3,1.0,2799,397,3,0
49447,2014/03/31,2010/10/18,566,2,1.5,1866,566,2,0
49448,2014/03/31,2007/05/31,477,3,1.0,2799,477,3,0
49449,2014/03/31,2010/04/12,315,3,1.0,2799,315,1,2
49450,2014/03/31,2005/12/21,641,3,1.0,2799,641,3,0
49451,2014/03/31,2012/06/10,594,4,0.841015625,3328,594,4,0
49452,2014/03/31,2008/12/23,387,3,0.670287425,4175,387,3,0
49453,2014/03/31,2005/08/10,170,3,0.842964748,3319,170,2,1
49454,2014/03/31,2013/03/09,199,3,0.409334309,6835,199,1,2
49455,2014/03/31,2008/05/10,102,3,0.7476456440000001,3742,102,0,3
49456,2014/03/31,2007/02/21,171,6,0.589692243,4744,171,4,2
49457,2014/03/31,2012/11/16,391,4,0.7026124090000001,3981,391,4,0
49458,2014/03/31,2012/10/02,49,5,0.846320726,3305,49,2,3
49459,2014/03/31,2011/08/26,155,2,0.474610555,5893,155,1,1
49460,2014/03/31,2011/05/10,548,5,0.905699482,3088,548,5,0
49461,2014/03/31,2012/08/02,345,3,0.716197183,3905,345,1,2
49462,2014/03/31,2012/05/16,510,7,0.587279412,4760,510,7,0
49463,2014/03/31,2010/08/27,423,4,0.728485796,3837,423,4,0
49464,2014/03/31,2011/08/25,301,5,0.496028394,5635,301,2,3
49465,2014/03/31,2006/09/20,504,3,1.0,2795,504,3,0
49466,2014/03/31,2011/07/19,647,2,0.65,4300,647,2,0
49467,2014/03/31,2013/03/15,49,6,0.7033660620000001,3972,49,0,6
49468,2014/03/31,2007/11/10,231,2,0.71,3934,231,1,1
49469,2014/03/31,2007/10/23,66,2,0.71,3934,66,0,2
49470,2014/03/31,2011/01/11,207,4,0.643982015,4337,207,2,2
49471,2014/03/31,2008/01/29,279,7,0.524285714,5327,279,6,1
49472,2014/03/31,2009/11/11,112,3,0.726136245,3846,112,0,3
49473,2014/03/31,2012/07/14,2,3,0.805724178,3466,2,1,2
49474,2014/03/31,2012/12/06,46,3,0.490537502,5693,46,1,2
49475,2014/03/31,2007/11/12,1,6,0.529133978,5277,1,3,3
49476,2014/03/31,2006/09/14,544,3,0.556951925,5013,544,3,0
49477,2014/03/31,2005/09/17,417,2,0.887631161,3145,417,2,0
49478,2014/03/31,2012/04/12,320,2,0.731485849,3816,320,1,1
49479,2014/03/31,2013/01/01,359,2,0.540615921,5163,359,0,2
49480,2014/03/31,2012/02/23,376,2,0.666292671,4189,376,2,0
49481,2014/03/31,2006/07/07,89,2,0.642620309,4343,89,0,2
49482,2014/03/31,2007/07/16,222,4,0.595660619,4685,222,2,2
49483,2014/03/31,2012/07/18,579,2,0.71996904,3876,579,2,0
49484,2014/03/31,2013/01/03,125,4,0.6042161110000001,4618,125,3,1
49485,2014/03/31,2013/03/27,344,3,0.930997664,2997,344,2,1
49486,2014/03/31,2009/03/23,574,4,0.778242678,3585,574,4,0
49487,2014/03/31,2012/10/08,30,9,0.534444444,5220,30,3,6
49488,2014/03/31,2010/02/16,21,3,0.767605944,3634,21,1,2
49489,2014/03/31,2012/07/01,141,6,0.508843488,5482,141,1,5
49490,2014/03/31,2012/01/04,87,4,0.6042049389999999,4616,87,3,1
49491,2014/03/31,2012/12/12,475,3,1.276430206,2185,475,3,0
49492,2014/03/31,2010/12/13,414,5,0.423511543,6584,414,5,0
49493,2014/03/31,2008/11/15,350,2,1.0,2788,350,1,1
49494,2014/03/31,2009/06/25,228,3,0.92,3030,228,0,3
49495,2014/03/31,2005/03/08,439,2,0.7593298829999999,3671,439,2,0
49496,2014/03/31,2011/03/13,119,4,0.519327371,5367,119,2,2
49497,2014/03/31,2008/05/22,565,2,0.671081146,4153,565,2,0
49498,2014/03/31,2008/08/04,437,4,0.376150628,7409,437,4,0
49499,2014/03/31,2011/05/04,356,2,0.6,4644,356,1,1
49500,2014/03/31,2006/09/14,278,3,0.6105435020000001,4563,278,2,1
49501,2014/03/31,2011/03/09,292,4,0.845579842,3294,292,2,2
49502,2014/03/31,2011/12/06,536,3,0.7666666670000001,3633,536,3,0
49503,2014/03/31,2012/06/25,356,3,0.7,3979,356,2,1
49504,2014/03/31,2009/10/07,320,4,0.575,4844,320,3,1
49505,2014/03/31,2011/06/01,209,2,0.49,5684,209,1,1
49506,2014/03/31,2008/02/08,214,4,0.321410271,8665,214,1,3
49507,2014/03/31,2011/09/14,635,3,1.457905759,1910,635,3,0
49508,2014/03/31,2010/07/02,108,5,0.492737569,5651,108,3,2
49509,2014/03/31,2009/02/09,12,5,0.603049599,4617,12,0,5
49510,2014/03/31,2011/04/19,47,2,0.875,3182,47,0,2
49511,2014/03/31,2005/10/22,177,2,0.786497175,3540,177,0,2
49512,2014/03/31,2010/07/07,186,7,0.685714286,4060,186,4,3
49513,2014/03/31,2008/12/14,212,4,0.928562375,2998,212,3,1
49514,2014/03/31,2008/10/05,697,3,0.6738804159999999,4131,697,3,0
49515,2014/03/31,2011/10/01,182,4,0.379620892,7333,182,2,2
49516,2014/03/31,2007/10/01,251,4,0.665002389,4186,251,1,3
49517,2014/03/31,2012/01/03,367,4,0.909062704,3062,367,4,0
49518,2014/03/31,2008/12/11,460,4,1.031690141,2698,460,4,0
49519,2014/03/31,2011/08/01,112,4,0.7188636359999999,3872,112,3,1
49520,2014/03/31,2006/01/09,20,3,0.737897667,3772,20,0,3
49521,2014/03/31,2013/01/24,45,2,0.67,4154,45,0,2
49522,2014/03/31,2012/02/09,284,2,0.67,4154,284,0,2
49523,2014/03/31,2007/06/03,23,3,0.446666667,6231,23,0,3
49524,2014/03/31,2011/03/09,288,2,0.67,4154,288,0,2
49525,2014/03/31,2011/12/19,453,3,0.637076465,4368,453,3,0
49526,2014/03/31,2007/04/26,164,5,0.818308824,3400,164,1,4
49527,2014/03/31,2007/10/17,54,3,0.679912023,4092,54,2,1
49528,2014/03/31,2011/02/10,344,4,0.5466011789999999,5090,344,2,2
49529,2014/03/31,2012/09/25,549,3,0.35650948200000004,7804,549,3,0
49530,2014/03/31,2010/11/24,540,3,0.522558227,5324,540,3,0
49531,2014/03/31,2012/05/17,348,5,0.49836976,5582,348,3,2
49532,2014/03/31,2013/03/01,40,2,0.593059701,4690,40,0,2
49533,2014/03/31,2007/09/21,138,4,0.571355793,4868,138,2,2
49534,2014/03/31,2011/06/19,184,4,0.647794083,4293,184,3,1
49535,2014/03/31,2011/09/23,377,3,0.6067532179999999,4583,377,3,0
49536,2014/03/31,2011/04/01,416,4,0.963409563,2886,416,4,0
49537,2014/03/31,2009/08/08,29,4,0.645530532,4307,29,0,4
49538,2014/03/31,2010/08/08,225,4,0.642811561,4325,225,0,4
49539,2014/03/31,2010/08/11,157,2,0.6903874809999999,4026,157,1,1
49540,2014/03/31,2006/09/17,68,3,0.8232849529999999,3376,68,1,2
49541,2014/03/31,2011/06/21,82,5,0.476892588,5828,82,0,5
49542,2014/03/31,2012/06/07,99,3,0.706666667,3933,99,0,3
49543,2014/03/31,2010/07/10,392,4,0.909126595,3057,392,4,0
49544,2014/03/31,2010/08/30,192,3,0.963981963,2883,192,1,2
49545,2014/03/31,2012/09/15,17,6,0.5692257270000001,4882,17,2,4
49546,2014/03/31,2012/07/07,271,2,0.52,5344,271,1,1
49547,2014/03/31,2011/08/15,93,3,0.753685924,3687,93,2,1
49548,2014/03/31,2008/06/05,401,5,0.609855136,4556,401,5,0
49549,2014/03/31,2008/08/23,162,5,0.60837968,4567,162,3,2
49550,2014/03/31,2005/12/22,185,5,0.3897096370000001,7129,185,1,4
49551,2014/03/31,2008/07/12,3,6,0.5339869279999999,5202,3,4,2
49552,2014/03/31,2011/12/03,311,3,0.473410602,5867,311,2,1
49553,2014/03/31,2010/10/24,89,4,0.8659869040000001,3207,89,2,2
49554,2014/03/31,2008/12/01,121,5,0.705379731,3937,121,3,2
49555,2014/03/31,2012/07/21,253,4,0.7593109109999999,3657,253,2,2
49556,2014/03/31,2011/05/16,503,2,0.894235105,3105,503,2,0
49557,2014/03/31,2007/03/31,350,3,0.47200782,5882,350,2,1
49558,2014/03/31,2013/01/03,340,3,1.144783505,2425,340,2,1
49559,2014/03/31,2004/12/12,78,3,0.578942649,4795,78,0,3
49560,2014/03/31,2011/11/18,439,3,1.0,2776,439,3,0
49561,2014/03/31,2012/10/18,414,5,0.700466818,3963,414,5,0
49562,2014/03/31,2009/01/09,156,2,0.581949686,4770,156,0,2
49563,2014/03/31,2009/06/29,24,4,0.703418652,3946,24,2,2
49564,2014/03/31,2009/12/23,410,2,0.577267055,4808,410,2,0
49565,2014/03/31,2011/10/09,453,2,0.567470865,4891,453,2,0
49566,2014/03/31,2005/10/20,172,3,0.528466959,5251,172,2,1
49567,2014/03/31,2012/04/29,421,2,0.788238636,3520,421,2,0
49568,2014/03/31,2011/07/13,673,4,0.7858356940000001,3530,673,4,0
49569,2014/03/31,2012/10/13,392,2,0.778557395,3563,392,2,0
49570,2014/03/31,2011/09/01,57,5,0.722019781,3842,57,4,1
49571,2014/03/31,2006/01/16,187,3,0.823368952,3369,187,2,1
49572,2014/03/31,2010/04/19,206,2,0.735,3774,206,0,2
49573,2014/03/31,2011/05/09,234,2,0.705,3934,234,0,2
49574,2014/03/31,2012/12/26,31,3,0.47,5901,31,1,2
49575,2014/03/31,2012/08/17,44,3,0.47,5901,44,0,3
49576,2014/03/31,2013/02/12,190,2,0.705,3934,190,0,2
49577,2014/03/31,2006/10/25,526,2,0.932235294,2975,526,2,0
49578,2014/03/31,2012/11/20,39,2,0.584429926,4745,39,0,2
49579,2014/03/31,2010/06/02,57,3,0.553453094,5010,57,0,3
49580,2014/03/31,2011/07/05,359,6,0.451269531,6144,359,4,2
49581,2014/03/31,2011/03/09,102,2,0.7711571629999999,3595,102,1,1
49582,2014/03/31,2011/08/11,520,4,0.5974784479999999,4640,520,4,0
49583,2014/03/31,2010/05/28,97,2,0.7979965459999999,3474,97,1,1
49584,2014/03/31,2012/06/25,644,2,0.968285016,2863,644,2,0
49585,2014/03/31,2012/07/05,590,3,0.628440263,4411,590,3,0
49586,2014/03/31,2009/10/28,340,2,0.829428486,3342,340,1,1
49587,2014/03/31,2010/09/19,284,3,0.6648884620000001,4169,284,2,1
49588,2014/03/31,2005/07/24,116,2,0.915711926,3027,116,0,2
49589,2014/03/31,2010/04/01,279,3,0.8227218759999999,3369,279,2,1
49590,2014/03/31,2012/11/10,360,4,0.54803243,5057,360,2,2
49591,2014/03/31,2005/06/16,523,4,1.0,2771,523,4,0
49592,2014/03/31,2010/12/11,507,3,0.58744965,4717,507,3,0
49593,2014/03/31,2012/07/29,611,2,0.85,3260,611,2,0
49594,2014/03/31,2012/03/15,44,5,0.708330777,3912,44,3,2
49595,2014/03/31,2009/05/08,2,5,0.417435975,6638,2,4,1
49596,2014/03/31,2013/03/10,57,2,0.740470337,3742,57,1,1
49597,2014/03/31,2011/04/15,12,2,0.822672209,3368,12,1,1
49598,2014/03/31,2006/10/14,278,2,1.350789859,2051,278,0,2
49599,2014/03/31,2005/12/22,501,2,1.0,2770,501,2,0
49600,2014/03/31,2005/06/26,70,4,0.73832578,3751,70,3,1
49601,2014/03/31,2009/08/05,473,3,0.6166666670000001,4491,473,3,0
49602,2014/03/31,2007/02/04,370,4,0.517417305,5351,370,4,0
49603,2014/03/31,2012/04/18,150,3,0.965022656,2869,150,1,2
49604,2014/03/31,2011/12/23,168,3,0.689715994,4014,168,2,1
49605,2014/03/31,2012/01/11,457,4,0.459875415,6020,457,4,0
49606,2014/03/31,2013/03/22,203,6,0.92,3009,203,0,6
49607,2014/03/31,2012/03/23,541,3,1.0,2768,541,3,0
49608,2014/03/31,2012/11/05,504,2,0.65,4258,504,2,0
49609,2014/03/31,2007/08/02,524,3,0.704966887,3926,524,3,0
49610,2014/03/31,2012/12/23,71,5,0.744784715,3716,71,0,5
49611,2014/03/31,2011/04/01,23,2,0.77,3594,23,0,2
49612,2014/03/31,2010/04/15,409,4,0.56393927,4907,409,4,0
49613,2014/03/31,2012/06/04,666,2,0.807249125,3428,666,2,0
49614,2014/03/31,2011/06/07,103,4,0.6948141640000001,3982,103,1,3
49615,2014/03/31,2010/05/25,582,4,0.74375,3720,582,4,0
49616,2014/03/31,2012/06/17,442,3,0.437067467,6329,442,3,0
49617,2014/03/31,2008/10/18,125,3,0.689332004,4012,125,1,2
49618,2014/03/31,2008/03/06,130,3,0.92,3006,130,0,3
49619,2014/03/31,2006/03/08,20,3,0.539923858,5122,20,0,3
49620,2014/03/31,2012/03/25,577,3,0.600564726,4604,577,3,0
49621,2014/03/31,2012/10/28,519,2,0.562428804,4916,519,2,0
49622,2014/03/31,2005/04/03,523,3,0.544476172,5078,523,3,0
49623,2014/03/31,2012/06/13,38,3,0.403333333,6855,38,1,2
49624,2014/03/31,2013/01/01,331,3,0.5877232139999999,4704,331,1,2
49625,2014/03/31,2008/02/07,95,3,0.954166379,2897,95,2,1
49626,2014/03/31,2012/12/11,355,3,0.523962085,5275,355,2,1
49627,2014/03/31,2005/06/23,272,2,0.800376484,3453,272,0,2
49628,2014/03/31,2012/04/16,191,4,0.735,3760,191,1,3
49629,2014/03/31,2012/11/05,117,3,0.767937743,3598,117,1,2
49630,2014/03/31,2012/03/02,606,3,0.640872187,4311,606,3,0
49631,2014/03/31,2013/03/27,291,4,0.91,3036,291,2,2
49632,2014/03/31,2007/02/12,21,4,0.8215075829999999,3363,21,3,1
49633,2014/03/31,2012/12/10,100,4,0.46594704,5929,100,3,1
49634,2014/03/31,2009/02/26,26,3,0.822441203,3359,26,1,2
49635,2014/03/31,2010/09/13,70,2,0.665,4154,70,0,2
49636,2014/03/31,2012/07/01,95,5,0.53400348,5173,95,0,5
49637,2014/03/31,2009/11/21,598,5,0.664038462,4160,598,5,0
49638,2014/03/31,2011/06/13,133,4,0.541114594,5105,133,2,2
49639,2014/03/31,2012/08/15,479,3,0.495906643,5570,479,3,0
49640,2014/03/31,2012/10/14,513,2,0.45,6138,513,2,0
49641,2014/03/31,2009/10/19,182,2,0.45,6138,182,0,2
49642,2014/03/31,2012/08/18,407,4,0.426118482,6482,407,4,0
49643,2014/03/31,2005/03/06,252,3,0.656066508,4210,252,2,1
49644,2014/03/31,2008/04/16,124,4,0.8117166370000001,3402,124,2,2
49645,2014/03/31,2011/01/15,85,5,0.614613844,4493,85,1,4
49646,2014/03/31,2009/11/17,156,2,0.7118277909999999,3879,156,0,2
49647,2014/03/31,2008/08/22,10,3,0.7585329670000001,3640,10,0,3
49648,2014/03/31,2013/03/13,299,3,0.5747356370000001,4804,299,1,2
49649,2014/03/31,2007/05/27,531,5,0.800289855,3450,531,5,0
49650,2014/03/31,2011/04/16,418,2,1.0,2761,418,2,0
49651,2014/03/31,2007/03/26,88,6,0.8552943000000001,3228,88,0,6
49652,2014/03/31,2013/02/12,276,6,0.572321725,4824,276,1,5
49653,2014/03/31,2013/01/20,37,5,0.460286762,5998,37,0,5
49654,2014/03/31,2012/03/15,342,2,0.8,3451,342,1,1
49655,2014/03/31,2008/07/21,22,2,0.444326412,6213,22,1,1
49656,2014/03/31,2008/02/03,29,2,0.731475888,3774,29,1,1
49657,2014/03/31,2012/09/26,12,3,0.6189237670000001,4460,12,2,1
49658,2014/03/31,2005/08/16,383,3,0.507576315,5438,383,3,0
49659,2014/03/31,2007/07/01,351,4,1.0,2760,351,2,2
49660,2014/03/31,2011/11/26,579,2,1.0,2760,579,2,0
49661,2014/03/31,2012/12/25,456,3,1.312410842,2103,456,3,0
49662,2014/03/31,2008/09/25,317,4,1.0,2760,317,1,3
49663,2014/03/31,2012/12/25,456,3,1.312410842,2103,456,3,0
49664,2014/03/31,2011/11/27,40,3,0.550522641,5013,40,0,3
49665,2014/03/31,2005/10/19,497,3,0.576027969,4791,497,3,0
49666,2014/03/31,2012/10/02,6,3,0.781685552,3530,6,0,3
49667,2014/03/31,2012/10/30,100,3,0.476237487,5794,100,0,3
49668,2014/03/31,2012/10/08,394,3,0.571854922,4825,394,3,0
49669,2014/03/31,2012/08/12,243,4,0.5453607429999999,5059,243,1,3
49670,2014/03/31,2007/03/01,161,5,0.652225112,4229,161,3,2
49671,2014/03/31,2009/04/25,308,3,0.666666667,4137,308,0,3
49672,2014/03/31,2012/04/22,707,3,0.6533996679999999,4221,707,3,0
49673,2014/03/31,2012/07/03,590,3,0.4,6895,590,3,0
49674,2014/03/31,2013/01/10,440,2,0.5,5516,440,2,0
49675,2014/03/31,2010/10/08,557,4,0.8004354140000001,3445,557,4,0
49676,2014/03/31,2012/03/14,428,4,0.85,3244,428,4,0
49677,2014/03/31,2008/12/06,3,3,0.693660377,3975,3,0,3
49678,2014/03/31,2006/02/01,598,3,0.570099256,4836,598,3,0
49679,2014/03/31,2012/02/07,391,3,0.8236928590000001,3347,391,3,0
49680,2014/03/31,2012/01/29,116,6,0.4611659420000001,5978,116,1,5
49681,2014/03/31,2011/09/07,173,5,0.616580183,4471,173,0,5
49682,2014/03/31,2006/11/16,135,4,0.8765373609999999,3145,135,3,1
49683,2014/03/31,2012/01/21,67,4,0.761868436,3618,67,1,3
49684,2014/03/31,2013/02/10,33,3,0.945861359,2914,33,1,2
49685,2014/03/31,2009/12/25,133,3,0.7133911470000001,3863,133,0,3
49686,2014/03/31,2011/03/29,6,2,0.922248996,2988,6,0,2
49687,2014/03/31,2011/01/02,37,2,0.855795031,3220,37,1,1
49688,2014/03/31,2011/08/15,192,5,0.5974609710000001,4612,192,4,1
49689,2014/03/31,2011/09/09,278,4,0.50475545,5459,278,3,1
49690,2014/03/31,2011/07/21,20,5,0.8140000000000001,3385,20,2,3
49691,2014/03/31,2009/12/23,106,3,0.492017857,5600,106,0,3
49692,2014/03/31,2012/05/09,686,4,0.472031866,5837,686,4,0
49693,2014/03/31,2005/04/21,25,3,0.751962336,3664,25,1,2
49694,2014/03/31,2008/04/04,348,3,0.6461303939999999,4264,348,1,2
49695,2014/03/31,2010/12/08,152,2,0.73038176,3772,152,1,1
49696,2014/03/31,2012/04/09,607,5,0.590525188,4665,607,5,0
49697,2014/03/31,2012/05/18,611,3,0.343662675,8016,611,3,0
49698,2014/03/31,2008/02/12,2,4,0.722452137,3813,2,1,3
49699,2014/03/31,2007/03/01,229,3,0.723778245,3806,229,2,1
49700,2014/03/31,2012/02/14,65,3,0.939495225,2932,65,2,1
49701,2014/03/31,2011/02/08,430,4,0.558054711,4935,430,4,0
49702,2014/03/31,2011/04/05,721,2,0.7,3934,721,2,0
49703,2014/03/31,2011/04/18,592,2,0.7,3934,592,2,0
49704,2014/03/31,2012/06/18,510,2,0.7,3934,510,2,0
49705,2014/03/31,2009/05/01,6,2,0.7,3934,6,0,2
49706,2014/03/31,2008/07/24,623,2,0.7,3934,623,2,0
49707,2014/03/31,2005/12/31,84,4,0.458660893,6004,84,0,4
49708,2014/03/31,2013/02/08,316,2,0.7,3934,316,0,2
49709,2014/03/31,2013/03/21,316,2,0.7,3934,316,0,2
49710,2014/03/31,2010/09/27,701,2,0.7,3934,701,2,0
49711,2014/03/31,2012/07/16,376,2,0.7,3934,376,2,0
49712,2014/03/31,2008/03/26,490,2,0.7,3934,490,2,0
49713,2014/03/31,2008/07/12,318,2,0.7,3934,318,0,2
49714,2014/03/31,2010/02/19,521,2,0.7,3934,521,2,0
49715,2014/03/31,2012/04/30,489,3,0.466666667,5901,489,3,0
49716,2014/03/31,2012/07/27,598,2,0.7,3934,598,2,0
49717,2014/03/31,2013/03/22,364,2,0.7,3934,364,1,1
49718,2014/03/31,2009/07/13,191,5,0.7806889709999999,3527,191,3,2
49719,2014/03/31,2008/09/21,15,4,0.60369875,4561,15,2,2
49720,2014/03/31,2012/07/31,17,10,0.495713,5554,17,4,6
49721,2014/03/31,2012/03/15,20,2,0.675,4078,20,0,2
49722,2014/03/31,2012/05/05,298,3,0.5384565729999999,5112,298,2,1
49723,2014/03/31,2011/02/01,501,3,0.819321227,3359,501,3,0
49724,2014/03/31,2011/11/04,121,3,0.804228521,3422,121,1,2
49725,2014/03/31,2012/10/29,222,4,0.887346017,3101,222,2,2
49726,2014/03/31,2009/11/18,298,3,0.809258824,3400,298,2,1
49727,2014/03/31,2008/08/07,208,2,0.852765034,3226,208,0,2
49728,2014/03/31,2011/08/12,45,3,0.8766666670000001,3138,45,1,2
49729,2014/03/31,2012/08/24,411,3,0.666872727,4125,411,3,0
49730,2014/03/31,2010/01/13,37,5,0.561549612,4898,37,2,3
49731,2014/03/31,2013/02/26,167,3,0.48,5730,167,0,3
49732,2014/03/31,2012/08/15,26,4,0.472070031,5826,26,0,4
49733,2014/03/31,2012/04/09,716,3,0.847273567,3246,716,3,0
49734,2014/03/31,2011/01/13,402,6,0.791666667,3474,402,6,0
49735,2014/03/31,2008/09/03,378,2,1.0,2750,378,2,0
49736,2014/03/31,2010/03/03,555,2,1.0,2750,555,2,0
49737,2014/03/31,2011/01/16,402,2,1.0,2750,402,2,0
49738,2014/03/31,2011/07/19,427,3,0.629411765,4369,427,3,0
49739,2014/03/31,2013/01/19,435,2,0.775,3548,435,2,0
49740,2014/03/31,2013/03/19,243,3,0.709014956,3878,243,1,2
49741,2014/03/31,2011/03/18,674,4,0.722195955,3807,674,4,0
49742,2014/03/31,2008/09/21,7,2,0.782587532,3513,7,0,2
49743,2014/03/31,2011/09/04,377,2,0.464874006,5913,377,2,0
49744,2014/03/31,2013/03/19,71,7,0.446755527,6152,71,1,6
49745,2014/03/31,2009/08/08,195,4,0.712759336,3856,195,3,1
49746,2014/03/31,2009/02/25,549,2,0.827884905,3319,549,2,0
49747,2014/03/31,2013/01/19,130,3,0.897341607,3062,130,0,3
49748,2014/03/31,2009/10/24,264,3,0.5929218820000001,4634,264,2,1
49749,2014/03/31,2007/10/08,173,4,0.719628078,3818,173,3,1
49750,2014/03/31,2007/05/24,1,2,0.785,3500,1,1,1
49751,2014/03/31,2008/11/23,97,2,0.95,2892,97,1,1
49752,2014/03/31,2012/03/16,508,2,0.95,2892,508,2,0
49753,2014/03/31,2008/09/23,144,3,0.876589024,3134,144,0,3
49754,2014/03/31,2013/03/15,305,3,0.906666667,3030,305,2,1
49755,2014/03/31,2009/11/02,454,3,0.7,3924,454,3,0
49756,2014/03/31,2012/10/16,58,2,0.8741311270000001,3142,58,0,2
49757,2014/03/31,2011/04/20,29,4,0.602620145,4557,29,1,3
49758,2014/03/31,2009/11/01,354,4,0.517451941,5306,354,3,1
49759,2014/03/31,2005/12/04,133,5,0.546654719,5022,133,2,3
49760,2014/03/31,2009/03/08,27,2,0.92,2984,27,0,2
49761,2014/03/31,2009/11/05,33,5,0.846,3245,33,2,3
49762,2014/03/31,2006/09/17,464,5,0.8403857929999999,3266,464,5,0
49763,2014/03/31,2013/01/15,76,4,0.496681144,5526,76,2,2
49764,2014/03/31,2011/08/01,271,2,0.8460604190000001,3244,271,1,1
49765,2014/03/31,2009/09/30,37,4,0.53748727,5106,37,1,3
49766,2014/03/31,2005/02/09,5,3,0.727748608,3771,5,1,2
49767,2014/03/31,2012/04/02,730,2,0.853592535,3215,730,2,0
49768,2014/03/31,2009/09/28,97,4,0.35017226,7837,97,1,3
49769,2014/03/31,2011/10/09,595,3,0.893310547,3072,595,3,0
49770,2014/03/31,2009/06/26,81,2,0.7860269259999999,3491,81,0,2
49771,2014/03/31,2012/03/03,474,3,0.8942633640000001,3068,474,3,0
49772,2014/03/31,2011/12/04,372,5,0.456996502,6003,372,5,0
49773,2014/03/31,2012/08/07,364,3,0.8423832920000001,3256,364,2,1
49774,2014/03/31,2010/09/24,12,4,0.680049591,4033,12,1,3
49775,2014/03/31,2008/10/28,8,3,0.388844463,7053,8,1,2
49776,2014/03/31,2011/11/17,563,3,0.930889341,2946,563,3,0
49777,2014/03/31,2010/08/19,396,2,0.55,4986,396,2,0
49778,2014/03/31,2012/09/15,212,2,0.55,4986,212,1,1
49779,2014/03/31,2008/02/07,230,3,0.633277136,4330,230,2,1
49780,2014/03/31,2011/11/23,30,5,0.7780987509999999,3524,30,0,5
49781,2014/03/31,2006/11/10,239,4,0.49359676,5555,239,3,1
49782,2014/03/31,2011/11/07,456,4,0.349808625,7838,456,4,0
49783,2014/03/31,2005/11/29,288,3,0.950624133,2884,288,2,1
49784,2014/03/31,2012/08/23,121,2,1.41236476,1941,121,1,1
49785,2014/03/31,2009/08/26,35,2,0.551999597,4966,35,0,2
49786,2014/03/31,2006/11/28,504,4,0.78244362,3503,504,4,0
49787,2014/03/31,2012/09/13,560,4,0.4,6852,560,4,0
49788,2014/03/31,2008/06/03,13,3,0.5578623779999999,4912,13,0,3
49789,2014/03/31,2007/12/21,558,3,0.701100307,3908,558,3,0
49790,2014/03/31,2011/02/22,23,3,1.0946384340000002,2503,23,1,2
49791,2014/03/31,2009/07/22,61,3,0.8895714290000001,3080,61,1,2
49792,2014/03/31,2009/12/27,38,3,0.540130126,5072,38,2,1
49793,2014/03/31,2006/06/24,11,2,0.774043515,3539,11,0,2
49794,2014/03/31,2011/08/14,138,3,0.696088945,3935,138,2,1
49795,2014/03/31,2011/03/07,640,3,0.797379913,3435,640,3,0
49796,2014/03/31,2008/06/17,113,3,0.7913666570000001,3461,113,1,2
49797,2014/03/31,2012/09/19,16,4,0.553938107,4944,16,0,4
49798,2014/03/31,2012/02/17,416,3,0.524636015,5220,416,3,0
49799,2014/03/31,2011/12/26,1,3,0.76,3603,1,0,3
49800,2014/03/31,2008/07/04,375,4,1.0,2738,375,4,0
49801,2014/03/31,2007/10/24,276,4,0.96374516,2841,276,3,1
49802,2014/03/31,2013/01/01,5,4,0.607488351,4507,5,0,4
49803,2014/03/31,2012/07/12,376,2,0.728318702,3759,376,2,0
49804,2014/03/31,2012/08/15,402,4,0.594784876,4602,402,4,0
49805,2014/03/31,2011/06/09,651,3,0.800995025,3417,651,3,0
49806,2014/03/31,2008/06/21,473,2,0.799357477,3424,473,2,0
49807,2014/03/31,2013/03/20,361,4,0.4,6842,361,2,2
49808,2014/03/31,2012/07/08,465,4,0.4,6842,465,4,0
49809,2014/03/31,2007/11/30,681,2,0.375,7298,681,2,0
49810,2014/03/31,2009/04/25,530,2,0.375,7298,530,2,0
49811,2014/03/31,2011/10/16,702,3,0.666991711,4102,702,3,0
49812,2014/03/31,2007/01/16,79,7,0.832861492,3285,79,4,3
49813,2014/03/31,2009/12/03,198,5,0.446742325,6124,198,3,2
49814,2014/03/31,2012/11/15,20,6,0.7002226770000001,3907,20,4,2
49815,2014/03/31,2010/04/03,95,5,0.641343494,4265,95,3,2
49816,2014/03/31,2012/11/23,486,4,0.4,6838,486,4,0
49817,2014/03/31,2012/07/05,629,4,0.4,6838,629,4,0
49818,2014/03/31,2011/05/03,83,2,0.785,3484,83,0,2
49819,2014/03/31,2010/11/18,85,4,0.544250746,5025,85,2,2
49820,2014/03/31,2009/09/30,137,4,0.548723917,4984,137,0,4
49821,2014/03/31,2012/01/17,31,3,0.370215243,7387,31,1,2
49822,2014/03/31,2013/01/24,185,2,0.752550908,3634,185,1,1
49823,2014/03/31,2011/11/15,294,3,0.5803140920000001,4712,294,2,1
49824,2014/03/31,2010/10/14,32,2,0.608388963,4494,32,0,2
49825,2014/03/31,2013/03/09,80,3,0.655954894,4168,80,0,3
49826,2014/03/31,2012/05/09,141,5,0.541705964,5047,141,1,4
49827,2014/03/31,2011/03/18,207,3,0.566741294,4824,207,0,3
49828,2014/03/31,2012/03/26,8,4,0.7325,3732,8,3,1
49829,2014/03/31,2012/11/07,478,2,0.7,3904,478,2,0
49830,2014/03/31,2012/06/23,645,2,0.7,3904,645,2,0
49831,2014/03/31,2012/10/10,536,2,0.7,3904,536,2,0
49832,2014/03/31,2012/07/25,598,2,0.7,3904,598,2,0
49833,2014/03/31,2012/05/10,681,2,0.7,3904,681,2,0
49834,2014/03/31,2012/05/09,691,2,0.7,3904,691,2,0
49835,2014/03/31,2005/10/25,121,4,0.760578903,3593,121,1,3
49836,2014/03/31,2012/04/30,544,4,0.53844335,5075,544,4,0
49837,2014/03/31,2008/06/19,295,3,0.570110578,4793,295,1,2
49838,2014/03/31,2012/08/16,290,2,0.6976506640000001,3916,290,1,1
49839,2014/03/31,2007/11/12,450,2,0.7703891709999999,3546,450,2,0
49840,2014/03/31,2008/04/26,28,5,0.775819369,3521,28,4,1
49841,2014/03/31,2011/01/15,352,5,0.8461895909999999,3228,352,4,1
49842,2014/03/31,2013/01/03,72,3,0.392828995,6953,72,2,1
49843,2014/03/31,2009/04/10,221,6,0.754864566,3618,221,5,1
49844,2014/03/31,2012/11/27,371,4,0.669362745,4080,371,4,0
49845,2014/03/31,2006/08/14,584,4,0.622050114,4390,584,4,0
49846,2014/03/31,2012/04/09,9,4,0.5363956,5091,9,1,3
49847,2014/03/31,2009/04/11,112,3,0.628906034,4342,112,1,2
49848,2014/03/31,2012/10/01,27,6,0.664217952,4111,27,2,4
49849,2014/03/31,2008/06/14,32,3,0.735416106,3713,32,0,3
49850,2014/03/31,2006/11/26,12,3,0.533713839,5116,12,0,3
49851,2014/03/31,2005/05/30,304,3,0.7886655109999999,3462,304,2,1
49852,2014/03/31,2005/08/25,503,2,1.0,2730,503,2,0
49853,2014/03/31,2012/07/28,473,3,0.66124031,4128,473,3,0
49854,2014/03/31,2012/12/05,130,2,0.6386429570000001,4274,130,0,2
49855,2014/03/31,2005/06/14,161,4,0.7066934229999999,3862,161,0,4
49856,2014/03/31,2013/03/15,13,4,0.62154179,4391,13,0,4
49857,2014/03/31,2006/04/15,77,6,0.469320722,5815,77,0,6
49858,2014/03/31,2007/12/22,263,4,0.569624296,4791,263,0,4
49859,2014/03/31,2012/06/23,224,2,0.45,6064,224,0,2
49860,2014/03/31,2008/07/22,75,4,0.8775490509999999,3109,75,2,2
49861,2014/03/31,2010/06/16,468,3,0.568859466,4796,468,3,0
49862,2014/03/31,2013/02/16,185,3,0.497169674,5487,185,2,1
49863,2014/03/31,2009/07/05,64,3,0.595997378,4577,64,2,1
49864,2014/03/31,2009/12/16,83,3,0.917715343,2972,83,1,2
49865,2014/03/31,2009/12/08,252,2,0.65,4196,252,1,1
49866,2014/03/31,2005/07/17,647,2,0.65,4196,647,2,0
49867,2014/03/31,2006/02/07,61,4,0.680426647,4008,61,2,2
49868,2014/03/31,2007/02/26,23,5,0.4936121670000001,5523,23,0,5
49869,2014/03/31,2006/11/09,557,3,0.52729207,5170,557,3,0
49870,2014/03/31,2011/10/24,365,6,0.783333333,3480,365,5,1
49871,2014/03/31,2011/05/31,337,3,0.8582808559999999,3176,337,2,1
49872,2014/03/31,2009/12/01,182,6,0.516420315,5277,182,5,1
49873,2014/03/31,2008/03/11,673,2,0.8,3406,673,2,0
49874,2014/03/31,2006/08/29,44,4,0.698272681,3902,44,2,2
49875,2014/03/31,2013/01/21,142,4,1.078638163,2526,142,2,2
49876,2014/03/31,2013/01/20,225,7,0.830134065,3282,225,2,5
49877,2014/03/31,2010/02/24,256,4,0.5250529970000001,5189,256,2,2
49878,2014/03/31,2006/09/12,299,3,0.973333333,2799,299,1,2
49879,2014/03/31,2005/11/08,245,3,0.973333333,2799,245,2,1
49880,2014/03/31,2008/01/17,188,3,0.973333333,2799,188,2,1
49881,2014/03/31,2012/12/02,52,6,0.341640331,7974,52,2,4
49882,2014/03/31,2010/11/17,238,2,0.58307363,4672,238,0,2
49883,2014/03/31,2013/02/20,400,3,0.653864618,4166,400,3,0
49884,2014/03/31,2011/10/02,574,3,0.6139057920000001,4437,574,3,0
49885,2014/03/31,2006/08/20,209,5,0.8194043320000001,3324,209,3,2
49886,2014/03/31,2012/11/12,25,3,0.58348329,4668,25,0,3
49887,2014/03/31,2012/04/19,293,3,0.708083723,3846,293,1,2
49888,2014/03/31,2012/05/01,540,2,0.8,3404,540,2,0
49889,2014/03/31,2012/05/01,511,2,0.8,3404,511,2,0
49890,2014/03/31,2011/09/09,213,4,0.7675,3548,213,1,3
49891,2014/03/31,2012/07/07,576,4,0.845652174,3220,576,4,0
49892,2014/03/31,2009/09/02,601,2,0.8937294809999999,3046,601,2,0
49893,2014/03/31,2012/02/23,369,3,0.543048075,5013,369,3,0
49894,2014/03/31,2007/06/02,25,2,0.721213567,3774,25,1,1
49895,2014/03/31,2007/02/01,24,2,0.721213567,3774,24,0,2
49896,2014/03/31,2013/01/20,24,9,0.732222222,3717,24,1,8
49897,2014/03/31,2005/02/01,332,3,0.74279476,3664,332,1,2
49898,2014/03/31,2010/08/12,697,3,0.734971645,3703,697,3,0
49899,2014/03/31,2012/01/25,377,5,0.94,2895,377,5,0
49900,2014/03/31,2013/01/15,228,3,0.696666667,3906,228,1,2
49901,2014/03/31,2012/01/13,633,3,0.6853904279999999,3970,633,3,0
49902,2014/03/31,2012/11/30,421,2,0.8,3401,421,2,0
49903,2014/03/31,2012/08/05,239,3,0.693333333,3924,239,0,3
49904,2014/03/31,2006/03/01,561,2,0.690332403,3941,561,2,0
49905,2014/03/31,2007/12/11,58,3,0.651412835,4176,58,1,2
49906,2014/03/31,2005/07/13,206,4,0.5404867870000001,5033,206,3,1
49907,2014/03/31,2008/08/03,21,2,0.673498391,4039,21,0,2
49908,2014/03/31,2010/04/28,370,2,0.725,3752,370,2,0
49909,2014/03/31,2009/03/06,220,2,0.677169529,4017,220,0,2
49910,2014/03/31,2009/11/22,60,3,0.747488321,3639,60,0,3
49911,2014/03/31,2010/04/21,710,2,0.701470209,3877,710,2,0
49912,2014/03/31,2005/01/05,538,2,0.701470209,3877,538,2,0
49913,2014/03/31,2013/03/27,232,3,0.770413598,3530,232,0,3
49914,2014/03/31,2006/05/27,565,4,0.7391954340000001,3679,565,4,0
49915,2014/03/31,2011/01/14,22,2,0.672415925,4044,22,0,2
49916,2014/03/31,2006/08/12,33,3,0.8,3399,33,0,3
49917,2014/03/31,2012/12/18,238,2,0.595,4570,238,0,2
49918,2014/03/31,2006/12/01,167,6,0.42,6474,167,1,5
49919,2014/03/31,2012/03/15,60,8,0.93375,2912,60,4,4
49920,2014/03/31,2012/05/06,544,4,0.55063791,4938,544,4,0
49921,2014/03/31,2009/09/20,164,5,0.437669028,6212,164,3,2
49922,2014/03/31,2013/02/24,50,2,0.7628170590000001,3564,50,0,2
49923,2014/03/31,2012/12/17,327,3,0.6658217,4083,327,0,3
49924,2014/03/31,2013/02/23,44,3,0.574735729,4730,44,1,2
49925,2014/03/31,2007/11/12,118,2,0.835579465,3253,118,1,1
49926,2014/03/31,2012/06/24,296,4,0.641770956,4235,296,3,1
49927,2014/03/31,2010/11/19,214,3,0.7780876040000001,3493,214,1,2
49928,2014/03/31,2011/01/14,47,2,0.875,3106,47,0,2
49929,2014/03/31,2010/11/29,61,3,0.6810952379999999,3990,61,0,3
49930,2014/03/31,2013/02/03,150,5,0.463180501,5867,150,2,3
49931,2014/03/31,2010/03/28,499,2,0.7,3882,499,2,0
49932,2014/03/31,2009/10/01,706,2,0.7,3882,706,2,0
49933,2014/03/31,2011/05/30,283,2,0.72,3774,283,0,2
49934,2014/03/31,2011/10/28,153,4,0.704120238,3859,153,2,2
49935,2014/03/31,2011/12/30,400,3,0.884505208,3072,400,3,0
49936,2014/03/31,2012/10/15,529,4,0.472404799,5751,529,4,0
49937,2014/03/31,2008/06/17,60,3,0.77549529,3503,60,2,1
49938,2014/03/31,2005/12/08,154,2,0.88137573,3082,154,1,1
49939,2014/03/31,2009/11/11,95,2,0.820069444,3312,95,1,1
49940,2014/03/31,2011/09/19,539,3,0.6189721970000001,4388,539,3,0
49941,2014/03/31,2011/09/05,371,4,0.470620343,5771,371,4,0
49942,2014/03/31,2009/12/23,173,7,0.7368231140000001,3686,173,6,1
49943,2014/03/31,2011/10/08,321,2,0.571867762,4749,321,1,1
49944,2014/03/31,2008/03/08,473,4,0.398152493,6820,473,4,0
49945,2014/03/31,2012/11/27,461,3,0.491847826,5520,461,3,0
49946,2014/03/31,2010/08/12,75,4,0.723515458,3752,75,1,3
49947,2014/03/31,2007/02/04,74,2,0.69,3934,74,0,2
49948,2014/03/31,2007/08/17,172,3,0.603028216,4501,172,0,3
49949,2014/03/31,2011/03/13,66,2,0.88,3084,66,1,1
49950,2014/03/31,2010/09/19,49,3,0.591379385,4589,49,2,1
49951,2014/03/31,2007/12/17,31,6,0.67541563,4018,31,0,6
49952,2014/03/31,2012/08/01,146,3,0.337685416,8036,146,1,2
49953,2014/03/31,2006/04/12,206,6,0.302519509,8970,206,5,1
49954,2014/03/31,2010/12/03,300,5,0.480533026,5647,300,4,1
49955,2014/03/31,2008/09/18,103,2,0.896432111,3027,103,0,2
49956,2014/03/31,2011/01/16,359,3,0.75,3618,359,2,1
49957,2014/03/31,2012/05/11,114,6,0.616530334,4401,114,3,3
49958,2014/03/31,2011/09/10,158,3,0.562250777,4825,158,2,1
49959,2014/03/31,2012/06/04,145,2,0.7481163820000001,3626,145,0,2
49960,2014/03/31,2010/11/25,94,6,0.467850983,5798,94,4,2
49961,2014/03/31,2012/05/24,350,8,0.588628472,4608,350,5,3
49962,2014/03/31,2008/05/17,116,2,0.626799168,4327,116,0,2
49963,2014/03/31,2011/07/16,724,3,0.63844162,4248,724,3,0
49964,2014/03/31,2010/02/23,235,6,0.722835821,3752,235,5,1
49965,2014/03/31,2011/03/08,260,2,0.986181818,2750,260,0,2
49966,2014/03/31,2009/03/20,716,2,1.0,2712,716,2,0
49967,2014/03/31,2008/11/19,169,2,0.815572932,3325,169,0,2
49968,2014/03/31,2012/02/03,218,5,0.90663992,2991,218,3,2
49969,2014/03/31,2012/12/28,108,3,0.729886945,3715,108,1,2
49970,2014/03/31,2010/07/01,10,4,0.544316402,4981,10,1,3
49971,2014/03/31,2008/02/19,337,4,0.7819440440000001,3467,337,3,1
49972,2014/03/31,2011/02/25,641,4,0.916672303,2957,641,4,0
49973,2014/03/31,2006/10/24,362,5,0.73752381,3675,362,4,1
49974,2014/03/31,2006/10/21,571,3,0.51882657,5224,571,3,0
49975,2014/03/31,2010/05/20,374,5,0.392804348,6900,374,5,0
49976,2014/03/31,2006/09/28,614,4,0.835707678,3243,614,4,0
49977,2014/03/31,2011/10/12,196,5,0.987638484,2744,196,4,1
49978,2014/03/31,2006/02/25,178,3,0.7410500409999999,3657,178,1,2
49979,2014/03/31,2013/02/25,397,2,0.5,5420,397,2,0
49980,2014/03/31,2013/02/22,400,2,0.5,5420,400,2,0
49981,2014/03/31,2008/04/10,311,2,0.953819078,2841,311,1,1
49982,2014/03/31,2009/12/29,57,3,0.799062224,3391,57,0,3
49983,2014/03/31,2008/10/02,364,2,0.6,4516,364,0,2
49984,2014/03/31,2005/01/01,195,3,0.627083333,4320,195,0,3
49985,2014/03/31,2009/07/06,240,3,0.79,3429,240,2,1
49986,2014/03/31,2012/10/09,48,2,0.72,3762,48,0,2
49987,2014/03/31,2008/01/04,47,2,1.14,2376,47,0,2
49988,2014/03/31,2012/06/11,137,6,0.531936371,5092,137,1,5
49989,2014/03/31,2008/07/23,199,3,0.611548882,4429,199,1,2
49990,2014/03/31,2011/07/07,193,5,0.577866439,4687,193,2,3
49991,2014/03/31,2013/02/13,71,4,0.739568542,3662,71,1,3
49992,2014/03/31,2009/01/14,23,4,0.540854803,5007,23,0,4
49993,2014/03/31,2013/02/06,410,4,1.0,2708,410,4,0
49994,2014/03/31,2010/11/26,17,5,0.485987078,5572,17,0,5
49995,2014/03/31,2012/03/27,206,5,0.819500605,3304,206,4,1
49996,2014/03/31,2012/07/01,96,5,0.445688889,6075,96,2,3
49997,2014/03/31,2008/08/10,139,3,0.69,3924,139,0,3
49998,2014/03/31,2011/12/31,467,3,0.8899901379999999,3042,467,3,0
49999,2014/03/31,2008/04/16,191,2,0.641094009,4223,191,1,1
50000,2014/03/31,2011/08/29,43,4,0.55888109,4844,43,1,3
50001,2014/03/31,2012/09/08,214,4,0.47,5760,214,3,1
50002,2014/03/31,2010/12/29,202,3,0.796147059,3400,202,2,1
50003,2014/03/31,2012/09/22,209,4,0.7100865690000001,3812,209,1,3
50004,2014/03/31,2012/07/10,145,3,0.5163620760000001,5242,145,2,1
50005,2014/03/31,2009/03/21,232,3,0.8917858320000001,3035,232,1,2
50006,2014/03/31,2012/06/15,345,6,0.377188458,7174,345,4,2
50007,2014/03/31,2008/11/29,295,2,0.395,6850,295,0,2
50008,2014/03/31,2011/09/24,522,4,0.551386058,4906,522,4,0
50009,2014/03/31,2008/01/05,120,4,0.522825667,5174,120,2,2
50010,2014/03/31,2012/12/12,268,4,0.98,2760,268,3,1
50011,2014/03/31,2012/02/15,401,2,0.890549885,3037,401,2,0
50012,2014/03/31,2008/06/29,43,6,0.717971861,3767,43,3,3
50013,2014/03/31,2012/12/28,458,2,0.5254711479999999,5147,458,2,0
50014,2014/03/31,2012/02/22,527,3,0.778020713,3476,527,3,0
50015,2014/03/31,2011/11/02,499,4,0.5404476420000001,5004,499,4,0
50016,2014/03/31,2005/11/12,216,3,0.778675497,3473,216,1,2
50017,2014/03/31,2007/11/29,269,2,0.958978723,2820,269,1,1
50018,2014/03/31,2006/06/07,157,2,0.809141233,3342,157,1,1
50019,2014/03/31,2012/07/04,635,2,1.377534386,1963,635,2,0
50020,2014/03/31,2008/09/19,162,4,0.524241954,5158,162,3,1
50021,2014/03/31,2009/12/18,7,5,0.56743073,4764,7,0,5
50022,2014/03/31,2006/11/29,136,3,0.5424683929999999,4983,136,1,2
50023,2014/03/31,2013/01/14,287,3,0.421145217,6418,287,1,2
50024,2014/03/31,2005/06/07,556,3,0.573207467,4714,556,3,0
50025,2014/03/31,2007/04/08,86,3,0.525436855,5139,86,2,1
50026,2014/03/31,2012/08/30,478,2,0.65,4154,478,2,0
50027,2014/03/31,2008/03/06,364,2,0.65,4154,364,1,1
50028,2014/03/31,2012/10/29,519,2,0.65,4154,519,2,0
50029,2014/03/31,2013/02/08,225,2,0.65,4154,225,1,1
50030,2014/03/31,2010/04/25,329,2,0.65,4154,329,0,2
50031,2014/03/31,2012/08/18,19,4,0.52765683,5117,19,2,2
50032,2014/03/31,2012/01/27,543,2,0.9,3000,543,2,0
50033,2014/03/31,2012/09/05,562,3,0.960170697,2812,562,3,0
50034,2014/03/31,2013/03/07,21,4,0.588735281,4586,21,0,4
50035,2014/03/31,2012/04/10,708,2,0.475,5684,708,2,0
50036,2014/03/31,2013/02/17,395,2,0.524528852,5147,395,2,0
50037,2014/03/31,2011/08/15,268,4,0.461641587,5848,268,3,1
50038,2014/03/31,2012/08/15,71,5,0.843913723,3199,71,2,3
50039,2014/03/31,2012/01/13,23,4,0.8175832829999999,3302,23,0,4
50040,2014/03/31,2011/02/01,243,2,0.92,2934,243,0,2
50041,2014/03/31,2006/12/26,46,3,0.683341772,3950,46,0,3
50042,2014/03/31,2010/09/15,348,3,0.5611538460000001,4810,348,2,1
50043,2014/03/31,2007/06/12,29,5,0.51575387,5233,29,3,2
50044,2014/03/31,2012/06/18,263,4,0.667654626,4042,263,3,1
50045,2014/03/31,2009/10/26,112,2,0.7819443640000001,3451,112,1,1
50046,2014/03/31,2012/09/29,223,5,0.5153705120000001,5236,223,1,4
50047,2014/03/31,2012/12/09,284,4,0.670089397,4027,284,1,3
50048,2014/03/31,2012/06/29,471,3,0.92627875,2913,471,3,0
50049,2014/03/31,2012/07/24,247,4,0.760033803,3550,247,2,2
50050,2014/03/31,2011/08/30,678,2,1.0,2698,678,2,0
50051,2014/03/31,2012/07/30,190,3,0.4752087370000001,5677,190,1,2
50052,2014/03/31,2009/04/03,150,2,0.505,5342,150,0,2
50053,2014/03/31,2006/07/05,15,2,0.675,3996,15,0,2
50054,2014/03/31,2006/11/22,226,4,0.433419573,6223,226,1,3
50055,2014/03/31,2008/07/17,16,3,0.503852046,5353,16,1,2
50056,2014/03/31,2009/04/13,102,3,0.5721255829999999,4714,102,1,2
50057,2014/03/31,2007/09/24,144,2,0.802846085,3359,144,0,2
50058,2014/03/31,2012/11/16,424,3,0.813729632,3314,424,3,0
50059,2014/03/31,2011/03/09,3,3,0.640522565,4210,3,0,3
50060,2014/03/31,2011/02/21,189,3,0.576062807,4681,189,2,1
50061,2014/03/31,2011/11/02,114,5,0.8220000000000001,3280,114,3,2
50062,2014/03/31,2008/12/27,160,5,0.630343699,4277,160,3,2
50063,2014/03/31,2010/04/05,435,3,0.617063401,4369,435,3,0
50064,2014/03/31,2010/01/08,609,2,0.710624835,3793,609,2,0
50065,2014/03/31,2012/11/08,112,3,0.653262239,4126,112,1,2
50066,2014/03/31,2008/12/20,387,2,0.7810199940000001,3451,387,2,0
50067,2014/03/31,2006/03/31,382,5,0.8556507940000001,3150,382,5,0
50068,2014/03/31,2011/01/20,549,3,0.826748466,3260,549,3,0
50069,2014/03/31,2012/07/05,501,2,1.0,2695,501,2,0
50070,2014/03/31,2009/01/10,331,4,0.470487081,5728,331,2,2
50071,2014/03/31,2010/12/06,240,2,0.7863437409999999,3427,240,1,1
50072,2014/03/31,2007/04/01,33,2,0.685,3934,33,0,2
50073,2014/03/31,2008/07/05,289,2,0.913154863,2951,289,0,2
50074,2014/03/31,2008/01/18,130,6,0.673333333,4002,130,3,3
50075,2014/03/31,2010/01/14,137,5,0.578550569,4657,137,1,4
50076,2014/03/31,2010/01/08,350,3,0.401146516,6716,350,2,1
50077,2014/03/31,2011/12/21,662,2,0.6964839709999999,3868,662,2,0
50078,2014/03/31,2012/12/11,254,2,0.58,4644,254,0,2
50079,2014/03/31,2012/06/01,94,5,0.51857913,5194,94,2,3
50080,2014/03/31,2010/06/12,13,3,0.7748676640000001,3476,13,2,1
50081,2014/03/31,2010/06/02,400,6,0.691666667,3894,400,6,0
50082,2014/03/31,2010/09/09,104,2,0.398358231,6761,104,0,2
50083,2014/03/31,2008/08/25,152,4,0.331378122,8127,152,0,4
50084,2014/03/31,2011/07/20,203,3,0.8108852759999999,3321,203,2,1
50085,2014/03/31,2012/12/02,40,6,0.558237977,4824,40,1,5
50086,2014/03/31,2012/10/02,140,4,0.603641256,4460,140,1,3
50087,2014/03/31,2011/09/06,75,3,0.493333333,5457,75,2,1
50088,2014/03/31,2011/07/23,228,4,0.75255801,3577,228,3,1
50089,2014/03/31,2006/05/31,403,2,0.925,2910,403,2,0
50090,2014/03/31,2009/10/13,37,3,0.6337909110000001,4247,37,0,3
50091,2014/03/31,2008/04/22,185,4,0.614509132,4380,185,3,1
50092,2014/03/31,2007/05/14,57,2,0.66,4078,57,0,2
50093,2014/03/31,2012/12/10,34,5,0.627749009,4287,34,2,3
50094,2014/03/31,2012/06/30,48,3,0.75,3588,48,0,3
50095,2014/03/31,2011/05/24,472,4,0.975,2760,472,4,0
50096,2014/03/31,2012/08/23,102,2,0.805411553,3341,102,0,2
50097,2014/03/31,2013/02/09,91,5,0.514,5235,91,2,3
50098,2014/03/31,2012/04/01,378,4,0.5760115610000001,4671,378,4,0
50099,2014/03/31,2009/08/27,40,5,0.524926829,5125,40,2,3
50100,2014/03/31,2010/07/03,99,4,0.673404255,3995,99,2,2
50101,2014/03/31,2011/12/24,60,4,0.593985427,4529,60,3,1
50102,2014/03/31,2005/03/05,74,4,0.804684415,3343,74,1,3
50103,2014/03/31,2011/06/05,164,2,0.588076082,4574,164,1,1
50104,2014/03/31,2012/09/14,562,2,0.825,3260,562,2,0
50105,2014/03/31,2012/02/07,543,3,0.986065273,2727,543,3,0
50106,2014/03/31,2005/06/25,47,2,0.63,4268,47,0,2
50107,2014/03/31,2011/11/30,149,2,0.845,3182,149,0,2
50108,2014/03/31,2013/03/16,379,2,0.75,3584,379,2,0
50109,2014/03/31,2010/12/06,38,3,0.440931759,6096,38,2,1
50110,2014/03/31,2008/05/22,37,3,0.592951688,4533,37,1,2
50111,2014/03/31,2012/08/17,173,4,1.021375903,2631,173,2,2
50112,2014/03/31,2012/05/10,686,4,0.4,6718,686,4,0
50113,2014/03/31,2010/11/25,136,4,0.673941295,3986,136,0,4
50114,2014/03/31,2012/10/30,135,3,0.4271501270000001,6288,135,2,1
50115,2014/03/31,2012/07/01,259,4,0.661026335,4063,259,3,1
50116,2014/03/31,2012/04/25,140,7,0.347849741,7720,140,5,2
50117,2014/03/31,2011/10/17,377,3,0.878426562,3057,377,3,0
50118,2014/03/31,2011/06/17,161,4,0.677065053,3966,161,1,3
50119,2014/03/31,2010/01/08,526,3,0.816666667,3288,526,3,0
50120,2014/03/31,2011/05/25,358,3,0.533624801,5032,358,1,2
50121,2014/03/31,2012/07/26,590,3,0.81739726,3285,590,3,0
50122,2014/03/31,2010/05/18,583,2,0.675,3978,583,2,0
50123,2014/03/31,2009/11/27,650,2,0.45,5966,650,2,0
50124,2014/03/31,2013/01/01,32,3,0.360787529,7441,32,1,2
50125,2014/03/31,2012/12/25,34,3,0.636856465,4215,34,0,3
50126,2014/03/31,2007/04/12,298,3,0.642273271,4179,298,2,1
50127,2014/03/31,2006/04/11,601,3,0.82657838,3247,601,3,0
50128,2014/03/31,2007/07/08,85,4,0.662188502,4053,85,0,4
50129,2014/03/31,2010/12/13,37,4,0.505039518,5314,37,1,3
50130,2014/03/31,2006/12/11,34,2,0.79898184,3359,34,0,2
50131,2014/03/31,2012/03/04,239,4,0.403074497,6658,239,2,2
50132,2014/03/31,2011/09/24,277,7,0.472993125,5673,277,3,4
50133,2014/03/31,2012/11/27,278,3,0.58521265,4585,278,1,2
50134,2014/03/31,2010/05/06,49,2,0.87,3084,49,0,2
50135,2014/03/31,2008/07/21,304,2,0.495,5420,304,1,1
50136,2014/03/31,2013/01/01,116,4,0.648766626,4135,116,0,4
50137,2014/03/31,2009/08/25,242,3,0.798386905,3360,242,2,1
50138,2014/03/31,2013/01/05,396,3,0.966666667,2775,396,3,0
50139,2014/03/31,2012/09/20,62,4,0.7825,3428,62,1,3
50140,2014/03/31,2011/09/22,336,4,0.359076305,7470,336,2,2
50141,2014/03/31,2009/12/31,208,4,0.481371141,5572,208,2,2
50142,2014/03/31,2012/06/01,20,5,0.904613828,2965,20,1,4
50143,2014/03/31,2013/02/05,417,2,1.0,2682,417,2,0
50144,2014/03/31,2007/04/27,705,3,0.816347032,3285,705,3,0
50145,2014/03/31,2012/07/24,306,3,0.816347032,3285,306,2,1
50146,2014/03/31,2011/06/28,307,3,0.683333333,3924,307,1,2
50147,2014/03/31,2008/10/16,507,4,0.4875,5500,507,4,0
50148,2014/03/31,2006/08/12,181,3,0.653066991,4105,181,2,1
50149,2014/03/31,2011/09/30,334,3,0.6500242479999999,4124,334,0,3
50150,2014/03/31,2013/02/05,219,3,0.6782920040000001,3952,219,2,1
50151,2014/03/31,2009/03/04,447,3,0.85669543,3129,447,3,0
50152,2014/03/31,2008/01/25,132,2,0.829613123,3231,132,0,2
50153,2014/03/31,2010/11/15,10,3,0.7433333329999999,3606,10,2,1
50154,2014/03/31,2011/01/15,42,3,0.704479495,3804,42,0,3
50155,2014/03/31,2013/03/19,110,6,0.6031674920000001,4442,110,1,5
50156,2014/03/31,2013/01/15,426,2,0.529476285,5060,426,2,0
50157,2014/03/31,2007/08/02,248,3,0.46,5823,248,1,2
50158,2014/03/31,2012/07/06,253,3,0.920474227,2910,253,2,1
50159,2014/03/31,2009/09/30,298,3,0.584379228,4583,298,1,2
50160,2014/03/31,2010/09/27,12,3,0.487732653,5491,12,0,3
50161,2014/03/31,2007/12/08,172,2,0.92,2911,172,0,2
50162,2014/03/31,2005/07/01,168,3,0.648430993,4130,168,0,3
50163,2014/03/31,2010/05/25,449,4,1.0,2678,449,4,0
50164,2014/03/31,2012/05/11,679,2,1.0,2678,679,2,0
50165,2014/03/31,2012/05/20,554,3,0.7752750429999999,3454,554,3,0
50166,2014/03/31,2006/03/16,133,3,0.8506099109999999,3148,133,0,3
50167,2014/03/31,2009/10/02,52,3,0.624024703,4291,52,0,3
50168,2014/03/31,2013/03/12,191,2,0.6587011070000001,4065,191,0,2
50169,2014/03/31,2012/05/27,668,2,0.875,3060,668,2,0
50170,2014/03/31,2012/07/18,282,2,0.875,3060,282,1,1
50171,2014/03/31,2008/09/19,315,4,0.6597831439999999,4058,315,3,1
50172,2014/03/31,2010/05/20,224,4,0.807385404,3316,224,2,2
50173,2014/03/31,2011/11/25,314,2,0.675,3966,314,1,1
50174,2014/03/31,2011/05/14,199,4,0.6886930790000001,3887,199,3,1
50175,2014/03/31,2005/09/22,306,4,0.6625,4040,306,3,1
50176,2014/03/31,2008/06/08,430,2,0.7152324959999999,3742,430,2,0
50177,2014/03/31,2006/09/30,207,2,0.6938294009999999,3857,207,0,2
50178,2014/03/31,2012/06/02,646,4,0.8243992609999999,3246,646,4,0
50179,2014/03/31,2012/08/14,592,4,0.787739182,3397,592,4,0
50180,2014/03/31,2012/06/09,153,4,0.54196273,4937,153,1,3
50181,2014/03/31,2013/02/20,46,4,0.713128998,3752,46,1,3
50182,2014/03/31,2013/03/11,89,3,0.5883069479999999,4548,89,1,2
50183,2014/03/31,2010/11/29,614,3,0.872099087,3068,614,3,0
50184,2014/03/31,2013/01/01,176,4,0.626557377,4270,176,1,3
50185,2014/03/31,2009/08/22,605,4,0.905960041,2953,605,4,0
50186,2014/03/31,2006/12/04,611,4,0.718367347,3724,611,4,0
50187,2014/03/31,2012/04/25,216,3,0.453333333,5901,216,1,2
50188,2014/03/31,2012/09/21,557,2,0.925,2892,557,2,0
50189,2014/03/31,2012/10/03,274,3,0.801864508,3336,274,1,2
50190,2014/03/31,2013/01/05,220,4,0.6987225709999999,3828,220,2,2
50191,2014/03/31,2008/10/06,517,3,0.700720461,3817,517,3,0
50192,2014/03/31,2008/06/10,313,4,0.50131209,5335,313,3,1
50193,2014/03/31,2011/08/02,430,2,0.817389976,3272,430,2,0
50194,2014/03/31,2011/06/17,94,2,0.934802517,2861,94,1,1
50195,2014/03/31,2006/12/14,412,5,0.530855498,5038,412,5,0
50196,2014/03/31,2011/03/15,519,4,0.649283807,4119,519,4,0
50197,2014/03/31,2012/09/23,80,3,0.9506861,2813,80,1,2
50198,2014/03/31,2007/04/25,19,4,0.665728155,4017,19,0,4
50199,2014/03/31,2007/05/28,547,3,0.6342979129999999,4216,547,3,0
50200,2014/03/31,2012/06/10,659,2,1.347782258,1984,659,2,0
50201,2014/03/31,2012/07/21,12,4,0.739477323,3616,12,2,2
50202,2014/03/31,2007/03/27,44,5,0.532906119,5017,44,0,5
50203,2014/03/31,2011/03/19,42,3,0.39,6855,42,2,1
50204,2014/03/31,2012/04/02,645,3,0.637831067,4191,645,3,0
50205,2014/03/31,2008/04/05,159,3,0.710930851,3760,159,2,1
50206,2014/03/31,2008/01/17,563,4,0.718548387,3720,563,4,0
50207,2014/03/31,2008/11/19,229,3,0.820641695,3257,229,0,3
50208,2014/03/31,2010/11/10,536,2,0.716747117,3729,536,2,0
50209,2014/03/31,2007/10/10,548,4,0.4880752370000001,5476,548,4,0
50210,2014/03/31,2010/08/31,558,2,0.7604723959999999,3514,558,2,0
50211,2014/03/31,2011/02/06,1,5,0.870733138,3069,1,4,1
50212,2014/03/31,2011/11/05,212,2,0.910763463,2934,212,0,2
50213,2014/03/31,2011/07/12,8,4,0.507704731,5263,8,0,4
50214,2014/03/31,2013/01/24,91,4,0.744096352,3591,91,0,4
50215,2014/03/31,2006/02/24,180,2,0.5,5344,180,0,2
50216,2014/03/31,2007/12/13,23,2,0.67,3988,23,0,2
50217,2014/03/31,2012/11/02,392,3,0.615480304,4341,392,3,0
50218,2014/03/31,2012/12/03,219,2,1.093618502,2443,219,1,1
50219,2014/03/31,2013/03/02,72,2,0.754902515,3539,72,1,1
50220,2014/03/31,2011/12/13,66,6,0.658334155,4058,66,4,2
50221,2014/03/31,2008/02/25,69,5,0.5756302520000001,4641,69,2,3
50222,2014/03/31,2011/06/01,564,2,0.65,4110,564,2,0
50223,2014/03/31,2009/08/03,661,2,0.65,4110,661,2,0
50224,2014/03/31,2013/01/01,278,2,0.47,5684,278,0,2
50225,2014/03/31,2012/08/06,54,2,0.47,5684,54,1,1
50226,2014/03/31,2010/03/01,12,5,0.612,4365,12,3,2
50227,2014/03/31,2012/03/07,502,2,0.429937228,6213,502,2,0
50228,2014/03/31,2013/03/26,147,3,0.585639114,4561,147,1,2
50229,2014/03/31,2012/06/08,621,3,0.759181353,3518,621,3,0
50230,2014/03/31,2010/04/26,543,3,0.87053455,3068,543,3,0
50231,2014/03/31,2007/05/17,47,4,0.289480815,9226,47,0,4
50232,2014/03/31,2013/02/06,50,2,0.875,3052,50,0,2
50233,2014/03/31,2012/07/27,209,4,0.463247745,5764,209,1,3
50234,2014/03/31,2012/10/14,506,2,0.75,3560,506,2,0
50235,2014/03/31,2011/01/23,313,2,0.75,3560,313,0,2
50236,2014/03/31,2012/09/26,8,4,0.506765376,5268,8,0,4
50237,2014/03/31,2010/01/06,124,3,0.8246431879999999,3237,124,1,2
50238,2014/03/31,2008/02/21,153,4,0.902671627,2957,153,1,3
50239,2014/03/31,2012/07/01,497,2,0.775,3444,497,2,0
50240,2014/03/31,2009/04/08,562,4,0.7,3813,562,4,0
50241,2014/03/31,2010/02/01,8,2,0.702685624,3798,8,1,1
50242,2014/03/31,2006/01/25,36,5,0.549913456,4853,36,2,3
50243,2014/03/31,2008/08/02,122,4,0.540411098,4938,122,2,2
50244,2014/03/31,2013/01/31,358,3,0.910716724,2930,358,2,1
50245,2014/03/31,2010/12/10,80,4,0.616191686,4330,80,2,2
50246,2014/03/31,2011/01/13,4,4,0.334449041,7977,4,0,4
50247,2014/03/31,2008/01/12,177,2,0.561855518,4748,177,1,1
50248,2014/03/31,2008/03/25,217,4,0.598223817,4459,217,1,3
50249,2014/03/31,2010/10/22,36,3,0.50883823,5242,36,0,3
50250,2014/03/31,2013/01/02,193,3,0.7279257640000001,3664,193,0,3
50251,2014/03/31,2006/10/01,228,3,0.805283816,3312,228,2,1
50252,2014/03/31,2009/04/11,65,2,0.719436202,3707,65,0,2
50253,2014/03/31,2007/02/05,159,5,0.695498174,3834,159,2,3
50254,2014/03/31,2006/04/03,418,3,0.6877740520000001,3877,418,3,0
50255,2014/03/31,2008/07/15,22,4,0.409277053,6515,22,0,4
50256,2014/03/31,2009/11/28,35,3,0.88,3030,35,0,3
50257,2014/03/31,2011/07/09,11,3,0.847790143,3145,11,1,2
50258,2014/03/31,2008/06/06,223,2,0.91,2930,223,0,2
50259,2014/03/31,2006/03/15,357,5,0.527219695,5057,357,3,2
50260,2014/03/31,2011/12/22,629,4,0.6067835189999999,4393,629,4,0
50261,2014/03/31,2012/09/03,276,5,0.648520681,4110,276,4,1
50262,2014/03/31,2011/12/14,544,3,0.598159785,4456,544,3,0
50263,2014/03/31,2010/08/18,706,2,0.675,3948,706,2,0
50264,2014/03/31,2007/07/19,226,3,0.85795235,3106,226,2,1
50265,2014/03/31,2011/10/14,2,3,0.593333333,4491,2,2,1
50266,2014/03/31,2012/05/08,663,4,0.7170928670000001,3715,663,4,0
50267,2014/03/31,2010/03/01,538,2,0.925,2880,538,2,0
50268,2014/03/31,2010/09/10,174,2,0.365,7298,174,0,2
50269,2014/03/31,2011/12/25,555,8,0.4375,6088,555,8,0
50270,2014/03/31,2012/07/02,380,4,0.875,3044,380,4,0
50271,2014/03/31,2009/02/20,164,2,0.59453125,4480,164,1,1
50272,2014/03/31,2011/07/19,217,4,0.6857595259999999,3884,217,0,4
50273,2014/03/31,2010/10/26,165,3,0.815718224,3265,165,1,2
50274,2014/03/31,2012/05/27,35,2,0.684240555,3891,35,1,1
50275,2014/03/31,2011/10/10,13,2,0.560614866,4749,13,1,1
50276,2014/03/31,2009/08/17,100,2,0.817124002,3258,100,1,1
50277,2014/03/31,2010/11/19,234,2,0.55,4840,234,0,2
50278,2014/03/31,2007/06/15,312,3,0.704579142,3778,312,2,1
50279,2014/03/31,2009/06/30,447,3,0.951555238,2797,447,3,0
50280,2014/03/31,2011/03/03,507,3,0.50463595,5274,507,3,0
50281,2014/03/31,2011/09/14,210,2,0.5651688260000001,4709,210,0,2
50282,2014/03/31,2012/02/25,38,4,0.7282430209999999,3654,38,0,4
50283,2014/03/31,2008/12/13,525,2,0.45,5913,525,2,0
50284,2014/03/31,2013/02/09,371,3,0.794223881,3350,371,3,0
50285,2014/03/31,2006/02/02,415,4,0.7303458690000001,3643,415,4,0
50286,2014/03/31,2011/12/26,177,2,0.92,2892,177,0,2
50287,2014/03/31,2007/11/08,188,2,0.92,2892,188,0,2
50288,2014/03/31,2008/10/11,103,3,0.760546026,3498,103,2,1
50289,2014/03/31,2005/03/05,96,4,0.589878049,4510,96,2,2
50290,2014/03/31,2011/12/22,156,3,0.8965824059999999,2967,156,1,2
50291,2014/03/31,2009/11/04,6,4,0.740125209,3594,6,2,2
50292,2014/03/31,2007/08/24,423,3,0.468283451,5680,423,3,0
50293,2014/03/31,2010/04/23,207,3,0.7266612020000001,3660,207,1,2
50294,2014/03/31,2008/05/02,415,6,0.944760213,2815,415,6,0
50295,2014/03/31,2013/01/01,34,2,0.849386777,3131,34,1,1
50296,2014/03/31,2006/11/21,305,3,0.851440922,3123,305,1,2
50297,2014/03/31,2010/02/27,678,3,0.95,2799,678,3,0
50298,2014/03/31,2009/01/27,284,4,0.7125,3732,284,2,2
50299,2014/03/31,2012/08/18,445,4,0.489596759,5431,445,4,0
50300,2014/03/31,2011/07/09,12,5,0.658296608,4039,12,1,4
50301,2014/03/31,2011/06/15,233,4,0.478608461,5555,233,0,4
50302,2014/03/31,2011/06/22,429,3,0.6279168629999999,4234,429,3,0
50303,2014/03/31,2008/05/13,233,2,0.64,4154,233,0,2
50304,2014/03/31,2011/03/11,302,2,0.98240946,2706,302,1,1
50305,2014/03/31,2010/05/27,388,6,0.7155450870000001,3715,388,6,0
50306,2014/03/31,2008/10/03,245,3,0.569096553,4671,245,2,1
50307,2014/03/31,2011/04/15,716,2,0.8968117409999999,2964,716,2,0
50308,2014/03/31,2012/02/20,459,3,0.830625,3200,459,3,0
50309,2014/03/31,2005/11/11,59,6,0.765,3474,59,4,2
50310,2014/03/31,2012/07/22,76,3,0.8700654879999999,3054,76,2,1
50311,2014/03/31,2010/12/25,94,2,0.7849512559999999,3385,94,0,2
50312,2014/03/31,2007/04/03,262,3,0.846666667,3138,262,1,2
50313,2014/03/31,2012/10/31,87,4,0.500391788,5309,87,2,2
50314,2014/03/31,2007/08/20,106,3,0.908208547,2925,106,1,2
50315,2014/03/31,2006/04/07,99,3,0.7049522290000001,3768,99,0,3
50316,2014/03/31,2010/10/21,263,4,0.464150647,5722,263,2,2
50317,2014/03/31,2010/04/27,40,3,0.528174224,5028,40,0,3
50318,2014/03/31,2010/08/04,126,2,0.675,3934,126,0,2
50319,2014/03/31,2005/04/06,233,2,0.675,3934,233,0,2
50320,2014/03/31,2012/12/08,478,2,0.675,3934,478,2,0
50321,2014/03/31,2011/01/04,214,2,0.675,3934,214,0,2
50322,2014/03/31,2005/05/04,187,2,0.675,3934,187,0,2
50323,2014/03/31,2011/03/12,199,2,0.675,3934,199,0,2
50324,2014/03/31,2009/01/13,402,2,0.675,3934,402,2,0
50325,2014/03/31,2005/12/09,633,2,0.946631016,2805,633,2,0
50326,2014/03/31,2007/06/29,237,2,0.668504532,3972,237,1,1
50327,2014/03/31,2011/08/12,529,4,0.958210032,2771,529,4,0
50328,2014/03/31,2011/05/08,92,5,0.593208222,4476,92,4,1
50329,2014/03/31,2009/09/30,249,4,0.496439791,5348,249,3,1
50330,2014/03/31,2011/03/07,10,2,0.556237167,4773,10,1,1
50331,2014/03/31,2013/03/06,68,5,0.609052535,4359,68,0,5
50332,2014/03/31,2010/11/01,122,3,0.613264033,4329,122,1,2
50333,2014/03/31,2010/07/25,96,3,0.604710706,4390,96,1,2
50334,2014/03/31,2012/10/16,50,6,0.460856051,5759,50,3,3
50335,2014/03/31,2006/07/10,167,3,0.8829241520000001,3006,167,0,3
50336,2014/03/31,2009/01/23,497,2,0.6305535760000001,4209,497,2,0
50337,2014/03/31,2011/03/29,398,6,0.729708551,3637,398,6,0
50338,2014/03/31,2011/05/30,356,3,0.564115646,4704,356,1,2
50339,2014/03/31,2011/01/24,116,2,0.780441176,3400,116,0,2
50340,2014/03/31,2012/03/15,472,4,0.7609868040000001,3486,472,4,0
50341,2014/03/31,2006/10/08,162,5,0.938556263,2826,162,3,2
50342,2014/03/31,2006/09/28,162,5,0.484,5480,162,3,2
50343,2014/03/31,2012/06/13,84,5,0.5874130679999999,4515,84,1,4
50344,2014/03/31,2008/02/06,127,4,0.7475,3548,127,0,4
50345,2014/03/31,2013/02/15,90,8,0.35742318100000003,7420,90,0,8
50346,2014/03/31,2007/10/25,6,3,0.729378438,3636,6,0,3
50347,2014/03/31,2005/03/19,148,3,0.638567301,4153,148,0,3
50348,2014/03/31,2012/06/21,142,3,0.965750182,2746,142,1,2
50349,2014/03/31,2008/05/17,375,5,0.547717414,4841,375,5,0
50350,2014/03/31,2011/01/14,297,6,0.371666667,7134,297,4,2
50351,2014/03/31,2013/01/10,109,5,0.6713724990000001,3949,109,1,4
50352,2014/03/31,2009/01/08,470,5,0.504471931,5255,470,5,0
50353,2014/03/31,2012/04/11,520,2,0.862642369,3073,520,2,0
50354,2014/03/31,2010/01/27,4,3,0.914641132,2898,4,1,2
50355,2014/03/31,2013/03/26,184,2,0.788978863,3359,184,1,1
50356,2014/03/31,2013/02/06,417,2,1.0,2650,417,2,0
50357,2014/03/31,2013/02/06,417,2,1.0,2650,417,2,0
50358,2014/03/31,2011/08/07,708,3,1.0,2650,708,3,0
50359,2014/03/31,2012/07/05,562,3,0.75,3533,562,3,0
50360,2014/03/31,2008/04/22,216,4,0.96,2760,216,0,4
50361,2014/03/31,2009/10/17,93,4,0.698494595,3793,93,3,1
50362,2014/03/31,2011/12/04,194,4,0.661801149,4003,194,2,2
50363,2014/03/31,2006/09/11,164,3,0.624268206,4243,164,2,1
50364,2014/03/31,2012/04/24,86,3,0.52387856,5056,86,1,2
50365,2014/03/31,2009/10/30,527,2,0.436182477,6072,527,2,0
50366,2014/03/31,2008/05/02,5,3,0.530685371,4990,5,1,2
50367,2014/03/31,2008/07/01,194,2,0.49,5404,194,0,2
50368,2014/03/31,2006/11/27,69,3,0.602756658,4393,69,0,3
50369,2014/03/31,2012/11/02,359,3,0.5679429429999999,4662,359,2,1
50370,2014/03/31,2009/03/14,585,3,0.66407073,3987,585,3,0
50371,2014/03/31,2009/11/03,314,5,0.608749138,4349,314,2,3
50372,2014/03/31,2010/12/22,133,3,0.634970017,4169,133,1,2
50373,2014/03/31,2012/11/24,290,3,0.35679741200000004,7419,290,2,1
50374,2014/03/31,2012/09/16,97,6,0.4466756670000001,5926,97,5,1
50375,2014/03/31,2007/11/13,430,4,0.475323276,5568,430,4,0
50376,2014/03/31,2010/04/17,150,3,0.908856456,2912,150,0,3
50377,2014/03/31,2011/04/12,393,2,0.874297985,3027,393,2,0
50378,2014/03/31,2008/06/17,533,3,0.810551302,3265,533,3,0
50379,2014/03/31,2009/12/29,395,2,0.8,3308,395,2,0
50380,2014/03/31,2012/07/14,625,2,0.8,3308,625,2,0
50381,2014/03/31,2011/12/30,12,4,0.6485808820000001,4080,12,1,3
50382,2014/03/31,2012/06/19,81,2,0.456929719,5791,81,0,2
50383,2014/03/31,2008/05/10,515,3,0.9,2940,515,3,0
50384,2014/03/31,2009/02/18,166,3,0.680833762,3886,166,1,2
50385,2014/03/31,2011/01/19,414,5,0.449829961,5881,414,5,0
50386,2014/03/31,2010/04/16,120,2,0.7222829059999999,3662,120,1,1
50387,2014/03/31,2011/01/14,90,4,0.6259834320000001,4225,90,2,2
50388,2014/03/31,2013/02/26,97,2,0.628045595,4211,97,1,1
50389,2014/03/31,2006/11/06,42,2,0.632149175,4183,42,0,2
50390,2014/03/31,2011/04/07,109,4,0.603673516,4380,109,3,1
50391,2014/03/31,2006/07/18,155,2,1.4550742980000002,1817,155,1,1
50392,2014/03/31,2009/12/20,116,5,0.430478749,6141,116,4,1
50393,2014/03/31,2006/12/03,63,2,0.82353271,3210,63,0,2
50394,2014/03/31,2012/03/24,214,2,0.65982027,4006,214,0,2
50395,2014/03/31,2012/11/29,124,5,0.582319894,4539,124,1,4
50396,2014/03/31,2012/05/25,95,4,0.7003524109999999,3774,95,0,4
50397,2014/03/31,2011/06/14,244,6,0.455392833,5804,244,4,2
50398,2014/03/31,2009/11/03,600,3,0.333333333,7929,600,3,0
50399,2014/03/31,2013/02/05,5,3,0.7671872279999999,3445,5,0,3
50400,2014/03/31,2010/04/30,132,4,0.575306922,4594,132,0,4
50401,2014/03/31,2008/08/28,339,2,0.973443831,2715,339,1,1
50402,2014/03/31,2009/03/10,674,2,0.45,5873,674,2,0
50403,2014/03/31,2005/12/01,350,2,0.8641595809999999,3058,350,1,1
50404,2014/03/31,2007/11/14,12,3,0.65,4065,12,1,2
50405,2014/03/31,2012/02/28,14,3,0.594536454,4444,14,0,3
50406,2014/03/31,2011/11/16,212,4,0.461979367,5719,212,3,1
50407,2014/03/31,2010/09/12,472,4,0.752063763,3513,472,4,0
50408,2014/03/31,2007/07/25,249,3,0.64,4128,249,1,2
50409,2014/03/31,2012/07/05,629,2,0.45,5870,629,2,0
50410,2014/03/31,2012/12/22,454,2,0.45,5870,454,2,0
50411,2014/03/31,2012/05/18,557,3,0.599477985,4406,557,3,0
50412,2014/03/31,2011/09/27,402,2,0.86625123,3049,402,2,0
50413,2014/03/31,2012/08/28,134,4,0.71982284,3669,134,2,2
50414,2014/03/31,2008/04/17,37,4,0.634545891,4162,37,2,2
50415,2014/03/31,2008/11/06,150,4,0.617854469,4274,150,2,2
50416,2014/03/31,2011/06/29,44,3,0.817270195,3231,44,1,2
50417,2014/03/31,2008/03/18,305,2,0.6382741120000001,4137,305,1,1
50418,2014/03/31,2008/03/20,194,3,0.8863645520000001,2979,194,0,3
50419,2014/03/31,2005/09/20,521,3,0.7828194490000001,3373,521,3,0
50420,2014/03/31,2010/09/26,192,4,0.514802106,5129,192,3,1
50421,2014/03/31,2013/01/12,106,4,0.615336751,4291,106,2,2
50422,2014/03/31,2010/02/15,1,2,0.36,7334,1,0,2
50423,2014/03/31,2011/06/14,184,2,0.735,3592,184,0,2
50424,2014/03/31,2008/11/02,685,3,0.84456174,3126,685,3,0
50425,2014/03/31,2013/03/14,14,3,0.552896335,4775,14,0,3
50426,2014/03/31,2005/10/27,483,3,0.48807543,5409,483,3,0
50427,2014/03/31,2012/08/03,508,4,0.444145357,5944,508,4,0
50428,2014/03/31,2010/10/15,683,3,0.578120894,4566,683,3,0
50429,2014/03/31,2010/03/04,506,9,0.408480347,6462,506,9,0
50430,2014/03/31,2008/03/06,80,2,0.722356322,3654,80,1,1
50431,2014/03/31,2011/12/17,126,3,0.777020024,3396,126,2,1
50432,2014/03/31,2010/11/01,48,2,0.6991308959999999,3774,48,0,2
50433,2014/03/31,2007/02/26,641,2,0.945698925,2790,641,2,0
50434,2014/03/31,2007/07/26,365,2,0.709274194,3720,365,1,1
50435,2014/03/31,2012/01/01,108,5,0.43342369,6087,108,4,1
50436,2014/03/31,2011/04/08,712,2,0.7503412970000001,3516,712,2,0
50437,2014/03/31,2012/04/30,286,4,0.642433025,4106,286,2,2
50438,2014/03/31,2012/11/16,500,2,0.558534519,4722,500,2,0
50439,2014/03/31,2009/03/08,6,3,0.8254021909999999,3195,6,0,3
50440,2014/03/31,2011/05/01,697,2,0.9,2930,697,2,0
50441,2014/03/31,2010/10/28,103,4,0.639386518,4124,103,0,4
50442,2014/03/31,2010/08/16,132,7,0.433667763,6080,132,4,3
50443,2014/03/31,2007/08/17,341,2,0.838314785,3145,341,1,1
50444,2014/03/31,2010/01/23,705,4,0.825391359,3194,705,4,0
50445,2014/03/31,2013/01/31,41,3,0.446666667,5901,41,0,3
50446,2014/03/31,2013/01/29,161,3,0.8301669290000001,3175,161,1,2
50447,2014/03/31,2009/11/29,45,4,0.335,7868,45,2,2
50448,2014/03/31,2012/03/27,114,4,0.335,7868,114,1,3
50449,2014/03/31,2006/04/27,587,2,0.6483886839999999,4065,587,2,0
50450,2014/03/31,2012/04/01,234,2,0.7087012640000001,3719,234,1,1
50451,2014/03/31,2012/01/18,365,2,1.5,1757,365,1,1
50452,2014/03/31,2012/08/21,268,3,0.313501071,8406,268,0,3
50453,2014/03/31,2012/06/12,345,2,0.675,3904,345,1,1
50454,2014/03/31,2007/10/01,506,2,0.775,3400,506,2,0
50455,2014/03/31,2012/01/16,245,2,0.78834231,3342,245,1,1
50456,2014/03/31,2005/12/10,196,2,0.687130934,3834,196,1,1
50457,2014/03/31,2013/02/02,68,3,0.396449962,6645,68,1,2
50458,2014/03/31,2008/07/24,45,5,0.521762725,5049,45,3,2
50459,2014/03/31,2012/08/25,10,2,0.8606239790000001,3061,10,1,1
50460,2014/03/31,2012/04/12,16,5,0.5049511210000001,5217,16,1,4
50461,2014/03/31,2009/07/24,25,4,0.6712563709999999,3924,25,2,2
50462,2014/03/31,2009/12/01,595,2,0.490959925,5365,595,2,0
50463,2014/03/31,2008/12/17,130,2,0.92,2863,130,0,2
50464,2014/03/31,2012/05/02,695,2,0.634216229,4153,695,2,0
50465,2014/03/31,2011/08/17,209,4,0.505250336,5213,209,2,2
50466,2014/03/31,2010/02/20,10,2,0.654025329,4027,10,0,2
50467,2014/03/31,2012/12/19,131,3,0.86352459,3050,131,1,2
50468,2014/03/31,2012/08/12,153,3,0.522846933,5037,153,1,2
50469,2014/03/31,2011/12/13,576,2,0.7,3762,576,2,0
50470,2014/03/31,2013/03/23,297,3,0.466666667,5643,297,2,1
50471,2014/03/31,2007/11/10,266,4,0.315326946,8350,266,2,2
50472,2014/03/31,2008/02/10,439,4,0.57523487,4577,439,4,0
50473,2014/03/31,2009/02/19,319,5,0.79465741,3313,319,3,2
50474,2014/03/31,2011/02/26,377,4,0.845711532,3113,377,4,0
50475,2014/03/31,2011/08/14,108,2,0.907724138,2900,108,0,2
50476,2014/03/31,2011/11/01,368,3,0.584836703,4501,368,3,0
50477,2014/03/31,2008/08/08,39,7,0.33340595300000003,7895,39,5,2
50478,2014/03/31,2012/07/25,111,3,0.574313768,4583,111,1,2
50479,2014/03/31,2008/03/28,4,2,0.58,4538,4,0,2
50480,2014/03/31,2011/05/28,397,4,0.496397586,5302,397,4,0
50481,2014/03/31,2012/10/14,41,4,0.801907374,3282,41,2,2
50482,2014/03/31,2009/11/22,145,3,0.68,3870,145,1,2
50483,2014/03/31,2012/10/09,535,4,0.459490134,5727,535,4,0
50484,2014/03/31,2011/04/14,436,5,0.919287212,2862,436,5,0
50485,2014/03/31,2006/04/10,187,4,0.395141184,6658,187,3,1
50486,2014/03/31,2007/09/10,208,8,0.79625,3304,208,7,1
50487,2014/03/31,2011/02/22,101,4,0.390093416,6744,101,1,3
50488,2014/03/31,2012/09/24,323,2,0.661146017,3979,323,1,1
50489,2014/03/31,2008/03/01,617,4,0.45,5846,617,4,0
50490,2014/03/31,2012/07/11,530,3,0.828274559,3176,530,3,0
50491,2014/03/31,2011/08/05,625,3,0.950144509,2768,625,3,0
50492,2014/03/31,2011/04/18,428,3,0.5090301970000001,5166,428,3,0
50493,2014/03/31,2012/10/15,189,7,0.34532239,7615,189,4,3
50494,2014/03/31,2011/05/25,222,3,0.902210021,2914,222,2,1
50495,2014/03/31,2009/08/23,527,2,0.79258366,3317,527,2,0
50496,2014/03/31,2010/11/07,144,4,0.508057596,5174,144,3,1
50497,2014/03/31,2013/03/29,160,3,0.668278668,3933,160,0,3
50498,2014/03/31,2008/09/03,28,4,0.77365028,3397,28,0,4
50499,2014/03/31,2012/05/29,181,3,0.513094494,5122,181,1,2
50500,2014/03/31,2010/12/20,66,5,0.843128008,3117,66,2,3
50501,2014/03/31,2008/04/22,72,2,0.593636774,4427,72,0,2
50502,2014/03/31,2007/06/19,380,3,0.603502526,4354,380,3,0
50503,2014/03/31,2005/04/07,390,2,0.6239848020000001,4211,390,2,0
50504,2014/03/31,2012/10/09,525,2,0.519156293,5061,525,2,0
50505,2014/03/31,2008/09/12,94,2,0.980268657,2680,94,0,2
50506,2014/03/31,2013/03/28,230,3,0.787485012,3336,230,0,3
50507,2014/03/31,2010/08/08,341,2,1.0,2627,341,1,1
50508,2014/03/31,2012/09/09,521,3,0.851198963,3086,521,3,0
50509,2014/03/31,2012/10/30,250,4,0.674163244,3896,250,2,2
50510,2014/03/31,2007/09/19,331,3,0.744233494,3529,331,1,2
50511,2014/03/31,2012/06/05,49,6,0.6853549059999999,3832,49,4,2
50512,2014/03/31,2012/05/29,239,5,0.592917137,4429,239,1,4
50513,2014/03/31,2008/07/15,319,3,1.0,2625,319,2,1
50514,2014/03/31,2012/05/06,511,2,0.75,3500,511,2,0
50515,2014/03/31,2012/10/14,454,3,0.6859905909999999,3826,454,3,0
50516,2014/03/31,2011/03/05,5,4,0.736975569,3561,5,1,3
50517,2014/03/31,2011/12/06,631,3,0.589057239,4455,631,3,0
50518,2014/03/31,2008/08/25,100,3,0.6833828129999999,3840,100,2,1
50519,2014/03/31,2008/10/25,284,2,0.491211384,5341,284,0,2
50520,2014/03/31,2007/10/17,533,2,0.760185453,3451,533,2,0
50521,2014/03/31,2013/02/25,361,2,0.959546452,2734,361,1,1
50522,2014/03/31,2011/08/29,669,2,1.0,2623,669,2,0
50523,2014/03/31,2012/06/03,666,4,0.859718125,3051,666,4,0
50524,2014/03/31,2011/01/13,28,3,0.51547956,5088,28,0,3
50525,2014/03/31,2012/05/18,680,3,0.892682097,2938,680,3,0
50526,2014/03/31,2009/08/01,98,2,1.147768053,2285,98,0,2
50527,2014/03/31,2012/12/05,480,2,0.625,4196,480,2,0
50528,2014/03/31,2006/05/08,25,5,0.431177244,6082,25,0,5
50529,2014/03/31,2010/07/14,463,5,0.523060044,5013,463,5,0
50530,2014/03/31,2006/11/15,70,3,0.624290476,4200,70,1,2
50531,2014/03/31,2012/09/28,547,2,1.0,2622,547,2,0
50532,2014/03/31,2011/07/31,460,2,1.0,2622,460,2,0
50533,2014/03/31,2013/01/05,140,7,0.441835496,5933,140,0,7
50534,2014/03/31,2012/08/11,2,5,0.483727625,5419,2,3,2
50535,2014/03/31,2013/02/15,331,2,0.782651538,3349,331,1,1
50536,2014/03/31,2012/09/20,557,2,0.8,3276,557,2,0
50537,2014/03/31,2012/09/27,549,2,0.8,3276,549,2,0
50538,2014/03/31,2011/12/05,516,2,0.8,3276,516,2,0
50539,2014/03/31,2012/07/19,307,5,0.385155791,6804,307,3,2
50540,2014/03/31,2011/09/15,635,2,0.5179051379999999,5060,635,2,0
50541,2014/03/31,2012/12/06,35,2,0.675,3882,35,0,2
50542,2014/03/31,2008/03/09,278,2,0.568442178,4609,278,0,2
50543,2014/03/31,2008/04/19,151,4,0.5745087720000001,4560,151,0,4
50544,2014/03/31,2007/10/25,534,2,0.727060783,3603,534,2,0
50545,2014/03/31,2012/11/29,184,4,0.6372700729999999,4110,184,2,2
50546,2014/03/31,2007/04/10,295,2,0.439879073,5954,295,1,1
50547,2014/03/31,2008/06/23,93,2,0.826836123,3167,93,0,2
50548,2014/03/31,2012/08/19,17,2,0.49,5344,17,1,1
50549,2014/03/31,2012/02/20,158,3,0.513025078,5104,158,1,2
50550,2014/03/31,2012/03/31,69,4,0.578242049,4528,69,3,1
50551,2014/03/31,2011/01/03,197,2,0.77,3400,197,0,2
50552,2014/03/31,2011/09/12,95,6,0.724761905,3612,95,0,6
50553,2014/03/31,2010/02/17,343,4,0.766334895,3416,343,3,1
50554,2014/03/31,2007/11/13,163,2,0.761649695,3437,163,0,2
50555,2014/03/31,2008/05/28,588,2,0.525,4986,588,2,0
50556,2014/03/31,2011/04/01,73,2,0.62,4222,73,0,2
50557,2014/03/31,2010/12/20,479,4,0.4,6544,479,4,0
50558,2014/03/31,2012/01/23,619,3,0.8494969170000001,3081,619,3,0
50559,2014/03/31,2009/02/20,135,2,0.59,4436,135,0,2
50560,2014/03/31,2009/12/01,82,2,1.155,2266,82,0,2
50561,2014/03/31,2011/12/29,74,3,0.67,3906,74,0,3
50562,2014/03/31,2005/10/15,192,4,0.683949294,3826,192,0,4
50563,2014/03/31,2012/07/10,341,4,0.33525304300000003,7805,341,2,2
50564,2014/03/31,2008/07/09,3,3,0.443333333,5901,3,2,1
50565,2014/03/31,2008/12/02,549,2,1.0,2616,549,2,0
50566,2014/03/31,2010/08/19,473,2,1.0,2616,473,2,0
50567,2014/03/31,2011/09/24,355,2,1.0,2616,355,1,1
50568,2014/03/31,2012/05/29,575,2,1.0,2616,575,2,0
50569,2014/03/31,2012/07/31,493,2,1.0,2616,493,2,0
50570,2014/03/31,2010/07/06,402,3,1.0,2616,402,3,0
50571,2014/03/31,2008/09/23,512,2,1.0,2616,512,2,0
50572,2014/03/31,2012/07/29,610,2,1.0,2616,610,2,0
50573,2014/03/31,2011/07/12,719,2,1.0,2616,719,2,0
50574,2014/03/31,2006/08/12,422,2,1.0,2616,422,2,0
50575,2014/03/31,2008/01/31,578,2,1.0,2616,578,2,0
50576,2014/03/31,2008/05/27,718,2,1.0,2616,718,2,0
50577,2014/03/31,2005/08/02,634,3,0.59204211,4417,634,3,0
50578,2014/03/31,2010/03/01,76,3,0.57841628,4521,76,2,1
50579,2014/03/31,2005/09/08,75,3,0.833333333,3138,75,0,3
50580,2014/03/31,2012/05/11,390,3,0.6652251339999999,3931,390,3,0
50581,2014/03/31,2010/08/26,297,6,0.558345078,4683,297,3,3
50582,2014/03/31,2007/11/21,298,2,0.637556693,4101,298,1,1
50583,2014/03/31,2012/05/20,242,2,0.782342908,3342,242,1,1
50584,2014/03/31,2012/03/22,29,4,0.91087108,2870,29,0,4
50585,2014/03/31,2008/09/08,256,2,0.7426448859999999,3520,256,1,1
50586,2014/03/31,2007/03/16,128,2,0.358600631,7289,128,0,2
50587,2014/03/31,2013/03/01,163,4,0.8447640590000001,3094,163,0,4
50588,2014/03/31,2012/12/26,208,5,0.564961089,4626,208,2,3
50589,2014/03/31,2011/10/25,239,2,0.7883076920000001,3315,239,1,1
50590,2014/03/31,2007/11/09,706,2,1.0,2613,706,2,0
50591,2014/03/31,2007/01/12,152,3,0.665044541,3929,152,1,2
50592,2014/03/31,2007/08/01,430,4,0.378078426,6911,430,4,0
50593,2014/03/31,2012/08/31,56,6,0.383223819,6818,56,2,4
50594,2014/03/31,2012/05/24,412,3,0.7110778440000001,3674,412,3,0
50595,2014/03/31,2011/11/09,659,3,0.933333333,2799,659,3,0
50596,2014/03/31,2011/02/22,175,2,0.949963636,2750,175,1,1
50597,2014/03/31,2009/11/11,144,2,0.949963636,2750,144,1,1
50598,2014/03/31,2006/02/14,137,2,0.445,5870,137,0,2
50599,2014/03/31,2009/10/24,60,3,0.84692607,3084,60,0,3
50600,2014/03/31,2012/06/18,251,2,0.603602958,4327,251,1,1
50601,2014/03/31,2011/01/13,15,3,0.569869081,4583,15,2,1
50602,2014/03/31,2012/10/16,142,4,0.577419854,4523,142,2,2
50603,2014/03/31,2012/09/13,459,2,0.8587306809999999,3041,459,2,0
50604,2014/03/31,2006/12/26,42,2,0.764623719,3415,42,0,2
50605,2014/03/31,2013/03/24,1,2,0.667981064,3908,1,1,1
50606,2014/03/31,2012/07/17,580,2,1.0,2610,580,2,0
50607,2014/03/31,2011/01/10,119,2,0.8198209240000001,3183,119,0,2
50608,2014/03/31,2013/01/01,1,3,0.586927575,4446,1,0,3
50609,2014/03/31,2008/11/21,605,3,0.7061975640000001,3695,605,3,0
50610,2014/03/31,2011/02/21,604,3,0.962730627,2710,604,3,0
50611,2014/03/31,2012/12/30,384,2,0.4,6522,384,2,0
50612,2014/03/31,2012/01/10,674,4,0.8139469579999999,3205,674,4,0
50613,2014/03/31,2012/12/22,216,4,0.959396837,2719,216,1,3
50614,2014/03/31,2012/05/07,693,2,0.75,3478,693,2,0
50615,2014/03/31,2004/12/24,195,5,0.952,2740,195,3,2
50616,2014/03/31,2009/09/03,418,4,0.895144132,2914,418,4,0
50617,2014/03/31,2008/12/24,121,6,0.984226415,2650,121,5,1
50618,2014/03/31,2013/01/07,233,4,0.704516478,3702,233,1,3
50619,2014/03/31,2012/11/12,147,5,0.569290548,4581,147,0,5
50620,2014/03/31,2012/09/22,103,4,0.91246676,2858,103,1,3
50621,2014/03/31,2007/10/14,17,2,1.09,2392,17,0,2
50622,2014/03/31,2011/10/24,271,3,0.631249395,4130,271,2,1
50623,2014/03/31,2006/10/08,248,3,0.670640597,3887,248,1,2
50624,2014/03/31,2012/10/13,58,3,0.7010650890000001,3718,58,1,2
50625,2014/03/31,2008/12/10,500,2,0.7634739309999999,3414,500,2,0
50626,2014/03/31,2011/09/27,4,2,0.559064779,4662,4,0,2
50627,2014/03/31,2005/10/03,155,4,0.645,4040,155,0,4
50628,2014/03/31,2007/07/14,58,5,0.9,2895,58,3,2
50629,2014/03/31,2011/04/21,101,2,0.847826228,3073,101,1,1
50630,2014/03/31,2011/12/21,206,3,0.375510233,6938,206,2,1
50631,2014/03/31,2007/06/11,234,5,0.436,5975,234,3,2
50632,2014/03/31,2004/12/20,32,6,0.5344296270000001,4874,32,1,5
50633,2014/03/31,2010/06/03,290,3,0.517225973,5036,290,2,1
50634,2014/03/31,2007/04/20,582,3,0.820895052,3173,582,3,0
50635,2014/03/31,2005/09/21,557,4,0.739437819,3522,557,4,0
50636,2014/03/31,2009/08/16,593,4,0.739437819,3522,593,4,0
50637,2014/03/31,2010/08/26,280,3,0.830660287,3135,280,1,2
50638,2014/03/31,2010/06/12,461,6,0.7907986640000001,3293,461,6,0
50639,2014/03/31,2012/12/26,90,4,0.479729182,5428,90,0,4
50640,2014/03/31,2007/10/13,43,3,0.73,3567,43,0,3
50641,2014/03/31,2008/03/13,356,3,0.791218475,3291,356,2,1
50642,2014/03/31,2011/06/12,350,4,0.7545349170000001,3451,350,3,1
50643,2014/03/31,2006/05/04,253,3,0.6410192020000001,4062,253,0,3
50644,2014/03/31,2005/01/30,171,3,0.60780112,4284,171,1,2
50645,2014/03/31,2009/12/21,95,5,0.641014279,4062,95,3,2
50646,2014/03/31,2008/08/13,292,4,0.59924954,4344,292,3,1
50647,2014/03/31,2013/01/22,286,3,0.663333333,3924,286,1,2
50648,2014/03/31,2008/07/18,71,2,0.9,2892,71,0,2
50649,2014/03/31,2012/04/10,622,3,0.6,4338,622,3,0
50650,2014/03/31,2013/03/09,363,2,0.9,2892,363,1,1
50651,2014/03/31,2012/09/05,571,2,0.9,2892,571,2,0
50652,2014/03/31,2011/11/25,292,3,0.455942537,5708,292,2,1
50653,2014/03/31,2013/03/12,156,4,0.798514882,3259,156,0,4
50654,2014/03/31,2010/08/08,234,2,0.8335201790000001,3122,234,1,1
50655,2014/03/31,2008/08/27,112,5,0.75989486,3424,112,0,5
50656,2014/03/31,2011/05/09,86,5,0.596,4365,86,0,5
50657,2014/03/31,2011/05/05,19,5,0.611257049,4256,19,0,5
50658,2014/03/31,2011/03/14,80,2,1.41,1845,80,0,2
50659,2014/03/31,2005/09/13,156,3,0.81726673,3183,156,0,3
50660,2014/03/31,2011/05/10,28,5,0.453347856,5738,28,2,3
50661,2014/03/31,2012/03/16,32,4,0.44497092,5846,32,1,3
50662,2014/03/31,2012/04/25,598,2,0.85,3060,598,2,0
50663,2014/03/31,2006/11/24,585,3,0.848629243,3064,585,3,0
50664,2014/03/31,2008/09/21,249,5,0.360292406,7216,249,4,1
50665,2014/03/31,2010/04/21,715,2,0.857920792,3030,715,2,0
50666,2014/03/31,2012/07/13,524,3,0.783438819,3318,524,3,0
50667,2014/03/31,2011/07/31,2,3,0.655255861,3967,2,0,3
50668,2014/03/31,2010/10/08,367,3,0.7666666670000001,3390,367,3,0
50669,2014/03/31,2010/01/23,116,2,1.153528628,2253,116,0,2
50670,2014/03/31,2007/07/11,42,8,0.33811865700000004,7686,42,1,7
50671,2014/03/31,2012/02/27,183,2,0.6257404289999999,4153,183,0,2
50672,2014/03/31,2013/02/06,85,5,0.8060018609999999,3224,85,2,3
50673,2014/03/31,2013/02/22,398,2,0.721176797,3603,398,2,0
50674,2014/03/31,2013/02/22,398,2,0.721176797,3603,398,2,0
50675,2014/03/31,2011/04/24,32,3,0.5982684779999999,4343,32,1,2
50676,2014/03/31,2012/03/25,84,10,0.467545438,5557,84,3,7
50677,2014/03/31,2007/05/20,258,5,0.739974366,3511,258,1,4
50678,2014/03/31,2009/02/17,479,3,0.586455982,4430,479,3,0
50679,2014/03/31,2010/07/17,488,4,0.831546095,3124,488,4,0
50680,2014/03/31,2011/03/31,151,2,0.920496102,2822,151,0,2
50681,2014/03/31,2008/09/21,12,2,0.729845462,3559,12,0,2
50682,2014/03/31,2009/07/25,205,3,0.909177459,2857,205,2,1
50683,2014/03/31,2006/10/30,99,4,0.7269801290000001,3573,99,1,3
50684,2014/03/31,2007/10/23,5,2,0.7011717059999999,3704,5,1,1
50685,2014/03/31,2013/02/01,257,3,0.798113092,3254,257,2,1
50686,2014/03/31,2012/08/24,84,7,0.519070558,5003,84,4,3
50687,2014/03/31,2005/01/29,566,3,0.714081408,3636,566,3,0
50688,2014/03/31,2010/08/02,625,3,0.8614134040000001,3014,625,3,0
50689,2014/03/31,2010/02/03,559,2,0.625,4154,559,2,0
50690,2014/03/31,2012/09/27,546,2,0.625,4154,546,2,0
50691,2014/03/31,2007/04/12,337,2,0.625,4154,337,1,1
50692,2014/03/31,2005/01/27,594,2,0.625,4154,594,2,0
50693,2014/03/31,2009/01/14,598,2,0.625,4154,598,2,0
50694,2014/03/31,2010/11/19,592,2,0.625,4154,592,2,0
50695,2014/03/31,2008/04/10,32,2,0.625,4154,32,0,2
50696,2014/03/31,2008/07/20,520,2,0.625,4154,520,2,0
50697,2014/03/31,2011/11/17,353,2,0.625,4154,353,0,2
50698,2014/03/31,2010/07/10,18,2,0.625,4154,18,0,2
50699,2014/03/31,2007/04/28,50,2,0.700356083,3707,50,0,2
50700,2014/03/31,2005/11/02,257,3,0.978578967,2653,257,0,3
50701,2014/03/31,2013/01/31,295,2,0.665,3904,295,1,1
50702,2014/03/31,2011/09/01,453,6,0.666666667,3894,453,6,0
50703,2014/03/31,2013/03/27,3,4,0.7487481970000001,3467,3,1,3
50704,2014/03/31,2012/06/10,636,2,0.643984123,4031,636,2,0
50705,2014/03/31,2012/11/17,410,3,0.484172729,5361,410,3,0
50706,2014/03/31,2011/11/07,346,4,0.626641719,4142,346,3,1
50707,2014/03/31,2012/04/18,432,4,0.69921875,3712,432,4,0
50708,2014/03/31,2013/03/05,6,3,1.25796413,2063,6,1,2
50709,2014/03/31,2012/04/23,12,2,0.551219201,4708,12,0,2
50710,2014/03/31,2011/06/28,438,3,0.885967907,2929,438,3,0
50711,2014/03/31,2008/12/20,100,4,0.631364964,4110,100,0,4
50712,2014/03/31,2013/02/02,283,4,0.714181118,3633,283,2,2
50713,2014/03/31,2012/05/26,505,2,0.861993355,3010,505,2,0
50714,2014/03/31,2008/04/01,203,2,0.656643888,3951,203,1,1
50715,2014/03/31,2013/03/05,37,4,0.94,2760,37,0,4
50716,2014/03/31,2008/01/18,574,3,0.750043365,3459,574,3,0
50717,2014/03/31,2013/01/15,88,3,0.523322574,4957,88,0,3
50718,2014/03/31,2013/03/08,221,3,0.574656624,4514,221,0,3
50719,2014/03/31,2009/08/02,429,3,0.5464398570000001,4747,429,3,0
50720,2014/03/31,2010/05/18,57,5,0.8959999999999999,2895,57,0,5
50721,2014/03/31,2007/11/30,121,6,0.47625964,5446,121,4,2
50722,2014/03/31,2011/08/19,110,3,0.593496568,4370,110,0,3
50723,2014/03/31,2012/05/29,44,2,0.835,3106,44,1,1
50724,2014/03/31,2011/02/06,193,3,0.639095614,4058,193,1,2
50725,2014/03/31,2010/01/12,142,5,0.8220000000000001,3155,142,2,3
50726,2014/03/31,2010/03/26,212,2,0.643930966,4027,212,0,2
50727,2014/03/31,2010/03/29,188,2,0.643930966,4027,188,0,2
50728,2014/03/31,2008/06/20,595,3,1.0,2593,595,3,0
50729,2014/03/31,2008/10/27,397,3,0.6888815090000001,3764,397,3,0
50730,2014/03/31,2012/09/19,463,3,0.448030067,5787,463,3,0
50731,2014/03/31,2011/11/02,128,3,0.609154135,4256,128,2,1
50732,2014/03/31,2011/09/30,16,2,0.69167556,3748,16,1,1
50733,2014/03/31,2012/08/07,496,4,0.4835291920000001,5361,496,4,0
50734,2014/03/31,2012/11/11,382,3,0.920419034,2816,382,3,0
50735,2014/03/31,2011/06/14,1,6,0.777848139,3332,1,3,3
50736,2014/03/31,2012/02/27,652,2,0.561581798,4615,652,2,0
50737,2014/03/31,2012/04/30,238,3,0.788630554,3286,238,2,1
50738,2014/03/31,2012/09/28,284,4,0.646122195,4010,284,3,1
50739,2014/03/31,2012/10/16,7,2,0.949527126,2728,7,1,1
50740,2014/03/31,2012/12/10,455,2,1.0,2590,455,2,0
50741,2014/03/31,2005/12/21,469,3,0.6166666670000001,4200,469,3,0
50742,2014/03/31,2012/05/18,308,2,0.623621478,4153,308,1,1
50743,2014/03/31,2013/03/14,297,2,0.485361694,5336,297,0,2
50744,2014/03/31,2007/05/24,67,5,0.548914794,4718,67,3,2
50745,2014/03/31,2012/09/26,413,4,0.85639881,3024,413,4,0
50746,2014/03/31,2009/12/08,412,2,0.45,5754,412,2,0
50747,2014/03/31,2010/12/15,242,3,0.86333111,2999,242,0,3
50748,2014/03/31,2012/09/27,542,4,0.6896643579999999,3754,542,4,0
50749,2014/03/31,2008/04/26,291,4,0.585528161,4421,291,1,3
50750,2014/03/31,2010/02/12,231,2,0.808129878,3203,231,1,1
50751,2014/03/31,2010/05/18,10,4,0.389643233,6643,10,0,4
50752,2014/03/31,2011/04/11,106,2,0.895,2892,106,0,2
50753,2014/03/31,2011/08/05,282,3,0.635121472,4075,282,1,2
50754,2014/03/31,2010/06/17,479,4,0.679873883,3806,479,4,0
50755,2014/03/31,2011/07/31,445,3,0.493618848,5242,445,3,0
50756,2014/03/31,2007/10/01,539,4,0.85,3044,539,4,0
50757,2014/03/31,2012/10/03,235,4,0.6175,4188,235,2,2
50758,2014/03/31,2013/01/25,299,4,0.517271454,4999,299,1,3
50759,2014/03/31,2011/03/10,516,2,0.757632581,3413,516,2,0
50760,2014/03/31,2008/04/18,585,4,0.8171934259999999,3164,585,4,0
50761,2014/03/31,2013/02/09,65,2,0.849911243,3042,65,1,1
50762,2014/03/31,2012/04/01,451,4,0.518719904,4984,451,4,0
50763,2014/03/31,2010/03/08,328,3,0.424482759,6090,328,2,1
50764,2014/03/31,2010/03/30,541,3,0.535761658,4825,541,3,0
50765,2014/03/31,2012/03/17,720,3,0.7783197829999999,3321,720,3,0
50766,2014/03/31,2006/10/14,510,3,1.30332829,1983,510,3,0
50767,2014/03/31,2013/02/06,420,2,1.3,1988,420,2,0
50768,2014/03/31,2009/02/13,145,4,0.463980251,5570,145,3,1
50769,2014/03/31,2011/01/14,151,4,0.588196721,4392,151,1,3
50770,2014/03/31,2007/06/22,80,3,0.76,3399,80,0,3
50771,2014/03/31,2011/08/27,258,3,0.983640518,2626,258,2,1
50772,2014/03/31,2012/06/18,647,2,0.45,5740,647,2,0
50773,2014/03/31,2011/07/27,311,4,0.733541607,3521,311,1,3
50774,2014/03/31,2010/04/06,511,3,0.675039205,3826,511,3,0
50775,2014/03/31,2006/12/09,3,5,0.376894337,6852,3,0,5
50776,2014/03/31,2012/08/10,451,2,0.826119642,3126,451,2,0
50777,2014/03/31,2012/12/15,356,2,0.590262857,4375,356,1,1
50778,2014/03/31,2013/01/10,225,2,0.759059377,3402,225,1,1
50779,2014/03/31,2012/05/01,533,2,1.0,2582,533,2,0
50780,2014/03/31,2012/05/01,540,2,1.0,2582,540,2,0
50781,2014/03/31,2012/05/01,337,2,1.0,2582,337,1,1
50782,2014/03/31,2012/07/28,152,3,0.941159315,2743,152,1,2
50783,2014/03/31,2008/11/28,244,2,0.793495235,3253,244,1,1
50784,2014/03/31,2010/11/10,164,9,0.494444444,5220,164,3,6
50785,2014/03/31,2012/06/21,645,2,0.55,4692,645,2,0
50786,2014/03/31,2012/10/17,520,2,0.55,4692,520,2,0
50787,2014/03/31,2010/07/25,550,2,0.55,4692,550,2,0
50788,2014/03/31,2011/07/15,226,4,0.65,3970,226,0,4
50789,2014/03/31,2012/10/31,328,4,0.65,3970,328,2,2
50790,2014/03/31,2012/10/18,269,3,0.646514658,3991,269,2,1
50791,2014/03/31,2012/11/11,31,10,0.381796389,6758,31,0,10
50792,2014/03/31,2013/02/08,401,2,1.0,2580,401,2,0
50793,2014/03/31,2007/01/03,397,2,0.75,3440,397,2,0
50794,2014/03/31,2008/03/12,25,3,0.852177073,3027,25,0,3
50795,2014/03/31,2008/02/19,69,6,0.655668531,3934,69,4,2
50796,2014/03/31,2007/03/05,46,4,0.7787137679999999,3312,46,2,2
50797,2014/03/31,2011/07/23,542,2,1.0,2579,542,2,0
50798,2014/03/31,2009/09/27,390,2,1.0,2579,390,2,0
50799,2014/03/31,2009/07/03,485,3,0.530440148,4862,485,3,0
50800,2014/03/31,2006/11/14,20,4,0.495825803,5201,20,1,3
50801,2014/03/31,2011/10/21,76,3,0.7043813170000001,3661,76,2,1
50802,2014/03/31,2011/06/09,355,2,0.675,3820,355,1,1
50803,2014/03/31,2005/12/20,340,4,0.895865184,2878,340,3,1
50804,2014/03/31,2006/11/17,27,3,1.217879074,2117,27,2,1
50805,2014/03/31,2013/03/06,144,4,0.5543367020000001,4651,144,1,3
50806,2014/03/31,2005/09/07,135,2,0.926370823,2783,135,0,2
50807,2014/03/31,2006/09/01,431,5,0.531854756,4847,431,5,0
50808,2014/03/31,2011/02/24,401,4,0.924605452,2788,401,4,0
50809,2014/03/31,2008/07/05,267,3,0.7563732390000001,3408,267,1,2
50810,2014/03/31,2010/03/19,5,3,0.590270208,4367,5,2,1
50811,2014/03/31,2011/04/26,301,4,0.353932445,7283,301,2,2
50812,2014/03/31,2011/10/15,171,3,0.6150465279999999,4191,171,2,1
50813,2014/03/31,2008/06/30,81,3,0.505709241,5097,81,2,1
50814,2014/03/31,2012/09/16,436,4,0.6,4296,436,4,0
50815,2014/03/31,2012/10/30,61,3,0.8153685540000001,3161,61,2,1
50816,2014/03/31,2009/04/06,259,2,0.717325355,3593,259,1,1
50817,2014/03/31,2012/04/06,77,5,0.479179993,5378,77,0,5
50818,2014/03/31,2010/04/07,65,4,0.5763855960000001,4471,65,1,3
50819,2014/03/31,2013/03/19,48,4,0.4925,5232,48,0,4
50820,2014/03/31,2012/07/14,131,4,0.666171148,3868,131,1,3
50821,2014/03/31,2012/03/01,339,3,0.621041215,4149,339,2,1
50822,2014/03/31,2009/11/22,577,6,0.7416666670000001,3474,577,6,0
50823,2014/03/31,2010/12/06,146,4,0.499806014,5155,146,2,2
50824,2014/03/31,2006/12/22,23,5,0.528709214,4873,23,0,5
50825,2014/03/31,2009/06/05,46,6,0.672760512,3829,46,4,2
50826,2014/03/31,2010/04/22,344,3,0.7824119079999999,3292,344,1,2
50827,2014/03/31,2012/12/20,451,2,0.659746414,3904,451,2,0
50828,2014/03/31,2010/01/01,411,5,0.47,5480,411,5,0
50829,2014/03/31,2007/07/31,252,3,0.67423822,3820,252,1,2
50830,2014/03/31,2011/11/25,109,3,0.539137534,4777,109,0,3
50831,2014/03/31,2012/12/08,123,4,0.498139265,5170,123,0,4
50832,2014/03/31,2011/01/16,302,4,0.634928501,4056,302,2,2
50833,2014/03/31,2012/08/09,600,2,0.6131190479999999,4200,600,2,0
50834,2014/03/31,2013/03/29,221,3,0.92,2799,221,0,3
50835,2014/03/31,2009/10/04,190,3,0.92,2799,190,0,3
50836,2014/03/31,2006/09/15,188,3,0.92,2799,188,0,3
50837,2014/03/31,2010/01/29,392,3,0.71542095,3599,392,3,0
50838,2014/03/31,2009/03/21,529,2,0.8,3218,529,2,0
50839,2014/03/31,2011/08/16,551,3,0.585867091,4394,551,3,0
50840,2014/03/31,2013/01/01,400,2,0.832013575,3094,400,2,0
50841,2014/03/31,2013/03/15,143,2,0.555573063,4633,143,0,2
50842,2014/03/31,2012/03/17,433,2,0.6,4289,433,2,0
50843,2014/03/31,2011/04/09,4,5,0.676132422,3806,4,2,3
50844,2014/03/31,2006/06/07,16,4,0.595762908,4319,16,2,2
50845,2014/03/31,2010/03/16,415,2,0.667990654,3852,415,2,0
50846,2014/03/31,2012/09/21,488,3,1.0,2573,488,3,0
50847,2014/03/31,2005/01/03,347,4,0.8391715590000001,3066,347,3,1
50848,2014/03/31,2008/09/28,387,3,0.665296095,3867,387,3,0
50849,2014/03/31,2010/02/24,516,2,0.478365563,5378,516,2,0
50850,2014/03/31,2010/01/08,466,4,0.870003382,2957,466,4,0
50851,2014/03/31,2010/11/18,25,2,0.8541002659999999,3012,25,1,1
50852,2014/03/31,2006/09/04,463,5,0.59,4360,463,5,0
50853,2014/03/31,2012/05/25,516,3,0.966666667,2661,516,3,0
50854,2014/03/31,2008/01/20,261,4,0.414518936,6205,261,1,3
50855,2014/03/31,2011/11/27,686,2,1.0,2572,686,2,0
50856,2014/03/31,2007/05/21,556,3,0.666666667,3858,556,3,0
50857,2014/03/31,2010/06/07,93,5,0.806690715,3188,93,4,1
50858,2014/03/31,2012/07/25,206,3,0.768816143,3345,206,1,2
50859,2014/03/31,2012/08/19,44,6,0.554000431,4642,44,0,6
50860,2014/03/31,2010/04/19,99,8,0.8192194970000001,3139,99,5,3
50861,2014/03/31,2012/06/26,171,3,0.6166666670000001,4170,171,1,2
50862,2014/03/31,2012/11/20,403,2,0.695616883,3696,403,2,0
50863,2014/03/31,2013/02/05,29,5,0.827806763,3105,29,0,5
50864,2014/03/31,2012/06/23,256,2,0.659479086,3897,256,0,2
50865,2014/03/31,2013/02/04,189,2,0.775581044,3313,189,1,1
50866,2014/03/31,2008/10/21,554,3,0.641868599,4003,554,3,0
50867,2014/03/31,2010/08/10,48,7,0.632857143,4060,48,3,4
50868,2014/03/31,2011/04/05,446,5,0.7920468559999999,3244,446,5,0
50869,2014/03/31,2007/11/16,94,3,0.763056133,3367,94,1,2
50870,2014/03/31,2009/12/02,449,3,0.410091011,6263,449,3,0
50871,2014/03/31,2010/02/17,469,2,0.686260358,3741,469,2,0
50872,2014/03/31,2012/05/27,159,5,0.39297107,6533,159,2,3
50873,2014/03/31,2008/03/03,83,3,1.24,2070,83,0,3
50874,2014/03/31,2012/05/01,177,3,0.6199275360000001,4140,177,1,2
50875,2014/03/31,2011/10/17,693,2,0.712902778,3600,693,2,0
50876,2014/03/31,2012/10/11,255,4,0.522166836,4915,255,2,2
50877,2014/03/31,2012/08/23,552,2,0.476960967,5380,552,2,0
50878,2014/03/31,2012/07/09,263,2,0.517657858,4957,263,1,1
50879,2014/03/31,2012/08/14,9,4,0.653399542,3927,9,0,4
50880,2014/03/31,2012/08/14,208,2,0.740692841,3464,208,1,1
50881,2014/03/31,2006/10/22,16,3,0.916666667,2799,16,0,3
50882,2014/03/31,2012/09/04,116,2,0.53,4840,116,0,2
50883,2014/03/31,2008/06/28,530,3,0.626986067,4091,530,3,0
50884,2014/03/31,2011/08/12,145,2,0.57,4500,145,0,2
50885,2014/03/31,2012/10/11,3,5,0.475346553,5396,3,1,4
50886,2014/03/31,2005/04/10,98,5,0.551235762,4653,98,0,5
50887,2014/03/31,2012/08/07,163,5,0.468,5480,163,1,4
50888,2014/03/31,2010/02/20,704,2,0.9449521,2714,704,2,0
50889,2014/03/31,2012/04/04,129,3,0.46065026,5567,129,2,1
50890,2014/03/31,2008/02/15,134,4,0.950719318,2697,134,3,1
50891,2014/03/31,2013/03/21,17,4,0.5750280329999999,4459,17,0,4
50892,2014/03/31,2012/04/14,716,2,0.775,3308,716,2,0
50893,2014/03/31,2012/12/26,122,3,0.653333333,3924,122,1,2
50894,2014/03/31,2008/08/21,63,3,0.653333333,3924,63,2,1
50895,2014/03/31,2008/02/20,68,3,0.570710151,4492,68,1,2
50896,2014/03/31,2007/11/26,25,4,0.53597742,4783,25,3,1
50897,2014/03/31,2012/03/15,227,2,0.916371112,2797,227,1,1
50898,2014/03/31,2013/01/19,187,3,0.836455614,3064,187,0,3
50899,2014/03/31,2012/03/12,13,3,0.726403061,3528,13,0,3
50900,2014/03/31,2006/05/11,602,4,0.889208883,2882,602,4,0
50901,2014/03/31,2007/06/29,90,2,0.755,3394,90,0,2
50902,2014/03/31,2008/07/30,240,6,0.933442623,2745,240,4,2
50903,2014/03/31,2012/02/24,40,4,0.385392599,6648,40,3,1
50904,2014/03/31,2012/09/26,162,3,0.6770348840000001,3784,162,1,2
50905,2014/03/31,2010/05/27,512,3,0.967314955,2648,512,3,0
50906,2014/03/31,2011/10/07,291,2,0.796684292,3215,291,0,2
50907,2014/03/31,2008/04/26,85,2,0.838932198,3053,85,1,1
50908,2014/03/31,2012/10/23,419,3,0.716806605,3573,419,3,0
50909,2014/03/31,2011/04/12,442,4,0.7579313409999999,3379,442,4,0
50910,2014/03/31,2011/09/19,201,2,0.781981679,3275,201,1,1
50911,2014/03/31,2012/09/14,294,2,0.781981679,3275,294,1,1
50912,2014/03/31,2007/04/25,653,2,0.6,4268,653,2,0
50913,2014/03/31,2008/05/13,45,3,0.609961887,4198,45,1,2
50914,2014/03/31,2013/03/06,16,5,1.24,2065,16,1,4
50915,2014/03/31,2011/10/13,315,3,0.661444071,3871,315,0,3
50916,2014/03/31,2012/10/27,69,6,0.5374391270000001,4764,69,2,4
50917,2014/03/31,2009/09/05,211,2,0.8544908179999999,2995,211,0,2
50918,2014/03/31,2009/04/11,258,5,0.884,2895,258,4,1
50919,2014/03/31,2012/09/03,467,4,0.76002376,3367,467,4,0
50920,2014/03/31,2009/10/01,400,3,0.92796518,2757,400,3,0
50921,2014/03/31,2006/07/27,222,3,0.83380704,3068,222,0,3
50922,2014/03/31,2012/03/24,715,2,0.6606663220000001,3872,715,2,0
50923,2014/03/31,2011/08/15,29,4,0.373258427,6853,29,0,4
50924,2014/03/31,2012/10/01,481,2,0.45,5684,481,2,0
50925,2014/03/31,2013/01/04,450,2,0.45,5684,450,2,0
50926,2014/03/31,2010/01/05,43,2,0.858885158,2978,43,0,2
50927,2014/03/31,2008/09/24,358,2,0.619910325,4126,358,1,1
50928,2014/03/31,2006/09/13,575,2,0.8,3197,575,2,0
50929,2014/03/31,2011/05/18,348,2,0.39129437,6536,348,1,1
50930,2014/03/31,2012/02/22,466,3,0.524057377,4880,466,3,0
50931,2014/03/31,2008/04/26,23,2,0.65,3934,23,0,2
50932,2014/03/31,2011/11/12,696,2,0.65,3934,696,2,0
50933,2014/03/31,2009/09/13,583,2,0.65,3934,583,2,0
50934,2014/03/31,2009/10/20,641,3,0.433333333,5901,641,3,0
50935,2014/03/31,2005/05/26,637,2,0.65,3934,637,2,0
50936,2014/03/31,2012/07/22,611,2,0.65,3934,611,2,0
50937,2014/03/31,2013/01/18,425,2,0.65,3934,425,2,0
50938,2014/03/31,2011/07/31,611,2,0.65,3934,611,2,0
50939,2014/03/31,2012/05/29,543,2,0.65,3934,543,2,0
50940,2014/03/31,2007/10/26,696,2,0.65,3934,696,2,0
50941,2014/03/31,2010/01/12,588,2,0.65,3934,588,2,0
50942,2014/03/31,2012/11/13,291,2,0.35,7306,291,1,1
50943,2014/03/31,2006/05/26,583,2,0.65,3934,583,2,0
50944,2014/03/31,2006/09/19,502,2,0.65,3934,502,2,0
50945,2014/03/31,2008/02/21,608,2,0.65,3934,608,2,0
50946,2014/03/31,2008/08/07,604,2,0.65,3934,604,2,0
50947,2014/03/31,2012/09/13,369,2,0.65,3934,369,2,0
50948,2014/03/31,2005/01/13,700,2,0.65,3934,700,2,0
50949,2014/03/31,2009/02/17,587,2,0.65,3934,587,2,0
50950,2014/03/31,2012/08/22,585,2,0.65,3934,585,2,0
50951,2014/03/31,2007/03/09,646,2,0.65,3934,646,2,0
50952,2014/03/31,2012/01/06,721,2,0.65,3934,721,2,0
50953,2014/03/31,2013/01/28,161,4,0.727669323,3514,161,0,4
50954,2014/03/31,2012/10/27,506,3,0.5775417979999999,4426,506,3,0
50955,2014/03/31,2013/01/25,345,2,0.862415655,2964,345,0,2
50956,2014/03/31,2010/04/19,463,3,0.850332668,3006,463,3,0
50957,2014/03/31,2006/12/30,83,4,0.492098575,5194,83,0,4
50958,2014/03/31,2012/10/02,282,4,0.7031361759999999,3635,282,3,1
50959,2014/03/31,2012/11/13,231,4,0.541013971,4724,231,2,2
50960,2014/03/31,2006/07/05,606,2,0.959707097,2663,606,2,0
50961,2014/03/31,2008/09/27,52,4,0.580674847,4401,52,2,2
50962,2014/03/31,2012/02/21,16,4,0.744615385,3432,16,0,4
50963,2014/03/31,2012/10/25,203,2,0.7855886870000001,3253,203,0,2
50964,2014/03/31,2012/09/19,558,2,0.634591507,4027,558,2,0
50965,2014/03/31,2010/04/07,4,4,0.444813719,5744,4,2,2
50966,2014/03/31,2012/03/15,273,2,0.875,2920,273,1,1
50967,2014/03/31,2005/10/13,27,3,0.489771856,5216,27,2,1
50968,2014/03/31,2012/06/10,631,2,0.663110073,3852,631,2,0
50969,2014/03/31,2010/12/29,165,2,0.55,4644,165,0,2
50970,2014/03/31,2012/03/18,229,2,0.881322057,2897,229,0,2
50971,2014/03/31,2007/10/08,580,2,0.739814547,3451,580,2,0
50972,2014/03/31,2012/04/01,9,3,0.6927706920000001,3685,9,2,1
50973,2014/03/31,2012/06/07,77,4,0.6837101529999999,3733,77,1,3
50974,2014/03/31,2007/04/05,458,5,0.543147478,4699,458,5,0
50975,2014/03/31,2012/11/06,284,2,0.74948605,3405,284,1,1
50976,2014/03/31,2012/02/27,291,2,0.845019868,3020,291,0,2
50977,2014/03/31,2010/12/01,522,2,0.591550765,4314,522,2,0
50978,2014/03/31,2012/05/20,579,3,0.543756659,4693,579,3,0
50979,2014/03/31,2008/04/06,51,2,0.838819855,3042,51,1,1
50980,2014/03/31,2008/11/08,257,4,0.71431131,3572,257,2,2
50981,2014/03/31,2012/06/25,6,4,0.835960026,3052,6,1,3
50982,2014/03/31,2012/12/27,337,3,0.971069661,2627,337,2,1
50983,2014/03/31,2011/06/01,180,3,0.538597973,4736,180,1,2
50984,2014/03/31,2012/01/10,192,3,0.637645,4000,192,0,3
50985,2014/03/31,2007/05/07,221,2,0.819855352,3111,221,0,2
50986,2014/03/31,2008/09/10,39,5,0.5744920029999999,4439,39,1,4
50987,2014/03/31,2011/06/15,423,3,0.7047954670000001,3618,423,3,0
50988,2014/03/31,2009/09/04,561,2,0.609380975,4184,561,2,0
50989,2014/03/31,2012/09/01,319,2,0.945974026,2695,319,1,1
50990,2014/03/31,2006/09/07,189,4,0.612829327,4160,189,1,3
50991,2014/03/31,2012/07/07,109,3,0.68780626,3706,109,1,2
50992,2014/03/31,2011/12/04,142,4,0.420070864,6068,142,2,2
50993,2014/03/31,2010/09/27,148,2,0.6412100629999999,3975,148,1,1
50994,2014/03/31,2008/12/10,290,2,0.625,4078,290,0,2
50995,2014/03/31,2010/01/01,372,3,0.878221916,2902,372,3,0
50996,2014/03/31,2010/08/15,384,2,1.0,2548,384,2,0
50997,2014/03/31,2008/12/05,41,4,0.614121475,4149,41,0,4
50998,2014/03/31,2012/10/18,424,3,0.5747349420000001,4433,424,3,0
50999,2014/03/31,2012/04/27,477,6,0.7333333329999999,3474,477,6,0
51000,2014/03/31,2012/07/01,1,2,0.675,3774,1,0,2
51001,2014/03/31,2007/01/07,197,2,0.600235627,4244,197,0,2
51002,2014/03/31,2013/03/01,102,3,0.633186677,4023,102,0,3
51003,2014/03/31,2010/11/17,467,3,0.6774468090000001,3760,467,3,0
51004,2014/03/31,2011/02/21,6,2,0.960452489,2652,6,0,2
51005,2014/03/31,2011/02/19,49,2,0.82,3106,49,0,2
51006,2014/03/31,2012/12/03,469,2,0.629760138,4044,469,2,0
51007,2014/03/31,2010/01/23,367,8,0.6871019970000001,3706,367,8,0
51008,2014/03/31,2010/10/10,473,3,0.6981897970000001,3646,473,3,0
51009,2014/03/31,2012/11/12,130,4,0.375,6788,130,3,1
51010,2014/03/31,2010/09/08,557,2,0.694164167,3667,557,2,0
51011,2014/03/31,2010/08/26,468,4,0.616396222,4129,468,4,0
51012,2014/03/31,2012/07/21,245,2,0.81,3142,245,0,2
51013,2014/03/31,2011/07/09,20,2,0.8244217690000001,3087,20,0,2
51014,2014/03/31,2012/12/29,345,3,0.8442767090000001,3014,345,1,2
51015,2014/03/31,2013/02/27,107,4,0.614249155,4142,107,1,3
51016,2014/03/31,2012/05/28,673,2,0.95,2678,673,2,0
51017,2014/03/31,2007/07/21,480,4,0.5640798229999999,4510,480,4,0
51018,2014/03/31,2012/10/16,467,3,0.916666667,2775,467,3,0
51019,2014/03/31,2009/09/09,236,5,0.396430798,6416,236,0,5
51020,2014/03/31,2009/03/08,357,4,0.975115031,2608,357,0,4
51021,2014/03/31,2011/03/01,541,2,1.05,2422,541,2,0
51022,2014/03/31,2008/11/17,11,2,0.51,4986,11,0,2
51023,2014/03/31,2011/02/20,128,7,0.561193997,4531,128,0,7
51024,2014/03/31,2012/09/09,207,4,0.598695243,4246,207,3,1
51025,2014/03/31,2013/03/05,143,7,0.410615509,6190,143,0,7
51026,2014/03/31,2011/08/23,647,3,0.888050314,2862,647,3,0
51027,2014/03/31,2011/05/01,617,2,0.772757677,3289,617,2,0
51028,2014/03/31,2013/03/28,221,3,0.879387331,2889,221,0,3
51029,2014/03/31,2011/12/09,525,2,0.457052897,5558,525,2,0
51030,2014/03/31,2009/09/17,33,3,0.756610069,3357,33,0,3
51031,2014/03/31,2012/03/18,655,2,0.9,2822,655,2,0
51032,2014/03/31,2008/11/03,258,3,0.3,8466,258,2,1
51033,2014/03/31,2010/07/19,78,3,0.8448502990000001,3006,78,0,3
51034,2014/03/31,2007/01/14,165,5,0.543773019,4670,165,2,3
51035,2014/03/31,2012/11/17,86,3,0.432825976,5867,86,1,2
51036,2014/03/31,2012/01/12,296,2,0.71691135,3542,296,0,2
51037,2014/03/31,2009/03/18,308,5,0.584888275,4341,308,4,1
51038,2014/03/31,2011/08/22,133,4,0.6134187,4139,133,1,3
51039,2014/03/31,2012/02/23,219,3,0.8032046820000001,3161,219,0,3
51040,2014/03/31,2012/05/30,604,3,0.45,5642,604,3,0
51041,2014/03/31,2012/05/13,364,3,0.5352941179999999,4743,364,2,1
51042,2014/03/31,2013/03/25,212,5,0.704026622,3606,212,1,4
51043,2014/03/31,2008/04/09,93,4,0.549026817,4624,93,0,4
51044,2014/03/31,2005/06/18,119,5,0.468685377,5416,119,3,2
51045,2014/03/31,2013/03/10,385,2,0.475,5344,385,2,0
51046,2014/03/31,2009/09/14,90,2,0.627616222,4044,90,0,2
51047,2014/03/31,2012/07/21,121,4,0.487529773,5206,121,2,2
51048,2014/03/31,2011/10/07,698,4,0.589969781,4302,698,4,0
51049,2014/03/31,2012/02/10,244,3,0.906666667,2799,244,2,1
51050,2014/03/31,2012/11/28,111,3,0.746382353,3400,111,1,2
51051,2014/03/31,2011/09/19,633,2,0.600911674,4223,633,2,0
51052,2014/03/31,2011/03/16,152,5,0.480155156,5285,152,2,3
51053,2014/03/31,2010/10/28,173,2,0.65,3904,173,0,2
51054,2014/03/31,2012/08/19,236,3,0.946865672,2680,236,2,1
51055,2014/03/31,2012/10/02,16,4,0.416464796,6093,16,0,4
51056,2014/03/31,2008/02/27,203,2,0.761323132,3333,203,0,2
51057,2014/03/31,2009/12/29,154,2,0.624189422,4065,154,0,2
51058,2014/03/31,2010/11/17,522,3,0.577378243,4394,522,3,0
51059,2014/03/31,2011/05/08,166,3,0.7393471290000001,3431,166,1,2
51060,2014/03/31,2012/03/01,373,5,0.42653885,5946,373,5,0
51061,2014/03/31,2008/11/18,482,4,1.0,2536,482,4,0
51062,2014/03/31,2010/04/08,205,3,0.6533960320000001,3881,205,1,2
51063,2014/03/31,2012/06/16,290,3,0.794669383,3191,290,2,1
51064,2014/03/31,2010/09/01,526,2,0.758874588,3341,526,2,0
51065,2014/03/31,2013/02/12,79,5,0.67157351,3775,79,0,5
51066,2014/03/31,2008/03/31,376,2,0.69124625,3667,376,2,0
51067,2014/03/31,2012/03/09,208,4,0.652582389,3884,208,2,2
51068,2014/03/31,2011/08/06,45,8,0.54625,4640,45,2,6
51069,2014/03/31,2007/11/08,76,3,0.634758327,3993,76,0,3
51070,2014/03/31,2009/01/25,499,4,0.404259052,6269,499,4,0
51071,2014/03/31,2006/11/22,195,2,0.55450547,4570,195,1,1
51072,2014/03/31,2007/03/29,263,2,0.61,4154,263,1,1
51073,2014/03/31,2006/08/09,263,2,0.61,4154,263,1,1
51074,2014/03/31,2012/03/21,51,6,0.48338802,5242,51,4,2
51075,2014/03/31,2012/04/21,448,6,0.407887959,6212,448,6,0
51076,2014/03/31,2008/03/21,101,3,0.576636322,4394,101,0,3
51077,2014/03/31,2013/01/28,116,3,0.755651655,3353,116,2,1
51078,2014/03/31,2011/03/02,41,3,0.803135701,3154,41,2,1
51079,2014/03/31,2012/12/07,230,2,0.81132287,3122,230,1,1
51080,2014/03/31,2013/03/16,225,3,0.915014451,2768,225,0,3
51081,2014/03/31,2009/12/04,300,2,0.395,6412,300,1,1
51082,2014/03/31,2012/08/07,328,2,0.425352704,5954,328,1,1
51083,2014/03/31,2012/12/27,212,4,0.6533591329999999,3876,212,1,3
51084,2014/03/31,2008/06/26,541,4,0.512082912,4945,541,4,0
51085,2014/03/31,2009/02/07,195,3,0.85,2979,195,1,2
51086,2014/03/31,2011/01/14,45,3,0.6434917410000001,3935,45,2,1
51087,2014/03/31,2012/08/23,69,2,1.055,2400,69,1,1
51088,2014/03/31,2012/05/22,492,3,1.0,2532,492,3,0
51089,2014/03/31,2012/12/13,99,2,0.6377733,3970,99,0,2
51090,2014/03/31,2009/12/07,250,4,0.668560866,3787,250,3,1
51091,2014/03/31,2009/12/29,171,2,0.33,7672,171,0,2
51092,2014/03/31,2012/10/28,35,3,0.8161702129999999,3102,35,1,2
51093,2014/03/31,2011/11/02,368,3,0.641911765,3944,368,3,0
51094,2014/03/31,2011/10/08,58,4,0.725,3492,58,2,2
51095,2014/03/31,2011/09/17,434,3,0.964457143,2625,434,3,0
51096,2014/03/31,2012/07/17,350,3,0.7299596309999999,3468,350,1,2
51097,2014/03/31,2013/02/19,239,3,0.560433916,4517,239,1,2
51098,2014/03/31,2013/02/05,22,5,0.392455814,6450,22,1,4
51099,2014/03/31,2012/06/08,638,3,0.42379039,5973,638,3,0
51100,2014/03/31,2007/10/07,333,2,0.838357072,3019,333,1,1
51101,2014/03/31,2011/06/29,400,3,0.6948929159999999,3642,400,3,0
51102,2014/03/31,2005/03/26,168,3,0.6035296920000001,4193,168,2,1
51103,2014/03/31,2012/02/06,381,5,0.644233707,3928,381,5,0
51104,2014/03/31,2007/04/01,567,2,0.875,2892,567,2,0
51105,2014/03/31,2013/03/07,38,2,0.875,2892,38,0,2
51106,2014/03/31,2012/11/14,502,2,0.875,2892,502,2,0
51107,2014/03/31,2012/06/29,638,2,0.875,2892,638,2,0
51108,2014/03/31,2007/05/21,74,2,0.875,2892,74,0,2
51109,2014/03/31,2006/05/06,209,2,0.6620512820000001,3822,209,0,2
51110,2014/03/31,2012/11/21,381,3,0.390824838,6474,381,3,0
51111,2014/03/31,2011/08/01,12,3,0.60776123,4163,12,2,1
51112,2014/03/31,2010/12/02,24,3,0.618138285,4093,24,2,1
51113,2014/03/31,2012/12/19,226,4,0.695,3640,226,1,3
51114,2014/03/31,2012/11/11,261,3,0.8799234779999999,2875,261,1,2
51115,2014/03/31,2013/03/01,339,2,0.713409475,3546,339,1,1
51116,2014/03/31,2009/09/24,604,3,0.71016283,3562,604,3,0
51117,2014/03/31,2010/11/17,37,5,0.471929104,5360,37,2,3
51118,2014/03/31,2012/08/31,550,2,0.7137133179999999,3544,550,2,0
51119,2014/03/31,2012/03/20,6,5,0.4320000000000001,5855,6,3,2
51120,2014/03/31,2013/03/11,208,5,0.4320000000000001,5855,208,0,5
51121,2014/03/31,2011/01/15,180,3,0.6811904120000001,3713,180,1,2
51122,2014/03/31,2010/04/29,9,6,0.607468172,4163,9,1,5
51123,2014/03/31,2010/10/16,300,3,0.613200776,4124,300,2,1
51124,2014/03/31,2013/03/21,60,2,0.960992018,2631,60,1,1
51125,2014/03/31,2012/07/21,338,4,0.6102582670000001,4143,338,2,2
51126,2014/03/31,2011/08/09,156,3,0.92,2748,156,0,3
51127,2014/03/31,2008/05/18,447,3,0.832159315,3038,447,3,0
51128,2014/03/31,2012/03/19,197,2,0.889640971,2841,197,0,2
51129,2014/03/31,2012/04/25,102,3,0.8286557379999999,3050,102,2,1
51130,2014/03/31,2012/11/19,205,4,0.448095745,5640,205,2,2
51131,2014/03/31,2012/02/17,35,6,0.726624497,3478,35,3,3
51132,2014/03/31,2013/03/10,339,3,0.561101243,4504,339,1,2
51133,2014/03/31,2011/02/15,238,4,0.510743735,4948,238,2,2
51134,2014/03/31,2011/09/29,178,3,0.706666667,3576,178,1,2
51135,2014/03/31,2010/02/21,514,2,0.656875487,3847,514,2,0
51136,2014/03/31,2012/12/12,275,2,0.575318761,4392,275,1,1
51137,2014/03/31,2010/12/06,113,3,0.684167344,3693,113,1,2
51138,2014/03/31,2012/03/03,361,2,0.735117835,3437,361,1,1
51139,2014/03/31,2013/02/28,224,4,0.700016625,3609,224,1,3
51140,2014/03/31,2013/01/23,428,3,0.840352628,3006,428,3,0
51141,2014/03/31,2012/04/23,302,3,0.7051647120000001,3582,302,0,3
51142,2014/03/31,2011/08/15,593,3,0.892438163,2830,593,3,0
51143,2014/03/31,2011/01/24,437,3,0.907147989,2784,437,3,0
51144,2014/03/31,2011/01/26,235,3,0.62838517,4019,235,2,1
51145,2014/03/31,2008/06/25,84,2,0.818049887,3087,84,0,2
51146,2014/03/31,2012/10/02,336,3,0.609804395,4141,336,2,1
51147,2014/03/31,2011/09/19,48,3,0.687837102,3671,48,1,2
51148,2014/03/31,2012/07/14,512,2,1.25,2020,512,2,0
51149,2014/03/31,2012/04/05,616,3,0.833333333,3030,616,3,0
51150,2014/03/31,2010/12/12,589,4,0.975241406,2589,589,4,0
51151,2014/03/31,2012/03/12,226,2,1.46109375,1728,226,0,2
51152,2014/03/31,2013/03/01,140,6,0.423937867,5955,140,0,6
51153,2014/03/31,2013/01/21,195,3,0.92,2744,195,0,3
51154,2014/03/31,2009/10/22,496,3,0.602338344,4191,496,3,0
51155,2014/03/31,2011/09/10,537,3,0.591690108,4266,537,3,0
51156,2014/03/31,2008/07/11,169,6,0.323995378,7789,169,5,1
51157,2014/03/31,2010/04/30,112,6,0.445982679,5658,112,5,1
51158,2014/03/31,2012/12/26,183,3,0.463827206,5440,183,2,1
51159,2014/03/31,2010/08/03,398,3,0.951074256,2653,398,3,0
51160,2014/03/31,2008/01/01,420,5,0.87,2900,420,5,0
51161,2014/03/31,2008/05/17,26,8,0.617172211,4088,26,6,2
51162,2014/03/31,2012/11/14,30,6,0.604543494,4173,30,1,5
51163,2014/03/31,2007/02/20,82,5,0.646912029,3899,82,4,1
51164,2014/03/31,2006/06/29,223,4,0.680186084,3708,223,3,1
51165,2014/03/31,2009/10/21,103,2,0.82936534,3041,103,0,2
51166,2014/03/31,2011/02/04,164,4,0.663657895,3800,164,2,2
51167,2014/03/31,2012/09/02,530,3,0.613403065,4111,530,3,0
51168,2014/03/31,2012/03/08,170,3,0.5999072089999999,4203,170,0,3
51169,2014/03/31,2007/03/31,102,2,0.730150594,3453,102,0,2
51170,2014/03/31,2008/09/19,661,4,0.557149171,4525,661,4,0
51171,2014/03/31,2011/07/26,547,2,0.65,3878,547,2,0
51172,2014/03/31,2009/07/03,263,3,0.825096563,3055,263,2,1
51173,2014/03/31,2012/12/11,41,5,0.781544186,3225,41,3,2
51174,2014/03/31,2011/07/09,608,2,0.675,3734,608,2,0
51175,2014/03/31,2009/03/14,413,4,0.664636076,3792,413,4,0
51176,2014/03/31,2010/10/18,86,3,0.5553768179999999,4538,86,1,2
51177,2014/03/31,2012/12/30,35,2,0.543283035,4639,35,1,1
51178,2014/03/31,2012/09/25,425,2,0.9,2800,425,2,0
51179,2014/03/31,2010/01/12,9,3,0.7612145020000001,3310,9,0,3
51180,2014/03/31,2011/07/23,14,2,1.439777143,1750,14,1,1
51181,2014/03/31,2008/11/04,5,4,0.371941246,6774,5,0,4
51182,2014/03/31,2012/07/15,252,2,0.39,6460,252,1,1
51183,2014/03/31,2006/02/07,611,3,0.9,2799,611,3,0
51184,2014/03/31,2005/06/22,256,4,0.71,3548,256,2,2
51185,2014/03/31,2006/08/20,337,3,0.790986181,3184,337,2,1
51186,2014/03/31,2012/09/16,525,3,1.3460716190000002,1871,525,3,0
51187,2014/03/31,2010/06/17,677,2,0.8,3148,677,2,0
51188,2014/03/31,2012/12/30,453,2,0.8,3148,453,2,0
51189,2014/03/31,2011/05/09,214,3,0.783559428,3214,214,2,1
51190,2014/03/31,2008/04/09,55,3,0.73948605,3405,55,1,2
51191,2014/03/31,2010/12/20,40,5,0.593254006,4244,40,0,5
51192,2014/03/31,2012/07/16,298,2,0.64,3934,298,0,2
51193,2014/03/31,2011/04/14,332,2,0.6,4196,332,0,2
51194,2014/03/31,2011/05/26,527,3,0.838640906,3002,527,3,0
51195,2014/03/31,2013/01/16,438,2,0.6,4196,438,2,0
51196,2014/03/31,2008/09/06,469,2,0.6,4196,469,2,0
51197,2014/03/31,2007/11/21,10,3,0.48887551,5149,10,0,3
51198,2014/03/31,2012/03/19,493,2,0.910379747,2765,493,2,0
51199,2014/03/31,2011/06/28,665,3,1.0,2517,665,3,0
51200,2014/03/31,2011/05/28,96,3,0.379287221,6636,96,0,3
51201,2014/03/31,2006/12/24,494,3,0.8648109970000001,2910,494,3,0
51202,2014/03/31,2012/10/06,355,2,0.547855432,4593,355,0,2
51203,2014/03/31,2008/02/21,256,2,0.758453422,3317,256,1,1
51204,2014/03/31,2006/10/06,37,2,0.842696817,2985,37,0,2
51205,2014/03/31,2010/03/01,3,4,0.6352816370000001,3959,3,3,1
51206,2014/03/31,2008/07/27,709,2,1.0,2515,709,2,0
51207,2014/03/31,2012/05/07,35,3,0.83,3030,35,0,3
51208,2014/03/31,2009/04/04,45,5,0.958,2625,45,2,3
51209,2014/03/31,2009/11/30,127,2,0.44,5715,127,0,2
51210,2014/03/31,2011/02/01,527,3,0.681553266,3689,527,3,0
51211,2014/03/31,2012/10/15,190,2,1.317610063,1908,190,1,1
51212,2014/03/31,2005/07/20,594,3,0.745964392,3370,594,3,0
51213,2014/03/31,2013/01/24,363,4,0.771042945,3260,363,3,1
51214,2014/03/31,2011/07/31,635,2,0.8,3142,635,2,0
51215,2014/03/31,2011/01/13,348,2,0.55,4570,348,0,2
51216,2014/03/31,2012/12/26,317,4,0.322698678,7789,317,3,1
51217,2014/03/31,2012/06/26,395,2,0.55,4570,395,2,0
51218,2014/03/31,2005/01/28,80,3,0.403333333,6231,80,1,2
51219,2014/03/31,2009/04/02,11,2,0.605,4154,11,0,2
51220,2014/03/31,2011/08/13,267,4,0.571011134,4401,267,2,2
51221,2014/03/31,2012/10/13,192,2,0.568552036,4420,192,1,1
51222,2014/03/31,2012/12/10,103,2,1.41,1782,103,0,2
51223,2014/03/31,2010/09/11,39,4,0.496071076,5065,39,2,2
51224,2014/03/31,2013/01/04,218,5,0.430488348,5836,218,2,3
51225,2014/03/31,2013/03/23,337,5,0.34715312299999995,7236,337,2,3
51226,2014/03/31,2013/02/22,218,3,0.7439514220000001,3376,218,2,1
51227,2014/03/31,2011/11/09,25,2,0.96,2616,25,1,1
51228,2014/03/31,2013/03/02,26,3,0.533433185,4707,26,0,3
51229,2014/03/31,2012/02/10,277,3,0.886581921,2832,277,2,1
51230,2014/03/31,2013/02/24,144,6,0.432283058,5808,144,3,3
51231,2014/03/31,2011/11/18,33,2,0.606434783,4140,33,0,2
51232,2014/03/31,2012/08/21,588,2,0.631426056,3976,588,2,0
51233,2014/03/31,2012/08/21,588,2,0.631426056,3976,588,2,0
51234,2014/03/31,2011/01/15,256,2,0.742484472,3381,256,1,1
51235,2014/03/31,2011/09/29,113,2,0.535,4692,113,0,2
51236,2014/03/31,2010/06/10,216,4,0.904020173,2776,216,3,1
51237,2014/03/31,2008/09/10,121,4,0.608820961,4122,121,0,4
51238,2014/03/31,2012/09/29,541,2,0.875,2868,541,2,0
51239,2014/03/31,2008/11/03,491,2,0.6,4182,491,2,0
51240,2014/03/31,2011/07/01,227,2,0.937302951,2677,227,1,1
51241,2014/03/31,2007/09/01,553,2,0.601186197,4173,553,2,0
51242,2014/03/31,2012/11/21,124,7,0.349302423,7182,124,2,5
51243,2014/03/31,2012/04/03,729,2,0.487264426,5147,729,2,0
51244,2014/03/31,2011/09/05,248,2,0.92,2726,248,0,2
51245,2014/03/31,2008/05/19,565,4,0.555090748,4518,565,4,0
51246,2014/03/31,2013/02/10,345,2,0.505462608,4961,345,1,1
51247,2014/03/31,2013/01/25,145,2,0.665287875,3769,145,1,1
51248,2014/03/31,2012/02/27,618,3,0.505667608,4958,618,3,0
51249,2014/03/31,2008/05/27,10,2,0.590454545,4246,10,0,2
51250,2014/03/31,2011/12/13,651,2,0.725,3458,651,2,0
51251,2014/03/31,2011/09/13,108,5,0.7441080440000001,3369,108,0,5
51252,2014/03/31,2009/12/08,144,3,0.776196965,3229,144,2,1
51253,2014/03/31,2011/02/08,459,3,0.5911084910000001,4240,459,3,0
51254,2014/03/31,2012/01/09,203,4,0.482793296,5191,203,2,2
51255,2014/03/31,2008/05/29,277,4,0.868682842,2885,277,0,4
51256,2014/03/31,2011/12/27,258,5,0.559633765,4478,258,2,3
51257,2014/03/31,2011/06/07,88,4,0.460240588,5445,88,2,2
51258,2014/03/31,2012/03/27,103,2,0.488868513,5126,103,1,1
51259,2014/03/31,2011/04/28,72,8,0.54,4640,72,2,6
51260,2014/03/31,2011/10/28,111,5,0.65552067,3822,111,4,1
51261,2014/03/31,2012/06/30,578,3,0.4,6263,578,3,0
51262,2014/03/31,2011/01/28,339,3,0.646143926,3877,339,2,1
51263,2014/03/31,2012/04/06,8,2,1.186107955,2112,8,1,1
51264,2014/03/31,2011/09/05,716,2,0.6,4175,716,2,0
51265,2014/03/31,2011/01/13,662,3,0.553446752,4526,662,3,0
51266,2014/03/31,2012/03/27,489,4,0.825,3036,489,4,0
51267,2014/03/31,2012/09/19,56,4,0.372763804,6719,56,1,3
51268,2014/03/31,2011/07/20,629,2,0.8454422690000001,2962,629,2,0
51269,2014/03/31,2012/08/09,75,3,0.630780856,3970,75,1,2
51270,2014/03/31,2013/01/22,71,2,0.904987351,2767,71,0,2
51271,2014/03/31,2007/08/01,55,3,0.956839893,2617,55,0,3
51272,2014/03/31,2005/05/28,632,3,0.7996806129999999,3131,632,3,0
51273,2014/03/31,2013/02/11,151,4,0.69743454,3590,151,3,1
51274,2014/03/31,2006/06/14,561,2,0.938029224,2669,561,2,0
51275,2014/03/31,2009/11/09,610,2,0.623238735,4017,610,2,0
51276,2014/03/31,2008/01/23,132,3,0.630589421,3970,132,0,3
51277,2014/03/31,2010/11/16,488,3,0.7472537309999999,3350,488,3,0
51278,2014/03/31,2011/01/26,431,4,0.758101151,3302,431,4,0
51279,2014/03/31,2011/08/16,618,3,0.597279885,4191,618,3,0
51280,2014/03/31,2008/09/11,175,4,0.640186701,3910,175,1,3
51281,2014/03/31,2007/11/05,133,2,0.67,3736,133,0,2
51282,2014/03/31,2013/01/30,403,2,0.892017106,2806,403,2,0
51283,2014/03/31,2010/02/23,208,6,0.468782544,5339,208,0,6
51284,2014/03/31,2008/07/08,606,3,0.916666667,2730,606,3,0
51285,2014/03/31,2007/08/13,175,3,0.452513562,5530,175,0,3
51286,2014/03/31,2010/12/29,402,2,0.9,2780,402,2,0
51287,2014/03/31,2006/01/06,313,2,0.6,4170,313,0,2
51288,2014/03/31,2013/03/04,113,2,0.597097852,4190,113,0,2
51289,2014/03/31,2012/05/08,687,2,0.775,3228,687,2,0
51290,2014/03/31,2011/07/01,596,3,0.436263736,5733,596,3,0
51291,2014/03/31,2011/11/26,19,3,0.7042664040000001,3551,19,2,1
51292,2014/03/31,2008/05/27,437,3,0.583979449,4282,437,3,0
51293,2014/03/31,2012/12/12,241,4,0.52500105,4763,241,3,1
51294,2014/03/31,2011/06/09,153,3,0.452311867,5528,153,1,2
51295,2014/03/31,2009/07/19,142,2,0.7065103140000001,3539,142,1,1
51296,2014/03/31,2012/12/29,455,2,0.636345126,3929,455,2,0
51297,2014/03/31,2007/05/01,81,5,0.477558739,5235,81,2,3
51298,2014/03/31,2012/10/09,10,7,0.53016755,4715,10,3,4
51299,2014/03/31,2010/08/24,352,5,0.6728532970000001,3715,352,4,1
51300,2014/03/31,2009/11/04,17,3,0.7184075879999999,3479,17,1,2
51301,2014/03/31,2006/09/25,321,5,0.553922872,4512,321,3,2
51302,2014/03/31,2012/10/18,28,4,0.650859375,3840,28,1,3
51303,2014/03/31,2011/01/09,611,3,0.547110333,4568,611,3,0
51304,2014/03/31,2010/07/25,253,3,0.558052702,4478,253,0,3
51305,2014/03/31,2011/08/18,256,3,0.65157236,3835,256,1,2
51306,2014/03/31,2008/05/11,387,5,0.77,3245,387,5,0
51307,2014/03/31,2010/09/03,299,3,0.614793307,4064,299,0,3
51308,2014/03/31,2007/09/01,184,3,0.808527508,3090,184,2,1
51309,2014/03/31,2007/11/21,16,2,0.635,3934,16,0,2
51310,2014/03/31,2011/02/19,46,2,0.635,3934,46,1,1
51311,2014/03/31,2011/08/29,64,2,0.635,3934,64,1,1
51312,2014/03/31,2007/05/19,6,2,0.555,4500,6,0,2
51313,2014/03/31,2010/01/12,129,7,0.392928403,6355,129,1,6
51314,2014/03/31,2009/05/11,160,4,0.829352159,3010,160,2,2
51315,2014/03/31,2009/04/01,574,4,0.93494382,2670,574,4,0
51316,2014/03/31,2012/06/14,652,2,0.6,4160,652,2,0
51317,2014/03/31,2012/07/20,621,2,0.7136402629999999,3497,621,2,0
51318,2014/03/31,2010/03/08,142,2,0.3918134720000001,6369,142,0,2
51319,2014/03/31,2010/12/20,494,4,0.5753746829999999,4337,494,4,0
51320,2014/03/31,2012/01/14,398,2,0.4,6238,398,2,0
51321,2014/03/31,2005/09/26,713,2,0.949790636,2627,713,2,0
51322,2014/03/31,2012/10/20,153,3,0.92,2712,153,0,3
51323,2014/03/31,2012/09/13,108,3,0.7392266670000001,3375,108,1,2
51324,2014/03/31,2013/01/19,386,4,0.525,4752,386,4,0
51325,2014/03/31,2007/05/27,7,2,0.77,3240,7,0,2
51326,2014/03/31,2012/10/31,429,4,0.7633567929999999,3268,429,4,0
51327,2014/03/31,2006/05/10,258,2,0.8464845609999999,2947,258,0,2
51328,2014/03/31,2010/05/28,60,3,0.676166983,3689,60,0,3
51329,2014/03/31,2008/08/08,127,4,0.540361785,4616,127,2,2
51330,2014/03/31,2009/08/30,593,3,0.759762412,3283,593,3,0
51331,2014/03/31,2012/11/30,165,2,0.487684787,5114,165,1,1
51332,2014/03/31,2009/03/09,345,3,0.772854044,3227,345,2,1
51333,2014/03/31,2005/11/16,625,3,0.452604356,5510,625,3,0
51334,2014/03/31,2013/02/16,45,3,0.799563963,3119,45,0,3
51335,2014/03/31,2010/06/06,292,7,0.5424543079999999,4596,292,2,5
51336,2014/03/31,2012/10/17,114,5,0.6852721279999999,3638,114,2,3
51337,2014/03/31,2012/11/06,500,2,0.5,4986,500,2,0
51338,2014/03/31,2008/03/11,389,2,0.5,4986,389,2,0
51339,2014/03/31,2008/08/11,13,3,0.773846631,3221,13,1,2
51340,2014/03/31,2011/12/24,383,4,0.480815972,5184,383,4,0
51341,2014/03/31,2011/04/27,514,2,0.6,4154,514,2,0
51342,2014/03/31,2007/06/19,30,2,0.6,4154,30,0,2
51343,2014/03/31,2010/09/12,443,3,0.4,6231,443,3,0
51344,2014/03/31,2012/02/27,586,2,0.6,4154,586,2,0
51345,2014/03/31,2009/08/11,595,2,0.6,4154,595,2,0
51346,2014/03/31,2009/09/26,506,4,0.602295795,4138,506,4,0
51347,2014/03/31,2011/03/04,35,3,0.593333333,4200,35,0,3
51348,2014/03/31,2007/05/23,358,3,0.733775029,3396,358,2,1
51349,2014/03/31,2013/01/11,441,2,0.6,4153,441,2,0
51350,2014/03/31,2009/12/12,655,2,0.949980938,2623,655,2,0
51351,2014/03/31,2012/08/14,41,3,0.666740701,3737,41,0,3
51352,2014/03/31,2010/05/08,421,2,0.75,3322,421,2,0
51353,2014/03/31,2012/05/21,237,4,0.711427756,3502,237,3,1
51354,2014/03/31,2012/05/19,677,2,0.8,3114,677,2,0
51355,2014/03/31,2012/08/14,571,4,0.55086245,4522,571,4,0
51356,2014/03/31,2006/01/24,115,4,0.4643736020000001,5364,115,0,4
51357,2014/03/31,2012/03/01,400,3,0.6333333329999999,3933,400,3,0
51358,2014/03/31,2010/07/12,373,3,0.424825175,5863,373,3,0
51359,2014/03/31,2008/12/02,476,3,0.7187878790000001,3465,476,3,0
51360,2014/03/31,2012/03/30,568,2,0.8,3113,568,2,0
51361,2014/03/31,2012/11/26,26,2,0.642352334,3877,26,1,1
51362,2014/03/31,2008/08/28,655,3,0.972053084,2562,655,3,0
51363,2014/03/31,2012/09/11,84,3,0.489310277,5089,84,1,2
51364,2014/03/31,2010/05/15,72,4,0.492289442,5058,72,2,2
51365,2014/03/31,2012/01/25,393,2,0.590559772,4216,393,2,0
51366,2014/03/31,2013/01/24,243,4,0.7675,3244,243,1,3
51367,2014/03/31,2009/04/22,37,2,0.725,3434,37,0,2
51368,2014/03/31,2011/01/13,443,3,0.7895972090000001,3153,443,3,0
51369,2014/03/31,2012/08/11,46,6,0.31678330600000004,7859,46,2,4
51370,2014/03/31,2013/02/07,379,2,0.599903614,4150,379,2,0
51371,2014/03/31,2009/09/26,213,4,0.666716658,3734,213,0,4
51372,2014/03/31,2010/10/28,34,3,0.5387297120000001,4621,34,1,2
51373,2014/03/31,2011/12/18,355,4,0.407355588,6111,355,2,2
51374,2014/03/31,2012/06/23,549,3,0.765687481,3251,549,3,0
51375,2014/03/31,2009/09/16,285,3,0.460203365,5409,285,1,2
51376,2014/03/31,2012/04/11,156,2,0.6734172079999999,3696,156,1,1
51377,2014/03/31,2007/11/28,244,2,0.60273674,4129,244,1,1
51378,2014/03/31,2013/03/09,205,2,0.60273674,4129,205,1,1
51379,2014/03/31,2004/12/31,254,2,0.7278443990000001,3419,254,0,2
51380,2014/03/31,2010/02/11,36,5,0.451273123,5514,36,3,2
51381,2014/03/31,2009/04/11,157,3,0.8171133,3045,157,1,2
51382,2014/03/31,2012/03/19,603,2,1.0,2488,603,2,0
51383,2014/03/31,2011/08/07,157,3,0.69925801,3558,157,1,2
51384,2014/03/31,2013/01/01,299,2,0.418751052,5941,299,0,2
51385,2014/03/31,2012/12/10,203,2,0.531781056,4677,203,1,1
51386,2014/03/31,2008/08/09,244,2,0.86,2892,244,1,1
51387,2014/03/31,2012/11/27,222,2,0.86,2892,222,1,1
51388,2014/03/31,2006/12/29,290,2,0.86,2892,290,1,1
51389,2014/03/31,2010/01/08,716,4,0.852090473,2918,716,4,0
51390,2014/03/31,2010/09/12,308,3,0.754826958,3294,308,0,3
51391,2014/03/31,2008/02/22,101,4,0.5857173139999999,4245,101,3,1
51392,2014/03/31,2012/08/29,540,3,0.449710564,5528,540,3,0
51393,2014/03/31,2013/01/22,103,3,0.588922056,4221,103,0,3
51394,2014/03/31,2012/11/27,367,2,0.926845638,2682,367,2,0
51395,2014/03/31,2011/01/13,584,2,0.821619835,3025,584,2,0
51396,2014/03/31,2011/01/14,38,5,0.723537118,3435,38,1,4
51397,2014/03/31,2008/04/14,28,3,0.6333333329999999,3924,28,0,3
51398,2014/03/31,2010/07/25,618,2,0.95,2616,618,2,0
51399,2014/03/31,2006/11/01,711,2,0.95,2616,711,2,0
51400,2014/03/31,2007/12/08,713,2,0.95,2616,713,2,0
51401,2014/03/31,2012/03/08,487,2,0.95,2616,487,2,0
51402,2014/03/31,2012/07/21,578,2,0.95,2616,578,2,0
51403,2014/03/31,2009/08/31,542,3,0.814285714,3052,542,3,0
51404,2014/03/31,2009/02/20,383,3,0.696301485,3569,383,3,0
51405,2014/03/31,2012/01/19,567,4,0.645454545,3850,567,4,0
51406,2014/03/31,2006/06/27,123,2,0.465,5344,123,0,2
51407,2014/03/31,2011/09/17,257,4,0.425054738,5846,257,2,2
51408,2014/03/31,2010/07/22,530,2,0.6779809,3665,530,2,0
51409,2014/03/31,2012/12/06,247,2,0.77,3227,247,0,2
51410,2014/03/31,2011/08/17,688,2,0.877693395,2831,688,2,0
51411,2014/03/31,2010/09/01,404,6,0.648746736,3830,404,6,0
51412,2014/03/31,2010/02/03,71,2,0.519007729,4787,71,1,1
51413,2014/03/31,2013/02/28,394,2,0.886670236,2802,394,2,0
51414,2014/03/31,2005/01/25,91,3,0.8783592640000001,2828,91,2,1
51415,2014/03/31,2011/08/18,96,5,0.845760981,2937,96,2,3
51416,2014/03/31,2012/12/27,448,4,0.787507926,3154,448,4,0
51417,2014/03/31,2012/05/05,207,4,0.76749691,3236,207,3,1
51418,2014/03/31,2010/11/24,348,3,0.933333333,2661,348,2,1
51419,2014/03/31,2010/12/03,330,3,0.933333333,2661,330,1,2
51420,2014/03/31,2013/03/13,142,3,0.590171103,4208,142,2,1
51421,2014/03/31,2011/05/11,548,4,0.775,3204,548,4,0
51422,2014/03/31,2005/09/08,284,2,0.66,3762,284,0,2
51423,2014/03/31,2013/03/17,198,2,0.812992796,3054,198,0,2
51424,2014/03/31,2008/08/22,57,4,0.59565499,4168,57,0,4
51425,2014/03/31,2013/03/07,217,2,0.6357362360000001,3905,217,1,1
51426,2014/03/31,2008/10/11,18,4,0.7310070670000001,3396,18,0,4
51427,2014/03/31,2009/10/28,113,4,0.517268181,4799,113,1,3
51428,2014/03/31,2010/10/17,106,2,0.6804331140000001,3648,106,0,2
51429,2014/03/31,2012/12/28,433,4,0.4,6205,433,4,0
51430,2014/03/31,2012/05/01,132,4,0.574793886,4318,132,3,1
51431,2014/03/31,2012/07/04,89,3,0.8866666670000001,2799,89,1,2
51432,2014/03/31,2006/12/07,133,3,0.8866666670000001,2799,133,1,2
51433,2014/03/31,2010/11/19,156,5,0.485436228,5112,156,2,3
51434,2014/03/31,2012/09/04,342,3,0.5142383420000001,4825,342,2,1
51435,2014/03/31,2009/02/24,619,3,0.732693444,3386,619,3,0
51436,2014/03/31,2006/10/08,111,5,0.921162273,2693,111,3,2
51437,2014/03/31,2011/10/15,446,6,0.349225679,7103,446,6,0
51438,2014/03/31,2007/03/25,65,3,0.678113723,3658,65,0,3
51439,2014/03/31,2012/02/21,272,3,0.964776352,2571,272,1,2
51440,2014/03/31,2011/12/10,417,3,0.669293038,3706,417,3,0
51441,2014/03/31,2010/08/13,693,3,0.395471217,6271,693,3,0
51442,2014/03/31,2008/01/23,332,4,0.6987179490000001,3549,332,2,2
51443,2014/03/31,2005/10/26,69,5,0.366,6775,69,2,3
51444,2014/03/31,2010/11/29,39,3,0.91631929,2706,39,1,2
51445,2014/03/31,2007/10/20,167,2,0.794215247,3122,167,0,2
51446,2014/03/31,2008/02/01,44,3,0.6971991,3556,44,0,3
51447,2014/03/31,2012/05/25,56,2,1.465265957,1692,56,1,1
51448,2014/03/31,2008/10/11,630,4,0.68352633,3627,630,4,0
51449,2014/03/31,2013/01/26,247,5,0.541373662,4579,247,1,4
51450,2014/03/31,2009/11/27,147,2,0.5469594,4532,147,1,1
51451,2014/03/31,2007/07/04,69,7,0.517042136,4794,69,0,7
51452,2014/03/31,2011/09/24,541,2,0.975,2542,541,2,0
51453,2014/03/31,2008/12/10,107,2,0.63,3934,107,0,2
51454,2014/03/31,2006/09/24,154,2,0.63,3934,154,0,2
51455,2014/03/31,2011/08/21,270,2,0.63,3934,270,0,2
51456,2014/03/31,2010/11/17,238,2,0.63,3934,238,0,2
51457,2014/03/31,2013/01/12,155,2,0.63,3934,155,0,2
51458,2014/03/31,2009/12/01,85,2,0.74360036,3333,85,1,1
51459,2014/03/31,2006/03/02,279,3,0.552100691,4489,279,1,2
51460,2014/03/31,2009/03/14,107,3,0.635601436,3899,107,2,1
51461,2014/03/31,2005/03/29,305,2,0.6341018420000001,3908,305,0,2
51462,2014/03/31,2010/01/05,151,5,0.7659999999999999,3235,151,2,3
51463,2014/03/31,2005/04/23,717,4,0.388476011,6378,717,4,0
51464,2014/03/31,2007/06/20,147,3,0.712178787,3479,147,2,1
51465,2014/03/31,2013/01/30,142,2,0.833106927,2974,142,1,1
51466,2014/03/31,2008/10/27,484,2,0.49576746,4997,484,2,0
51467,2014/03/31,2012/07/18,538,2,0.7,3539,538,2,0
51468,2014/03/31,2011/11/07,117,4,0.6552962960000001,3780,117,1,3
51469,2014/03/31,2010/05/09,64,4,0.315579055,7849,64,1,3
51470,2014/03/31,2013/01/20,16,5,0.395490979,6263,16,1,4
51471,2014/03/31,2012/02/23,544,3,0.77740113,3186,544,3,0
51472,2014/03/31,2009/09/25,15,8,0.53375,4640,15,2,6
51473,2014/03/31,2012/09/14,371,7,0.585714286,4228,371,7,0
51474,2014/03/31,2006/06/03,30,2,0.751748634,3294,30,1,1
51475,2014/03/31,2008/09/10,390,2,0.782864369,3163,390,2,0
51476,2014/03/31,2012/07/10,254,3,0.8150691240000001,3038,254,2,1
51477,2014/03/31,2011/10/31,203,2,0.541901948,4569,203,1,1
51478,2014/03/31,2007/06/10,89,2,0.7377681759999999,3356,89,0,2
51479,2014/03/31,2010/08/23,241,4,0.406685283,6088,241,0,4
51480,2014/03/31,2006/06/08,312,3,0.630058539,3929,312,2,1
51481,2014/03/31,2005/09/27,618,3,0.861942897,2872,618,3,0
51482,2014/03/31,2011/05/18,232,2,0.7583394609999999,3264,232,1,1
51483,2014/03/31,2010/03/26,103,4,0.638087136,3879,103,1,3
51484,2014/03/31,2011/01/11,538,3,0.490983932,5041,538,3,0
51485,2014/03/31,2008/01/20,639,3,0.3784403670000001,6540,639,3,0
51486,2014/03/31,2011/08/09,439,3,0.6369884170000001,3885,439,3,0
51487,2014/03/31,2012/04/12,198,3,0.545022026,4540,198,0,3
51488,2014/03/31,2010/10/29,118,2,0.695,3560,118,0,2
51489,2014/03/31,2011/09/28,244,4,0.638894628,3872,244,2,2
51490,2014/03/31,2012/11/22,457,2,0.475,5208,457,2,0
51491,2014/03/31,2009/07/05,383,5,0.4411985020000001,5607,383,5,0
51492,2014/03/31,2010/12/20,603,3,0.7377870559999999,3353,603,3,0
51493,2014/03/31,2010/07/10,211,2,0.334299811,7398,211,0,2
51494,2014/03/31,2008/08/29,142,4,0.365342,6769,142,3,1
51495,2014/03/31,2011/05/06,338,3,0.481212298,5139,338,2,1
51496,2014/03/31,2008/06/13,184,3,0.7034708390000001,3515,184,2,1
51497,2014/03/31,2005/09/09,480,3,0.8833333329999999,2799,480,3,0
51498,2014/03/31,2013/01/09,34,3,0.8833333329999999,2799,34,0,3
51499,2014/03/31,2009/10/20,457,2,0.45,5494,457,2,0
51500,2014/03/31,2012/02/24,3,3,0.63,3924,3,0,3
51501,2014/03/31,2012/07/17,624,2,0.641770509,3852,624,2,0
51502,2014/03/31,2010/10/22,552,2,0.83036614,2977,552,2,0
51503,2014/03/31,2009/01/29,9,4,0.7074327420000001,3494,9,2,2
51504,2014/03/31,2012/12/30,291,4,0.564582001,4378,291,3,1
51505,2014/03/31,2008/01/06,13,2,0.77,3210,13,0,2
51506,2014/03/31,2008/06/29,324,3,0.463627837,5331,324,1,2
51507,2014/03/31,2007/11/05,329,3,0.706057143,3500,329,1,2
51508,2014/03/31,2012/10/20,142,3,0.585587678,4220,142,2,1
51509,2014/03/31,2010/04/05,197,2,0.636885795,3879,197,0,2
51510,2014/03/31,2011/07/02,392,4,0.7817405059999999,3160,392,4,0
51511,2014/03/31,2013/01/27,203,3,0.7600430770000001,3250,203,1,2
51512,2014/03/31,2009/07/12,7,7,0.613664596,4025,7,0,7
51513,2014/03/31,2012/04/03,546,2,0.914063657,2702,546,2,0
51514,2014/03/31,2008/12/31,109,4,0.6768155659999999,3649,109,1,3
51515,2014/03/31,2013/02/13,45,4,0.6818580890000001,3622,45,1,3
51516,2014/03/31,2010/05/21,144,2,0.8075212559999999,3058,144,1,1
51517,2014/03/31,2006/12/06,261,3,0.78266561,3155,261,2,1
51518,2014/03/31,2007/05/19,22,3,0.8888336929999999,2778,22,0,3
51519,2014/03/31,2010/01/12,243,2,0.895,2758,243,0,2
51520,2014/03/31,2005/03/23,91,4,0.660307651,3738,91,2,2
51521,2014/03/31,2007/08/27,532,3,0.586932224,4205,532,3,0
51522,2014/03/31,2010/10/29,688,3,0.889351351,2775,688,3,0
51523,2014/03/31,2010/12/29,427,4,0.823165444,2998,427,4,0
51524,2014/03/31,2010/10/01,9,8,0.35375,6976,9,3,5
51525,2014/03/31,2010/04/07,86,5,0.7968162740000001,3097,86,2,3
51526,2014/03/31,2011/11/15,705,3,0.692368126,3564,705,3,0
51527,2014/03/31,2010/05/30,592,3,0.578635084,4264,592,3,0
51528,2014/03/31,2011/07/19,28,4,0.5809962320000001,4246,28,2,2
51529,2014/03/31,2011/12/22,26,2,0.531763311,4639,26,0,2
51530,2014/03/31,2013/02/28,204,4,0.28,8810,204,0,4
51531,2014/03/31,2012/03/02,96,5,0.452948953,5446,96,0,5
51532,2014/03/31,2007/06/20,98,5,0.426250216,5787,98,2,3
51533,2014/03/31,2008/02/18,31,7,0.7189478290000001,3431,31,5,2
51534,2014/03/31,2009/01/20,363,4,0.7409131870000001,3329,363,2,2
51535,2014/03/31,2013/01/16,420,2,0.570002311,4327,420,2,0
51536,2014/03/31,2007/11/03,518,3,0.745120846,3310,518,3,0
51537,2014/03/31,2005/07/20,473,4,0.95,2596,473,4,0
51538,2014/03/31,2011/01/13,31,2,0.58,4252,31,0,2
51539,2014/03/31,2010/09/24,460,3,0.42955931,5741,460,3,0
51540,2014/03/31,2012/02/27,558,4,0.714397451,3452,558,4,0
51541,2014/03/31,2013/02/28,45,2,0.91,2710,45,0,2
51542,2014/03/31,2010/02/17,366,2,0.6,4110,366,1,1
51543,2014/03/31,2008/04/16,331,2,0.6,4110,331,1,1
51544,2014/03/31,2005/01/15,361,2,0.931972789,2646,361,1,1
51545,2014/03/31,2008/11/22,8,2,0.7321763659999999,3368,8,0,2
51546,2014/03/31,2007/05/02,121,5,0.794601998,3103,121,4,1
51547,2014/03/31,2010/06/28,95,3,0.497990305,4951,95,1,2
51548,2014/03/31,2006/01/10,138,5,0.746159201,3304,138,3,2
51549,2014/03/31,2010/01/14,92,4,0.54540708,4520,92,1,3
51550,2014/03/31,2010/11/27,58,2,0.635,3882,58,0,2
51551,2014/03/31,2012/07/21,159,2,0.875559503,2815,159,0,2
51552,2014/03/31,2008/07/10,349,4,0.455825781,5407,349,2,2
51553,2014/03/31,2012/08/10,12,3,0.80333442,3068,12,1,2
51554,2014/03/31,2010/02/11,384,2,0.7566932759999999,3257,384,2,0
51555,2014/03/31,2012/08/10,548,2,0.560810196,4394,548,2,0
51556,2014/03/31,2013/02/28,26,2,0.472769142,5211,26,0,2
51557,2014/03/31,2010/04/26,76,2,0.917839046,2684,76,1,1
51558,2014/03/31,2013/03/12,76,3,0.764768705,3221,76,2,1
51559,2014/03/31,2006/04/20,652,2,0.525,4692,652,2,0
51560,2014/03/31,2009/12/07,136,2,0.562108626,4382,136,1,1
51561,2014/03/31,2008/03/09,202,3,0.88,2799,202,1,2
51562,2014/03/31,2012/07/09,198,3,0.979355865,2515,198,2,1
51563,2014/03/31,2013/03/19,76,4,0.442417819,5567,76,1,3
51564,2014/03/31,2008/11/19,132,3,0.551963245,4462,132,0,3
51565,2014/03/31,2012/10/26,175,2,0.8900758940000001,2767,175,1,1
51566,2014/03/31,2012/03/04,428,3,0.8502935079999999,2896,428,3,0
51567,2014/03/31,2006/11/12,131,2,0.567228749,4341,131,0,2
51568,2014/03/31,2012/12/03,379,2,0.7599382720000001,3240,379,2,0
51569,2014/03/31,2006/06/18,1,3,0.461744186,5332,1,0,3
51570,2014/03/31,2008/09/11,512,3,0.497725435,4946,512,3,0
51571,2014/03/31,2012/12/17,464,2,0.475,5182,464,2,0
51572,2014/03/31,2012/12/17,464,2,0.475,5182,464,2,0
51573,2014/03/31,2012/03/22,132,4,0.741126167,3321,132,2,2
51574,2014/03/31,2011/11/27,204,4,0.522893563,4707,204,1,3
51575,2014/03/31,2011/02/27,140,4,0.42,5860,140,2,2
51576,2014/03/31,2012/09/17,20,3,0.483407975,5091,20,0,3
51577,2014/03/31,2010/04/19,640,2,0.925535916,2659,640,2,0
51578,2014/03/31,2011/05/27,277,3,0.769480926,3198,277,1,2
51579,2014/03/31,2012/12/25,208,4,0.528139086,4659,208,1,3
51580,2014/03/31,2013/01/29,117,4,0.726421612,3387,117,2,2
51581,2014/03/31,2012/07/26,268,2,0.828629168,2969,268,1,1
51582,2014/03/31,2012/06/27,257,2,0.85451893,2879,257,1,1
51583,2014/03/31,2012/07/25,515,3,0.513034411,4795,515,3,0
51584,2014/03/31,2011/07/05,192,2,1.091846427,2253,192,0,2
51585,2014/03/31,2011/03/17,106,4,0.700997435,3509,106,3,1
51586,2014/03/31,2007/01/05,77,3,0.7841026459999999,3137,77,0,3
51587,2014/03/31,2010/11/01,47,2,0.63,3904,47,0,2
51588,2014/03/31,2007/06/12,412,7,0.4633974,5307,412,7,0
51589,2014/03/31,2006/02/10,117,3,0.810293245,3035,117,1,2
51590,2014/03/31,2008/11/06,21,3,0.6266666670000001,3924,21,0,3
51591,2014/03/31,2011/04/20,501,5,0.649326644,3787,501,5,0
51592,2014/03/31,2007/03/08,30,2,0.625,3934,30,0,2
51593,2014/03/31,2012/05/29,328,2,0.625,3934,328,0,2
51594,2014/03/31,2011/06/30,697,2,0.625,3934,697,2,0
51595,2014/03/31,2012/06/06,648,2,0.625,3934,648,2,0
51596,2014/03/31,2009/12/25,45,2,0.625,3934,45,0,2
51597,2014/03/31,2013/01/01,11,2,0.625,3934,11,0,2
51598,2014/03/31,2008/10/25,520,3,0.4166666670000001,5901,520,3,0
51599,2014/03/31,2013/03/26,50,2,0.625,3934,50,0,2
51600,2014/03/31,2008/06/20,400,2,0.625,3934,400,2,0
51601,2014/03/31,2009/05/05,13,2,0.625,3934,13,0,2
51602,2014/03/31,2012/12/29,456,2,0.625,3934,456,2,0
51603,2014/03/31,2008/05/28,226,4,0.5406971629999999,4547,226,0,4
51604,2014/03/31,2012/02/16,520,4,0.513471178,4788,520,4,0
51605,2014/03/31,2009/03/04,211,4,0.669640425,3671,211,2,2
51606,2014/03/31,2012/06/12,309,2,0.85,2892,309,1,1
51607,2014/03/31,2007/11/26,546,3,0.639118565,3846,546,3,0
51608,2014/03/31,2007/11/07,26,5,0.6459999999999999,3805,26,3,2
51609,2014/03/31,2006/08/20,659,2,1.0,2458,659,2,0
51610,2014/03/31,2013/02/03,91,4,0.368181546,6676,91,1,3
51611,2014/03/31,2012/08/01,331,2,0.725,3390,331,0,2
51612,2014/03/31,2012/02/13,345,4,0.86936682,2827,345,3,1
51613,2014/03/31,2005/12/07,64,3,0.963426107,2551,64,2,1
51614,2014/03/31,2008/08/12,12,2,0.796099773,3087,12,1,1
51615,2014/03/31,2012/10/07,102,6,0.615,3996,102,1,5
51616,2014/03/31,2011/03/19,19,2,0.46,5342,19,0,2
51617,2014/03/31,2008/09/01,13,4,0.5112484389999999,4806,13,0,4
51618,2014/03/31,2011/04/23,350,4,0.675,3640,350,2,2
51619,2014/03/31,2007/05/15,221,2,0.75,3276,221,0,2
51620,2014/03/31,2011/09/19,16,5,0.555367398,4423,16,0,5
51621,2014/03/31,2013/01/08,156,4,0.540552377,4544,156,0,4
51622,2014/03/31,2009/10/12,91,3,0.5076829270000001,4838,91,1,2
51623,2014/03/31,2011/01/24,354,5,0.900917095,2726,354,3,2
51624,2014/03/31,2012/03/01,29,3,0.578212856,4247,29,0,3
51625,2014/03/31,2011/02/03,410,2,0.906757755,2708,410,2,0
51626,2014/03/31,2012/12/29,203,4,0.620068182,3960,203,2,2
51627,2014/03/31,2011/05/07,163,4,0.626821547,3917,163,2,2
51628,2014/03/31,2013/02/23,169,4,0.754011057,3256,169,0,4
51629,2014/03/31,2010/10/16,181,4,0.548737148,4474,181,2,2
51630,2014/03/31,2012/03/17,73,4,0.509964686,4814,73,2,2
51631,2014/03/31,2011/07/21,110,2,0.585,4196,110,1,1
51632,2014/03/31,2005/05/04,45,6,0.426151042,5760,45,1,5
51633,2014/03/31,2011/03/27,520,2,0.45,5454,520,2,0
51634,2014/03/31,2013/01/14,165,5,0.486,5050,165,0,5
51635,2014/03/31,2006/05/22,230,4,0.656219251,3740,230,0,4
51636,2014/03/31,2010/11/25,268,4,0.346687385,7079,268,2,2
51637,2014/03/31,2012/05/17,352,2,0.575,4268,352,0,2
51638,2014/03/31,2010/08/12,628,4,0.946048574,2594,628,4,0
51639,2014/03/31,2006/03/18,225,4,0.6949957520000001,3531,225,1,3
51640,2014/03/31,2007/11/20,483,4,0.819092123,2996,483,4,0
51641,2014/03/31,2009/10/20,371,4,0.665568213,3687,371,4,0
51642,2014/03/31,2009/08/10,707,4,0.822319035,2984,707,4,0
51643,2014/03/31,2012/03/27,702,3,0.941442824,2606,702,3,0
51644,2014/03/31,2012/08/28,221,3,0.52078115,4711,221,1,2
51645,2014/03/31,2010/08/17,44,3,0.66,3717,44,2,1
51646,2014/03/31,2006/11/19,86,2,0.724459539,3386,86,0,2
51647,2014/03/31,2012/05/01,521,2,0.95,2582,521,2,0
51648,2014/03/31,2012/05/11,521,2,0.95,2582,521,2,0
51649,2014/03/31,2008/07/02,616,5,0.7093117409999999,3458,616,5,0
51650,2014/03/31,2009/11/13,287,3,0.7963636359999999,3080,287,0,3
51651,2014/03/31,2013/03/26,234,3,0.939272309,2611,234,0,3
51652,2014/03/31,2012/02/28,358,3,0.665689468,3684,358,2,1
51653,2014/03/31,2009/10/15,340,3,0.698405013,3511,340,2,1
51654,2014/03/31,2012/12/26,166,4,0.599210655,4092,166,0,4
51655,2014/03/31,2006/07/06,158,4,0.469724138,5220,158,2,2
51656,2014/03/31,2008/06/25,35,2,0.897474378,2732,35,0,2
51657,2014/03/31,2006/12/01,460,3,0.514317181,4767,460,3,0
51658,2014/03/31,2007/08/14,391,3,0.881589356,2781,391,3,0
51659,2014/03/31,2013/03/15,137,5,0.407217608,6020,137,3,2
51660,2014/03/31,2011/07/09,125,2,0.48,5107,125,0,2
51661,2014/03/31,2008/03/03,71,3,0.88713717,2763,71,1,2
51662,2014/03/31,2010/01/19,397,2,1.0,2451,397,2,0
51663,2014/03/31,2009/03/06,145,2,0.72,3404,145,0,2
51664,2014/03/31,2006/03/10,242,2,0.72,3404,242,0,2
51665,2014/03/31,2011/01/13,145,2,0.78,3142,145,0,2
51666,2014/03/31,2011/01/31,432,3,0.6134543179999999,3995,432,3,0
51667,2014/03/31,2010/10/17,278,2,1.41,1738,278,0,2
51668,2014/03/31,2010/02/17,65,2,0.953463035,2570,65,1,1
51669,2014/03/31,2012/03/20,122,3,0.7305426359999999,3354,122,0,3
51670,2014/03/31,2006/11/22,9,2,0.524665953,4670,9,1,1
51671,2014/03/31,2011/11/22,219,2,0.7,3500,219,1,1
51672,2014/03/31,2013/02/04,419,2,0.7,3500,419,2,0
51673,2014/03/31,2007/02/08,486,4,0.424610052,5770,486,4,0
51674,2014/03/31,2010/01/26,527,4,0.5125,4780,527,4,0
51675,2014/03/31,2012/09/27,454,3,0.6124375,4000,454,3,0
51676,2014/03/31,2010/03/31,44,4,0.502451282,4875,44,2,2
51677,2014/03/31,2010/08/10,60,3,0.698815977,3505,60,1,2
51678,2014/03/31,2008/01/26,424,5,0.60358551,4058,424,5,0
51679,2014/03/31,2004/11/11,145,4,0.755,3244,145,1,3
51680,2014/03/31,2012/01/21,331,4,0.630587024,3884,331,2,2
51681,2014/03/31,2012/08/24,29,3,1.41,1737,29,0,3
51682,2014/03/31,2011/08/19,709,2,0.439922759,5567,709,2,0
51683,2014/03/31,2007/11/03,337,3,0.681575285,3593,337,1,2
51684,2014/03/31,2009/11/11,160,3,0.418540171,5850,160,0,3
51685,2014/03/31,2011/08/19,89,3,0.620928227,3943,89,0,3
51686,2014/03/31,2013/02/05,57,3,0.553288136,4425,57,2,1
51687,2014/03/31,2012/10/29,367,4,0.6857843140000001,3570,367,4,0
51688,2014/03/31,2012/05/09,565,2,0.8,3060,565,2,0
51689,2014/03/31,2012/04/23,677,2,0.8,3060,677,2,0
51690,2014/03/31,2012/03/09,36,3,0.439782609,5566,36,0,3
51691,2014/03/31,2008/01/03,259,2,0.843996552,2900,259,0,2
51692,2014/03/31,2010/01/15,471,3,0.727743087,3363,471,3,0
51693,2014/03/31,2013/01/15,56,2,0.842119752,2906,56,0,2
51694,2014/03/31,2012/02/01,648,3,0.632829066,3867,648,3,0
51695,2014/03/31,2005/04/02,301,3,0.859497717,2847,301,1,2
51696,2014/03/31,2008/12/30,569,2,0.6,4078,569,2,0
51697,2014/03/31,2011/02/01,54,3,0.4,6117,54,0,3
51698,2014/03/31,2008/06/13,403,2,0.6,4078,403,2,0
51699,2014/03/31,2013/02/25,125,5,0.782456028,3127,125,0,5
51700,2014/03/31,2011/09/21,650,2,0.6925537940000001,3532,650,2,0
51701,2014/03/31,2012/09/08,413,4,0.7777424479999999,3145,413,4,0
51702,2014/03/31,2007/07/13,116,4,0.4675,5232,116,0,4
51703,2014/03/31,2008/02/27,44,2,0.334964393,7302,44,1,1
51704,2014/03/31,2005/03/27,542,2,0.861430081,2839,542,2,0
51705,2014/03/31,2009/03/16,278,2,0.65,3762,278,0,2
51706,2014/03/31,2006/04/22,340,4,0.668594476,3657,340,1,3
51707,2014/03/31,2009/07/02,142,2,0.606546763,4031,142,0,2
51708,2014/03/31,2012/12/03,401,2,0.65249533,3747,401,2,0
51709,2014/03/31,2007/02/28,9,3,0.806666667,3030,9,0,3
51710,2014/03/31,2012/06/07,661,2,0.620644997,3938,661,2,0
51711,2014/03/31,2006/11/28,145,2,0.731313585,3342,145,0,2
51712,2014/03/31,2012/10/16,322,2,0.612622211,3989,322,1,1
51713,2014/03/31,2008/02/23,258,2,0.845,2892,258,0,2
51714,2014/03/31,2010/05/20,274,2,0.845,2892,274,0,2
51715,2014/03/31,2012/04/22,458,3,0.6333333329999999,3858,458,3,0
51716,2014/03/31,2010/05/05,571,3,0.518903993,4708,571,3,0
51717,2014/03/31,2008/04/10,589,2,1.0,2443,589,2,0
51718,2014/03/31,2006/11/26,14,5,0.891554745,2740,14,0,5
51719,2014/03/31,2007/05/11,44,3,0.663804348,3680,44,0,3
51720,2014/03/31,2006/10/13,5,7,0.857945205,2847,5,2,5
51721,2014/03/31,2011/01/29,212,2,0.860038732,2840,212,1,1
51722,2014/03/31,2010/10/11,159,3,0.802108374,3045,159,0,3
51723,2014/03/31,2011/07/31,3,4,0.450462929,5422,3,2,2
51724,2014/03/31,2012/02/09,93,3,0.672652162,3631,93,2,1
51725,2014/03/31,2005/07/11,67,3,0.965682088,2529,67,2,1
51726,2014/03/31,2011/11/29,102,5,0.461045875,5297,102,0,5
51727,2014/03/31,2010/12/08,261,3,0.532955041,4582,261,2,1
51728,2014/03/31,2012/11/22,144,2,0.909746647,2684,144,0,2
51729,2014/03/31,2013/03/24,330,2,0.8,3052,330,0,2
51730,2014/03/31,2008/11/17,537,2,0.8,3052,537,2,0
51731,2014/03/31,2007/02/16,468,2,0.558011429,4375,468,2,0
51732,2014/03/31,2012/07/04,444,3,0.757932319,3221,444,3,0
51733,2014/03/31,2007/05/16,585,2,0.84095763,2903,585,2,0
51734,2014/03/31,2008/05/08,150,3,0.489496691,4987,150,1,2
51735,2014/03/31,2012/08/23,258,4,0.56169121,4346,258,2,2
51736,2014/03/31,2010/02/17,193,3,0.92,2653,193,0,3
51737,2014/03/31,2011/12/15,304,2,0.534021882,4570,304,0,2
51738,2014/03/31,2011/02/23,215,3,0.6201397710000001,3935,215,1,2
51739,2014/03/31,2007/12/01,286,2,0.591371789,4126,286,0,2
51740,2014/03/31,2007/09/16,240,2,0.55,4436,240,0,2
51741,2014/03/31,2006/10/20,655,2,0.55,4436,655,2,0
51742,2014/03/31,2012/10/29,393,3,0.920951302,2649,393,3,0
51743,2014/03/31,2013/01/18,268,3,0.723243403,3373,268,1,2
51744,2014/03/31,2010/11/13,73,4,0.479891796,5083,73,0,4
51745,2014/03/31,2008/12/20,641,2,0.45,5420,641,2,0
51746,2014/03/31,2011/04/25,326,5,0.52142399,4677,326,4,1
51747,2014/03/31,2012/11/22,483,3,0.703491056,3466,483,3,0
51748,2014/03/31,2009/06/01,398,3,0.753693972,3235,398,3,0
51749,2014/03/31,2004/12/20,597,3,0.566666667,4302,597,3,0
51750,2014/03/31,2009/07/16,526,2,0.7721729490000001,3157,526,2,0
51751,2014/03/31,2010/06/09,170,2,0.71400703,3414,170,0,2
51752,2014/03/31,2012/07/23,615,2,0.799376845,3049,615,2,0
51753,2014/03/31,2011/08/07,119,2,0.781413915,3119,119,0,2
51754,2014/03/31,2013/03/20,188,4,0.790256161,3084,188,2,2
51755,2014/03/31,2011/04/07,139,2,0.658772641,3699,139,0,2
51756,2014/03/31,2010/05/03,5,3,0.89900369,2710,5,0,3
51757,2014/03/31,2013/01/23,31,3,0.935552995,2604,31,0,3
51758,2014/03/31,2012/12/19,363,2,0.800838264,3042,363,1,1
51759,2014/03/31,2008/08/31,366,7,0.511356003,4764,366,6,1
51760,2014/03/31,2005/11/07,34,3,0.563632578,4322,34,0,3
51761,2014/03/31,2007/05/11,57,2,0.885,2752,57,0,2
51762,2014/03/31,2013/02/14,256,3,0.64694474,3764,256,1,2
51763,2014/03/31,2011/01/16,591,3,0.778950736,3126,591,3,0
51764,2014/03/31,2009/01/23,369,3,0.682399103,3568,369,3,0
51765,2014/03/31,2012/01/17,387,2,0.7,3478,387,2,0
51766,2014/03/31,2010/10/14,319,4,0.428751321,5678,319,3,1
51767,2014/03/31,2011/04/19,257,3,0.669477448,3636,257,1,2
51768,2014/03/31,2012/11/02,188,2,0.731650135,3327,188,1,1
51769,2014/03/31,2012/09/06,569,2,0.823756345,2955,569,2,0
51770,2014/03/31,2011/03/18,7,3,0.803333333,3030,7,0,3
51771,2014/03/31,2012/09/17,129,2,0.605899925,4017,129,1,1
51772,2014/03/31,2008/06/16,27,4,0.435041115,5594,27,2,2
51773,2014/03/31,2011/06/17,627,4,0.8872037909999999,2743,627,4,0
51774,2014/03/31,2012/12/19,82,3,0.512652201,4747,82,0,3
51775,2014/03/31,2005/04/12,14,2,0.8849163640000001,2750,14,1,1
51776,2014/03/31,2010/07/31,480,3,0.6714541940000001,3624,480,3,0
51777,2014/03/31,2007/08/03,376,3,0.658895207,3693,376,3,0
51778,2014/03/31,2012/05/01,542,2,0.7,3476,542,2,0
51779,2014/03/31,2011/06/24,81,2,0.742052455,3279,81,1,1
51780,2014/03/31,2011/09/20,73,3,0.458415301,5307,73,2,1
51781,2014/03/31,2011/12/12,403,2,0.875,2780,403,2,0
51782,2014/03/31,2012/07/16,399,3,0.6309987029999999,3855,399,3,0
51783,2014/03/31,2006/12/01,565,2,0.875,2780,565,2,0
51784,2014/03/31,2011/12/14,402,2,0.875,2780,402,2,0
51785,2014/03/31,2012/10/30,48,2,0.875,2780,48,0,2
51786,2014/03/31,2012/12/08,351,4,0.6462274179999999,3764,351,2,2
51787,2014/03/31,2010/03/25,392,3,0.910651441,2671,392,3,0
51788,2014/03/31,2010/12/21,711,2,0.825,2948,711,2,0
51789,2014/03/31,2011/07/27,399,4,0.667792422,3642,399,4,0
51790,2014/03/31,2012/07/07,371,11,0.581818182,4180,371,11,0
51791,2014/03/31,2011/09/01,306,6,0.35359116,6878,306,5,1
51792,2014/03/31,2012/01/25,253,2,0.838606897,2900,253,0,2
51793,2014/03/31,2009/07/30,462,2,0.45,5404,462,2,0
51794,2014/03/31,2010/11/08,162,3,0.8059098440000001,3017,162,2,1
51795,2014/03/31,2012/07/01,56,2,0.8249881240000001,2947,56,1,1
51796,2014/03/31,2010/02/12,488,3,0.602080238,4038,488,3,0
51797,2014/03/31,2012/04/23,189,2,0.7463494009999999,3257,189,1,1
51798,2014/03/31,2009/08/04,108,2,0.914806172,2657,108,0,2
51799,2014/03/31,2012/07/06,175,4,0.841853135,2887,175,3,1
51800,2014/03/31,2010/08/10,244,3,0.511447811,4752,244,1,2
51801,2014/03/31,2008/05/13,138,2,0.585,4154,138,0,2
51802,2014/03/31,2005/08/07,160,3,0.885477405,2744,160,2,1
51803,2014/03/31,2012/06/11,78,3,0.828581173,2932,78,2,1
51804,2014/03/31,2007/07/23,77,4,0.539227525,4505,77,3,1
51805,2014/03/31,2012/11/10,500,2,0.924685954,2627,500,2,0
51806,2014/03/31,2013/02/20,404,2,0.8,3036,404,2,0
51807,2014/03/31,2008/09/02,447,3,0.672603878,3610,447,3,0
51808,2014/03/31,2011/10/15,362,4,0.451226538,5381,362,3,1
51809,2014/03/31,2011/04/05,542,2,0.477349587,5086,542,2,0
51810,2014/03/31,2012/01/06,491,3,0.6335334029999999,3832,491,3,0
51811,2014/03/31,2012/06/24,254,3,0.8396368040000001,2891,254,2,1
51812,2014/03/31,2013/01/12,396,2,0.65,3734,396,2,0
51813,2014/03/31,2012/06/09,653,2,0.849789916,2856,653,2,0
51814,2014/03/31,2009/09/15,21,5,0.856,2835,21,0,5
51815,2014/03/31,2013/03/18,285,3,0.803962889,3018,285,1,2
51816,2014/03/31,2010/11/26,35,4,0.587050569,4133,35,1,3
51817,2014/03/31,2012/03/23,311,3,0.7108848520000001,3413,311,2,1
51818,2014/03/31,2012/05/28,527,3,0.810999666,2991,527,3,0
51819,2014/03/31,2012/04/06,723,3,0.52570995,4613,723,3,0
51820,2014/03/31,2012/03/19,478,2,0.691248575,3508,478,2,0
51821,2014/03/31,2011/11/07,315,3,0.544631626,4452,315,2,1
51822,2014/03/31,2010/03/30,27,5,0.520631308,4657,27,0,5
51823,2014/03/31,2011/02/04,56,2,0.669508423,3621,56,0,2
51824,2014/03/31,2011/11/04,504,4,0.775463852,3126,504,4,0
51825,2014/03/31,2009/12/02,236,2,0.588778237,4117,236,0,2
51826,2014/03/31,2011/11/12,87,3,0.8,3030,87,1,2
51827,2014/03/31,2012/12/22,456,4,0.6,4040,456,4,0
51828,2014/03/31,2012/08/08,38,2,0.77,3148,38,0,2
51829,2014/03/31,2013/01/27,201,3,0.462380771,5242,201,2,1
51830,2014/03/31,2008/03/12,14,2,0.7023152709999999,3451,14,1,1
51831,2014/03/31,2011/01/13,264,3,0.796162943,3044,264,1,2
51832,2014/03/31,2012/06/11,51,5,0.697404317,3475,51,4,1
51833,2014/03/31,2013/02/12,413,2,0.739938931,3275,413,2,0
51834,2014/03/31,2010/05/14,165,4,0.914790487,2649,165,0,4
51835,2014/03/31,2007/09/19,14,3,0.6634282579999999,3652,14,0,3
51836,2014/03/31,2012/05/20,225,3,0.8052127659999999,3008,225,2,1
51837,2014/03/31,2008/12/30,647,3,0.4,6055,647,3,0
51838,2014/03/31,2009/07/13,13,2,0.5297375329999999,4572,13,0,2
51839,2014/03/31,2012/11/06,154,6,0.519839021,4659,154,4,2
51840,2014/03/31,2006/10/26,565,2,0.843573668,2871,565,2,0
51841,2014/03/31,2011/08/31,494,2,0.843573668,2871,494,2,0
51842,2014/03/31,2006/06/17,218,2,0.5907733589999999,4099,218,1,1
51843,2014/03/31,2013/01/13,442,2,0.7760897440000001,3120,442,2,0
51844,2014/03/31,2012/09/12,163,3,0.914695882,2647,163,2,1
51845,2014/03/31,2012/11/10,47,2,0.731038647,3312,47,0,2
51846,2014/03/31,2012/07/25,63,3,1.233944954,1962,63,1,2
51847,2014/03/31,2010/11/15,94,3,0.711825934,3401,94,0,3
51848,2014/03/31,2012/11/10,504,4,0.570405278,4244,504,4,0
51849,2014/03/31,2012/11/20,286,2,0.7,3458,286,1,1
51850,2014/03/31,2005/12/13,561,2,0.7,3458,561,2,0
51851,2014/03/31,2013/03/20,321,2,0.7,3458,321,1,1
51852,2014/03/31,2012/07/22,610,2,0.5549174689999999,4362,610,2,0
51853,2014/03/31,2011/10/21,74,3,0.651874495,3713,74,1,2
51854,2014/03/31,2004/12/28,685,2,0.90246085,2682,685,2,0
51855,2014/03/31,2006/11/08,110,2,0.943257989,2566,110,1,1
51856,2014/03/31,2012/04/08,404,4,0.451230425,5364,404,4,0
51857,2014/03/31,2013/01/03,15,3,0.7537215820000001,3211,15,0,3
51858,2014/03/31,2012/12/02,455,3,0.541057456,4473,455,3,0
51859,2014/03/31,2011/12/18,5,3,0.68629325,3526,5,1,2
51860,2014/03/31,2013/03/01,394,2,0.925,2616,394,2,0
51861,2014/03/31,2007/05/28,620,2,0.925,2616,620,2,0
51862,2014/03/31,2010/04/09,551,2,0.925,2616,551,2,0
51863,2014/03/31,2011/12/18,597,2,0.925,2616,597,2,0
51864,2014/03/31,2012/07/01,79,3,0.485011024,4989,79,0,3
51865,2014/03/31,2009/08/29,587,2,0.629108164,3846,587,2,0
51866,2014/03/31,2013/01/25,66,3,0.41,5901,66,1,2
51867,2014/03/31,2007/02/22,685,2,1.0,2419,685,2,0
51868,2014/03/31,2011/03/30,99,7,0.71157105,3399,99,4,3
51869,2014/03/31,2009/04/25,85,4,0.420180681,5756,85,0,4
51870,2014/03/31,2011/12/19,57,3,0.616006113,3926,57,1,2
51871,2014/03/31,2012/12/02,98,2,1.447163375,1671,98,1,1
51872,2014/03/31,2008/10/21,576,5,0.8139347020000001,2971,576,5,0
51873,2014/03/31,2011/07/31,159,3,0.949042386,2548,159,0,3
51874,2014/03/31,2010/05/24,415,3,0.768398475,3147,415,3,0
51875,2014/03/31,2009/10/17,280,3,0.878630087,2752,280,2,1
51876,2014/03/31,2013/03/13,272,5,0.797710327,3031,272,2,3
51877,2014/03/31,2008/01/17,511,3,0.436890134,5534,511,3,0
51878,2014/03/31,2009/10/23,98,4,0.6177133370000001,3914,98,0,4
51879,2014/03/31,2010/11/17,114,4,0.5009697470000001,4826,114,0,4
51880,2014/03/31,2012/09/20,558,2,0.750978565,3219,558,2,0
51881,2014/03/31,2012/09/20,558,2,0.750978565,3219,558,2,0
51882,2014/03/31,2011/11/12,17,4,0.56,4316,17,0,4
51883,2014/03/31,2013/03/19,84,2,0.315,7672,84,0,2
51884,2014/03/31,2012/03/09,15,3,0.476457019,5072,15,0,3
51885,2014/03/31,2011/06/22,102,4,0.8951834009999999,2699,102,1,3
51886,2014/03/31,2011/09/13,404,2,0.425,5684,404,2,0
51887,2014/03/31,2012/02/27,635,2,0.425,5684,635,2,0
51888,2014/03/31,2012/06/05,660,2,0.55,4392,660,2,0
51889,2014/03/31,2012/06/05,660,2,0.55,4392,660,2,0
51890,2014/03/31,2012/06/05,660,2,0.55,4392,660,2,0
51891,2014/03/31,2012/06/05,660,2,0.55,4392,660,2,0
51892,2014/03/31,2012/06/05,463,4,0.557711845,4331,463,4,0
51893,2014/03/31,2013/01/21,390,2,0.597279921,4044,390,2,0
51894,2014/03/31,2011/11/03,124,4,0.6853972759999999,3524,124,0,4
51895,2014/03/31,2012/08/14,281,2,0.81348939,2969,281,1,1
51896,2014/03/31,2011/06/07,626,2,0.86971552,2777,626,2,0
51897,2014/03/31,2011/01/13,50,2,0.875,2760,50,0,2
51898,2014/03/31,2005/12/30,33,2,0.835,2892,33,0,2
51899,2014/03/31,2011/03/19,235,2,0.835,2892,235,1,1
51900,2014/03/31,2007/09/02,104,2,0.835,2892,104,0,2
51901,2014/03/31,2006/09/20,161,3,0.6659238829999999,3626,161,0,3
51902,2014/03/31,2010/09/01,20,3,0.716043891,3372,20,0,3
51903,2014/03/31,2006/01/26,534,2,0.885711665,2726,534,2,0
51904,2014/03/31,2011/06/24,144,3,0.503617021,4794,144,1,2
51905,2014/03/31,2011/10/12,160,4,0.93,2596,160,2,2
51906,2014/03/31,2012/08/15,590,2,0.922116119,2618,590,2,0
51907,2014/03/31,2011/04/19,311,3,0.59495933,4057,311,2,1
51908,2014/03/31,2013/02/03,210,2,0.74957764,3220,210,1,1
51909,2014/03/31,2008/05/12,506,2,0.8,3017,506,2,0
51910,2014/03/31,2010/12/08,199,4,0.7809708740000001,3090,199,2,2
51911,2014/03/31,2010/12/13,110,4,0.633053515,3812,110,0,4
51912,2014/03/31,2012/10/24,432,4,0.473910055,5092,432,4,0
51913,2014/03/31,2012/11/15,4,13,0.642307692,3757,4,2,11
51914,2014/03/31,2012/02/19,391,2,1.0,2413,391,2,0
51915,2014/03/31,2012/11/02,94,2,1.025495113,2353,94,0,2
51916,2014/03/31,2012/05/22,45,2,0.575,4196,45,0,2
51917,2014/03/31,2011/02/18,221,4,0.68,3548,221,3,1
51918,2014/03/31,2006/11/15,24,3,0.479934354,5027,24,1,2
51919,2014/03/31,2012/02/19,626,3,0.500217707,4823,626,3,0
51920,2014/03/31,2008/08/23,49,3,0.890184502,2710,49,0,3
51921,2014/03/31,2011/03/28,130,2,0.685301136,3520,130,1,1
51922,2014/03/31,2011/11/08,509,2,0.754755945,3196,509,2,0
51923,2014/03/31,2011/08/09,421,2,0.819327446,2944,421,2,0
51924,2014/03/31,2005/10/01,567,2,1.418823529,1700,567,2,0
51925,2014/03/31,2011/10/10,127,5,0.408268156,5907,127,2,3
51926,2014/03/31,2011/03/31,31,3,0.676666667,3564,31,0,3
51927,2014/03/31,2012/10/30,8,2,0.565,4268,8,1,1
51928,2014/03/31,2009/11/28,41,2,0.729515885,3305,41,0,2
51929,2014/03/31,2013/01/01,311,2,0.459443492,5247,311,1,1
51930,2014/03/31,2010/04/12,544,2,0.8,3013,544,2,0
51931,2014/03/31,2008/06/17,163,4,0.642696,3750,163,0,4
51932,2014/03/31,2011/04/06,461,2,0.653320683,3689,461,2,0
51933,2014/03/31,2011/12/07,599,6,0.576141525,4183,599,6,0
51934,2014/03/31,2009/08/31,402,3,0.8170566290000001,2949,402,3,0
51935,2014/03/31,2012/09/02,23,3,0.738158137,3263,23,1,2
51936,2014/03/31,2011/06/16,313,4,0.462915626,5203,313,3,1
51937,2014/03/31,2008/03/15,44,2,0.824281314,2922,44,0,2
51938,2014/03/31,2008/03/15,95,2,0.760473634,3167,95,1,1
51939,2014/03/31,2012/04/13,712,4,0.4,6020,712,4,0
51940,2014/03/31,2012/04/12,703,2,0.7,3440,703,2,0
51941,2014/03/31,2010/06/07,508,3,0.5335696879999999,4513,508,3,0
51942,2014/03/31,2010/06/24,119,5,0.742,3245,119,2,3
51943,2014/03/31,2013/01/30,32,2,0.64,3762,32,0,2
51944,2014/03/31,2007/05/31,452,3,0.66615938,3614,452,3,0
51945,2014/03/31,2012/12/14,352,3,0.781099935,3082,352,2,1
51946,2014/03/31,2011/05/22,500,3,0.492370628,4889,500,3,0
51947,2014/03/31,2011/04/14,594,2,0.89753915,2682,594,2,0
51948,2014/03/31,2007/02/19,159,2,0.868070682,2773,159,0,2
51949,2014/03/31,2011/02/16,175,4,0.3875,6212,175,0,4
51950,2014/03/31,2012/07/26,516,3,0.7470204840000001,3222,516,3,0
51951,2014/03/31,2012/03/22,134,3,0.708114151,3399,134,0,3
51952,2014/03/31,2010/07/09,235,2,0.92,2616,235,0,2
51953,2014/03/31,2012/07/03,55,3,0.42,5730,55,0,3
51954,2014/03/31,2013/02/22,312,3,0.855492357,2813,312,1,2
51955,2014/03/31,2011/01/10,364,5,0.682860386,3524,364,4,1
51956,2014/03/31,2013/02/26,304,2,0.749402055,3211,304,1,1
51957,2014/03/31,2010/04/22,40,2,0.700113471,3437,40,0,2
51958,2014/03/31,2012/09/19,309,5,0.334978421,7183,309,2,3
51959,2014/03/31,2006/03/13,13,4,0.590422189,4074,13,1,3
51960,2014/03/31,2010/03/18,530,4,0.48589899,4950,530,4,0
51961,2014/03/31,2009/04/09,356,3,0.8666666670000001,2775,356,2,1
51962,2014/03/31,2007/04/13,710,2,0.45,5344,710,2,0
51963,2014/03/31,2007/08/07,384,3,0.325538107,7387,384,3,0
51964,2014/03/31,2010/12/24,656,3,0.325538107,7387,656,3,0
51965,2014/03/31,2011/10/17,641,2,0.575,4182,641,2,0
51966,2014/03/31,2009/05/03,455,2,0.575,4182,455,2,0
51967,2014/03/31,2011/07/13,49,4,0.6237639429999999,3855,49,2,2
51968,2014/03/31,2011/03/25,312,2,0.375,6412,312,0,2
51969,2014/03/31,2009/12/12,2,2,0.590174276,4074,2,0,2
51970,2014/03/31,2010/12/24,47,3,0.6243261489999999,3851,47,0,3
51971,2014/03/31,2012/12/22,382,4,0.588555692,4085,382,4,0
51972,2014/03/31,2012/04/10,715,2,0.45,5342,715,2,0
51973,2014/03/31,2012/07/17,614,2,0.45,5342,614,2,0
51974,2014/03/31,2013/01/13,437,2,0.45,5342,437,2,0
51975,2014/03/31,2011/12/26,485,2,0.45,5342,485,2,0
51976,2014/03/31,2012/05/08,687,2,0.45,5342,687,2,0
51977,2014/03/31,2008/08/15,384,4,0.518944301,4632,384,4,0
51978,2014/03/31,2005/08/20,228,6,0.344449699,6978,228,3,3
51979,2014/03/31,2012/05/01,138,4,0.5133489960000001,4682,138,2,2
51980,2014/03/31,2012/06/27,228,2,0.786713584,3055,228,1,1
51981,2014/03/31,2013/02/26,227,2,0.788933027,3046,227,1,1
51982,2014/03/31,2010/09/06,402,2,0.675,3560,402,2,0
51983,2014/03/31,2007/08/07,555,2,0.6820891290000001,3523,555,2,0
51984,2014/03/31,2009/12/02,474,2,0.675,3560,474,2,0
51985,2014/03/31,2012/06/25,636,2,0.675,3560,636,2,0
51986,2014/03/31,2013/03/18,252,2,0.909738735,2641,252,0,2
51987,2014/03/31,2007/04/04,14,3,0.499904286,4806,14,0,3
51988,2014/03/31,2010/06/01,153,4,0.770949936,3116,153,3,1
51989,2014/03/31,2012/12/30,2,2,0.92,2611,2,0,2
51990,2014/03/31,2010/11/29,45,2,0.43,5586,45,0,2
51991,2014/03/31,2012/09/25,147,2,0.7230252859999999,3322,147,1,1
51992,2014/03/31,2013/02/04,73,3,0.692965955,3466,73,1,2
51993,2014/03/31,2006/11/30,231,2,0.87809872,2735,231,1,1
51994,2014/03/31,2012/03/07,158,3,0.69985427,3431,158,2,1
51995,2014/03/31,2012/01/25,392,2,0.575,4176,392,2,0
51996,2014/03/31,2009/11/20,330,4,0.5806892379999999,4135,330,3,1
51997,2014/03/31,2005/04/06,506,3,0.371802416,6458,506,3,0
51998,2014/03/31,2012/05/22,7,3,0.6720039179999999,3573,7,1,2
51999,2014/03/31,2006/10/22,652,3,0.562175135,4271,652,3,0
52000,2014/03/31,2012/09/10,332,4,0.5765970220000001,4164,332,2,2
52001,2014/03/31,2011/12/07,15,4,0.617740607,3886,15,0,4
52002,2014/03/31,2008/07/18,32,2,0.83,2892,32,0,2
52003,2014/03/31,2012/09/01,113,7,0.588030377,4082,113,2,5
52004,2014/03/31,2012/06/01,610,3,0.45,5334,610,3,0
52005,2014/03/31,2011/10/08,471,2,0.7,3429,471,2,0
52006,2014/03/31,2012/10/01,48,2,0.733477995,3272,48,0,2
52007,2014/03/31,2012/07/31,165,2,0.61,3934,165,1,1
52008,2014/03/31,2008/05/24,33,2,0.61,3934,33,1,1
52009,2014/03/31,2008/06/06,177,3,0.54341712,4416,177,1,2
52010,2014/03/31,2010/03/29,657,2,0.525,4570,657,2,0
52011,2014/03/31,2013/02/04,104,2,0.915,2622,104,0,2
52012,2014/03/31,2012/07/11,401,3,0.8082547170000001,2968,401,3,0
52013,2014/03/31,2011/08/22,552,3,0.493478708,4861,552,3,0
52014,2014/03/31,2011/01/22,90,4,0.562829657,4262,90,1,3
52015,2014/03/31,2012/08/16,520,2,0.817831572,2933,520,2,0
52016,2014/03/31,2007/06/26,313,2,0.690613303,3473,313,1,1
52017,2014/03/31,2012/07/15,624,2,0.725,3308,624,2,0
52018,2014/03/31,2008/10/09,607,2,0.706837607,3393,607,2,0
52019,2014/03/31,2011/04/14,376,2,0.76254372,3145,376,2,0
52020,2014/03/31,2012/09/03,253,3,0.65699726,3650,253,2,1
52021,2014/03/31,2009/11/24,474,2,0.818954918,2928,474,2,0
52022,2014/03/31,2007/03/01,156,6,0.661666667,3624,156,4,2
52023,2014/03/31,2012/03/28,429,3,0.6664257920000001,3598,429,3,0
52024,2014/03/31,2004/12/02,139,2,0.982277755,2441,139,1,1
52025,2014/03/31,2012/03/22,234,4,0.348646212,6877,234,2,2
52026,2014/03/31,2012/09/17,236,3,0.584579371,4101,236,1,2
52027,2014/03/31,2011/07/14,192,4,0.5297348070000001,4525,192,1,3
52028,2014/03/31,2012/05/31,381,2,0.65012205,3687,381,2,0
52029,2014/03/31,2008/04/20,222,2,0.71,3376,222,0,2
52030,2014/03/31,2013/03/01,283,4,0.645,3716,283,2,2
52031,2014/03/31,2006/02/08,139,3,0.617562484,3881,139,2,1
52032,2014/03/31,2010/09/09,623,2,0.9,2663,623,2,0
52033,2014/03/31,2013/01/28,62,2,0.583046229,4110,62,1,1
52034,2014/03/31,2008/04/16,139,2,0.6943523620000001,3451,139,0,2
52035,2014/03/31,2013/01/24,192,4,0.6550054670000001,3658,192,0,4
52036,2014/03/31,2012/12/03,105,4,0.376841774,6358,105,2,2
52037,2014/03/31,2011/05/15,345,4,0.58795092,4075,345,3,1
52038,2014/03/31,2009/12/11,17,3,0.6958553590000001,3443,17,0,3
52039,2014/03/31,2012/11/11,389,2,0.506801354,4727,389,2,0
52040,2014/03/31,2004/12/24,677,2,0.484939271,4940,677,2,0
52041,2014/03/31,2008/01/18,696,3,0.404517055,5922,696,3,0
52042,2014/03/31,2011/08/02,411,2,0.8460967859999999,2831,411,2,0
52043,2014/03/31,2013/03/05,331,3,0.5,4790,331,1,2
52044,2014/03/31,2012/12/09,477,2,0.55,4354,477,2,0
52045,2014/03/31,2008/02/05,350,2,0.652862595,3668,350,1,1
52046,2014/03/31,2012/07/05,497,3,0.780270446,3069,497,3,0
52047,2014/03/31,2008/10/26,418,3,0.8756400879999999,2734,418,3,0
52048,2014/03/31,2008/03/07,564,2,0.912466641,2623,564,2,0
52049,2014/03/31,2010/05/14,630,3,0.690536642,3466,630,3,0
52050,2014/03/31,2011/01/18,12,2,0.48,4986,12,0,2
52051,2014/03/31,2005/04/29,128,3,0.816791809,2930,128,0,3
52052,2014/03/31,2004/12/02,238,3,0.58,4125,238,1,2
52053,2014/03/31,2009/08/27,191,5,0.593213489,4033,191,2,3
52054,2014/03/31,2007/11/13,148,3,0.774868805,3087,148,2,1
52055,2014/03/31,2007/03/01,170,6,0.427357513,5597,170,2,4
52056,2014/03/31,2008/02/06,128,4,0.443766933,5389,128,0,4
52057,2014/03/31,2011/06/14,83,2,0.9,2657,83,0,2
52058,2014/03/31,2008/03/08,441,2,0.371304348,6440,441,2,0
52059,2014/03/31,2008/08/23,111,6,0.8942333579999999,2674,111,5,1
52060,2014/03/31,2006/01/26,27,3,0.917088608,2607,27,0,3
52061,2014/03/31,2007/07/01,360,3,0.858692529,2784,360,1,2
52062,2014/03/31,2012/08/19,590,2,0.863656069,2768,590,2,0
52063,2014/03/31,2011/08/07,491,4,0.7724628309999999,3094,491,4,0
52064,2014/03/31,2011/01/15,478,2,1.0,2390,478,2,0
52065,2014/03/31,2007/10/20,368,2,1.0,2390,368,2,0
52066,2014/03/31,2010/02/15,247,4,0.829854167,2880,247,2,2
52067,2014/03/31,2008/12/16,221,3,0.508283709,4702,221,2,1
52068,2014/03/31,2009/07/06,57,3,0.645913514,3700,57,2,1
52069,2014/03/31,2012/12/31,65,2,0.567504156,4211,65,1,1
52070,2014/03/31,2012/07/11,5,2,0.567504156,4211,5,1,1
52071,2014/03/31,2010/04/16,163,2,0.7796704729999999,3065,163,1,1
52072,2014/03/31,2012/07/08,632,2,0.78374877,3049,632,2,0
52073,2014/03/31,2011/10/02,475,3,0.458911081,5207,475,3,0
52074,2014/03/31,2007/09/05,68,4,0.635959542,3757,68,3,1
52075,2014/03/31,2009/11/11,119,3,0.491006987,4866,119,0,3
52076,2014/03/31,2010/11/29,4,4,0.8767633029999999,2725,4,0,4
52077,2014/03/31,2011/04/25,304,3,0.583121796,4097,304,1,2
52078,2014/03/31,2010/12/13,512,3,0.603982301,3955,512,3,0
52079,2014/03/31,2010/11/19,464,2,0.575,4154,464,2,0
52080,2014/03/31,2012/11/30,454,2,0.575,4154,454,2,0
52081,2014/03/31,2005/06/04,391,2,0.575,4154,391,2,0
52082,2014/03/31,2008/09/04,214,2,0.575,4154,214,0,2
52083,2014/03/31,2012/11/04,510,2,0.575,4154,510,2,0
52084,2014/03/31,2011/10/08,110,2,0.575,4154,110,0,2
52085,2014/03/31,2010/01/05,656,3,0.695139697,3436,656,3,0
52086,2014/03/31,2012/05/15,489,3,0.604148748,3953,489,3,0
52087,2014/03/31,2012/04/16,306,4,0.545862857,4375,306,2,2
52088,2014/03/31,2009/04/26,103,4,0.447248548,5339,103,1,3
52089,2014/03/31,2010/09/13,195,6,0.431859624,5528,195,3,3
52090,2014/03/31,2013/02/26,400,2,0.801780316,2977,400,2,0
52091,2014/03/31,2012/01/29,131,6,0.48770331,4894,131,2,4
52092,2014/03/31,2008/01/18,160,2,0.718870482,3320,160,0,2
52093,2014/03/31,2010/10/07,290,3,0.781457105,3054,290,1,2
52094,2014/03/31,2012/10/23,392,2,0.4,5966,392,2,0
52095,2014/03/31,2012/01/14,564,2,0.4,5966,564,2,0
52096,2014/03/31,2012/04/22,704,2,0.4,5966,704,2,0
52097,2014/03/31,2010/11/30,661,2,0.4,5966,661,2,0
52098,2014/03/31,2007/10/10,529,3,0.425937165,5602,529,3,0
52099,2014/03/31,2011/04/26,143,3,0.45938583,5194,143,1,2
52100,2014/03/31,2006/12/05,431,2,0.825,2892,431,2,0
52101,2014/03/31,2012/12/02,350,3,0.661830791,3605,350,2,1
52102,2014/03/31,2008/11/11,331,2,0.825,2892,331,0,2
52103,2014/03/31,2011/04/15,279,3,0.6779624890000001,3519,279,0,3
52104,2014/03/31,2013/03/05,393,2,0.619971414,3848,393,2,0
52105,2014/03/31,2012/08/03,256,2,0.585,4078,256,1,1
52106,2014/03/31,2008/10/24,640,2,0.7,3408,640,2,0
52107,2014/03/31,2011/11/17,509,4,0.48291498,4940,509,4,0
52108,2014/03/31,2006/10/09,160,3,0.76,3138,160,1,2
52109,2014/03/31,2012/02/04,456,4,0.722010294,3303,456,4,0
52110,2014/03/31,2011/11/24,587,2,0.597095643,3994,587,2,0
52111,2014/03/31,2010/07/21,232,3,0.583649046,4086,232,1,2
52112,2014/03/31,2007/06/25,59,2,0.874761555,2726,59,0,2
52113,2014/03/31,2006/04/29,701,2,1.149156627,2075,701,2,0
52114,2014/03/31,2012/04/19,210,3,0.525951908,4533,210,2,1
52115,2014/03/31,2011/11/23,310,4,0.73924031,3225,310,2,2
52116,2014/03/31,2012/05/21,470,2,0.909923664,2620,470,2,0
52117,2014/03/31,2013/01/21,410,2,0.575,4146,410,2,0
52118,2014/03/31,2012/06/11,28,3,0.71767841,3321,28,0,3
52119,2014/03/31,2012/01/27,62,2,0.637102379,3741,62,0,2
52120,2014/03/31,2011/01/13,291,2,0.985051674,2419,291,0,2
52121,2014/03/31,2012/05/01,622,2,0.7,3404,622,2,0
52122,2014/03/31,2009/09/01,311,3,0.76,3135,311,2,1
52123,2014/03/31,2012/01/25,228,4,0.632149111,3769,228,2,2
52124,2014/03/31,2008/09/08,310,3,0.350514933,6797,310,2,1
52125,2014/03/31,2010/08/12,69,5,0.678553119,3511,69,3,2
52126,2014/03/31,2006/01/17,160,4,0.51294143,4644,160,2,2
52127,2014/03/31,2012/10/31,316,3,0.681935299,3493,316,0,3
52128,2014/03/31,2012/10/14,528,2,1.0,2382,528,2,0
52129,2014/03/31,2006/06/04,549,5,0.685621762,3474,549,5,0
52130,2014/03/31,2011/11/26,503,4,0.468901359,5079,503,4,0
52131,2014/03/31,2008/01/10,600,3,0.761852207,3126,600,3,0
52132,2014/03/31,2011/03/06,339,2,0.66668533,3572,339,1,1
52133,2014/03/31,2011/11/22,239,4,0.730190126,3261,239,2,2
52134,2014/03/31,2005/04/16,590,2,0.6757451040000001,3523,590,2,0
52135,2014/03/31,2012/06/16,467,2,0.5,4761,467,2,0
52136,2014/03/31,2011/12/01,18,3,0.657412317,3621,18,1,2
52137,2014/03/31,2007/06/12,11,3,0.576666667,4128,11,0,3
52138,2014/03/31,2010/10/05,262,4,0.5602306429999999,4249,262,3,1
52139,2014/03/31,2012/08/13,391,2,0.868423933,2741,391,2,0
52140,2014/03/31,2013/02/15,30,2,0.80469236,2958,30,1,1
52141,2014/03/31,2009/11/18,69,2,0.605,3934,69,0,2
52142,2014/03/31,2009/07/28,43,2,0.605,3934,43,0,2
52143,2014/03/31,2011/10/30,19,2,0.605,3934,19,0,2
52144,2014/03/31,2012/10/05,518,2,1.0,2380,518,2,0
52145,2014/03/31,2007/12/07,550,2,0.85,2800,550,2,0
52146,2014/03/31,2010/02/07,378,3,0.684508055,3476,378,3,0
52147,2014/03/31,2011/04/17,417,3,0.4,5948,417,3,0
52148,2014/03/31,2013/02/15,86,5,0.345954043,6876,86,1,4
52149,2014/03/31,2012/02/16,77,2,0.795003342,2992,77,1,1
52150,2014/03/31,2010/04/19,51,5,0.475908363,4998,51,0,5
52151,2014/03/31,2006/05/01,69,2,0.467626819,5086,69,0,2
52152,2014/03/31,2012/04/29,100,3,0.8078125,2944,100,2,1
52153,2014/03/31,2007/06/11,368,6,0.5148517,4619,368,6,0
52154,2014/03/31,2011/05/25,132,2,0.445,5344,132,0,2
52155,2014/03/31,2010/04/23,73,2,0.926742011,2566,73,1,1
52156,2014/03/31,2011/08/10,447,2,1.0,2378,447,2,0
52157,2014/03/31,2013/03/12,27,3,0.386666667,6150,27,0,3
52158,2014/03/31,2010/10/31,364,2,1.0,2378,364,0,2
52159,2014/03/31,2009/12/25,604,4,1.025,2320,604,4,0
52160,2014/03/31,2008/03/21,519,2,0.876142225,2714,519,2,0
52161,2014/03/31,2010/02/11,105,2,0.643695181,3694,105,0,2
52162,2014/03/31,2013/01/09,437,4,0.4,5944,437,4,0
52163,2014/03/31,2013/01/09,437,4,0.4,5944,437,4,0
52164,2014/03/31,2013/01/09,437,4,0.4,5944,437,4,0
52165,2014/03/31,2009/06/30,130,7,0.7846732670000001,3030,130,3,4
52166,2014/03/31,2011/06/03,213,2,0.58,4099,213,0,2
52167,2014/03/31,2011/03/14,530,2,0.5148116070000001,4618,530,2,0
52168,2014/03/31,2012/03/11,598,3,0.753263625,3156,598,3,0
52169,2014/03/31,2012/03/28,508,3,0.5076997010000001,4682,508,3,0
52170,2014/03/31,2012/09/16,541,2,0.4,5942,541,2,0
52171,2014/03/31,2011/08/24,689,2,1.0,2376,689,2,0
52172,2014/03/31,2012/08/11,29,4,0.660155599,3599,29,2,2
52173,2014/03/31,2008/07/16,303,3,0.565789474,4199,303,1,2
52174,2014/03/31,2007/01/02,686,2,0.473375847,5018,686,2,0
52175,2014/03/31,2012/06/12,39,5,0.732,3245,39,0,5
52176,2014/03/31,2012/07/01,12,2,0.881376623,2695,12,0,2
52177,2014/03/31,2010/03/25,565,4,0.7333127509999999,3239,565,4,0
52178,2014/03/31,2012/12/22,341,5,0.571127946,4158,341,3,2
52179,2014/03/31,2011/03/15,247,2,0.838100953,2833,247,0,2
52180,2014/03/31,2012/08/07,456,3,0.7243136059999999,3278,456,3,0
52181,2014/03/31,2010/10/09,306,5,0.82,2895,306,3,2
52182,2014/03/31,2013/03/20,52,5,0.44,5395,52,0,5
52183,2014/03/31,2012/09/11,172,2,0.740159027,3207,172,0,2
52184,2014/03/31,2012/04/19,128,3,0.80568907,2946,128,1,2
52185,2014/03/31,2009/03/13,178,2,0.770808704,3079,178,0,2
52186,2014/03/31,2012/08/17,212,2,0.77,3082,212,0,2
52187,2014/03/31,2010/10/12,376,3,0.57293578,4142,376,3,0
52188,2014/03/31,2012/11/20,315,2,1.5,1582,315,1,1
52189,2014/03/31,2011/10/07,613,2,0.7,3390,613,2,0
52190,2014/03/31,2009/11/11,614,2,0.7,3390,614,2,0
52191,2014/03/31,2010/07/05,7,5,0.536013101,4427,7,1,4
52192,2014/03/31,2010/12/06,179,3,0.486730256,4875,179,1,2
52193,2014/03/31,2010/10/21,70,2,0.606472393,3912,70,0,2
52194,2014/03/31,2013/03/31,290,3,0.45,5272,290,1,2
52195,2014/03/31,2013/02/07,419,2,0.651221521,3643,419,2,0
52196,2014/03/31,2013/02/09,122,2,0.655067661,3621,122,0,2
52197,2014/03/31,2012/09/26,226,2,0.8675566929999999,2734,226,1,1
52198,2014/03/31,2008/06/12,382,2,0.908039816,2612,382,2,0
52199,2014/03/31,2009/12/14,6,4,0.71674524,3309,6,0,4
52200,2014/03/31,2012/05/23,359,2,0.725949173,3266,359,1,1
52201,2014/03/31,2011/06/18,325,2,0.525,4516,325,1,1
52202,2014/03/31,2012/10/24,104,5,0.7040184140000001,3367,104,3,2
52203,2014/03/31,2007/10/16,656,4,0.6669667979999999,3554,656,4,0
52204,2014/03/31,2012/09/12,558,2,1.0,2370,558,2,0
52205,2014/03/31,2012/04/13,386,2,0.7667259790000001,3091,386,2,0
52206,2014/03/31,2010/04/27,49,4,0.86876421,2727,49,0,4
52207,2014/03/31,2007/02/23,555,2,1.0,2369,555,2,0
52208,2014/03/31,2011/09/18,529,3,0.933333333,2538,529,3,0
52209,2014/03/31,2013/03/20,214,2,0.8635800220000001,2743,214,0,2
52210,2014/03/31,2012/11/03,230,3,0.573403534,4131,230,2,1
52211,2014/03/31,2012/07/27,156,2,0.552086247,4290,156,1,1
52212,2014/03/31,2007/03/01,122,3,0.413333333,5730,122,1,2
52213,2014/03/31,2005/07/25,242,4,0.62,3820,242,0,4
52214,2014/03/31,2010/04/02,525,2,0.475,4986,525,2,0
52215,2014/03/31,2011/08/27,647,3,0.493786489,4796,647,3,0
52216,2014/03/31,2009/01/01,20,5,0.386071079,6134,20,0,5
52217,2014/03/31,2013/01/06,447,2,0.5,4736,447,2,0
52218,2014/03/31,2011/04/14,522,2,0.5,4736,522,2,0
52219,2014/03/31,2012/02/17,278,4,0.5595321360000001,4232,278,2,2
52220,2014/03/31,2008/05/10,82,2,0.57,4154,82,0,2
52221,2014/03/31,2010/08/16,2,3,0.38,6231,2,0,3
52222,2014/03/31,2009/02/20,24,3,0.38,6231,24,0,3
52223,2014/03/31,2013/03/15,11,3,0.560836295,4221,11,1,2
52224,2014/03/31,2012/07/31,451,2,0.640289424,3697,451,2,0
52225,2014/03/31,2009/10/09,558,2,0.720139945,3287,558,2,0
52226,2014/03/31,2007/08/12,330,3,0.645310796,3668,330,2,1
52227,2014/03/31,2008/10/09,559,6,1.0,2367,559,6,0
52228,2014/03/31,2011/11/27,273,4,0.53166442,4452,273,1,3
52229,2014/03/31,2007/06/01,130,2,0.86,2752,130,0,2
52230,2014/03/31,2011/12/23,232,4,0.837473461,2826,232,3,1
52231,2014/03/31,2009/07/21,10,4,0.566409765,4178,10,0,4
52232,2014/03/31,2011/10/01,279,4,0.46,5144,279,2,2
52233,2014/03/31,2007/09/09,397,3,0.6674189,3545,397,3,0
52234,2014/03/31,2012/04/21,599,2,0.98501249,2402,599,2,0
52235,2014/03/31,2012/09/19,95,4,0.41878187,5648,95,2,2
52236,2014/03/31,2011/05/09,221,2,0.722073282,3275,221,0,2
52237,2014/03/31,2012/08/24,586,2,0.973281186,2429,586,2,0
52238,2014/03/31,2006/04/12,34,4,0.429094209,5509,34,2,2
52239,2014/03/31,2013/02/28,8,5,0.438,5395,8,0,5
52240,2014/03/31,2007/06/08,544,2,0.85,2780,544,2,0
52241,2014/03/31,2013/03/31,305,3,0.730426584,3235,305,1,2
52242,2014/03/31,2012/04/29,22,2,0.584287834,4044,22,1,1
52243,2014/03/31,2008/06/12,346,4,0.972098765,2430,346,2,2
52244,2014/03/31,2007/10/16,81,3,0.6883328479999999,3431,81,0,3
52245,2014/03/31,2008/12/03,118,4,0.630037353,3748,118,1,3
52246,2014/03/31,2011/01/14,164,3,0.796666667,2964,164,0,3
52247,2014/03/31,2012/03/15,78,3,0.591789474,3990,78,2,1
52248,2014/03/31,2013/02/10,243,2,0.661220947,3571,243,1,1
52249,2014/03/31,2008/07/07,68,5,0.485240444,4866,68,1,4
52250,2014/03/31,2012/10/20,198,2,0.7050104509999999,3349,198,1,1
52251,2014/03/31,2011/12/29,179,3,0.394989125,5977,179,2,1
52252,2014/03/31,2011/05/23,168,2,0.92,2566,168,0,2
52253,2014/03/31,2010/06/10,71,3,0.429907121,5491,71,0,3
52254,2014/03/31,2010/07/29,578,3,0.961115635,2456,578,3,0
52255,2014/03/31,2011/11/06,643,2,0.6,3934,643,2,0
52256,2014/03/31,2011/09/24,721,2,0.6,3934,721,2,0
52257,2014/03/31,2012/08/10,497,2,0.6,3934,497,2,0
52258,2014/03/31,2012/09/03,548,2,0.6,3934,548,2,0
52259,2014/03/31,2011/11/09,486,3,0.4,5901,486,3,0
52260,2014/03/31,2012/12/25,441,2,0.6,3934,441,2,0
52261,2014/03/31,2012/12/26,387,2,0.6,3934,387,2,0
52262,2014/03/31,2007/01/12,528,2,0.6,3934,528,2,0
52263,2014/03/31,2013/01/10,441,3,1.0,2360,441,3,0
52264,2014/03/31,2008/01/29,11,2,0.8565880220000001,2755,11,0,2
52265,2014/03/31,2012/01/14,153,3,0.660652296,3572,153,2,1
52266,2014/03/31,2010/07/10,316,2,0.712715192,3311,316,1,1
52267,2014/03/31,2007/10/30,605,2,0.666610169,3540,605,2,0
52268,2014/03/31,2012/12/14,207,3,0.7955731629999999,2966,207,0,3
52269,2014/03/31,2010/09/27,30,4,0.6841548270000001,3449,30,0,4
52270,2014/03/31,2006/04/18,351,3,0.648721474,3637,351,2,1
52271,2014/03/31,2011/10/26,17,4,0.8906002270000001,2649,17,2,2
52272,2014/03/31,2010/01/25,1,4,0.479108448,4924,1,1,3
52273,2014/03/31,2008/03/27,364,3,0.440751121,5352,364,2,1
52274,2014/03/31,2006/05/11,1,2,0.415,5684,1,0,2
52275,2014/03/31,2012/04/17,269,3,0.746436709,3160,269,2,1
52276,2014/03/31,2007/04/25,629,3,0.846894075,2785,629,3,0
52277,2014/03/31,2012/10/12,73,3,0.481383956,4899,73,2,1
52278,2014/03/31,2013/03/10,388,2,0.624715232,3775,388,2,0
52279,2014/03/31,2012/09/26,224,3,0.952423263,2476,224,2,1
52280,2014/03/31,2012/04/29,274,3,1.09,2163,274,1,2
52281,2014/03/31,2011/07/17,679,3,0.572776968,4116,679,3,0
52282,2014/03/31,2012/02/09,435,4,0.33387622100000003,7061,435,4,0
52283,2014/03/31,2007/01/16,342,2,0.7198167940000001,3275,342,1,1
52284,2014/03/31,2007/05/06,538,2,0.671595442,3510,538,2,0
52285,2014/03/31,2013/01/10,4,3,0.33284947800000003,7082,4,1,2
52286,2014/03/31,2011/12/17,169,4,0.74359306,3170,169,2,2
52287,2014/03/31,2011/11/18,497,2,0.79976247,2947,497,2,0
52288,2014/03/31,2009/08/09,110,2,0.582841949,4043,110,0,2
52289,2014/03/31,2013/01/13,83,3,0.489159228,4817,83,0,3
52290,2014/03/31,2012/03/11,675,3,0.621537853,3791,675,3,0
52291,2014/03/31,2010/03/02,4,2,0.809124313,2912,4,0,2
52292,2014/03/31,2010/02/17,416,3,0.5628912779999999,4185,416,3,0
52293,2014/03/31,2012/04/30,191,3,0.70382432,3347,191,1,2
52294,2014/03/31,2007/03/01,29,4,0.6758020090000001,3485,29,0,4
52295,2014/03/31,2008/10/25,209,4,0.723526882,3255,209,2,2
52296,2014/03/31,2012/05/28,261,3,0.904389401,2604,261,1,2
52297,2014/03/31,2007/12/03,121,2,0.607425845,3877,121,0,2
52298,2014/03/31,2012/12/26,45,3,0.7395288940000001,3184,45,0,3
52299,2014/03/31,2012/08/29,490,3,0.378597845,6219,490,3,0
52300,2014/03/31,2008/01/15,480,2,0.9,2616,480,2,0
52301,2014/03/31,2005/07/07,424,2,0.9,2616,424,2,0
52302,2014/03/31,2012/11/02,478,2,0.9,2616,478,2,0
52303,2014/03/31,2005/05/09,401,2,0.9,2616,401,2,0
52304,2014/03/31,2009/08/11,324,2,0.9,2616,324,0,2
52305,2014/03/31,2009/09/25,621,2,0.9,2616,621,2,0
52306,2014/03/31,2012/03/17,576,2,0.9,2616,576,2,0
52307,2014/03/31,2013/01/28,187,2,0.92,2559,187,0,2
52308,2014/03/31,2005/04/06,91,3,0.82,2871,91,0,3
52309,2014/03/31,2012/09/22,410,2,0.728854489,3230,410,2,0
52310,2014/03/31,2010/03/28,139,4,0.4925,4780,139,1,3
52311,2014/03/31,2009/09/09,684,2,0.623576159,3775,684,2,0
52312,2014/03/31,2009/02/08,61,5,0.5313589160000001,4430,61,1,4
52313,2014/03/31,2013/01/22,76,3,0.7007442690000001,3359,76,0,3
52314,2014/03/31,2007/06/08,160,3,0.588879159,3997,160,0,3
52315,2014/03/31,2011/03/27,368,2,0.8627565979999999,2728,368,2,0
52316,2014/03/31,2004/12/16,100,6,0.455626331,5165,100,3,3
52317,2014/03/31,2010/06/29,325,4,0.734701842,3203,325,2,2
52318,2014/03/31,2012/10/09,199,3,0.495306251,4751,199,1,2
52319,2014/03/31,2010/04/15,101,5,0.528651988,4451,101,0,5
52320,2014/03/31,2007/08/23,64,2,0.875364583,2688,64,0,2
52321,2014/03/31,2009/09/15,441,4,0.78166113,3010,441,4,0
52322,2014/03/31,2013/02/19,122,3,0.700607504,3358,122,1,2
52323,2014/03/31,2012/12/27,309,2,0.628869286,3741,309,1,1
52324,2014/03/31,2010/11/28,528,2,0.6,3921,528,2,0
52325,2014/03/31,2012/10/24,424,4,0.725,3244,424,4,0
52326,2014/03/31,2006/09/15,200,2,0.682897793,3444,200,1,1
52327,2014/03/31,2006/11/01,64,2,0.9045,2600,64,1,1
52328,2014/03/31,2007/06/28,307,3,0.618028909,3805,307,2,1
52329,2014/03/31,2012/08/22,179,5,0.28051539,8382,179,4,1
52330,2014/03/31,2012/08/14,509,2,0.625,3762,509,2,0
52331,2014/03/31,2010/05/18,254,2,0.8457553959999999,2780,254,0,2
52332,2014/03/31,2012/09/18,365,2,0.971971889,2419,365,0,2
52333,2014/03/31,2009/04/07,198,3,0.84,2799,198,0,3
52334,2014/03/31,2008/03/13,1,3,0.638159609,3684,1,0,3
52335,2014/03/31,2012/09/25,35,4,0.3760928,6250,35,1,3
52336,2014/03/31,2008/03/26,226,2,0.670973451,3503,226,1,1
52337,2014/03/31,2012/05/15,191,5,0.909442724,2584,191,1,4
52338,2014/03/31,2009/10/18,272,2,0.734967157,3197,272,0,2
52339,2014/03/31,2008/02/20,313,2,0.664104014,3538,313,1,1
52340,2014/03/31,2012/06/13,423,2,0.4,5873,423,2,0
52341,2014/03/31,2009/12/08,189,2,0.830053004,2830,189,0,2
52342,2014/03/31,2011/06/14,162,2,0.6996872209999999,3357,162,1,1
52343,2014/03/31,2006/04/20,160,4,0.930194059,2525,160,2,2
52344,2014/03/31,2008/10/24,591,3,0.881644144,2664,591,3,0
52345,2014/03/31,2008/05/09,411,2,0.68055636,3451,411,2,0
52346,2014/03/31,2012/11/28,347,2,0.875615213,2682,347,1,1
52347,2014/03/31,2011/10/29,655,2,0.65176242,3603,655,2,0
52348,2014/03/31,2010/10/22,183,4,0.451644547,5199,183,3,1
52349,2014/03/31,2007/01/05,43,2,0.697170428,3368,43,0,2
52350,2014/03/31,2010/04/06,175,3,0.56356217,4166,175,0,3
52351,2014/03/31,2010/08/24,175,3,0.56356217,4166,175,0,3
52352,2014/03/31,2008/09/09,66,2,0.7375871820000001,3183,66,1,1
52353,2014/03/31,2007/11/17,296,4,0.902629758,2601,296,1,3
52354,2014/03/31,2006/04/09,260,5,0.321879885,7293,260,4,1
52355,2014/03/31,2011/11/23,698,2,0.55,4268,698,2,0
52356,2014/03/31,2007/03/26,316,2,0.55,4268,316,0,2
52357,2014/03/31,2012/05/02,694,2,0.55,4268,694,2,0
52358,2014/03/31,2011/07/03,715,2,0.55,4268,715,2,0
52359,2014/03/31,2012/09/29,502,2,0.55,4268,502,2,0
52360,2014/03/31,2013/01/22,429,2,0.55,4268,429,2,0
52361,2014/03/31,2012/09/20,555,2,0.55,4268,555,2,0
52362,2014/03/31,2013/03/08,367,2,0.55,4268,367,2,0
52363,2014/03/31,2011/04/06,120,5,0.408808777,5742,120,2,3
52364,2014/03/31,2008/03/01,61,2,0.72,3260,61,0,2
52365,2014/03/31,2011/06/06,641,3,0.597353016,3929,641,3,0
52366,2014/03/31,2006/06/17,172,3,0.764980443,3068,172,0,3
52367,2014/03/31,2008/04/15,291,3,0.500383795,4690,291,1,2
52368,2014/03/31,2008/03/10,13,3,0.625937583,3749,13,1,2
52369,2014/03/31,2011/02/22,544,2,0.517328042,4536,544,2,0
52370,2014/03/31,2011/09/01,301,4,0.454474143,5163,301,3,1
52371,2014/03/31,2005/10/31,14,5,0.577065912,4066,14,3,2
52372,2014/03/31,2008/04/09,440,3,0.401463039,5844,440,3,0
52373,2014/03/31,2011/12/09,331,3,0.572474378,4098,331,1,2
52374,2014/03/31,2011/12/13,49,3,1.046666667,2241,49,1,2
52375,2014/03/31,2012/08/24,321,5,0.365464319,6418,321,4,1
52376,2014/03/31,2009/01/24,18,2,0.792914131,2958,18,1,1
52377,2014/03/31,2012/12/19,20,6,0.552161526,4247,20,1,5
52378,2014/03/31,2007/04/29,29,2,0.575,4078,29,0,2
52379,2014/03/31,2012/01/11,75,6,0.51358598,4565,75,2,4
52380,2014/03/31,2007/12/30,550,2,0.882699548,2656,550,2,0
52381,2014/03/31,2012/09/22,430,4,0.648354535,3616,430,4,0
52382,2014/03/31,2010/05/28,139,2,0.743023772,3155,139,1,1
52383,2014/03/31,2011/07/30,116,4,0.5844228370000001,4011,116,2,2
52384,2014/03/31,2008/08/10,718,2,0.8,2930,718,2,0
52385,2014/03/31,2010/08/16,74,2,0.688370044,3405,74,0,2
52386,2014/03/31,2010/07/17,443,2,0.9,2604,443,2,0
52387,2014/03/31,2009/03/10,27,2,0.798755965,2934,27,0,2
52388,2014/03/31,2012/07/10,288,3,0.715893676,3273,288,2,1
52389,2014/03/31,2011/06/14,135,3,0.473451202,4949,135,1,2
52390,2014/03/31,2007/04/04,280,4,0.819769069,2858,280,3,1
52391,2014/03/31,2012/11/13,126,3,0.823021785,2846,126,0,3
52392,2014/03/31,2007/09/01,26,3,0.978404344,2394,26,0,3
52393,2014/03/31,2011/01/14,381,3,0.6197671339999999,3779,381,3,0
52394,2014/03/31,2007/11/16,519,5,0.579715347,4040,519,5,0
52395,2014/03/31,2010/03/28,568,2,1.0,2342,568,2,0
52396,2014/03/31,2012/05/24,673,2,1.0,2342,673,2,0
52397,2014/03/31,2012/11/01,507,2,0.55,4258,507,2,0
52398,2014/03/31,2011/08/11,46,3,0.931129225,2515,46,1,2
52399,2014/03/31,2008/10/01,503,3,0.503104856,4654,503,3,0
52400,2014/03/31,2012/10/15,149,3,0.538610536,4347,149,1,2
52401,2014/03/31,2013/02/24,44,4,0.4475,5232,44,1,3
52402,2014/03/31,2013/02/27,46,2,0.6977436659999999,3355,46,0,2
52403,2014/03/31,2010/07/01,122,4,0.473838057,4940,122,0,4
52404,2014/03/31,2012/07/05,206,2,0.595,3934,206,1,1
52405,2014/03/31,2005/08/17,83,2,0.595,3934,83,0,2
52406,2014/03/31,2005/12/18,182,2,1.260387722,1857,182,0,2
52407,2014/03/31,2009/10/13,38,2,0.589252266,3972,38,0,2
52408,2014/03/31,2009/11/12,491,3,0.652845188,3585,491,3,0
52409,2014/03/31,2006/06/30,218,2,0.625,3744,218,0,2
52410,2014/03/31,2011/07/20,134,4,0.426426098,5487,134,2,2
52411,2014/03/31,2006/06/12,687,2,0.907799767,2577,687,2,0
52412,2014/03/31,2010/02/27,13,4,0.707990315,3304,13,0,4
52413,2014/03/31,2011/03/21,589,2,0.539584775,4335,589,2,0
52414,2014/03/31,2011/07/24,342,2,0.654223776,3575,342,1,1
52415,2014/03/31,2012/01/01,352,5,0.607035306,3852,352,3,2
52416,2014/03/31,2009/01/19,314,2,0.7395128120000001,3161,314,0,2
52417,2014/03/31,2012/11/22,182,5,0.5640444020000001,4144,182,1,4
52418,2014/03/31,2011/06/02,383,2,0.49634742,4709,383,2,0
52419,2014/03/31,2013/01/01,118,4,0.909770339,2569,118,0,4
52420,2014/03/31,2006/06/16,207,4,0.367757318,6354,207,3,1
52421,2014/03/31,2012/03/29,320,4,0.9,2596,320,2,2
52422,2014/03/31,2007/02/07,312,3,0.453054101,5157,312,2,1
52423,2014/03/31,2011/04/05,590,2,0.4,5840,590,2,0
52424,2014/03/31,2008/08/27,10,5,0.526914054,4433,10,0,5
52425,2014/03/31,2008/07/14,606,4,0.562512042,4152,606,4,0
52426,2014/03/31,2012/12/15,294,3,0.5474683539999999,4266,294,1,2
52427,2014/03/31,2008/03/14,25,3,0.616059087,3791,25,0,3
52428,2014/03/31,2012/04/11,63,3,0.79327106,2944,63,2,1
52429,2014/03/31,2009/12/15,7,5,0.518145108,4507,7,1,4
52430,2014/03/31,2012/11/01,508,2,0.641891149,3638,508,2,0
52431,2014/03/31,2007/04/22,2,7,0.399712427,5842,2,0,7
52432,2014/03/31,2012/10/13,507,3,0.416901786,5600,507,3,0
52433,2014/03/31,2006/09/25,3,3,0.6590965560000001,3542,3,1,2
52434,2014/03/31,2012/01/30,158,4,0.742021615,3146,158,3,1
52435,2014/03/31,2011/10/23,382,2,0.643044077,3630,382,2,0
52436,2014/03/31,2006/09/13,21,6,0.622764141,3748,21,0,6
52437,2014/03/31,2013/02/06,118,3,1.29168788,1807,118,2,1
52438,2014/03/31,2009/08/20,109,3,0.6308,3700,109,0,3
52439,2014/03/31,2010/08/01,92,3,0.672995963,3468,92,0,3
52440,2014/03/31,2011/05/09,670,2,0.637568306,3660,670,2,0
52441,2014/03/31,2009/07/23,35,3,0.5774437020000001,4041,35,0,3
52442,2014/03/31,2012/05/22,112,3,0.49421309,4721,112,1,2
52443,2014/03/31,2009/03/27,264,3,0.662995169,3519,264,0,3
52444,2014/03/31,2006/10/05,85,5,0.7687215820000001,3035,85,1,4
52445,2014/03/31,2010/09/12,334,4,0.705701754,3306,334,2,2
52446,2014/03/31,2010/09/20,217,4,0.495,4712,217,0,4
52447,2014/03/31,2010/07/05,121,6,0.34769230799999995,6708,121,2,4
52448,2014/03/31,2007/09/27,23,3,0.444914155,5242,23,2,1
52449,2014/03/31,2006/04/13,516,3,0.810354413,2878,516,3,0
52450,2014/03/31,2010/02/26,707,2,0.768181818,3036,707,2,0
52451,2014/03/31,2009/12/23,41,5,0.42823173,5446,41,1,4
52452,2014/03/31,2005/01/11,22,4,0.7841324820000001,2974,22,2,2
52453,2014/03/31,2013/02/01,46,4,0.719753086,3240,46,0,4
52454,2014/03/31,2005/11/16,282,2,0.45,5182,282,0,2
52455,2014/03/31,2005/11/01,199,4,0.29,8040,199,1,3
52456,2014/03/31,2011/08/16,498,4,0.321157025,7260,498,4,0
52457,2014/03/31,2013/01/14,434,2,0.655143339,3558,434,2,0
52458,2014/03/31,2006/11/20,231,3,0.669827586,3480,231,2,1
52459,2014/03/31,2012/10/02,200,4,0.449279106,5188,200,0,4
52460,2014/03/31,2011/10/31,41,3,0.34,6855,41,1,2
52461,2014/03/31,2011/11/22,562,2,0.500891898,4653,562,2,0
52462,2014/03/31,2011/08/12,495,4,0.514777999,4527,495,4,0
52463,2014/03/31,2011/09/11,672,4,0.4875,4780,672,4,0
52464,2014/03/31,2012/08/19,578,2,0.8601698040000001,2709,578,2,0
52465,2014/03/31,2007/03/06,70,4,0.6742361109999999,3456,70,1,3
52466,2014/03/31,2009/11/27,181,3,0.352105184,6617,181,2,1
52467,2014/03/31,2011/01/14,340,5,0.463908801,5022,340,3,2
52468,2014/03/31,2009/11/30,62,3,0.678157205,3435,62,1,2
52469,2014/03/31,2005/09/12,22,4,0.681720808,3417,22,1,3
52470,2014/03/31,2011/06/23,14,6,0.540596426,4309,14,3,3
52471,2014/03/31,2012/09/01,169,3,0.762665357,3054,169,0,3
52472,2014/03/31,2012/08/09,298,2,0.96,2426,298,1,1
52473,2014/03/31,2011/01/20,298,3,0.8097009740000001,2876,298,1,2
52474,2014/03/31,2013/02/07,237,3,0.927569721,2510,237,1,2
52475,2014/03/31,2006/02/25,403,2,0.7376742709999999,3156,403,2,0
52476,2014/03/31,2010/08/01,271,3,0.793867667,2932,271,1,2
52477,2014/03/31,2012/10/08,184,3,0.742693044,3134,184,1,2
52478,2014/03/31,2012/03/24,13,5,0.804,2895,13,2,3
52479,2014/03/31,2013/02/27,93,2,0.590891089,3939,93,0,2
52480,2014/03/31,2008/12/28,545,3,0.8,2909,545,3,0
52481,2014/03/31,2007/07/18,32,3,0.4652499,5002,32,0,3
52482,2014/03/31,2010/11/17,191,3,0.728581716,3194,191,0,3
52483,2014/03/31,2011/12/26,13,3,0.33993718,6845,13,2,1
52484,2014/03/31,2010/10/30,635,2,0.7,3324,635,2,0
52485,2014/03/31,2007/12/21,112,2,0.721022939,3226,112,1,1
52486,2014/03/31,2008/08/01,251,3,0.761086387,3056,251,2,1
52487,2014/03/31,2006/04/24,202,4,0.799776479,2908,202,3,1
52488,2014/03/31,2012/11/22,102,5,0.442157795,5260,102,4,1
52489,2014/03/31,2009/10/21,265,2,0.6972863570000001,3335,265,0,2
52490,2014/03/31,2008/04/11,635,2,0.76468267,3041,635,2,0
52491,2014/03/31,2012/12/08,278,2,1.455,1598,278,1,1
52492,2014/03/31,2012/04/03,665,3,0.837536023,2776,665,3,0
52493,2014/03/31,2007/08/16,102,2,0.860451517,2702,102,0,2
52494,2014/03/31,2011/05/30,278,3,0.56336888,4126,278,0,3
52495,2014/03/31,2007/09/22,85,2,0.844008715,2754,85,0,2
52496,2014/03/31,2006/04/24,446,3,0.7299937190000001,3184,446,3,0
52497,2014/03/31,2012/05/13,381,3,0.342066529,6794,381,3,0
52498,2014/03/31,2010/05/23,34,3,0.553333333,4200,34,0,3
52499,2014/03/31,2008/04/30,28,2,0.43,5404,28,0,2
52500,2014/03/31,2012/03/03,104,4,0.487864791,4763,104,0,4
52501,2014/03/31,2011/06/18,433,2,1.5,1549,433,2,0
52502,2014/03/31,2012/05/13,36,2,0.913231132,2544,36,1,1
52503,2014/03/31,2013/01/11,131,2,0.744103139,3122,131,1,1
52504,2014/03/31,2009/08/07,197,3,0.563297769,4124,197,2,1
52505,2014/03/31,2013/02/26,9,3,0.813642732,2855,9,0,3
52506,2014/03/31,2012/08/20,502,3,0.966666667,2403,502,3,0
52507,2014/03/31,2011/07/07,270,2,0.907659242,2559,270,0,2
52508,2014/03/31,2012/06/23,62,2,0.697378378,3330,62,1,1
52509,2014/03/31,2012/04/06,719,2,0.8923904690000001,2602,719,2,0
52510,2014/03/31,2013/02/27,48,6,0.693119403,3350,48,0,6
52511,2014/03/31,2010/11/01,186,3,0.409337094,5672,186,2,1
52512,2014/03/31,2006/06/11,494,2,0.8069169270000001,2877,494,2,0
52513,2014/03/31,2013/01/06,287,3,0.8069169270000001,2877,287,2,1
52514,2014/03/31,2013/01/25,427,2,0.744022436,3120,427,2,0
52515,2014/03/31,2012/01/28,265,3,0.644968047,3599,265,1,2
52516,2014/03/31,2008/04/23,312,2,0.8505679740000001,2729,312,1,1
52517,2014/03/31,2011/01/13,156,2,0.59,3934,156,1,1
52518,2014/03/31,2011/07/12,375,4,0.7259931190000001,3197,375,4,0
52519,2014/03/31,2010/12/15,445,5,0.623341391,3723,445,5,0
52520,2014/03/31,2010/02/10,31,2,0.90436477,2566,31,0,2
52521,2014/03/31,2008/04/27,633,2,0.7737912640000001,2999,633,2,0
52522,2014/03/31,2012/04/12,220,2,0.86350949,2687,220,1,1
52523,2014/03/31,2012/03/10,157,6,0.666666667,3480,157,4,2
52524,2014/03/31,2012/02/22,650,4,1.0,2320,650,4,0
52525,2014/03/31,2012/07/24,43,4,0.4325,5364,43,2,2
52526,2014/03/31,2010/11/29,23,5,0.458886251,5055,23,2,3
52527,2014/03/31,2009/07/25,15,3,0.453135991,5118,15,0,3
52528,2014/03/31,2013/01/26,32,5,0.818,2835,32,1,4
52529,2014/03/31,2010/06/28,324,3,0.897059961,2585,324,2,1
52530,2014/03/31,2012/04/12,614,4,0.70025672,3311,614,4,0
52531,2014/03/31,2005/11/10,15,4,0.6294922620000001,3683,15,0,4
52532,2014/03/31,2005/09/15,47,2,0.955564716,2426,47,1,1
52533,2014/03/31,2012/01/09,54,5,0.715257637,3241,54,1,4
52534,2014/03/31,2012/08/14,105,3,0.389710827,5948,105,1,2
52535,2014/03/31,2009/12/19,117,2,0.545096425,4252,117,0,2
52536,2014/03/31,2008/10/29,105,4,0.511837456,4528,105,2,2
52537,2014/03/31,2007/09/03,104,3,0.6754648790000001,3431,104,2,1
52538,2014/03/31,2006/11/06,4,2,0.855,2710,4,0,2
52539,2014/03/31,2010/01/12,207,2,0.7118095240000001,3255,207,0,2
52540,2014/03/31,2008/02/10,62,2,0.61382088,3774,62,0,2
52541,2014/03/31,2013/02/18,21,6,0.461538155,5019,21,0,6
52542,2014/03/31,2010/08/21,59,4,0.659203187,3514,59,1,3
52543,2014/03/31,2013/01/01,414,2,0.4,5791,414,2,0
52544,2014/03/31,2008/09/11,104,3,0.6490193329999999,3569,104,1,2
52545,2014/03/31,2012/10/13,11,3,0.625356371,3704,11,1,2
52546,2014/03/31,2012/09/08,431,4,1.0,2316,431,4,0
52547,2014/03/31,2005/10/08,10,3,0.816931217,2835,10,0,3
52548,2014/03/31,2013/03/12,5,3,0.648831605,3569,5,0,3
52549,2014/03/31,2011/04/03,159,6,0.469420231,4933,159,4,2
52550,2014/03/31,2005/09/14,146,4,0.548210227,4224,146,1,3
52551,2014/03/31,2013/02/03,411,2,0.7,3308,411,2,0
52552,2014/03/31,2008/08/24,187,3,0.724704225,3195,187,1,2
52553,2014/03/31,2013/02/23,48,3,0.59,3924,48,1,2
52554,2014/03/31,2011/09/30,33,4,0.4933177070000001,4693,33,0,4
52555,2014/03/31,2011/04/13,264,2,0.5135314999999999,4508,264,1,1
52556,2014/03/31,2008/08/21,53,3,0.526666667,4395,53,2,1
52557,2014/03/31,2013/03/28,79,4,0.7576563009999999,3055,79,0,4
52558,2014/03/31,2011/05/02,111,5,0.565785871,4091,111,1,4
52559,2014/03/31,2009/08/15,100,2,0.526994536,4392,100,1,1
52560,2014/03/31,2012/04/02,724,2,0.65,3560,724,2,0
52561,2014/03/31,2012/04/02,724,2,0.65,3560,724,2,0
52562,2014/03/31,2012/04/02,724,2,0.65,3560,724,2,0
52563,2014/03/31,2011/12/01,623,2,0.65,3560,623,2,0
52564,2014/03/31,2012/09/26,442,2,0.8,2892,442,2,0
52565,2014/03/31,2007/09/04,33,2,0.8,2892,33,0,2
52566,2014/03/31,2009/11/16,502,2,0.8,2892,502,2,0
52567,2014/03/31,2012/10/10,372,2,0.580235766,3987,372,2,0
52568,2014/03/31,2010/12/12,353,3,0.381497361,6064,353,1,2
52569,2014/03/31,2008/11/24,337,2,0.7461935479999999,3100,337,0,2
52570,2014/03/31,2013/03/05,94,4,0.5292107070000001,4371,94,0,4
52571,2014/03/31,2013/02/21,110,2,0.67027818,3451,110,0,2
52572,2014/03/31,2012/07/28,581,2,0.741615903,3119,581,2,0
52573,2014/03/31,2012/07/27,515,3,1.0,2313,515,3,0
52574,2014/03/31,2007/07/23,38,3,0.763333333,3030,38,0,3
52575,2014/03/31,2008/10/23,305,2,0.596543719,3877,305,1,1
52576,2014/03/31,2009/11/12,583,4,0.943168842,2452,583,4,0
52577,2014/03/31,2012/11/01,394,3,0.412910714,5600,394,3,0
52578,2014/03/31,2006/05/29,530,3,0.6828854109999999,3386,530,3,0
52579,2014/03/31,2006/02/22,664,5,0.690119403,3350,664,5,0
52580,2014/03/31,2012/11/16,478,2,0.75,3082,478,2,0
52581,2014/03/31,2010/01/02,683,2,0.575,4020,683,2,0
52582,2014/03/31,2008/08/16,106,2,0.941123779,2456,106,0,2
52583,2014/03/31,2006/04/08,126,2,0.470242116,4915,126,0,2
52584,2014/03/31,2012/01/17,90,4,0.787325383,2935,90,3,1
52585,2014/03/31,2011/12/30,163,3,0.6676249639999999,3461,163,1,2
52586,2014/03/31,2011/01/24,358,4,0.622816712,3710,358,3,1
52587,2014/03/31,2012/12/25,238,4,0.527381876,4381,238,0,4
52588,2014/03/31,2008/04/07,131,3,0.417475605,5534,131,1,2
52589,2014/03/31,2011/08/07,129,6,0.516354493,4474,129,4,2
52590,2014/03/31,2011/07/15,432,4,0.6245336579999999,3699,432,4,0
52591,2014/03/31,2007/04/16,483,2,1.0,2310,483,2,0
52592,2014/03/31,2009/04/19,19,3,0.535944316,4310,19,0,3
52593,2014/03/31,2008/06/18,440,2,0.796517241,2900,440,2,0
52594,2014/03/31,2006/01/06,390,2,0.796517241,2900,390,2,0
52595,2014/03/31,2011/06/15,621,2,0.796517241,2900,621,2,0
52596,2014/03/31,2006/08/07,341,2,0.571720297,4040,341,1,1
52597,2014/03/31,2005/12/02,286,3,0.7856515820000001,2939,286,1,2
52598,2014/03/31,2012/06/23,433,4,0.347740964,6640,433,4,0
52599,2014/03/31,2012/10/24,27,2,0.8064722320000001,2863,27,1,1
52600,2014/03/31,2012/05/29,16,2,0.8064722320000001,2863,16,1,1
52601,2014/03/31,2013/02/14,129,5,0.753265905,3065,129,1,4
52602,2014/03/31,2011/07/26,459,2,0.655880682,3520,459,2,0
52603,2014/03/31,2012/06/19,329,3,0.39763176,5806,329,1,2
52604,2014/03/31,2011/05/11,85,4,0.639421053,3610,85,2,2
52605,2014/03/31,2008/11/04,29,4,0.4412483270000001,5231,29,1,3
52606,2014/03/31,2007/09/16,82,3,0.758235874,3044,82,1,2
52607,2014/03/31,2012/09/15,532,2,1.0,2308,532,2,0
52608,2014/03/31,2012/06/05,288,3,0.418382886,5516,288,1,2
52609,2014/03/31,2008/05/20,54,3,0.3666666670000001,6294,54,0,3
52610,2014/03/31,2008/01/25,498,2,0.55,4196,498,2,0
52611,2014/03/31,2007/02/03,675,2,0.55,4196,675,2,0
52612,2014/03/31,2006/06/09,76,3,0.475610058,4852,76,0,3
52613,2014/03/31,2006/10/03,172,3,0.386666667,5967,172,1,2
52614,2014/03/31,2009/09/21,99,2,0.640352484,3603,99,1,1
52615,2014/03/31,2011/05/09,59,2,0.575751373,4006,59,1,1
52616,2014/03/31,2013/01/24,83,3,0.394199282,5851,83,2,1
52617,2014/03/31,2006/06/26,2,4,0.440416269,5237,2,0,4
52618,2014/03/31,2011/05/25,251,6,0.846666667,2724,251,5,1
52619,2014/03/31,2011/11/16,388,5,0.8494475140000001,2715,388,5,0
52620,2014/03/31,2007/07/07,677,3,0.8666666670000001,2661,677,3,0
52621,2014/03/31,2012/07/31,350,4,0.676260997,3410,350,3,1
52622,2014/03/31,2007/07/14,167,3,0.537809657,4287,167,2,1
52623,2014/03/31,2011/01/01,704,2,0.75,3074,704,2,0
52624,2014/03/31,2009/11/10,6,3,0.783333333,2943,6,0,3
52625,2014/03/31,2008/05/14,148,2,0.7241941559999999,3183,148,0,2
52626,2014/03/31,2008/01/29,101,2,0.8675573959999999,2657,101,1,1
52627,2014/03/31,2008/02/07,110,3,0.656341116,3512,110,0,3
52628,2014/03/31,2007/02/10,472,3,0.668115942,3450,472,3,0
52629,2014/03/31,2011/03/07,164,2,0.426511843,5404,164,0,2
52630,2014/03/31,2012/10/23,502,2,0.4,5762,502,2,0
52631,2014/03/31,2008/12/19,141,3,0.514800089,4477,141,2,1
52632,2014/03/31,2013/02/08,377,3,0.586437659,3930,377,3,0
52633,2014/03/31,2008/02/18,111,4,0.512124444,4500,111,2,2
52634,2014/03/31,2012/05/25,21,3,0.617166577,3734,21,2,1
52635,2014/03/31,2009/12/08,78,3,0.5033333329999999,4578,78,1,2
52636,2014/03/31,2010/06/11,606,3,0.492455653,4679,606,3,0
52637,2014/03/31,2013/02/24,318,4,0.8875,2596,318,1,3
52638,2014/03/31,2008/04/16,89,5,0.71,3245,89,0,5
52639,2014/03/31,2010/04/21,174,3,0.695416667,3312,174,0,3
52640,2014/03/31,2011/01/13,385,2,0.5701411239999999,4039,385,2,0
52641,2014/03/31,2008/04/22,76,3,0.662064405,3478,76,2,1
52642,2014/03/31,2012/04/23,72,3,0.716629318,3213,72,1,2
52643,2014/03/31,2005/04/27,60,2,0.8486583120000001,2713,60,0,2
52644,2014/03/31,2011/10/16,73,4,0.502859327,4578,73,0,4
52645,2014/03/31,2012/06/19,38,5,0.35200000000000004,6540,38,0,5
52646,2014/03/31,2008/06/20,501,3,0.641583055,3588,501,3,0
52647,2014/03/31,2010/05/31,562,4,0.525,4384,562,4,0
52648,2014/03/31,2009/12/17,103,3,0.697430303,3300,103,0,3
52649,2014/03/31,2008/04/22,24,2,0.50361488,4570,24,0,2
52650,2014/03/31,2012/12/12,170,2,0.585,3934,170,0,2
52651,2014/03/31,2012/03/15,143,2,0.832732537,2763,143,1,1
52652,2014/03/31,2012/07/13,298,3,0.786240602,2926,298,2,1
52653,2014/03/31,2012/10/18,157,6,0.30965136600000004,7429,157,2,4
52654,2014/03/31,2011/01/11,203,3,0.604731861,3804,203,1,2
52655,2014/03/31,2011/04/05,2,2,0.8548234859999999,2691,2,0,2
52656,2014/03/31,2012/07/28,37,5,0.525528901,4377,37,2,3
52657,2014/03/31,2009/11/18,159,5,0.566277696,4062,159,2,3
52658,2014/03/31,2011/04/19,17,4,0.6763128490000001,3401,17,1,3
52659,2014/03/31,2006/11/30,184,15,0.833333333,2760,184,10,5
52660,2014/03/31,2008/10/28,142,3,0.453268283,5073,142,0,3
52661,2014/03/31,2006/12/23,180,2,0.795,2892,180,0,2
52662,2014/03/31,2008/01/04,40,2,0.795,2892,40,1,1
52663,2014/03/31,2012/09/30,131,3,0.970793919,2368,131,2,1
52664,2014/03/31,2012/12/03,105,4,0.8481586720000001,2710,105,1,3
52665,2014/03/31,2007/04/14,117,2,1.41,1630,117,0,2
52666,2014/03/31,2012/07/21,278,4,0.509798137,4508,278,3,1
52667,2014/03/31,2011/02/14,367,3,0.46880865,4902,367,3,0
52668,2014/03/31,2011/07/24,181,4,0.629616438,3650,181,0,4
52669,2014/03/31,2012/10/11,114,4,0.885,2596,114,2,2
52670,2014/03/31,2009/10/14,239,3,0.543506033,4227,239,2,1
52671,2014/03/31,2008/05/14,547,3,0.561986301,4088,547,3,0
52672,2014/03/31,2009/10/02,51,5,0.750437765,3061,51,4,1
52673,2014/03/31,2007/11/03,95,4,0.687413948,3341,95,0,4
52674,2014/03/31,2007/04/15,2,6,0.782719836,2934,2,0,6
52675,2014/03/31,2011/11/26,11,2,0.835025455,2750,11,1,1
52676,2014/03/31,2012/03/15,3,3,0.628047046,3656,3,1,2
52677,2014/03/31,2007/10/08,342,2,0.875,2624,342,0,2
52678,2014/03/31,2007/07/24,66,2,0.83488,2750,66,1,1
52679,2014/03/31,2012/09/15,375,3,0.538391182,4264,375,3,0
52680,2014/03/31,2010/04/05,205,4,0.7256749920000001,3163,205,2,2
52681,2014/03/31,2012/05/24,263,3,0.785751455,2921,263,0,3
52682,2014/03/31,2010/08/24,567,3,0.736521181,3116,567,3,0
52683,2014/03/31,2012/02/19,640,2,0.75,3060,640,2,0
52684,2014/03/31,2012/07/07,578,3,1.0,2295,578,3,0
52685,2014/03/31,2012/04/02,174,4,0.77167115,2974,174,3,1
52686,2014/03/31,2010/10/17,5,2,0.91907489,2497,5,0,2
52687,2014/03/31,2012/10/23,313,5,0.374616389,6126,313,3,2
52688,2014/03/31,2012/03/07,17,5,0.732,3135,17,2,3
52689,2014/03/31,2012/06/15,218,3,0.94865647,2419,218,1,2
52690,2014/03/31,2013/01/26,249,3,0.7664495659999999,2994,249,2,1
52691,2014/03/31,2007/08/20,95,5,0.523538672,4383,95,4,1
52692,2014/03/31,2012/12/18,316,3,0.7328648990000001,3131,316,2,1
52693,2014/03/31,2012/09/19,66,4,0.8828434009999999,2599,66,2,2
52694,2014/03/31,2012/04/27,703,2,0.825,2780,703,2,0
52695,2014/03/31,2007/06/20,472,3,0.8234829440000001,2785,472,3,0
52696,2014/03/31,2011/08/27,653,3,0.5214188270000001,4398,653,3,0
52697,2014/03/31,2011/12/06,490,3,0.6081145579999999,3771,490,3,0
52698,2014/03/31,2008/01/13,33,6,0.964661338,2377,33,1,5
52699,2014/03/31,2008/08/30,359,3,0.495847751,4624,359,2,1
52700,2014/03/31,2013/01/01,151,3,0.7566666670000001,3030,151,2,1
52701,2014/03/31,2012/04/27,158,3,0.588375257,3896,158,0,3
52702,2014/03/31,2006/03/22,532,2,0.6998473279999999,3275,532,2,0
52703,2014/03/31,2007/09/12,339,2,0.927935223,2470,339,1,1
52704,2014/03/31,2007/05/17,413,2,0.8709236029999999,2631,413,2,0
52705,2014/03/31,2011/04/11,703,2,0.8709236029999999,2631,703,2,0
52706,2014/03/31,2011/04/28,193,3,0.902781718,2538,193,2,1
52707,2014/03/31,2011/10/23,322,4,0.572345741,4003,322,3,1
52708,2014/03/31,2012/05/24,301,3,0.970762712,2360,301,2,1
52709,2014/03/31,2010/08/30,165,3,0.92,2490,165,0,3
52710,2014/03/31,2010/12/20,190,2,0.5931123770000001,3862,190,0,2
52711,2014/03/31,2012/07/30,26,3,0.641430972,3571,26,1,2
52712,2014/03/31,2011/11/21,79,2,0.62,3694,79,0,2
52713,2014/03/31,2007/12/17,537,3,0.5770345179999999,3969,537,3,0
52714,2014/03/31,2013/03/10,113,4,0.454492955,5039,113,0,4
52715,2014/03/31,2007/07/25,125,4,0.411863309,5560,125,3,1
52716,2014/03/31,2008/01/06,587,2,0.789517241,2900,587,2,0
52717,2014/03/31,2012/04/17,12,3,0.972089172,2355,12,1,2
52718,2014/03/31,2007/07/08,46,2,0.663122827,3452,46,0,2
52719,2014/03/31,2008/03/06,377,3,0.5513246629999999,4152,377,3,0
52720,2014/03/31,2012/06/29,362,2,0.75,3052,362,1,1
52721,2014/03/31,2009/08/26,311,5,0.31796082800000003,7199,311,1,4
52722,2014/03/31,2009/03/07,58,2,0.875,2616,58,0,2
52723,2014/03/31,2012/09/20,96,3,0.826911127,2768,96,2,1
52724,2014/03/31,2013/02/24,127,4,0.77,2972,127,0,4
52725,2014/03/31,2007/10/01,23,2,0.675,3390,23,0,2
52726,2014/03/31,2012/04/02,535,4,0.664507697,3443,535,4,0
52727,2014/03/31,2012/07/28,607,2,0.949647156,2409,607,2,0
52728,2014/03/31,2008/10/17,409,2,0.550830725,4153,409,2,0
52729,2014/03/31,2007/07/10,173,2,1.254816237,1823,173,1,1
52730,2014/03/31,2009/10/31,548,3,0.807447935,2833,548,3,0
52731,2014/03/31,2009/11/29,46,2,1.41,1622,46,0,2
52732,2014/03/31,2012/11/01,410,2,0.867273417,2637,410,2,0
52733,2014/03/31,2008/07/04,457,4,0.8225719420000001,2780,457,4,0
52734,2014/03/31,2010/03/25,69,5,0.590860465,3870,69,1,4
52735,2014/03/31,2007/08/15,657,2,0.8,2858,657,2,0
52736,2014/03/31,2012/08/18,582,2,0.567767569,4027,582,2,0
52737,2014/03/31,2011/01/24,439,2,0.4,5715,439,2,0
52738,2014/03/31,2007/04/18,73,3,0.816666667,2799,73,0,3
52739,2014/03/31,2012/01/06,118,2,0.900638298,2538,118,0,2
52740,2014/03/31,2012/11/05,118,3,0.426519873,5359,118,1,2
52741,2014/03/31,2011/08/05,480,2,0.549267003,4161,480,2,0
52742,2014/03/31,2008/11/09,123,4,0.485,4712,123,2,2
52743,2014/03/31,2012/08/09,578,2,0.157401667,14517,578,2,0
52744,2014/03/31,2012/09/10,145,2,0.778463373,2935,145,1,1
52745,2014/03/31,2012/03/24,43,3,0.7370258059999999,3100,43,0,3
52746,2014/03/31,2011/10/24,167,5,0.975542272,2342,167,2,3
52747,2014/03/31,2011/08/30,464,2,0.55,4154,464,2,0
52748,2014/03/31,2011/10/16,677,2,0.55,4154,677,2,0
52749,2014/03/31,2012/07/04,543,2,0.55,4154,543,2,0
52750,2014/03/31,2008/07/26,476,2,0.55,4154,476,2,0
52751,2014/03/31,2011/06/24,720,2,0.55,4154,720,2,0
52752,2014/03/31,2013/03/22,116,5,0.577021975,3959,116,1,4
52753,2014/03/31,2011/02/28,154,3,0.644904009,3542,154,2,1
52754,2014/03/31,2007/08/12,57,2,0.94,2430,57,1,1
52755,2014/03/31,2007/04/04,43,2,0.804859056,2838,43,0,2
52756,2014/03/31,2009/09/15,224,2,0.746200588,3061,224,0,2
52757,2014/03/31,2012/06/18,649,3,0.5482357179999999,4166,649,3,0
52758,2014/03/31,2010/12/25,244,3,0.440460945,5185,244,2,1
52759,2014/03/31,2012/01/26,49,2,0.784445208,2911,49,0,2
52760,2014/03/31,2007/04/20,645,3,0.8023190440000001,2846,645,3,0
52761,2014/03/31,2013/01/15,33,4,0.457005604,4996,33,0,4
52762,2014/03/31,2012/04/06,726,2,0.7172478790000001,3183,726,2,0
52763,2014/03/31,2009/12/06,645,3,0.95,2403,645,3,0
52764,2014/03/31,2011/11/30,146,2,1.41,1619,146,0,2
52765,2014/03/31,2011/05/07,31,5,0.452,5050,31,1,4
52766,2014/03/31,2010/10/22,318,2,0.63671875,3584,318,1,1
52767,2014/03/31,2005/08/30,44,4,0.941741643,2423,44,2,2
52768,2014/03/31,2012/11/23,386,3,0.419602795,5438,386,3,0
52769,2014/03/31,2006/02/03,98,2,0.7449526609999999,3063,98,1,1
52770,2014/03/31,2010/07/05,205,4,0.6320609420000001,3610,205,0,4
52771,2014/03/31,2012/06/06,335,3,0.531446541,4293,335,2,1
52772,2014/03/31,2006/11/10,153,3,0.6707733020000001,3401,153,0,3
52773,2014/03/31,2012/09/01,299,2,0.785568182,2904,299,1,1
52774,2014/03/31,2009/12/17,179,2,0.909481659,2508,179,0,2
52775,2014/03/31,2012/08/29,184,2,0.746850033,3054,184,1,1
52776,2014/03/31,2006/09/02,58,3,0.629516975,3623,58,0,3
52777,2014/03/31,2012/03/06,79,5,0.691944782,3296,79,3,2
52778,2014/03/31,2011/09/14,339,4,0.798529412,2856,339,3,1
52779,2014/03/31,2008/05/15,272,4,0.523650976,4355,272,3,1
52780,2014/03/31,2007/08/23,123,4,0.4821226220000001,4730,123,0,4
52781,2014/03/31,2012/08/17,592,2,0.84828869,2688,592,2,0
52782,2014/03/31,2010/07/04,162,2,0.497195813,4586,162,1,1
52783,2014/03/31,2012/12/21,12,6,0.554512284,4111,12,1,5
52784,2014/03/31,2011/11/22,138,3,0.856666667,2661,138,2,1
52785,2014/03/31,2012/10/24,521,2,0.53706409,4244,521,2,0
52786,2014/03/31,2011/09/30,221,3,0.551985953,4129,221,1,2
52787,2014/03/31,2009/02/27,721,3,0.630428769,3615,721,3,0
52788,2014/03/31,2012/09/08,64,2,0.949100375,2401,64,1,1
52789,2014/03/31,2010/06/17,97,4,0.54693711,4166,97,2,2
52790,2014/03/31,2012/09/24,133,3,0.478680672,4760,133,1,2
52791,2014/03/31,2012/04/10,48,3,0.814889127,2796,48,1,2
52792,2014/03/31,2008/08/06,102,2,0.747931714,3046,102,0,2
52793,2014/03/31,2012/04/29,451,3,1.0,2278,451,3,0
52794,2014/03/31,2011/12/04,171,3,0.823851718,2765,171,2,1
52795,2014/03/31,2010/01/12,57,2,0.73,3120,57,0,2
52796,2014/03/31,2011/10/10,15,4,0.543964652,4187,15,1,3
52797,2014/03/31,2008/05/25,243,3,0.791358582,2878,243,1,2
52798,2014/03/31,2009/05/03,327,2,1.5,1518,327,0,2
52799,2014/03/31,2012/08/29,453,3,1.0,2277,453,3,0
52800,2014/03/31,2009/08/27,676,3,0.471854922,4825,676,3,0
52801,2014/03/31,2010/06/27,404,3,0.816666667,2787,404,3,0
52802,2014/03/31,2011/03/30,442,3,0.816666667,2787,442,3,0
52803,2014/03/31,2012/08/27,269,3,0.907070546,2509,269,2,1
52804,2014/03/31,2007/05/14,113,3,0.65413912,3479,113,0,3
52805,2014/03/31,2008/12/03,2,4,0.7215187059999999,3154,2,0,4
52806,2014/03/31,2010/11/29,149,2,0.49,4644,149,0,2
52807,2014/03/31,2005/11/19,575,2,1.244803063,1828,575,2,0
52808,2014/03/31,2011/01/27,685,2,0.7443245009999999,3057,685,2,0
52809,2014/03/31,2008/06/21,161,5,0.4397719370000001,5174,161,1,4
52810,2014/03/31,2008/04/06,245,3,0.59253125,3840,245,2,1
52811,2014/03/31,2012/04/29,184,2,0.96,2370,184,1,1
52812,2014/03/31,2010/10/21,28,4,0.611405536,3721,28,1,3
52813,2014/03/31,2011/03/21,711,2,1.25,1820,711,2,0
52814,2014/03/31,2012/08/29,581,2,0.492424242,4620,581,2,0
52815,2014/03/31,2007/02/13,226,2,0.964357779,2359,226,0,2
52816,2014/03/31,2012/10/26,39,4,0.71,3204,39,2,2
52817,2014/03/31,2012/04/11,522,3,0.518143508,4390,522,3,0
52818,2014/03/31,2011/04/01,641,3,0.435875814,5218,641,3,0
52819,2014/03/31,2012/09/25,315,3,0.468093866,4858,315,2,1
52820,2014/03/31,2008/08/07,29,2,0.733451613,3100,29,0,2
52821,2014/03/31,2011/05/06,125,3,0.7466666670000001,3045,125,2,1
52822,2014/03/31,2011/07/29,687,2,0.4,5684,687,2,0
52823,2014/03/31,2012/07/18,134,8,0.987216674,2303,134,5,3
52824,2014/03/31,2005/07/08,474,2,0.694001832,3276,474,2,0
52825,2014/03/31,2012/09/29,346,3,0.7408113390000001,3069,346,2,1
52826,2014/03/31,2005/07/22,400,2,0.97617003,2329,400,2,0
52827,2014/03/31,2010/06/01,174,4,0.441322073,5151,174,2,2
52828,2014/03/31,2008/12/01,144,2,0.694116031,3275,144,0,2
52829,2014/03/31,2009/05/17,4,2,0.694116031,3275,4,0,2
52830,2014/03/31,2006/04/05,21,3,0.513676836,4425,21,0,3
52831,2014/03/31,2013/02/27,323,2,0.736281179,3087,323,1,1
52832,2014/03/31,2011/01/01,63,2,0.5862496779999999,3877,63,1,1
52833,2014/03/31,2012/01/30,684,3,0.75,3030,684,3,0
52834,2014/03/31,2012/09/11,119,3,0.5610518520000001,4050,119,2,1
52835,2014/03/31,2012/03/16,234,4,0.388952414,5842,234,0,4
52836,2014/03/31,2012/11/27,10,2,0.563879375,4029,10,0,2
52837,2014/03/31,2011/10/19,68,3,0.6810071940000001,3336,68,2,1
52838,2014/03/31,2010/12/20,144,3,0.472966896,4803,144,2,1
52839,2014/03/31,2012/03/15,512,3,0.785916955,2890,512,3,0
52840,2014/03/31,2007/07/05,102,3,0.8738360909999999,2599,102,1,2
52841,2014/03/31,2012/09/08,151,4,0.94,2416,151,1,3
52842,2014/03/31,2013/01/14,434,4,0.7625923440000001,2978,434,4,0
52843,2014/03/31,2011/06/14,710,3,0.933333333,2433,710,3,0
52844,2014/03/31,2005/12/28,101,5,0.38,5975,101,4,1
52845,2014/03/31,2008/10/13,58,2,0.825,2752,58,0,2
52846,2014/03/31,2012/01/23,713,2,0.425,5342,713,2,0
52847,2014/03/31,2012/02/13,699,2,0.425,5342,699,2,0
52848,2014/03/31,2011/09/30,431,2,0.486353899,4668,431,2,0
52849,2014/03/31,2012/10/29,453,3,0.574430668,3952,453,3,0
52850,2014/03/31,2008/05/12,294,3,0.723333333,3138,294,2,1
52851,2014/03/31,2005/10/25,71,2,0.793978307,2858,71,0,2
52852,2014/03/31,2010/10/10,24,2,0.452204065,5018,24,0,2
52853,2014/03/31,2013/03/31,127,4,0.412523636,5500,127,1,3
52854,2014/03/31,2011/11/17,17,2,0.455,4986,17,0,2
52855,2014/03/31,2010/05/31,699,2,0.770846075,2943,699,2,0
52856,2014/03/31,2009/10/22,27,3,0.7015625,3232,27,0,3
52857,2014/03/31,2010/08/01,277,4,0.7949579240000001,2852,277,0,4
52858,2014/03/31,2008/07/12,44,2,0.5515596110000001,4110,44,0,2
52859,2014/03/31,2011/04/18,111,3,0.370465762,6119,111,2,1
52860,2014/03/31,2004/12/01,216,4,0.7212185809999999,3143,216,2,2
52861,2014/03/31,2011/05/07,417,3,0.5941546529999999,3815,417,3,0
52862,2014/03/31,2011/03/20,332,5,0.559792541,4049,332,4,1
52863,2014/03/31,2012/02/11,213,2,0.806296692,2811,213,1,1
52864,2014/03/31,2010/02/14,74,3,0.858390152,2640,74,2,1
52865,2014/03/31,2012/03/10,19,3,0.5357257679999999,4230,19,2,1
52866,2014/03/31,2012/07/30,394,4,0.338022076,6704,394,4,0
52867,2014/03/31,2012/04/28,699,2,0.5,4532,699,2,0
52868,2014/03/31,2006/11/29,278,2,1.005310559,2254,278,0,2
52869,2014/03/31,2007/07/15,622,2,0.88402263,2563,622,2,0
52870,2014/03/31,2012/01/13,321,3,0.7129011959999999,3178,321,1,2
52871,2014/03/31,2012/12/04,32,3,0.52846746,4287,32,2,1
52872,2014/03/31,2012/03/06,170,4,0.648009153,3496,170,1,3
52873,2014/03/31,2010/10/10,44,5,0.47520982,4766,44,2,3
52874,2014/03/31,2013/02/05,84,4,0.653181425,3467,84,0,4
52875,2014/03/31,2008/04/29,405,3,0.867292225,2611,405,3,0
52876,2014/03/31,2007/11/20,285,2,0.58,3904,285,0,2
52877,2014/03/31,2010/08/24,32,3,0.660151603,3430,32,0,3
52878,2014/03/31,2009/03/29,19,3,0.6740339390000001,3359,19,0,3
52879,2014/03/31,2012/05/23,69,2,0.732231565,3092,69,1,1
52880,2014/03/31,2012/10/16,117,5,0.473746337,4778,117,4,1
52881,2014/03/31,2009/07/02,676,3,0.644137735,3514,676,3,0
52882,2014/03/31,2011/06/20,157,3,0.627488217,3607,157,1,2
52883,2014/03/31,2012/04/28,371,2,1.0,2263,371,2,0
52884,2014/03/31,2010/11/01,139,3,0.648215411,3491,139,0,3
52885,2014/03/31,2013/03/26,284,2,0.450447939,5023,284,1,1
52886,2014/03/31,2012/11/27,298,3,0.88,2571,298,0,3
52887,2014/03/31,2008/05/14,84,4,0.56,4040,84,1,3
52888,2014/03/31,2010/03/23,68,4,0.889972463,2542,68,2,2
52889,2014/03/31,2007/11/08,238,2,0.72,3142,238,0,2
52890,2014/03/31,2013/03/02,65,2,0.8864420059999999,2552,65,0,2
52891,2014/03/31,2012/05/21,279,3,0.699696876,3233,279,2,1
52892,2014/03/31,2006/03/18,531,2,0.575,3934,531,2,0
52893,2014/03/31,2012/09/08,567,2,0.575,3934,567,2,0
52894,2014/03/31,2012/04/20,707,2,0.575,3934,707,2,0
52895,2014/03/31,2013/03/09,363,2,0.575,3934,363,1,1
52896,2014/03/31,2012/11/22,470,2,0.575,3934,470,2,0
52897,2014/03/31,2011/10/16,401,2,0.575,3934,401,2,0
52898,2014/03/31,2011/12/12,630,2,0.575,3934,630,2,0
52899,2014/03/31,2008/11/20,634,2,0.575,3934,634,2,0
52900,2014/03/31,2008/05/17,21,2,0.575,3934,21,0,2
52901,2014/03/31,2012/08/08,568,2,0.575,3934,568,2,0
52902,2014/03/31,2007/05/23,18,2,0.53,4268,18,0,2
52903,2014/03/31,2010/04/01,70,3,0.5551313529999999,4073,70,0,3
52904,2014/03/31,2013/01/31,231,2,0.83302874,2714,231,1,1
52905,2014/03/31,2010/06/27,153,2,0.785,2880,153,1,1
52906,2014/03/31,2005/09/13,187,2,0.637686883,3545,187,1,1
52907,2014/03/31,2012/12/13,170,4,0.586381323,3855,170,1,3
52908,2014/03/31,2012/11/17,500,2,0.55,4110,500,2,0
52909,2014/03/31,2010/06/30,290,2,0.7644132570000001,2957,290,1,1
52910,2014/03/31,2012/08/17,88,3,0.46973192,4812,88,2,1
52911,2014/03/31,2011/01/13,268,3,0.323132237,6995,268,2,1
52912,2014/03/31,2009/12/08,473,4,0.682870091,3310,473,4,0
52913,2014/03/31,2008/10/27,172,3,0.87179784,2592,172,1,2
52914,2014/03/31,2011/03/15,658,2,0.7,3228,658,2,0
52915,2014/03/31,2007/02/28,504,2,1.104252199,2046,504,2,0
52916,2014/03/31,2005/09/06,578,3,0.753,3000,578,3,0
52917,2014/03/31,2011/10/14,178,4,0.705,3204,178,0,4
52918,2014/03/31,2010/09/03,258,3,0.861441648,2622,258,2,1
52919,2014/03/31,2012/08/23,192,3,0.718143084,3145,192,2,1
52920,2014/03/31,2009/03/18,437,3,1.058059981,2134,437,3,0
52921,2014/03/31,2007/05/28,261,2,1.21,1866,261,0,2
52922,2014/03/31,2008/06/26,398,6,0.464356232,4862,398,6,0
52923,2014/03/31,2011/02/05,676,2,0.4,5644,676,2,0
52924,2014/03/31,2013/01/27,49,2,0.875,2580,49,0,2
52925,2014/03/31,2012/04/12,587,3,0.583333333,3870,587,3,0
52926,2014/03/31,2010/04/12,32,2,0.923621113,2444,32,1,1
52927,2014/03/31,2004/11/26,616,3,0.638918766,3533,616,3,0
52928,2014/03/31,2008/04/14,519,5,0.38,5940,519,5,0
52929,2014/03/31,2012/07/01,145,4,0.492618944,4582,145,0,4
52930,2014/03/31,2008/02/26,273,3,0.573919125,3932,273,2,1
52931,2014/03/31,2011/04/16,176,3,0.546666667,4128,176,0,3
52932,2014/03/31,2012/07/12,238,4,0.915440162,2465,238,2,2
52933,2014/03/31,2012/08/04,315,3,0.558075686,4043,315,2,1
52934,2014/03/31,2010/12/13,702,3,0.572058824,3944,702,3,0
52935,2014/03/31,2009/02/08,509,4,0.4,5640,509,4,0
52936,2014/03/31,2011/05/24,258,3,0.904016032,2495,258,2,1
52937,2014/03/31,2012/09/04,330,2,0.6,3759,330,1,1
52938,2014/03/31,2008/06/19,506,4,0.589824745,3823,506,4,0
52939,2014/03/31,2012/04/19,137,6,0.424545283,5311,137,2,4
52940,2014/03/31,2009/12/31,308,4,0.411582694,5478,308,2,2
52941,2014/03/31,2009/07/22,176,2,0.8364935059999999,2695,176,1,1
52942,2014/03/31,2007/11/29,45,3,0.54656644,4124,45,2,1
52943,2014/03/31,2012/05/01,185,2,0.829911635,2716,185,1,1
52944,2014/03/31,2009/10/20,704,2,0.793661972,2840,704,2,0
52945,2014/03/31,2012/08/13,526,2,1.0,2254,526,2,0
52946,2014/03/31,2011/01/01,320,2,0.704674797,3198,320,1,1
52947,2014/03/31,2007/05/28,112,3,0.485422232,4642,112,0,3
52948,2014/03/31,2008/09/22,272,2,0.7175796179999999,3140,272,1,1
52949,2014/03/31,2009/02/09,529,2,1.0,2253,529,2,0
52950,2014/03/31,2011/08/24,493,2,0.7935892920000001,2839,493,2,0
52951,2014/03/31,2009/07/05,130,2,0.681051995,3308,130,1,1
52952,2014/03/31,2011/07/16,101,3,0.507291151,4441,101,2,1
52953,2014/03/31,2012/08/07,27,4,0.645,3492,27,0,4
52954,2014/03/31,2011/08/11,65,2,0.825283987,2729,65,1,1
52955,2014/03/31,2010/03/03,108,4,0.422785808,5327,108,0,4
52956,2014/03/31,2012/08/07,37,2,0.49357002,4563,37,1,1
52957,2014/03/31,2011/07/07,154,4,0.52199351,4314,154,0,4
52958,2014/03/31,2009/08/18,8,2,0.725,3106,8,0,2
52959,2014/03/31,2012/09/17,370,3,0.51536965,4369,370,3,0
52960,2014/03/31,2006/08/01,213,2,0.58,3882,213,0,2
52961,2014/03/31,2005/03/09,162,3,0.876682243,2568,162,2,1
52962,2014/03/31,2011/02/25,125,4,0.440675411,5108,125,0,4
52963,2014/03/31,2011/08/18,124,3,0.912058347,2468,124,0,3
52964,2014/03/31,2007/02/27,491,4,0.492407002,4570,491,4,0
52965,2014/03/31,2013/01/11,74,5,0.838,2685,74,3,2
52966,2014/03/31,2012/03/27,652,2,0.6,3750,652,2,0
52967,2014/03/31,2006/04/14,259,2,0.86,2616,259,1,1
52968,2014/03/31,2006/06/23,151,2,0.86,2616,151,0,2
52969,2014/03/31,2012/08/26,584,2,0.808300395,2783,584,2,0
52970,2014/03/31,2013/03/01,91,3,0.553333333,4065,91,1,2
52971,2014/03/31,2013/03/05,112,4,0.450106064,4997,112,0,4
52972,2014/03/31,2009/04/12,159,3,0.618353038,3637,159,1,2
52973,2014/03/31,2010/02/14,66,5,0.321784232,6989,66,1,4
52974,2014/03/31,2011/01/15,174,3,0.716666667,3138,174,1,2
52975,2014/03/31,2010/12/29,218,3,0.704520677,3192,218,1,2
52976,2014/03/31,2006/07/07,528,3,0.716539197,3138,528,3,0
52977,2014/03/31,2009/06/28,33,3,0.8483773579999999,2650,33,1,2
52978,2014/03/31,2012/04/24,698,3,0.446603099,5034,698,3,0
52979,2014/03/31,2012/04/28,698,3,0.446603099,5034,698,3,0
52980,2014/03/31,2012/04/24,698,3,0.446603099,5034,698,3,0
52981,2014/03/31,2012/09/15,553,2,0.765701635,2936,553,2,0
52982,2014/03/31,2011/11/24,58,4,0.573197348,3922,58,0,4
52983,2014/03/31,2009/01/11,68,2,0.8580152670000001,2620,68,0,2
52984,2014/03/31,2008/09/18,153,3,0.8508705529999999,2642,153,2,1
52985,2014/03/31,2012/06/15,638,3,0.462320033,4862,638,3,0
52986,2014/03/31,2012/01/08,5,3,0.629101595,3573,5,0,3
52987,2014/03/31,2010/10/28,291,3,0.6780452490000001,3315,291,2,1
52988,2014/03/31,2006/10/09,386,2,0.65,3458,386,2,0
52989,2014/03/31,2013/02/12,146,2,0.600328526,3744,146,1,1
52990,2014/03/31,2010/06/25,608,2,0.8302918359999999,2707,608,2,0
52991,2014/03/31,2012/10/01,89,2,0.6853613909999999,3279,89,1,1
52992,2014/03/31,2005/05/13,502,4,0.694008647,3238,502,4,0
52993,2014/03/31,2011/04/29,410,2,0.77650311,2894,410,2,0
52994,2014/03/31,2012/08/17,155,4,0.455237034,4936,155,1,3
52995,2014/03/31,2011/02/04,333,2,1.0,2247,333,0,2
52996,2014/03/31,2012/09/04,340,3,0.430431034,5220,340,2,1
52997,2014/03/31,2013/01/22,380,4,0.528339605,4252,380,4,0
52998,2014/03/31,2013/01/13,404,2,0.6,3744,404,2,0
52999,2014/03/31,2005/07/03,410,3,0.810902527,2770,410,3,0
53000,2014/03/31,2007/04/16,641,2,0.55,4084,641,2,0
53001,2014/03/31,2012/03/15,4,4,0.631115482,3559,4,0,4
53002,2014/03/31,2011/09/30,335,3,0.556240713,4038,335,2,1
53003,2014/03/31,2011/11/27,432,3,0.79889719,2811,432,3,0
53004,2014/03/31,2006/08/10,327,3,0.6596797879999999,3404,327,2,1
53005,2014/03/31,2012/07/29,329,3,0.5,4491,329,2,1
53006,2014/03/31,2012/01/10,692,3,0.640993434,3503,692,3,0
53007,2014/03/31,2006/10/28,77,4,0.542474028,4139,77,0,4
53008,2014/03/31,2011/08/23,503,3,0.53262159,4215,503,3,0
53009,2014/03/31,2010/05/16,302,3,0.480091959,4676,302,2,1
53010,2014/03/31,2006/04/09,68,2,0.677242004,3314,68,1,1
53011,2014/03/31,2010/07/26,422,2,0.751876676,2984,422,2,0
53012,2014/03/31,2007/03/01,277,3,0.36,6231,277,2,1
53013,2014/03/31,2011/08/26,36,4,0.490382597,4574,36,1,3
53014,2014/03/31,2012/11/04,453,3,0.3666666670000001,6117,453,3,0
53015,2014/03/31,2013/02/24,18,3,0.5226753670000001,4291,18,0,3
53016,2014/03/31,2012/10/22,128,2,0.83212987,2695,128,1,1
53017,2014/03/31,2012/11/14,124,2,0.536425837,4180,124,1,1
53018,2014/03/31,2009/03/31,235,4,0.326891675,6859,235,2,2
53019,2014/03/31,2011/02/01,476,4,0.354634609,6322,476,4,0
53020,2014/03/31,2009/04/11,82,3,0.481032189,4660,82,1,2
53021,2014/03/31,2007/03/29,118,3,0.339327884,6606,118,1,2
53022,2014/03/31,2012/02/20,34,3,0.826188721,2713,34,2,1
53023,2014/03/31,2010/12/20,428,2,0.7193196409999999,3116,428,2,0
53024,2014/03/31,2008/04/24,160,3,0.459856381,4874,160,1,2
53025,2014/03/31,2012/11/06,95,3,0.534156339,4196,95,0,3
53026,2014/03/31,2012/06/28,636,2,0.775,2892,636,2,0
53027,2014/03/31,2010/10/30,458,2,0.775,2892,458,2,0
53028,2014/03/31,2010/12/09,640,2,0.8506454059999999,2634,640,2,0
53029,2014/03/31,2010/11/25,397,3,0.4,5601,397,3,0
53030,2014/03/31,2008/10/31,114,3,0.486260039,4607,114,0,3
53031,2014/03/31,2007/09/22,227,3,0.631725888,3546,227,1,2
53032,2014/03/31,2013/01/28,250,2,0.8,2800,250,1,1
53033,2014/03/31,2012/10/16,217,4,0.620457064,3610,217,0,4
53034,2014/03/31,2012/10/02,143,3,0.599328338,3737,143,2,1
53035,2014/03/31,2010/05/03,73,3,0.826420664,2710,73,0,3
53036,2014/03/31,2011/09/30,90,2,0.378950753,5909,90,1,1
53037,2014/03/31,2007/07/17,28,3,0.8,2799,28,0,3
53038,2014/03/31,2007/02/13,32,4,0.50659276,4420,32,2,2
53039,2014/03/31,2009/01/03,12,2,0.6484216620000001,3453,12,0,2
53040,2014/03/31,2005/12/20,624,3,1.0,2239,624,3,0
53041,2014/03/31,2007/12/03,556,3,1.0,2239,556,3,0
53042,2014/03/31,2011/08/30,76,4,0.469964308,4763,76,3,1
53043,2014/03/31,2012/06/16,137,3,0.715839463,3127,137,1,2
53044,2014/03/31,2005/01/15,48,3,0.790925795,2830,48,0,3
53045,2014/03/31,2010/12/08,25,2,0.830526902,2695,25,0,2
53046,2014/03/31,2010/12/24,622,4,0.510353478,4385,622,4,0
53047,2014/03/31,2010/12/01,171,3,0.460242698,4862,171,2,1
53048,2014/03/31,2011/01/08,257,2,0.92,2432,257,0,2
53049,2014/03/31,2013/01/01,37,3,0.554748326,4033,37,0,3
53050,2014/03/31,2005/04/26,154,2,0.503273341,4445,154,1,1
53051,2014/03/31,2010/05/25,657,3,0.7304702809999999,3062,657,3,0
53052,2014/03/31,2011/08/28,438,2,0.6197146020000001,3609,438,2,0
53053,2014/03/31,2007/12/03,263,3,0.6433803220000001,3476,263,1,2
53054,2014/03/31,2011/10/28,570,4,0.790296925,2829,570,4,0
53055,2014/03/31,2010/11/15,571,3,0.710390848,3147,571,3,0
53056,2014/03/31,2009/06/11,555,2,0.85,2630,555,2,0
53057,2014/03/31,2012/07/13,357,2,0.8952342809999999,2497,357,1,1
53058,2014/03/31,2005/09/22,16,2,0.789876325,2830,16,0,2
53059,2014/03/31,2011/10/10,465,2,0.5897757260000001,3790,465,2,0
53060,2014/03/31,2008/04/26,110,2,0.63,3548,110,0,2
53061,2014/03/31,2012/01/12,8,2,0.7747694970000001,2885,8,0,2
53062,2014/03/31,2011/07/19,219,2,0.615927253,3629,219,1,1
53063,2014/03/31,2012/10/31,320,2,0.91866009,2433,320,1,1
53064,2014/03/31,2013/01/18,154,2,0.469552521,4760,154,0,2
53065,2014/03/31,2013/01/18,154,2,0.469552521,4760,154,0,2
53066,2014/03/31,2013/03/05,111,3,0.682620648,3274,111,2,1
53067,2014/03/31,2012/08/17,55,4,0.879870079,2540,55,2,2
53068,2014/03/31,2011/11/21,200,4,0.6178766929999999,3617,200,2,2
53069,2014/03/31,2013/03/28,197,2,0.92,2429,197,0,2
53070,2014/03/31,2010/10/05,215,2,0.92,2429,215,0,2
53071,2014/03/31,2011/07/10,559,3,0.5936370879999999,3764,559,3,0
53072,2014/03/31,2010/10/29,276,2,0.535,4176,276,0,2
53073,2014/03/31,2010/04/23,296,2,0.609686135,3664,296,1,1
53074,2014/03/31,2008/11/11,66,4,0.682058015,3275,66,3,1
53075,2014/03/31,2012/06/12,80,2,0.745026684,2998,80,1,1
53076,2014/03/31,2007/08/26,648,4,0.587720453,3799,648,4,0
53077,2014/03/31,2010/11/23,438,3,0.764065708,2922,438,3,0
53078,2014/03/31,2012/08/28,533,2,0.65,3434,533,2,0
53079,2014/03/31,2010/10/27,575,2,0.962354463,2319,575,2,0
53080,2014/03/31,2010/10/25,229,3,0.644008658,3465,229,0,3
53081,2014/03/31,2008/05/22,565,3,0.824611973,2706,565,3,0
53082,2014/03/31,2011/11/17,127,5,0.509981714,4375,127,3,2
53083,2014/03/31,2013/03/23,268,2,0.616334254,3620,268,0,2
53084,2014/03/31,2012/04/10,713,2,0.5,4462,713,2,0
53085,2014/03/31,2012/03/31,692,2,0.5,4462,692,2,0
53086,2014/03/31,2011/12/26,51,2,0.5,4462,51,0,2
53087,2014/03/31,2012/07/10,628,2,0.8540199079999999,2612,628,2,0
53088,2014/03/31,2011/08/15,71,2,0.38,5870,71,0,2
53089,2014/03/31,2009/08/16,296,3,0.510888685,4366,296,1,2
53090,2014/03/31,2009/12/01,312,4,0.85,2624,312,3,1
53091,2014/03/31,2013/02/15,370,2,0.7,3186,370,2,0
53092,2014/03/31,2009/11/20,454,3,0.346973705,6427,454,3,0
53093,2014/03/31,2006/08/24,79,2,0.8308196720000001,2684,79,1,1
53094,2014/03/31,2007/06/04,251,4,0.5450745539999999,4091,251,2,2
53095,2014/03/31,2012/10/16,111,5,0.592265604,3765,111,1,4
53096,2014/03/31,2006/09/12,44,4,0.5975,3732,44,0,4
53097,2014/03/31,2006/02/16,416,3,0.6260106679999999,3562,416,3,0
53098,2014/03/31,2005/05/11,89,6,0.488333333,4566,89,3,3
53099,2014/03/31,2007/12/12,145,3,0.530004754,4207,145,0,3
53100,2014/03/31,2008/11/17,133,3,0.4797160070000001,4648,133,1,2
53101,2014/03/31,2013/02/12,380,3,0.8,2787,380,3,0
53102,2014/03/31,2012/02/05,663,3,0.8,2787,663,3,0
53103,2014/03/31,2008/04/23,21,4,0.558374656,3993,21,2,2
53104,2014/03/31,2006/11/14,62,4,0.480715826,4638,62,0,4
53105,2014/03/31,2013/01/26,78,3,0.333299447,6689,78,1,2
53106,2014/03/31,2010/04/30,123,3,0.6865383429999999,3247,123,0,3
53107,2014/03/31,2007/08/13,644,3,0.682323232,3267,644,3,0
53108,2014/03/31,2009/07/31,89,4,0.490863436,4540,89,0,4
53109,2014/03/31,2012/10/20,445,3,0.438987392,5076,445,3,0
53110,2014/03/31,2009/10/23,77,2,0.73,3052,77,0,2
53111,2014/03/31,2010/12/26,19,4,0.5925,3760,19,0,4
53112,2014/03/31,2012/03/08,11,2,0.68,3276,11,0,2
53113,2014/03/31,2006/12/20,444,3,0.424952308,5242,444,3,0
53114,2014/03/31,2011/04/13,300,3,0.826560297,2695,300,2,1
53115,2014/03/31,2008/12/26,268,3,0.483790182,4604,268,1,2
53116,2014/03/31,2012/12/19,57,4,0.361052034,6169,57,0,4
53117,2014/03/31,2011/04/27,12,2,0.809905455,2750,12,0,2
53118,2014/03/31,2012/12/07,172,3,0.309333333,7200,172,2,1
53119,2014/03/31,2011/12/25,505,4,0.603850325,3688,505,4,0
53120,2014/03/31,2012/09/18,370,4,0.5008547010000001,4446,370,4,0
53121,2014/03/31,2010/12/23,428,5,0.735888962,3026,428,5,0
53122,2014/03/31,2009/07/10,641,3,0.6,3711,641,3,0
53123,2014/03/31,2012/05/22,563,2,0.679877863,3275,563,2,0
53124,2014/03/31,2007/09/13,555,3,0.894855305,2488,555,3,0
53125,2014/03/31,2010/09/10,161,3,0.917276473,2427,161,0,3
53126,2014/03/31,2006/07/22,186,5,0.6983589579999999,3187,186,1,4
53127,2014/03/31,2011/08/08,282,3,0.82698625,2691,282,2,1
53128,2014/03/31,2012/12/04,479,2,0.625,3560,479,2,0
53129,2014/03/31,2008/08/07,613,3,0.764993122,2908,613,3,0
53130,2014/03/31,2010/02/08,352,5,0.622411863,3574,352,4,1
53131,2014/03/31,2008/07/21,257,2,0.718005165,3098,257,0,2
53132,2014/03/31,2011/06/27,277,3,0.56140838,3962,277,0,3
53133,2014/03/31,2012/07/10,289,2,0.5863854470000001,3793,289,1,1
53134,2014/03/31,2011/08/28,667,3,0.665868263,3340,667,3,0
53135,2014/03/31,2011/07/10,548,2,0.8,2780,548,2,0
53136,2014/03/31,2008/08/08,157,3,0.910712531,2442,157,0,3
53137,2014/03/31,2011/04/11,5,5,0.678185422,3279,5,1,4
53138,2014/03/31,2012/10/18,204,3,0.7161674720000001,3105,204,1,2
53139,2014/03/31,2011/10/10,52,4,0.406586213,5469,52,3,1
53140,2014/03/31,2010/12/31,23,3,0.954748819,2329,23,2,1
53141,2014/03/31,2009/08/23,221,6,0.438841524,5067,221,4,2
53142,2014/03/31,2006/05/24,574,2,0.85,2616,574,2,0
53143,2014/03/31,2012/04/05,639,2,0.85,2616,639,2,0
53144,2014/03/31,2008/05/05,661,2,0.85,2616,661,2,0
53145,2014/03/31,2013/03/02,388,2,0.85,2616,388,2,0
53146,2014/03/31,2004/12/02,404,2,0.85,2616,404,2,0
53147,2014/03/31,2011/09/06,667,2,0.85,2616,667,2,0
53148,2014/03/31,2012/07/01,595,2,0.4,5559,595,2,0
53149,2014/03/31,2011/08/01,595,2,0.85,2616,595,2,0
53150,2014/03/31,2011/08/02,458,2,0.85,2616,458,2,0
53151,2014/03/31,2006/01/17,664,2,0.85,2616,664,2,0
53152,2014/03/31,2006/10/14,468,2,0.85,2616,468,2,0
53153,2014/03/31,2010/06/01,293,2,1.41,1577,293,0,2
53154,2014/03/31,2007/07/28,576,3,0.8805940590000001,2525,576,3,0
53155,2014/03/31,2012/05/02,224,5,0.768,2895,224,3,2
53156,2014/03/31,2006/06/04,211,2,0.565,3934,211,0,2
53157,2014/03/31,2010/02/02,10,3,0.62,3585,10,1,2
53158,2014/03/31,2012/09/01,475,3,0.755438477,2942,475,3,0
53159,2014/03/31,2008/11/18,695,2,0.8,2778,695,2,0
53160,2014/03/31,2010/11/24,485,3,0.5325305539999999,4173,485,3,0
53161,2014/03/31,2009/08/28,148,2,0.7499358759999999,2963,148,0,2
53162,2014/03/31,2012/07/25,592,3,0.7333333329999999,3030,592,3,0
53163,2014/03/31,2010/04/29,26,7,0.382288369,5812,26,0,7
53164,2014/03/31,2008/04/24,152,7,0.506317229,4388,152,2,5
53165,2014/03/31,2010/11/05,139,2,0.5877460320000001,3780,139,1,1
53166,2014/03/31,2007/07/15,212,2,0.480878788,4620,212,0,2
53167,2014/03/31,2012/10/22,197,3,0.923333333,2406,197,1,2
53168,2014/03/31,2012/03/31,583,2,0.725,3064,583,2,0
53169,2014/03/31,2012/12/18,36,8,0.3475,6392,36,1,7
53170,2014/03/31,2007/06/03,316,4,0.674491345,3293,316,2,2
53171,2014/03/31,2011/11/25,323,5,0.686021007,3237,323,4,1
53172,2014/03/31,2010/06/08,43,5,0.593563218,3741,43,1,4
53173,2014/03/31,2011/08/23,37,4,0.532479616,4170,37,1,3
53174,2014/03/31,2011/09/07,3,2,0.624755205,3554,3,0,2
53175,2014/03/31,2008/12/11,98,2,0.8024177809999999,2767,98,0,2
53176,2014/03/31,2012/10/17,469,3,0.5223647060000001,4250,469,3,0
53177,2014/03/31,2011/12/04,607,4,0.755358966,2939,607,4,0
53178,2014/03/31,2012/09/17,337,5,0.6,3700,337,3,2
53179,2014/03/31,2013/03/30,66,3,0.686875,3232,66,1,2
53180,2014/03/31,2012/01/08,534,3,0.654199823,3393,534,3,0
53181,2014/03/31,2013/03/19,270,4,0.855,2596,270,1,3
53182,2014/03/31,2012/05/28,534,3,0.485858144,4568,534,3,0
53183,2014/03/31,2012/07/17,612,2,0.7485328840000001,2965,612,2,0
53184,2014/03/31,2012/02/24,162,3,0.537201646,4131,162,2,1
53185,2014/03/31,2010/05/08,25,4,0.566781609,3915,25,1,3
53186,2014/03/31,2011/11/05,498,2,0.5758759410000001,3853,498,2,0
53187,2014/03/31,2005/08/26,425,4,0.8434980990000001,2630,425,4,0
53188,2014/03/31,2012/08/11,596,2,0.575,3858,596,2,0
53189,2014/03/31,2012/10/03,397,2,0.77346583,2868,397,2,0
53190,2014/03/31,2011/10/30,166,2,0.776123163,2858,166,1,1
53191,2014/03/31,2007/06/11,283,4,0.5584466260000001,3972,283,1,3
53192,2014/03/31,2011/06/26,534,5,0.53851663,4119,534,5,0
53193,2014/03/31,2006/12/01,67,3,0.683333333,3246,67,0,3
53194,2014/03/31,2011/09/26,20,4,0.5392730370000001,4113,20,2,2
53195,2014/03/31,2011/05/24,356,3,0.756222298,2933,356,2,1
53196,2014/03/31,2008/08/02,96,3,0.68625,3232,96,0,3
53197,2014/03/31,2013/02/11,330,2,0.731497361,3032,330,1,1
53198,2014/03/31,2009/12/01,363,4,0.370287193,5989,363,3,1
53199,2014/03/31,2007/09/14,27,2,0.70023366,3167,27,0,2
53200,2014/03/31,2005/01/26,103,2,0.733513066,3023,103,0,2
53201,2014/03/31,2013/03/11,87,4,0.845,2624,87,0,4
53202,2014/03/31,2006/08/24,160,2,0.92,2410,160,0,2
53203,2014/03/31,2012/11/30,168,4,0.497274563,4458,168,0,4
53204,2014/03/31,2011/11/09,416,7,0.660942159,3354,416,7,0
53205,2014/03/31,2012/07/01,137,2,0.39,5684,137,0,2
53206,2014/03/31,2012/08/27,208,2,0.842554162,2631,208,1,1
53207,2014/03/31,2011/12/05,72,2,0.39,5684,72,1,1
53208,2014/03/31,2013/01/26,256,2,0.39,5684,256,1,1
53209,2014/03/31,2012/06/07,591,2,0.587659067,3772,591,2,0
53210,2014/03/31,2012/09/20,207,3,0.943499361,2349,207,1,2
53211,2014/03/31,2012/11/10,435,4,0.407400257,5439,435,4,0
53212,2014/03/31,2008/09/01,215,2,0.58,3820,215,0,2
53213,2014/03/31,2008/05/27,79,2,0.676341985,3275,79,0,2
53214,2014/03/31,2011/04/27,604,2,0.6588664089999999,3361,604,2,0
53215,2014/03/31,2013/01/01,269,4,0.487494496,4542,269,0,4
53216,2014/03/31,2011/09/14,36,3,0.68207024,3246,36,1,2
53217,2014/03/31,2012/12/29,77,8,0.505,4384,77,2,6
53218,2014/03/31,2012/01/01,141,2,0.7016038029999999,3155,141,0,2
53219,2014/03/31,2007/06/17,9,3,0.536736178,4124,9,1,2
53220,2014/03/31,2012/12/11,255,3,0.6912710809999999,3202,255,2,1
53221,2014/03/31,2009/10/29,713,2,0.85,2604,713,2,0
53222,2014/03/31,2009/12/13,228,4,0.947094566,2337,228,3,1
53223,2014/03/31,2012/09/24,254,2,0.64,3458,254,1,1
53224,2014/03/31,2013/01/27,30,2,0.779221831,2840,30,1,1
53225,2014/03/31,2009/11/02,43,4,0.798898917,2770,43,0,4
53226,2014/03/31,2010/08/10,47,2,0.49,4516,47,1,1
53227,2014/03/31,2010/10/15,222,5,0.560314004,3949,222,4,1
53228,2014/03/31,2009/11/14,201,3,0.602702261,3671,201,2,1
53229,2014/03/31,2007/04/27,104,2,0.765,2892,104,0,2
53230,2014/03/31,2013/01/18,228,3,0.542955326,4074,228,0,3
53231,2014/03/31,2005/10/08,118,3,0.754162973,2933,118,0,3
53232,2014/03/31,2008/07/25,346,3,0.771772505,2866,346,1,2
53233,2014/03/31,2012/08/31,488,4,0.631430203,3503,488,4,0
53234,2014/03/31,2013/03/28,368,2,0.53561395,4129,368,2,0
53235,2014/03/31,2010/11/02,431,2,0.498411089,4437,431,2,0
53236,2014/03/31,2013/03/26,203,5,0.470174357,4703,203,1,4
53237,2014/03/31,2010/06/11,723,2,0.75,2948,723,2,0
53238,2014/03/31,2011/03/26,370,2,0.55,4020,370,2,0
53239,2014/03/31,2007/07/03,310,3,0.806788321,2740,310,2,1
53240,2014/03/31,2012/07/19,277,2,0.845,2616,277,0,2
53241,2014/03/31,2006/11/15,167,2,0.845,2616,167,0,2
53242,2014/03/31,2005/03/11,370,3,0.39174938,5642,370,3,0
53243,2014/03/31,2011/02/01,244,3,0.7000791890000001,3157,244,2,1
53244,2014/03/31,2012/04/24,200,4,0.592813841,3728,200,3,1
53245,2014/03/31,2010/05/12,31,5,0.439000795,5034,31,3,2
53246,2014/03/31,2010/07/15,498,6,0.586620653,3767,498,6,0
53247,2014/03/31,2008/10/31,502,2,0.683993808,3230,502,2,0
53248,2014/03/31,2012/06/17,443,3,0.639820446,3453,443,3,0
53249,2014/03/31,2011/06/20,654,3,0.698040455,3164,654,3,0
53250,2014/03/31,2013/03/20,127,3,0.797500903,2769,127,0,3
53251,2014/03/31,2012/07/18,431,4,1.0,2208,431,4,0
53252,2014/03/31,2008/01/25,517,2,0.8,2760,517,2,0
53253,2014/03/31,2010/05/20,78,2,0.589268748,3747,78,0,2
53254,2014/03/31,2011/07/12,593,2,0.856068244,2579,593,2,0
53255,2014/03/31,2013/02/10,42,4,0.2775,7956,42,0,4
53256,2014/03/31,2012/04/17,242,2,0.7416022840000001,2977,242,1,1
53257,2014/03/31,2012/11/22,117,3,0.5563558470000001,3968,117,1,2
53258,2014/03/31,2011/12/12,347,3,0.625871846,3527,347,2,1
53259,2014/03/31,2008/06/09,443,4,0.566568275,3896,443,4,0
53260,2014/03/31,2011/09/14,183,2,0.952200173,2318,183,1,1
53261,2014/03/31,2012/09/16,514,2,0.776477833,2842,514,2,0
53262,2014/03/31,2011/12/26,415,4,0.85,2596,415,4,0
53263,2014/03/31,2009/09/27,708,2,0.597643554,3692,708,2,0
53264,2014/03/31,2013/03/29,363,2,0.8,2758,363,1,1
53265,2014/03/31,2011/12/03,263,5,0.506,4360,263,4,1
53266,2014/03/31,2011/03/25,311,3,0.788559171,2797,311,1,2
53267,2014/03/31,2012/03/09,470,4,0.625766175,3524,470,4,0
53268,2014/03/31,2009/10/25,357,3,0.5522539439999999,3993,357,2,1
53269,2014/03/31,2013/03/07,386,2,0.5191311510000001,4247,386,2,0
53270,2014/03/31,2010/02/23,37,2,0.829729018,2657,37,1,1
53271,2014/03/31,2009/09/12,113,5,0.428650593,5143,113,2,3
53272,2014/03/31,2006/06/10,544,3,0.593990838,3711,544,3,0
53273,2014/03/31,2012/05/29,87,4,0.690962382,3190,87,3,1
53274,2014/03/31,2005/11/10,660,3,0.576536751,3823,660,3,0
53275,2014/03/31,2011/08/21,123,2,0.7933549320000001,2778,123,1,1
53276,2014/03/31,2012/01/02,173,3,0.506129995,4354,173,2,1
53277,2014/03/31,2010/05/13,183,3,0.7337762240000001,3003,183,2,1
53278,2014/03/31,2007/12/19,480,2,0.65,3390,480,2,0
53279,2014/03/31,2012/08/23,57,3,0.503763146,4374,57,0,3
53280,2014/03/31,2012/07/22,591,2,0.668852459,3294,591,2,0
53281,2014/03/31,2008/02/24,36,5,0.656454112,3356,36,1,4
53282,2014/03/31,2013/03/21,148,3,0.928377581,2373,148,0,3
53283,2014/03/31,2012/04/18,656,3,1.0,2203,656,3,0
53284,2014/03/31,2012/09/19,402,2,0.886458753,2485,402,2,0
53285,2014/03/31,2011/05/31,18,6,0.527247487,4178,18,0,6
53286,2014/03/31,2008/07/12,148,3,0.879229541,2505,148,2,1
53287,2014/03/31,2011/11/07,428,3,0.635386613,3466,428,3,0
53288,2014/03/31,2012/12/27,46,4,0.605,3640,46,2,2
53289,2014/03/31,2013/01/01,68,3,0.429360499,5129,68,0,3
53290,2014/03/31,2008/07/07,86,3,0.503802334,4371,86,0,3
53291,2014/03/31,2006/06/10,95,2,0.546823938,4027,95,0,2
53292,2014/03/31,2005/04/02,23,2,0.569717982,3865,23,1,1
53293,2014/03/31,2008/10/28,6,2,1.09,2020,6,0,2
53294,2014/03/31,2007/02/16,36,2,0.53,4154,36,0,2
53295,2014/03/31,2009/11/18,4,2,0.8,2752,4,0,2
53296,2014/03/31,2011/01/20,19,4,0.8833667740000001,2492,19,0,4
53297,2014/03/31,2010/03/06,652,2,1.475335121,1492,652,2,0
53298,2014/03/31,2012/10/25,156,2,0.699860095,3145,156,1,1
53299,2014/03/31,2007/07/07,334,3,0.925399495,2378,334,2,1
53300,2014/03/31,2009/03/05,3,3,0.445152741,4943,3,2,1
53301,2014/03/31,2006/04/20,237,3,0.97015873,2268,237,2,1
53302,2014/03/31,2010/12/31,225,2,0.662535381,3321,225,1,1
53303,2014/03/31,2009/02/09,166,2,0.662535381,3321,166,1,1
53304,2014/03/31,2012/12/31,207,3,0.459148581,4792,207,1,2
53305,2014/03/31,2008/08/10,53,3,0.597866848,3680,53,2,1
53306,2014/03/31,2005/07/17,414,3,0.6166666670000001,3567,414,3,0
53307,2014/03/31,2010/11/07,440,4,0.4625,4756,440,4,0
53308,2014/03/31,2011/03/19,592,3,0.8666666670000001,2538,592,3,0
53309,2014/03/31,2012/12/11,471,2,0.7,3142,471,2,0
53310,2014/03/31,2005/11/16,12,3,0.736967158,2984,12,0,3
53311,2014/03/31,2010/11/09,528,3,0.844470046,2604,528,3,0
53312,2014/03/31,2011/07/02,8,2,0.8612455929999999,2553,8,1,1
53313,2014/03/31,2010/05/02,64,3,0.602323288,3650,64,1,2
53314,2014/03/31,2012/02/02,156,3,0.6384954979999999,3443,156,0,3
53315,2014/03/31,2009/11/01,50,3,0.5066666670000001,4338,50,2,1
53316,2014/03/31,2009/07/24,468,3,0.89200487,2464,468,3,0
53317,2014/03/31,2008/11/12,83,3,0.623110292,3527,83,0,3
53318,2014/03/31,2009/08/07,177,3,0.726015857,3027,177,2,1
53319,2014/03/31,2011/11/04,709,2,0.75,2930,709,2,0
53320,2014/03/31,2010/08/02,352,3,0.588655237,3733,352,2,1
53321,2014/03/31,2011/09/15,625,2,0.755899553,2907,625,2,0
53322,2014/03/31,2007/06/29,271,3,0.687636933,3195,271,2,1
53323,2014/03/31,2013/02/07,309,3,1.0,2197,309,2,1
53324,2014/03/31,2008/06/18,175,3,0.544885913,4032,175,0,3
53325,2014/03/31,2009/04/19,83,2,0.5417903820000001,4055,83,1,1
53326,2014/03/31,2012/11/20,138,7,0.478823017,4588,138,0,7
53327,2014/03/31,2009/04/13,425,4,0.418757148,5246,425,4,0
53328,2014/03/31,2010/07/21,440,2,0.575,3820,440,2,0
53329,2014/03/31,2009/07/03,299,2,0.52,4224,299,0,2
53330,2014/03/31,2009/04/11,480,6,0.45,4881,480,6,0
53331,2014/03/31,2011/12/26,143,2,0.623763135,3521,143,0,2
53332,2014/03/31,2010/10/31,33,2,0.443058301,4957,33,0,2
53333,2014/03/31,2013/02/22,266,2,0.92,2387,266,0,2
53334,2014/03/31,2008/01/29,126,4,0.733678583,2993,126,2,2
53335,2014/03/31,2013/01/01,339,2,0.525,4182,339,0,2
53336,2014/03/31,2010/12/20,265,2,0.7188998040000001,3054,265,0,2
53337,2014/03/31,2011/08/13,78,4,0.472645856,4645,78,1,3
53338,2014/03/31,2006/08/08,145,3,0.966302817,2272,145,2,1
53339,2014/03/31,2013/03/18,20,3,0.620687023,3537,20,0,3
53340,2014/03/31,2012/03/20,43,2,0.67,3276,43,0,2
53341,2014/03/31,2011/10/24,357,4,0.371890884,5902,357,2,2
53342,2014/03/31,2008/02/20,186,4,0.7184418990000001,3055,186,3,1
53343,2014/03/31,2013/03/19,162,2,0.3,7316,162,0,2
53344,2014/03/31,2008/10/23,74,2,0.7236102870000001,3033,74,0,2
53345,2014/03/31,2012/12/27,421,2,0.7801990759999999,2813,421,2,0
53346,2014/03/31,2012/11/21,497,2,0.724958705,3027,497,2,0
53347,2014/03/31,2011/08/05,125,2,0.808036832,2715,125,1,1
53348,2014/03/31,2013/02/27,233,4,0.961736081,2281,233,0,4
53349,2014/03/31,2011/03/10,398,3,0.4,5484,398,3,0
53350,2014/03/31,2010/05/09,256,2,0.642677996,3413,256,0,2
53351,2014/03/31,2012/09/01,29,4,0.7142136109999999,3071,29,0,4
53352,2014/03/31,2008/10/14,2,2,0.565,3882,2,0,2
53353,2014/03/31,2012/08/29,57,3,0.516556759,4246,57,2,1
53354,2014/03/31,2007/07/26,255,2,0.872063618,2515,255,1,1
53355,2014/03/31,2012/09/26,47,2,0.85,2580,47,0,2
53356,2014/03/31,2011/05/05,527,2,0.939991427,2333,527,2,0
53357,2014/03/31,2011/09/08,175,2,0.705790151,3107,175,1,1
53358,2014/03/31,2013/01/31,70,2,0.66,3322,70,1,1
53359,2014/03/31,2011/10/14,227,3,0.73007992,3003,227,2,1
53360,2014/03/31,2012/06/26,360,2,0.525,4176,360,1,1
53361,2014/03/31,2010/04/23,385,3,0.79896137,2744,385,3,0
53362,2014/03/31,2012/10/18,355,2,0.3,7306,355,1,1
53363,2014/03/31,2011/11/06,44,3,0.723333333,3030,44,2,1
53364,2014/03/31,2005/04/12,472,4,0.758618899,2889,472,4,0
53365,2014/03/31,2012/11/14,226,4,0.483984099,4528,226,1,3
53366,2014/03/31,2009/03/31,135,3,0.412598381,5311,135,0,3
53367,2014/03/31,2012/03/16,192,3,0.834697143,2625,192,2,1
53368,2014/03/31,2013/02/01,45,3,0.273333333,8016,45,0,3
53369,2014/03/31,2011/12/26,332,3,0.5288438329999999,4143,332,1,2
53370,2014/03/31,2013/02/07,90,6,0.463588658,4726,90,1,5
53371,2014/03/31,2006/04/01,153,5,0.64286385,3408,153,2,3
53372,2014/03/31,2012/03/15,219,3,0.523854615,4182,219,1,2
53373,2014/03/31,2012/08/10,302,6,0.370761679,5908,302,4,2
53374,2014/03/31,2010/03/16,395,5,0.710411936,3083,395,5,0
53375,2014/03/31,2013/03/09,374,2,0.75,2920,374,2,0
53376,2014/03/31,2012/09/20,72,2,0.648492745,3377,72,1,1
53377,2014/03/31,2012/03/19,548,3,0.6779876159999999,3230,548,3,0
53378,2014/03/31,2012/01/25,269,2,0.781770796,2801,269,1,1
53379,2014/03/31,2013/03/19,58,5,0.375839341,5826,58,0,5
53380,2014/03/31,2009/08/26,324,2,0.639485981,3424,324,1,1
53381,2014/03/31,2011/04/01,366,3,0.677444307,3232,366,2,1
53382,2014/03/31,2012/02/03,113,2,0.995,2200,113,0,2
53383,2014/03/31,2005/04/14,93,2,0.455050946,4809,93,0,2
53384,2014/03/31,2011/03/26,123,3,0.948119584,2308,123,1,2
53385,2014/03/31,2012/09/08,33,4,0.656543654,3333,33,3,1
53386,2014/03/31,2011/05/12,142,4,0.468439306,4671,142,0,4
53387,2014/03/31,2012/11/08,251,4,0.474931626,4607,251,2,2
53388,2014/03/31,2011/05/16,337,4,1.0,2188,337,3,1
53389,2014/03/31,2012/04/17,531,2,0.726910299,3010,531,2,0
53390,2014/03/31,2009/05/29,724,2,0.55,3978,724,2,0
53391,2014/03/31,2008/04/19,283,2,0.667865649,3275,283,1,1
53392,2014/03/31,2012/04/26,688,2,0.9,2430,688,2,0
53393,2014/03/31,2011/01/21,21,6,0.6316666670000001,3462,21,4,2
53394,2014/03/31,2012/04/16,348,4,0.360808581,6060,348,3,1
53395,2014/03/31,2005/06/23,1,6,0.458506085,4766,1,1,5
53396,2014/03/31,2005/10/12,139,4,0.362131256,6034,139,2,2
53397,2014/03/31,2011/12/10,659,2,1.0,2185,659,2,0
53398,2014/03/31,2010/09/27,15,3,0.666762283,3277,15,2,1
53399,2014/03/31,2011/09/01,624,2,0.8350152909999999,2616,624,2,0
53400,2014/03/31,2013/02/11,49,3,0.956666667,2283,49,2,1
53401,2014/03/31,2008/03/16,190,3,0.547246304,3991,190,1,2
53402,2014/03/31,2008/03/25,446,3,0.870119522,2510,446,3,0
53403,2014/03/31,2012/08/14,116,2,0.603093068,3621,116,0,2
53404,2014/03/31,2009/01/10,166,2,0.734761104,2972,166,0,2
53405,2014/03/31,2012/07/26,496,2,0.943239741,2315,496,2,0
53406,2014/03/31,2012/11/10,456,4,0.55,3970,456,4,0
53407,2014/03/31,2012/04/04,15,2,0.555,3934,15,0,2
53408,2014/03/31,2012/10/23,100,2,0.555,3934,100,0,2
53409,2014/03/31,2010/03/23,39,3,0.6795424840000001,3213,39,0,3
53410,2014/03/31,2010/12/20,143,2,0.35,6238,143,1,1
53411,2014/03/31,2007/09/11,312,2,0.35,6238,312,0,2
53412,2014/03/31,2007/02/08,34,6,0.614980282,3550,34,2,4
53413,2014/03/31,2010/05/15,201,2,0.877119325,2489,201,1,1
53414,2014/03/31,2008/05/27,133,2,0.745,2930,133,1,1
53415,2014/03/31,2009/04/20,195,3,0.719182867,3035,195,2,1
53416,2014/03/31,2010/01/30,170,3,0.833333333,2619,170,1,2
53417,2014/03/31,2011/11/19,103,4,0.787542403,2771,103,1,3
53418,2014/03/31,2009/01/29,301,3,0.433560501,5033,301,1,2
53419,2014/03/31,2012/06/21,5,2,0.52,4196,5,1,1
53420,2014/03/31,2010/06/15,2,3,0.846666667,2577,2,0,3
53421,2014/03/31,2010/11/17,593,4,0.467505892,4667,593,4,0
53422,2014/03/31,2010/05/30,95,2,0.535,4078,95,0,2
53423,2014/03/31,2011/05/09,124,3,0.549685059,3969,124,1,2
53424,2014/03/31,2009/07/30,135,2,0.4,5454,135,0,2
53425,2014/03/31,2009/10/19,390,2,0.4,5454,390,2,0
53426,2014/03/31,2008/03/08,100,3,0.6459875629999999,3377,100,1,2
53427,2014/03/31,2012/11/23,316,3,0.35,6231,316,1,2
53428,2014/03/31,2011/04/08,166,2,0.525,4154,166,0,2
53429,2014/03/31,2007/05/14,520,2,0.525,4154,520,2,0
53430,2014/03/31,2011/03/20,79,2,0.525,4154,79,0,2
53431,2014/03/31,2011/02/01,205,3,0.432620512,5041,205,1,2
53432,2014/03/31,2011/03/24,261,4,0.7347708890000001,2968,261,0,4
53433,2014/03/31,2010/02/19,436,2,0.8,2726,436,2,0
53434,2014/03/31,2012/01/11,103,4,0.385075945,5662,103,3,1
53435,2014/03/31,2008/03/16,482,3,0.4,5450,482,3,0
53436,2014/03/31,2007/04/01,668,4,0.529145424,4119,668,4,0
53437,2014/03/31,2012/12/15,247,3,0.667738971,3264,247,0,3
53438,2014/03/31,2011/07/04,73,3,0.393333333,5541,73,2,1
53439,2014/03/31,2009/01/25,165,3,0.467648069,4660,165,0,3
53440,2014/03/31,2013/01/12,443,2,0.5962643679999999,3654,443,2,0
53441,2014/03/31,2011/03/21,278,2,0.7714943340000001,2824,278,1,1
53442,2014/03/31,2012/12/07,476,2,0.760649441,2864,476,2,0
53443,2014/03/31,2012/02/27,286,2,0.820139307,2656,286,1,1
53444,2014/03/31,2012/05/31,182,4,0.704020685,3094,182,3,1
53445,2014/03/31,2011/11/29,279,2,0.859723648,2533,279,0,2
53446,2014/03/31,2012/10/21,321,4,0.286852852,7591,321,3,1
53447,2014/03/31,2012/07/06,12,7,0.486026786,4480,12,1,6
53448,2014/03/31,2012/05/14,379,3,0.854138878,2549,379,3,0
53449,2014/03/31,2011/02/08,216,4,0.94,2316,216,1,3
53450,2014/03/31,2013/01/22,66,4,0.7325,2972,66,2,2
53451,2014/03/31,2012/08/28,493,3,0.6734375,3232,493,3,0
53452,2014/03/31,2013/01/19,252,2,0.75,2902,252,1,1
53453,2014/03/31,2009/11/28,612,3,0.803396087,2709,612,3,0
53454,2014/03/31,2010/09/12,314,3,0.560866203,3879,314,2,1
53455,2014/03/31,2012/06/16,648,2,0.6,3626,648,2,0
53456,2014/03/31,2011/08/01,46,3,0.769964602,2825,46,0,3
53457,2014/03/31,2012/02/12,60,4,0.6140683229999999,3542,60,1,3
53458,2014/03/31,2011/11/26,500,2,1.0,2175,500,2,0
53459,2014/03/31,2009/12/17,427,4,0.9375,2320,427,4,0
53460,2014/03/31,2004/12/08,316,3,0.727911647,2988,316,2,1
53461,2014/03/31,2012/05/09,676,2,0.425097733,5116,676,2,0
53462,2014/03/31,2010/01/06,83,3,0.553781513,3927,83,1,2
53463,2014/03/31,2012/05/17,412,5,0.650598444,3342,412,5,0
53464,2014/03/31,2009/02/16,9,2,0.7,3106,9,0,2
53465,2014/03/31,2010/06/07,618,2,0.7,3106,618,2,0
53466,2014/03/31,2011/08/01,394,2,0.7,3106,394,2,0
53467,2014/03/31,2009/07/20,77,3,0.4272444970000001,5088,77,0,3
53468,2014/03/31,2009/12/14,211,3,0.536470879,4052,211,1,2
53469,2014/03/31,2008/06/05,57,4,0.67,3244,57,3,1
53470,2014/03/31,2010/02/12,35,2,0.8770621470000001,2478,35,0,2
53471,2014/03/31,2011/03/25,399,4,0.6125,3548,399,4,0
53472,2014/03/31,2012/12/07,288,3,0.8300802140000001,2618,288,1,2
53473,2014/03/31,2007/08/26,119,2,0.6951695459999999,3126,119,0,2
53474,2014/03/31,2012/03/14,578,4,0.929298546,2338,578,4,0
53475,2014/03/31,2013/03/31,360,3,0.603332408,3601,360,1,2
53476,2014/03/31,2012/08/02,8,2,0.78992,2750,8,1,1
53477,2014/03/31,2013/01/29,96,4,0.68719709,3161,96,2,2
53478,2014/03/31,2007/11/01,32,2,0.602825423,3603,32,0,2
53479,2014/03/31,2012/12/11,104,2,0.7740962570000001,2805,104,0,2
53480,2014/03/31,2005/12/25,11,2,0.808986587,2684,11,1,1
53481,2014/03/31,2012/11/03,9,2,0.83,2616,9,0,2
53482,2014/03/31,2012/05/16,222,5,0.75,2895,222,3,2
53483,2014/03/31,2012/02/13,229,3,0.908451883,2390,229,2,1
53484,2014/03/31,2012/02/07,604,2,0.475,4570,604,2,0
53485,2014/03/31,2012/10/30,518,2,0.725,2994,518,2,0
53486,2014/03/31,2012/06/01,670,2,0.681903864,3183,670,2,0
53487,2014/03/31,2008/07/24,149,3,0.559564208,3878,149,0,3
53488,2014/03/31,2007/06/29,35,4,0.522006255,4157,35,3,1
53489,2014/03/31,2011/09/27,215,2,0.6783182240000001,3199,215,1,1
53490,2014/03/31,2012/12/11,437,4,0.5199616579999999,4173,437,4,0
53491,2014/03/31,2012/03/01,158,2,0.8363993829999999,2594,158,1,1
53492,2014/03/31,2012/07/11,438,2,0.6308519920000001,3439,438,2,0
53493,2014/03/31,2008/09/12,372,6,0.506395892,4284,372,6,0
53494,2014/03/31,2012/07/04,561,2,0.663582135,3269,561,2,0
53495,2014/03/31,2012/02/13,148,2,0.7368138590000001,2944,148,0,2
53496,2014/03/31,2011/10/31,40,4,0.524314721,4137,40,0,4
53497,2014/03/31,2012/09/03,213,4,0.37,5860,213,3,1
53498,2014/03/31,2012/08/20,346,3,0.58552525,3703,346,2,1
53499,2014/03/31,2012/09/27,64,2,0.5431312629999999,3992,64,0,2
53500,2014/03/31,2009/03/23,277,3,0.571402214,3794,277,1,2
53501,2014/03/31,2006/04/14,307,4,0.34787353600000004,6231,307,2,2
53502,2014/03/31,2011/11/23,96,2,0.64070943,3383,96,0,2
53503,2014/03/31,2011/10/21,209,3,0.406511628,5332,209,0,3
53504,2014/03/31,2005/05/07,604,2,0.74737931,2900,604,2,0
53505,2014/03/31,2007/07/18,291,2,0.64202963,3375,291,1,1
53506,2014/03/31,2011/10/07,72,5,0.585712355,3699,72,0,5
53507,2014/03/31,2012/01/01,139,2,0.763400282,2838,139,1,1
53508,2014/03/31,2012/09/23,367,3,0.736530612,2940,367,3,0
53509,2014/03/31,2011/06/10,214,3,0.637597173,3396,214,2,1
53510,2014/03/31,2012/12/28,264,3,0.444617913,4868,264,1,2
53511,2014/03/31,2008/09/22,508,2,0.575,3764,508,2,0
53512,2014/03/31,2012/12/27,297,3,0.5449609670000001,3971,297,2,1
53513,2014/03/31,2013/03/01,10,3,0.810790558,2669,10,0,3
53514,2014/03/31,2012/07/09,193,2,0.541627034,3995,193,1,1
53515,2014/03/31,2012/04/10,695,2,0.55,3934,695,2,0
53516,2014/03/31,2010/08/08,685,2,0.55,3934,685,2,0
53517,2014/03/31,2006/09/17,685,2,0.55,3934,685,2,0
53518,2014/03/31,2009/02/20,614,2,0.55,3934,614,2,0
53519,2014/03/31,2007/11/19,414,2,0.55,3934,414,2,0
53520,2014/03/31,2009/05/31,402,2,0.55,3934,402,2,0
53521,2014/03/31,2010/10/11,321,2,0.55,3934,321,1,1
53522,2014/03/31,2012/05/08,421,2,0.55,3934,421,2,0
53523,2014/03/31,2012/12/25,402,2,0.55,3934,402,2,0
53524,2014/03/31,2012/11/11,89,2,0.55,3934,89,0,2
53525,2014/03/31,2012/09/14,523,2,0.8226235740000001,2630,523,2,0
53526,2014/03/31,2013/01/10,232,2,0.457494185,4729,232,1,1
53527,2014/03/31,2010/01/12,132,2,0.63,3434,132,0,2
53528,2014/03/31,2012/09/26,131,4,0.76445583,2830,131,1,3
53529,2014/03/31,2008/02/18,99,3,0.531419799,4071,99,0,3
53530,2014/03/31,2012/02/11,160,3,0.395953863,5462,160,2,1
53531,2014/03/31,2008/12/31,20,5,0.6982370040000001,3097,20,2,3
53532,2014/03/31,2007/03/03,181,3,0.832533693,2597,181,2,1
53533,2014/03/31,2008/08/11,93,6,0.7023066929999999,3078,93,1,5
53534,2014/03/31,2012/12/26,140,2,0.417443028,5178,140,1,1
53535,2014/03/31,2013/01/01,174,3,0.713333333,3030,174,0,3
53536,2014/03/31,2011/01/03,271,3,0.623583381,3466,271,2,1
53537,2014/03/31,2013/03/27,77,2,0.7705133690000001,2805,77,0,2
53538,2014/03/31,2007/02/25,13,2,0.8994007490000001,2403,13,0,2
53539,2014/03/31,2005/02/26,112,4,0.651344183,3318,112,2,2
53540,2014/03/31,2006/06/11,246,3,0.636931919,3393,246,1,2
53541,2014/03/31,2008/09/22,187,2,0.773464567,2794,187,1,1
53542,2014/03/31,2012/11/17,296,3,0.748268698,2888,296,2,1
53543,2014/03/31,2010/11/19,690,3,0.7273645240000001,2971,690,3,0
53544,2014/03/31,2012/12/14,422,2,0.7,3087,422,2,0
53545,2014/03/31,2008/01/18,369,2,0.7,3087,369,2,0
53546,2014/03/31,2011/06/09,352,2,0.8681799920000001,2489,352,1,1
53547,2014/03/31,2013/01/08,212,2,0.6673100679999999,3238,212,0,2
53548,2014/03/31,2012/02/27,194,3,0.56,3858,194,2,1
53549,2014/03/31,2012/02/01,128,2,0.8792673990000001,2457,128,0,2
53550,2014/03/31,2010/07/20,438,3,0.511774461,4221,438,3,0
53551,2014/03/31,2010/12/06,289,2,0.38,5684,289,0,2
53552,2014/03/31,2013/02/27,278,2,0.38,5684,278,0,2
53553,2014/03/31,2008/01/07,23,2,0.605155506,3569,23,1,1
53554,2014/03/31,2008/01/19,79,2,0.795781135,2714,79,0,2
53555,2014/03/31,2011/02/01,286,3,0.572473489,3772,286,1,2
53556,2014/03/31,2011/09/16,305,3,0.466886486,4625,305,2,1
53557,2014/03/31,2008/09/21,225,2,0.7849890909999999,2750,225,1,1
53558,2014/03/31,2013/02/22,25,4,0.3475,6212,25,0,4
53559,2014/03/31,2009/03/12,686,2,0.891942149,2420,686,2,0
53560,2014/03/31,2011/11/25,7,3,0.458826531,4704,7,0,3
53561,2014/03/31,2008/08/02,505,5,0.707855034,3049,505,5,0
53562,2014/03/31,2011/09/18,705,2,0.825,2616,705,2,0
53563,2014/03/31,2012/11/03,514,2,0.825,2616,514,2,0
53564,2014/03/31,2007/03/08,396,3,0.873058252,2472,396,3,0
53565,2014/03/31,2012/11/08,448,2,0.525,4110,448,2,0
53566,2014/03/31,2013/01/01,453,2,0.375,5754,453,2,0
53567,2014/03/31,2010/09/16,676,2,0.525,4110,676,2,0
53568,2014/03/31,2011/05/08,30,3,0.607283985,3553,30,0,3
53569,2014/03/31,2013/02/03,277,3,0.411441648,5244,277,2,1
53570,2014/03/31,2010/03/11,16,3,0.664028932,3249,16,1,2
53571,2014/03/31,2007/03/06,368,2,0.575,3752,368,2,0
53572,2014/03/31,2013/02/16,396,2,0.8,2696,396,2,0
53573,2014/03/31,2012/06/15,655,2,1.322194972,1631,655,2,0
53574,2014/03/31,2008/12/15,411,2,0.678888539,3176,411,2,0
53575,2014/03/31,2011/11/04,554,3,1.0,2156,554,3,0
53576,2014/03/31,2009/08/16,189,2,0.77,2800,189,0,2
53577,2014/03/31,2009/02/17,113,5,0.478415446,4506,113,2,3
53578,2014/03/31,2010/12/01,39,2,0.72,2994,39,0,2
53579,2014/03/31,2008/09/06,201,2,0.6581709920000001,3275,201,0,2
53580,2014/03/31,2009/09/28,147,3,0.773333333,2787,147,2,1
53581,2014/03/31,2005/05/10,245,4,0.483292218,4459,245,3,1
53582,2014/03/31,2007/11/22,170,2,0.38706305,5567,170,0,2
53583,2014/03/31,2013/03/15,209,5,0.4643340520000001,4640,209,2,3
53584,2014/03/31,2012/09/19,331,2,0.775,2780,331,0,2
53585,2014/03/31,2012/09/24,329,2,0.775,2780,329,0,2
53586,2014/03/31,2011/01/15,236,3,0.749589422,2874,236,2,1
53587,2014/03/31,2011/05/24,219,2,0.911637749,2363,219,1,1
53588,2014/03/31,2012/11/12,290,2,0.833975997,2583,290,1,1
53589,2014/03/31,2011/10/07,19,2,0.63973567,3367,19,0,2
53590,2014/03/31,2012/11/18,432,2,0.920299145,2340,432,2,0
53591,2014/03/31,2006/03/08,45,3,0.712534745,3022,45,0,3
53592,2014/03/31,2008/05/01,140,2,0.555367552,3877,140,0,2
53593,2014/03/31,2012/07/09,625,2,0.5184324579999999,4153,625,2,0
53594,2014/03/31,2009/12/27,633,2,0.8766286640000001,2456,633,2,0
53595,2014/03/31,2010/05/15,367,3,0.6,3588,367,3,0
53596,2014/03/31,2013/01/24,43,4,0.433138833,4970,43,1,3
53597,2014/03/31,2008/05/17,5,2,0.964466846,2232,5,0,2
53598,2014/03/31,2012/03/27,632,2,0.625,3444,632,2,0
53599,2014/03/31,2006/09/21,524,2,0.525,4100,524,2,0
53600,2014/03/31,2007/11/05,241,2,0.814411653,2643,241,0,2
53601,2014/03/31,2010/01/04,280,2,0.685,3142,280,1,1
53602,2014/03/31,2013/01/19,149,6,0.370946389,5801,149,2,4
53603,2014/03/31,2007/05/08,9,4,0.509306509,4225,9,1,3
53604,2014/03/31,2012/08/24,233,2,0.5833017079999999,3689,233,1,1
53605,2014/03/31,2012/11/26,300,3,0.94,2289,300,2,1
53606,2014/03/31,2007/09/20,278,3,0.557548588,3859,278,1,2
53607,2014/03/31,2012/06/30,634,2,0.757588028,2840,634,2,0
53608,2014/03/31,2009/10/15,15,3,0.465360156,4623,15,0,3
53609,2014/03/31,2012/04/21,526,2,1.0,2151,526,2,0
53610,2014/03/31,2007/05/16,519,2,1.0,2151,519,2,0
53611,2014/03/31,2011/03/01,426,3,0.9,2390,426,3,0
53612,2014/03/31,2009/03/03,511,2,1.0,2151,511,2,0
53613,2014/03/31,2012/06/03,105,4,0.414037351,5194,105,3,1
53614,2014/03/31,2012/08/10,600,2,0.8,2688,600,2,0
53615,2014/03/31,2012/08/14,586,4,0.4,5376,586,4,0
53616,2014/03/31,2007/05/29,3,2,0.836076983,2572,3,0,2
53617,2014/03/31,2011/09/14,219,3,0.7442713740000001,2889,219,2,1
53618,2014/03/31,2013/01/04,346,4,0.469545752,4579,346,3,1
53619,2014/03/31,2012/03/24,176,2,0.681296355,3155,176,1,1
53620,2014/03/31,2011/05/01,537,4,0.50789225,4232,537,4,0
53621,2014/03/31,2007/12/31,155,2,0.7098018490000001,3028,155,1,1
53622,2014/03/31,2012/06/02,416,3,0.810082925,2653,416,3,0
53623,2014/03/31,2012/04/09,629,3,0.966666667,2223,629,3,0
53624,2014/03/31,2010/06/14,393,3,0.638938448,3363,393,3,0
53625,2014/03/31,2012/08/23,581,2,0.660467261,3253,581,2,0
53626,2014/03/31,2007/12/25,176,2,0.28,7672,176,0,2
53627,2014/03/31,2012/09/29,357,3,0.62478185,3438,357,2,1
53628,2014/03/31,2011/10/16,611,3,0.666666667,3222,611,3,0
53629,2014/03/31,2007/09/03,646,2,0.6773974759999999,3170,646,2,0
53630,2014/03/31,2012/09/03,204,2,0.8404500979999999,2555,204,0,2
53631,2014/03/31,2011/12/03,726,2,0.683322724,3142,726,2,0
53632,2014/03/31,2013/03/29,267,2,0.771386992,2783,267,0,2
53633,2014/03/31,2008/12/21,127,4,0.585036795,3669,127,2,2
53634,2014/03/31,2011/10/29,157,3,0.6915206190000001,3104,157,2,1
53635,2014/03/31,2011/02/08,90,5,0.442014003,4856,90,2,3
53636,2014/03/31,2011/08/11,271,2,0.625,3434,271,0,2
53637,2014/03/31,2012/07/03,181,2,0.6845645929999999,3135,181,1,1
53638,2014/03/31,2012/08/25,56,2,1.41,1522,56,0,2
53639,2014/03/31,2013/03/01,2,2,0.43,4990,2,0,2
53640,2014/03/31,2007/09/19,613,2,0.8,2682,613,2,0
53641,2014/03/31,2010/10/12,701,2,0.891316992,2407,701,2,0
53642,2014/03/31,2012/07/19,422,3,0.764777184,2805,422,3,0
53643,2014/03/31,2006/01/26,130,2,0.82,2616,130,0,2
53644,2014/03/31,2013/01/01,35,2,0.745806676,2876,35,0,2
53645,2014/03/31,2009/09/18,287,3,0.784796926,2733,287,2,1
53646,2014/03/31,2005/04/16,319,4,0.444426026,4826,319,2,2
53647,2014/03/31,2007/08/16,253,4,0.509171415,4212,253,1,3
53648,2014/03/31,2009/11/07,160,2,0.8321303840000001,2577,160,0,2
53649,2014/03/31,2009/07/10,572,3,0.973705722,2202,572,3,0
53650,2014/03/31,2008/10/25,267,3,0.702519659,3052,267,0,3
53651,2014/03/31,2008/04/20,211,3,0.939886015,2281,211,1,2
53652,2014/03/31,2008/07/06,82,4,0.53603901,3999,82,1,3
53653,2014/03/31,2012/02/04,694,2,0.75,2858,694,2,0
53654,2014/03/31,2012/09/27,536,3,0.8812911179999999,2432,536,3,0
53655,2014/03/31,2012/09/30,259,4,0.44960772,4767,259,0,4
53656,2014/03/31,2010/10/29,16,4,0.689803669,3107,16,3,1
53657,2014/03/31,2007/03/16,518,2,1.0,2143,518,2,0
53658,2014/03/31,2013/01/01,244,3,0.88577098,2419,244,1,2
53659,2014/03/31,2012/08/22,27,3,0.8272857140000001,2590,27,1,2
53660,2014/03/31,2013/01/15,387,2,0.7,3060,387,2,0
53661,2014/03/31,2008/03/07,125,2,0.79925,2680,125,1,1
53662,2014/03/31,2011/06/04,393,4,0.518004837,4135,393,4,0
53663,2014/03/31,2012/04/23,153,2,0.651832015,3286,153,1,1
53664,2014/03/31,2009/02/13,2,2,0.724573748,2956,2,0,2
53665,2014/03/31,2006/02/27,33,8,0.67511034,3172,33,2,6
53666,2014/03/31,2012/09/13,220,4,0.665431945,3218,220,3,1
53667,2014/03/31,2008/04/17,91,3,0.763333333,2805,91,0,3
53668,2014/03/31,2013/01/14,178,4,0.413493627,5178,178,2,2
53669,2014/03/31,2011/05/24,553,2,0.950288504,2253,553,2,0
53670,2014/03/31,2006/06/19,624,2,0.6203709070000001,3451,624,2,0
53671,2014/03/31,2011/06/12,211,5,0.543638903,3938,211,1,4
53672,2014/03/31,2007/08/15,210,4,0.735,2912,210,0,4
53673,2014/03/31,2012/10/23,70,4,0.5095833329999999,4200,70,0,4
53674,2014/03/31,2012/03/18,108,3,0.840365279,2546,108,0,3
53675,2014/03/31,2013/02/18,26,3,0.450718348,4747,26,0,3
53676,2014/03/31,2006/08/11,172,6,0.58771978,3640,172,1,5
53677,2014/03/31,2011/06/02,205,3,0.542006587,3947,205,2,1
53678,2014/03/31,2011/11/07,287,3,0.819957838,2609,287,2,1
53679,2014/03/31,2007/07/01,366,3,0.670774537,3189,366,2,1
53680,2014/03/31,2005/11/27,375,2,0.775,2760,375,2,0
53681,2014/03/31,2011/10/23,356,2,0.8580024070000001,2493,356,1,1
53682,2014/03/31,2007/08/12,499,3,0.569600533,3755,499,3,0
53683,2014/03/31,2012/11/07,168,2,0.917152659,2332,168,1,1
53684,2014/03/31,2013/03/09,271,3,0.467938731,4570,271,0,3
53685,2014/03/31,2012/04/19,709,2,0.8168258209999999,2618,709,2,0
53686,2014/03/31,2006/12/18,132,2,0.870651466,2456,132,1,1
53687,2014/03/31,2012/01/26,249,2,0.463642671,4612,249,1,1
53688,2014/03/31,2010/05/26,641,2,0.61944364,3451,641,2,0
53689,2014/03/31,2011/04/18,656,2,0.4,5344,656,2,0
53690,2014/03/31,2009/05/09,429,3,0.316666667,6750,429,3,0
53691,2014/03/31,2008/01/22,13,2,0.713672788,2995,13,0,2
53692,2014/03/31,2010/10/23,248,2,0.596378348,3584,248,1,1
53693,2014/03/31,2012/04/06,621,3,0.74007964,2888,621,3,0
53694,2014/03/31,2011/01/15,576,2,0.4,5343,576,2,0
53695,2014/03/31,2008/07/02,61,2,0.78742815,2714,61,0,2
53696,2014/03/31,2012/04/22,709,2,0.825057915,2590,709,2,0
53697,2014/03/31,2009/11/02,517,2,0.4,5342,517,2,0
53698,2014/03/31,2008/11/08,395,2,0.4,5342,395,2,0
53699,2014/03/31,2010/12/13,478,2,0.4,5342,478,2,0
53700,2014/03/31,2012/04/25,546,3,0.7666666670000001,2787,546,3,0
53701,2014/03/31,2012/01/10,263,4,0.69483252,3075,263,1,3
53702,2014/03/31,2008/04/24,377,2,0.7,3052,377,2,0
53703,2014/03/31,2007/08/08,249,4,0.5270688379999999,4053,249,1,3
53704,2014/03/31,2007/07/06,382,2,1.0,2136,382,2,0
53705,2014/03/31,2012/12/11,105,3,0.871779592,2450,105,0,3
53706,2014/03/31,2013/01/09,81,4,0.4278621520000001,4991,81,0,4
53707,2014/03/31,2012/05/29,240,2,0.90490886,2359,240,1,1
53708,2014/03/31,2007/04/28,126,5,0.433583181,4923,126,2,3
53709,2014/03/31,2008/06/15,376,3,0.632819449,3373,376,3,0
53710,2014/03/31,2013/02/23,99,3,0.621368268,3435,99,1,2
53711,2014/03/31,2011/07/28,584,4,0.568433671,3754,584,4,0
53712,2014/03/31,2006/09/08,341,2,0.7949329359999999,2684,341,1,1
53713,2014/03/31,2012/04/28,40,9,0.635555556,3357,40,8,1
53714,2014/03/31,2007/06/13,223,3,0.694053351,3074,223,1,2
53715,2014/03/31,2005/06/19,580,4,0.506649252,4211,580,4,0
53716,2014/03/31,2011/09/16,31,5,0.39116795,5454,31,0,5
53717,2014/03/31,2011/12/23,73,3,0.42934192,4969,73,1,2
53718,2014/03/31,2011/11/25,528,2,0.8442421840000001,2527,528,2,0
53719,2014/03/31,2009/02/25,74,5,0.502558304,4245,74,1,4
53720,2014/03/31,2011/02/20,653,4,0.6625,3220,653,4,0
53721,2014/03/31,2012/03/23,297,3,0.528422096,4037,297,2,1
53722,2014/03/31,2009/10/03,1,2,0.775,2752,1,0,2
53723,2014/03/31,2012/11/24,15,3,0.641772495,3323,15,0,3
53724,2014/03/31,2008/06/26,34,3,0.849641434,2510,34,0,3
53725,2014/03/31,2010/06/03,108,4,0.414146436,5149,108,1,3
53726,2014/03/31,2012/12/31,101,2,0.8244083529999999,2586,101,1,1
53727,2014/03/31,2012/03/15,49,5,0.778,2740,49,2,3
53728,2014/03/31,2012/02/20,296,4,0.525,4060,296,3,1
53729,2014/03/31,2008/12/28,102,3,0.570168539,3738,102,1,2
53730,2014/03/31,2013/02/21,138,5,0.455207176,4682,138,0,5
53731,2014/03/31,2012/08/28,43,2,0.775,2750,43,0,2
53732,2014/03/31,2011/09/17,648,4,0.3875,5500,648,4,0
53733,2014/03/31,2009/08/02,595,4,0.7,3044,595,4,0
53734,2014/03/31,2012/03/01,569,4,0.7,3044,569,4,0
53735,2014/03/31,2012/05/03,402,4,0.7,3044,402,4,0
53736,2014/03/31,2005/12/06,172,4,0.92,2316,172,0,4
53737,2014/03/31,2012/10/23,231,3,0.43982659,4844,231,1,2
53738,2014/03/31,2012/12/28,356,2,0.8,2663,356,1,1
53739,2014/03/31,2012/10/27,115,3,0.516561591,4124,115,2,1
53740,2014/03/31,2007/11/30,328,3,0.516537342,4124,328,1,2
53741,2014/03/31,2010/03/03,76,4,0.61,3492,76,2,2
53742,2014/03/31,2010/10/19,397,3,1.0,2130,397,3,0
53743,2014/03/31,2012/01/19,55,3,0.389606731,5467,55,1,2
53744,2014/03/31,2009/07/05,218,2,0.7454497720000001,2857,218,1,1
53745,2014/03/31,2012/07/28,362,3,0.565454063,3766,362,2,1
53746,2014/03/31,2009/07/11,160,2,0.887536474,2399,160,1,1
53747,2014/03/31,2012/07/26,592,2,1.0,2129,592,2,0
53748,2014/03/31,2012/07/27,318,3,0.8,2661,318,1,2
53749,2014/03/31,2012/07/24,460,3,0.5761028420000001,3695,460,3,0
53750,2014/03/31,2008/11/08,495,3,0.535509434,3975,495,3,0
53751,2014/03/31,2009/10/29,124,2,0.597490174,3562,124,0,2
53752,2014/03/31,2011/11/12,492,2,0.649847328,3275,492,2,0
53753,2014/03/31,2012/10/28,516,2,0.8,2660,516,2,0
53754,2014/03/31,2012/03/13,444,2,0.8,2660,444,2,0
53755,2014/03/31,2007/09/09,156,3,0.92,2313,156,0,3
53756,2014/03/31,2009/01/04,342,3,0.441452282,4820,342,2,1
53757,2014/03/31,2012/07/05,526,3,0.4166666670000001,5106,526,3,0
53758,2014/03/31,2012/10/25,23,2,0.660981976,3218,23,1,1
53759,2014/03/31,2011/11/20,565,2,0.6700850660000001,3174,565,2,0
53760,2014/03/31,2012/03/18,201,3,0.354887369,5993,201,0,3
53761,2014/03/31,2011/06/25,657,2,0.620209974,3429,657,2,0
53762,2014/03/31,2012/05/23,639,2,0.6,3544,639,2,0
53763,2014/03/31,2012/10/17,525,2,0.620665499,3426,525,2,0
53764,2014/03/31,2012/05/30,261,2,0.875,2430,261,1,1
53765,2014/03/31,2012/06/13,376,3,0.717257085,2964,376,3,0
53766,2014/03/31,2011/01/15,139,2,0.6071836620000001,3501,139,0,2
53767,2014/03/31,2007/03/22,155,4,0.796157303,2670,155,1,3
53768,2014/03/31,2010/01/07,159,4,0.7629827709999999,2786,159,0,4
53769,2014/03/31,2008/04/21,101,2,0.735,2892,101,0,2
53770,2014/03/31,2008/04/09,34,3,0.676666667,3141,34,0,3
53771,2014/03/31,2007/07/06,460,3,0.933333333,2277,460,3,0
53772,2014/03/31,2012/09/10,342,2,0.739679777,2873,342,1,1
53773,2014/03/31,2009/11/13,119,2,0.705,3014,119,0,2
53774,2014/03/31,2012/08/30,466,2,0.8,2656,466,2,0
53775,2014/03/31,2008/09/24,567,2,0.684756687,3103,567,2,0
53776,2014/03/31,2007/07/23,251,2,0.911037736,2332,251,0,2
53777,2014/03/31,2011/06/29,610,2,0.775575027,2739,610,2,0
53778,2014/03/31,2009/07/12,486,3,0.483333333,4395,486,3,0
53779,2014/03/31,2006/06/21,290,4,0.8925,2380,290,0,4
53780,2014/03/31,2013/01/08,185,5,0.854424779,2486,185,4,1
53781,2014/03/31,2012/08/25,263,3,0.613681017,3461,263,2,1
53782,2014/03/31,2009/11/26,176,4,0.325160747,6532,176,2,2
53783,2014/03/31,2005/05/08,238,3,0.538625412,3943,238,2,1
53784,2014/03/31,2008/05/07,284,3,0.514860606,4125,284,1,2
53785,2014/03/31,2006/10/01,277,4,0.468616505,4532,277,3,1
53786,2014/03/31,2006/03/31,164,2,1.41,1506,164,0,2
53787,2014/03/31,2013/03/31,167,4,0.8027863890000001,2645,167,1,3
53788,2014/03/31,2012/03/07,195,4,0.7004717909999999,3031,195,3,1
53789,2014/03/31,2011/03/11,109,3,0.514265988,4128,109,1,2
53790,2014/03/31,2013/01/03,247,3,0.5230606210000001,4058,247,1,2
53791,2014/03/31,2013/03/01,342,2,0.639084613,3321,342,1,1
53792,2014/03/31,2010/09/21,104,3,0.641714545,3307,104,0,3
53793,2014/03/31,2012/12/22,33,5,0.7885730209999999,2691,33,3,2
53794,2014/03/31,2011/05/19,272,3,0.675071588,3143,272,0,3
53795,2014/03/31,2010/12/12,265,2,0.42972858,4937,265,0,2
53796,2014/03/31,2013/03/27,135,2,1.361578947,1558,135,1,1
53797,2014/03/31,2012/02/06,575,2,1.05,2020,575,2,0
53798,2014/03/31,2011/12/11,603,2,0.5624502779999999,3771,603,2,0
53799,2014/03/31,2011/03/18,490,3,0.435819975,4866,490,3,0
53800,2014/03/31,2013/02/02,42,3,0.34666666700000004,6117,42,0,3
53801,2014/03/31,2009/07/26,645,3,0.4764943820000001,4450,645,3,0
53802,2014/03/31,2013/01/18,416,2,1.0,2120,416,2,0
53803,2014/03/31,2012/11/02,467,2,0.772839956,2743,467,2,0
53804,2014/03/31,2007/07/11,388,2,0.5456628060000001,3885,388,2,0
53805,2014/03/31,2009/05/12,330,3,0.850300842,2493,330,2,1
53806,2014/03/31,2009/09/06,499,3,0.443946376,4774,499,3,0
53807,2014/03/31,2007/09/27,422,2,0.632815766,3349,422,2,0
53808,2014/03/31,2006/08/11,203,4,0.714223121,2967,203,2,2
53809,2014/03/31,2008/11/11,473,2,1.0,2119,473,2,0
53810,2014/03/31,2008/07/22,478,2,1.0,2119,478,2,0
53811,2014/03/31,2011/04/12,95,3,0.63,3363,95,0,3
53812,2014/03/31,2012/09/16,48,3,0.65209603,3249,48,1,2
53813,2014/03/31,2013/01/15,384,2,0.590713887,3586,384,2,0
53814,2014/03/31,2006/09/10,304,2,0.595,3560,304,0,2
53815,2014/03/31,2010/05/10,628,2,0.7187648459999999,2947,628,2,0
53816,2014/03/31,2013/01/09,371,2,0.637966867,3320,371,2,0
53817,2014/03/31,2007/02/11,37,3,0.7145546559999999,2964,37,0,3
53818,2014/03/31,2008/07/20,635,2,0.6684027779999999,3168,635,2,0
53819,2014/03/31,2007/04/10,478,3,0.540615424,3916,478,3,0
53820,2014/03/31,2012/12/23,16,3,0.600916832,3523,16,1,2
53821,2014/03/31,2013/03/31,353,2,0.725,2920,353,0,2
53822,2014/03/31,2007/12/13,444,2,1.0,2117,444,2,0
53823,2014/03/31,2012/04/21,409,2,0.5,4233,409,2,0
53824,2014/03/31,2006/07/04,77,3,0.355446758,5954,77,2,1
53825,2014/03/31,2012/04/20,412,2,0.946845638,2235,412,2,0
53826,2014/03/31,2010/04/27,54,3,0.833902247,2537,54,0,3
53827,2014/03/31,2009/09/25,150,3,0.6952086759999999,3043,150,2,1
53828,2014/03/31,2010/04/22,576,3,0.833333333,2538,576,3,0
53829,2014/03/31,2011/07/01,514,2,1.037027955,2039,514,2,0
53830,2014/03/31,2011/11/27,9,5,0.401914085,5261,9,3,2
53831,2014/03/31,2011/04/12,193,2,0.85430303,2475,193,1,1
53832,2014/03/31,2011/11/11,492,3,0.404883187,5222,492,3,0
53833,2014/03/31,2013/01/21,4,2,1.044098765,2025,4,0,2
53834,2014/03/31,2011/10/08,3,3,0.7041205859999999,3002,3,2,1
53835,2014/03/31,2011/09/19,615,4,0.580659341,3640,615,4,0
53836,2014/03/31,2007/10/13,428,4,0.447996608,4717,428,4,0
53837,2014/03/31,2008/12/03,308,3,0.370052539,5710,308,2,1
53838,2014/03/31,2008/11/08,353,4,0.382052441,5530,353,2,2
53839,2014/03/31,2013/02/26,273,2,0.5218947629999999,4048,273,1,1
53840,2014/03/31,2012/09/23,120,2,0.625,3380,120,0,2
53841,2014/03/31,2012/03/08,152,2,0.77,2743,152,0,2
53842,2014/03/31,2008/04/01,686,2,0.623884786,3385,686,2,0
53843,2014/03/31,2012/10/15,24,8,0.692594293,3049,24,3,5
53844,2014/03/31,2010/09/13,102,5,0.822961808,2566,102,4,1
53845,2014/03/31,2012/11/19,450,3,0.540478628,3907,450,3,0
53846,2014/03/31,2012/12/13,156,4,0.559255629,3775,156,2,2
53847,2014/03/31,2013/03/03,172,2,0.905922747,2330,172,0,2
53848,2014/03/31,2007/09/22,32,3,0.439011858,4807,32,0,3
53849,2014/03/31,2011/05/19,37,4,0.6503174110000001,3245,37,0,4
53850,2014/03/31,2012/09/01,78,4,0.703755837,2998,78,2,2
53851,2014/03/31,2012/01/05,24,5,0.432868281,4874,24,4,1
53852,2014/03/31,2011/11/20,35,3,0.394351402,5350,35,0,3
53853,2014/03/31,2004/11/24,12,4,0.440279691,4791,12,0,4
53854,2014/03/31,2012/12/11,256,3,0.962262774,2192,256,2,1
53855,2014/03/31,2012/12/15,428,3,0.8666666670000001,2433,428,3,0
53856,2014/03/31,2010/01/07,626,2,0.862060507,2446,626,2,0
53857,2014/03/31,2010/10/17,277,2,0.500676799,4211,277,1,1
53858,2014/03/31,2011/04/11,223,2,0.672786467,3133,223,1,1
53859,2014/03/31,2012/05/31,177,4,0.91,2316,177,2,2
53860,2014/03/31,2012/06/26,4,2,0.93,2266,4,0,2
53861,2014/03/31,2005/10/20,552,2,0.821520468,2565,552,2,0
53862,2014/03/31,2010/11/22,571,3,0.74608711,2824,571,3,0
53863,2014/03/31,2012/10/16,274,3,0.563041154,3742,274,0,3
53864,2014/03/31,2012/10/14,508,2,0.948604232,2221,508,2,0
53865,2014/03/31,2010/10/24,62,2,1.41,1494,62,0,2
53866,2014/03/31,2009/03/23,124,2,0.827227023,2546,124,0,2
53867,2014/03/31,2011/09/08,228,3,0.95256445,2211,228,2,1
53868,2014/03/31,2006/07/23,557,2,0.979125988,2151,557,2,0
53869,2014/03/31,2011/01/11,559,3,0.695049505,3030,559,3,0
53870,2014/03/31,2011/08/09,323,3,0.5337050179999999,3946,323,2,1
53871,2014/03/31,2011/10/27,196,2,0.92,2289,196,0,2
53872,2014/03/31,2007/02/15,199,2,0.92,2289,199,0,2
53873,2014/03/31,2008/01/18,145,4,0.333065486,6322,145,0,4
53874,2014/03/31,2012/05/16,5,2,0.765,2752,5,0,2
53875,2014/03/31,2011/02/12,177,3,0.51,4128,177,0,3
53876,2014/03/31,2011/01/24,379,3,0.705495979,2984,379,3,0
53877,2014/03/31,2009/07/03,136,2,0.6788036120000001,3101,136,0,2
53878,2014/03/31,2012/06/06,196,4,0.738211154,2851,196,2,2
53879,2014/03/31,2010/12/30,617,2,0.6739910309999999,3122,617,2,0
53880,2014/03/31,2007/05/23,580,2,1.0,2104,580,2,0
53881,2014/03/31,2007/10/19,62,2,0.765047273,2750,62,1,1
53882,2014/03/31,2012/03/14,659,3,0.416204986,5054,659,3,0
53883,2014/03/31,2006/04/23,21,4,0.584283333,3600,21,2,2
53884,2014/03/31,2013/01/29,257,2,1.118240298,1881,257,0,2
53885,2014/03/31,2012/08/14,252,2,0.574644809,3660,252,1,1
53886,2014/03/31,2011/01/05,33,5,0.597242261,3521,33,2,3
53887,2014/03/31,2012/10/02,223,3,0.31578315100000004,6659,223,1,2
53888,2014/03/31,2011/06/16,460,5,0.6007428570000001,3500,460,5,0
53889,2014/03/31,2008/07/02,234,3,0.8864909320000001,2371,234,1,2
53890,2014/03/31,2008/03/08,70,3,0.779325176,2697,70,0,3
53891,2014/03/31,2011/02/01,25,4,0.9075,2316,25,3,1
53892,2014/03/31,2007/01/19,197,3,0.498789461,4213,197,2,1
53893,2014/03/31,2013/01/01,219,3,0.69,3045,219,0,3
53894,2014/03/31,2011/12/13,188,3,0.530161494,3963,188,2,1
53895,2014/03/31,2013/03/07,312,2,0.55,3820,312,0,2
53896,2014/03/31,2010/04/19,161,3,0.592351946,3546,161,2,1
53897,2014/03/31,2013/03/26,260,2,0.587360179,3576,260,1,1
53898,2014/03/31,2006/11/13,544,2,0.75,2800,544,2,0
53899,2014/03/31,2008/04/08,688,2,0.75,2800,688,2,0
53900,2014/03/31,2012/04/25,677,2,0.75,2800,677,2,0
53901,2014/03/31,2008/02/07,720,2,0.75,2800,720,2,0
53902,2014/03/31,2008/04/10,552,3,0.8,2625,552,3,0
53903,2014/03/31,2010/09/20,684,2,0.75,2800,684,2,0
53904,2014/03/31,2009/07/19,43,3,0.907898833,2313,43,0,3
53905,2014/03/31,2009/12/28,11,3,0.7533333329999999,2787,11,1,2
53906,2014/03/31,2006/04/27,186,2,1.33126189,1577,186,1,1
53907,2014/03/31,2006/02/28,82,4,0.5625,3732,82,1,3
53908,2014/03/31,2012/06/23,328,3,0.75,2799,328,2,1
53909,2014/03/31,2009/09/12,235,4,0.9,2332,235,0,4
53910,2014/03/31,2012/04/23,705,2,0.8,2623,705,2,0
53911,2014/03/31,2013/03/20,110,3,0.7151465579999999,2934,110,0,3
53912,2014/03/31,2012/09/11,555,2,0.65,3228,555,2,0
53913,2014/03/31,2012/11/29,121,2,0.65,3228,121,0,2
53914,2014/03/31,2009/07/23,512,3,0.651552795,3220,512,3,0
53915,2014/03/31,2011/02/06,372,2,0.509509351,4117,372,2,0
53916,2014/03/31,2009/10/24,314,2,0.573428103,3658,314,1,1
53917,2014/03/31,2009/10/24,314,2,0.573428103,3658,314,1,1
53918,2014/03/31,2011/06/28,440,3,0.571966185,3667,440,3,0
53919,2014/03/31,2007/11/26,669,3,0.8486442740000001,2471,669,3,0
53920,2014/03/31,2007/11/01,371,2,0.725,2892,371,2,0
53921,2014/03/31,2007/02/16,182,2,0.92,2279,182,0,2
53922,2014/03/31,2008/03/10,573,3,0.8386399999999999,2500,573,3,0
53923,2014/03/31,2008/11/04,111,3,1.076666667,1947,111,0,3
53924,2014/03/31,2005/10/03,157,10,0.209794836,9992,157,8,2
53925,2014/03/31,2010/10/11,9,2,0.815,2572,9,0,2
53926,2014/03/31,2007/06/09,452,3,0.622312945,3368,452,3,0
53927,2014/03/31,2010/07/07,176,3,0.573447332,3655,176,1,2
53928,2014/03/31,2004/11/17,98,3,0.831897578,2519,98,1,2
53929,2014/03/31,2008/08/30,3,3,0.86199095,2431,3,0,3
53930,2014/03/31,2007/08/27,136,2,0.930057701,2253,136,0,2
53931,2014/03/31,2005/07/07,12,2,1.41,1486,12,0,2
53932,2014/03/31,2011/05/13,94,2,0.788859187,2656,94,1,1
53933,2014/03/31,2011/10/25,515,2,0.665079365,3150,515,2,0
53934,2014/03/31,2012/03/15,202,2,0.792633371,2643,202,1,1
53935,2014/03/31,2005/10/27,375,2,0.7466310159999999,2805,375,2,0
53936,2014/03/31,2012/07/28,503,3,0.77383592,2706,503,3,0
53937,2014/03/31,2012/11/11,115,3,0.696113697,3008,115,0,3
53938,2014/03/31,2012/07/24,612,2,0.825591483,2536,612,2,0
53939,2014/03/31,2004/11/25,503,4,0.8,2617,503,4,0
53940,2014/03/31,2012/07/16,21,2,0.8223055770000001,2546,21,1,1
53941,2014/03/31,2012/12/13,107,2,0.644675085,3247,107,1,1
53942,2014/03/31,2012/08/01,454,5,0.46,4550,454,5,0
53943,2014/03/31,2013/03/01,193,2,0.914329401,2289,193,1,1
53944,2014/03/31,2012/01/06,664,2,0.8,2616,664,2,0
53945,2014/03/31,2013/01/12,337,3,0.533333333,3924,337,2,1
53946,2014/03/31,2008/05/03,568,2,0.8,2616,568,2,0
53947,2014/03/31,2007/06/26,437,2,0.8,2616,437,2,0
53948,2014/03/31,2009/04/05,632,4,0.4,5232,632,4,0
53949,2014/03/31,2005/11/18,371,2,0.8,2616,371,2,0
53950,2014/03/31,2007/12/26,422,3,0.533333333,3924,422,3,0
53951,2014/03/31,2008/06/01,391,4,0.4,5232,391,4,0
53952,2014/03/31,2011/08/19,717,2,0.8,2616,717,2,0
53953,2014/03/31,2008/09/22,704,2,0.8,2616,704,2,0
53954,2014/03/31,2012/03/13,704,2,0.8,2616,704,2,0
53955,2014/03/31,2010/12/24,59,3,0.592984694,3528,59,1,2
53956,2014/03/31,2010/05/19,524,2,1.0,2092,524,2,0
53957,2014/03/31,2008/05/08,89,2,0.79969419,2616,89,0,2
53958,2014/03/31,2013/03/01,207,2,0.506616614,4129,207,0,2
53959,2014/03/31,2008/09/02,9,3,0.642164569,3257,9,2,1
53960,2014/03/31,2011/08/18,212,2,0.49,4268,212,0,2
53961,2014/03/31,2008/06/17,265,2,0.49,4268,265,0,2
53962,2014/03/31,2007/08/10,73,3,0.583333333,3585,73,1,2
53963,2014/03/31,2006/03/11,70,2,0.7650640320000001,2733,70,1,1
53964,2014/03/31,2012/04/06,260,3,0.818668755,2554,260,1,2
53965,2014/03/31,2011/05/22,595,2,0.588115331,3555,595,2,0
53966,2014/03/31,2006/05/21,65,2,0.685,3052,65,1,1
53967,2014/03/31,2010/05/08,78,5,0.451388469,4631,78,4,1
53968,2014/03/31,2011/12/25,694,3,0.921746802,2267,694,3,0
53969,2014/03/31,2012/08/02,300,4,0.4968965520000001,4205,300,2,2
53970,2014/03/31,2012/05/18,77,4,0.793558678,2633,77,3,1
53971,2014/03/31,2010/03/14,88,5,0.369405941,5656,88,4,1
53972,2014/03/31,2012/10/23,24,3,0.506556741,4124,24,1,2
53973,2014/03/31,2011/10/31,628,2,0.495504152,4215,628,2,0
53974,2014/03/31,2010/01/11,647,4,0.9,2320,647,4,0
53975,2014/03/31,2009/03/23,672,2,0.85,2456,672,2,0
53976,2014/03/31,2013/03/20,366,2,0.434061135,4809,366,1,1
53977,2014/03/31,2011/02/27,37,2,0.77,2710,37,0,2
53978,2014/03/31,2012/03/13,4,2,0.77,2710,4,0,2
53979,2014/03/31,2011/03/20,533,2,0.6167454920000001,3383,533,2,0
53980,2014/03/31,2009/04/17,318,3,0.639797484,3259,318,2,1
53981,2014/03/31,2010/01/08,646,2,0.75,2780,646,2,0
53982,2014/03/31,2012/09/14,551,2,0.75,2780,551,2,0
53983,2014/03/31,2010/11/19,618,2,0.75,2780,618,2,0
53984,2014/03/31,2012/07/27,225,2,0.615,3390,225,0,2
53985,2014/03/31,2009/09/30,345,2,0.7,2978,345,1,1
53986,2014/03/31,2010/05/21,497,2,0.513121615,4062,497,2,0
53987,2014/03/31,2009/07/18,77,7,0.39215428,5315,77,5,2
53988,2014/03/31,2007/05/17,291,3,0.603442386,3454,291,2,1
53989,2014/03/31,2010/09/03,333,3,0.497279885,4191,333,2,1
53990,2014/03/31,2012/05/10,169,2,0.845419878,2465,169,1,1
53991,2014/03/31,2011/04/18,652,2,0.7,2977,652,2,0
53992,2014/03/31,2013/03/26,97,2,0.461434898,4516,97,0,2
53993,2014/03/31,2011/07/28,470,4,0.598105082,3483,470,4,0
53994,2014/03/31,2012/07/30,599,2,0.8,2604,599,2,0
53995,2014/03/31,2012/09/20,379,2,0.8,2604,379,2,0
53996,2014/03/31,2012/03/18,334,3,0.591089671,3524,334,1,2
53997,2014/03/31,2007/11/03,33,2,0.6359145039999999,3275,33,0,2
53998,2014/03/31,2009/04/08,63,4,0.73897445,2818,63,3,1
53999,2014/03/31,2012/07/28,610,3,0.796328872,2615,610,3,0
54000,2014/03/31,2010/04/26,491,2,0.801385681,2598,491,2,0
54001,2014/03/31,2008/02/14,32,4,0.391223684,5320,32,0,4
54002,2014/03/31,2007/04/20,262,4,0.55932545,3721,262,3,1
54003,2014/03/31,2011/01/13,631,3,0.854351396,2436,631,3,0
54004,2014/03/31,2009/05/31,71,2,0.695,2994,71,0,2
54005,2014/03/31,2012/02/11,107,3,0.686666667,3030,107,1,2
54006,2014/03/31,2008/07/25,7,2,0.53816865,3866,7,1,1
54007,2014/03/31,2010/10/10,39,4,0.595088673,3496,39,2,2
54008,2014/03/31,2006/04/25,630,2,0.836093248,2488,630,2,0
54009,2014/03/31,2010/01/13,139,2,0.79095057,2630,139,0,2
54010,2014/03/31,2012/09/01,529,2,0.836093248,2488,529,2,0
54011,2014/03/31,2011/04/22,561,2,0.762481672,2728,561,2,0
54012,2014/03/31,2009/08/20,226,2,0.8383313179999999,2481,226,1,1
54013,2014/03/31,2008/11/13,565,3,0.798081351,2606,565,3,0
54014,2014/03/31,2012/07/31,156,5,0.416952686,4988,156,0,5
54015,2014/03/31,2011/11/21,140,4,0.605620268,3434,140,2,2
54016,2014/03/31,2010/12/17,209,2,1.042918756,1994,209,1,1
54017,2014/03/31,2012/04/30,509,5,0.521806775,3985,509,5,0
54018,2014/03/31,2011/04/13,277,3,0.638804916,3255,277,2,1
54019,2014/03/31,2013/03/18,159,3,0.58,3585,159,0,3
54020,2014/03/31,2010/06/05,523,4,0.949315068,2190,523,4,0
54021,2014/03/31,2006/09/11,178,3,0.669015127,3107,178,2,1
54022,2014/03/31,2009/04/15,691,2,0.772352285,2691,691,2,0
54023,2014/03/31,2010/10/04,695,2,1.0,2078,695,2,0
54024,2014/03/31,2012/02/25,593,2,1.0,2078,593,2,0
54025,2014/03/31,2007/07/12,510,4,0.713336766,2913,510,4,0
54026,2014/03/31,2011/01/13,600,3,0.5,4155,600,3,0
54027,2014/03/31,2012/03/31,140,2,0.911390961,2279,140,1,1
54028,2014/03/31,2009/03/17,228,3,0.487446609,4261,228,2,1
54029,2014/03/31,2005/12/21,566,2,0.5,4154,566,2,0
54030,2014/03/31,2011/10/03,328,2,0.5,4154,328,0,2
54031,2014/03/31,2011/06/14,14,4,0.8,2596,14,0,4
54032,2014/03/31,2012/05/22,48,2,0.6849571240000001,3032,48,1,1
54033,2014/03/31,2010/11/19,172,2,0.49,4238,172,0,2
54034,2014/03/31,2011/04/21,251,2,0.61,3404,251,1,1
54035,2014/03/31,2011/04/01,437,2,0.672562358,3087,437,2,0
54036,2014/03/31,2012/09/14,108,2,0.736170213,2820,108,0,2
54037,2014/03/31,2008/12/03,349,3,0.533226304,3893,349,2,1
54038,2014/03/31,2013/02/01,66,2,0.613000591,3386,66,1,1
54039,2014/03/31,2011/06/22,67,2,0.857286245,2421,67,1,1
54040,2014/03/31,2008/09/30,686,2,0.920177384,2255,686,2,0
54041,2014/03/31,2013/03/31,282,2,0.591211171,3509,282,1,1
54042,2014/03/31,2011/07/03,518,2,0.730715041,2839,518,2,0
54043,2014/03/31,2012/04/19,51,2,0.674791802,3074,51,0,2
54044,2014/03/31,2013/01/28,416,2,0.25,8296,416,2,0
54045,2014/03/31,2006/05/07,674,2,0.813652413,2549,674,2,0
54046,2014/03/31,2010/11/14,79,3,0.841607143,2464,79,2,1
54047,2014/03/31,2006/09/20,443,3,0.883091993,2348,443,3,0
54048,2014/03/31,2007/02/22,3,2,0.915,2266,3,0,2
54049,2014/03/31,2009/12/08,234,3,0.7656388479999999,2708,234,2,1
54050,2014/03/31,2012/05/27,352,3,0.5848378000000001,3545,352,1,2
54051,2014/03/31,2011/01/24,19,2,0.803811555,2579,19,0,2
54052,2014/03/31,2008/05/15,201,2,0.77,2692,201,0,2
54053,2014/03/31,2010/01/18,153,2,0.92,2253,153,0,2
54054,2014/03/31,2005/09/09,137,4,0.705405037,2938,137,3,1
54055,2014/03/31,2011/12/12,371,3,0.6,3454,371,3,0
54056,2014/03/31,2006/05/13,130,5,0.578509213,3582,130,3,2
54057,2014/03/31,2008/11/26,91,3,0.5426977479999999,3818,91,2,1
54058,2014/03/31,2011/01/14,406,3,1.0,2072,406,3,0
54059,2014/03/31,2005/01/12,430,2,0.617187965,3357,430,2,0
54060,2014/03/31,2006/12/02,415,2,0.742882754,2789,415,2,0
54061,2014/03/31,2005/04/01,341,2,0.6,3453,341,1,1
54062,2014/03/31,2013/02/08,297,3,0.7433333329999999,2787,297,1,2
54063,2014/03/31,2012/01/18,127,2,0.801373308,2585,127,0,2
54064,2014/03/31,2010/06/18,19,3,0.74,2799,19,0,3
54065,2014/03/31,2010/04/27,162,2,0.568873626,3640,162,1,1
54066,2014/03/31,2012/07/18,603,3,0.683333333,3030,603,3,0
54067,2014/03/31,2007/05/01,248,3,1.066666667,1941,248,2,1
54068,2014/03/31,2012/03/10,222,4,0.7975,2596,222,2,2
54069,2014/03/31,2005/08/05,109,3,0.615602141,3363,109,0,3
54070,2014/03/31,2011/04/04,524,2,0.929129264,2228,524,2,0
54071,2014/03/31,2007/07/06,561,3,1.0,2070,561,3,0
54072,2014/03/31,2011/01/17,375,3,1.0,2070,375,3,0
54073,2014/03/31,2011/08/27,694,3,1.0,2070,694,3,0
54074,2014/03/31,2011/08/02,488,3,1.0,2070,488,3,0
54075,2014/03/31,2011/12/01,663,3,1.0,2070,663,3,0
54076,2014/03/31,2012/08/16,432,3,1.0,2070,432,3,0
54077,2014/03/31,2013/03/30,365,2,1.5,1380,365,1,1
54078,2014/03/31,2011/10/18,579,3,1.0,2070,579,3,0
54079,2014/03/31,2013/01/09,361,3,1.0,2070,361,1,2
54080,2014/03/31,2009/03/29,503,4,0.746178803,2774,503,4,0
54081,2014/03/31,2012/08/18,349,3,0.744568345,2780,349,1,2
54082,2014/03/31,2011/01/13,118,2,0.667664516,3100,118,0,2
54083,2014/03/31,2008/01/05,614,2,0.847155137,2443,614,2,0
54084,2014/03/31,2011/03/17,608,3,0.7574304540000001,2732,608,3,0
54085,2014/03/31,2013/01/19,433,2,0.55,3762,433,2,0
54086,2014/03/31,2010/11/10,194,2,0.8581833259999999,2411,194,0,2
54087,2014/03/31,2012/02/05,149,4,0.5925,3492,149,3,1
54088,2014/03/31,2013/01/12,235,4,0.5925,3492,235,2,2
54089,2014/03/31,2010/10/24,676,2,1.0,2069,676,2,0
54090,2014/03/31,2008/09/25,215,3,0.719613913,2875,215,1,2
54091,2014/03/31,2009/09/24,310,3,0.442449198,4675,310,2,1
54092,2014/03/31,2010/05/24,260,4,0.911940035,2268,260,2,2
54093,2014/03/31,2005/01/27,191,2,0.6886346990000001,3003,191,0,2
54094,2014/03/31,2008/12/14,71,3,0.386595625,5349,71,0,3
54095,2014/03/31,2012/11/18,312,4,0.543585699,3804,312,2,2
54096,2014/03/31,2013/01/14,67,2,0.574865165,3597,67,0,2
54097,2014/03/31,2012/02/08,550,2,0.725,2852,550,2,0
54098,2014/03/31,2009/12/12,104,4,0.820420635,2520,104,0,4
54099,2014/03/31,2006/06/24,376,2,0.7779074140000001,2657,376,2,0
54100,2014/03/31,2007/03/08,251,2,0.77,2684,251,0,2
54101,2014/03/31,2009/08/10,331,2,0.8,2582,331,0,2
54102,2014/03/31,2012/02/27,144,3,0.925818019,2231,144,1,2
54103,2014/03/31,2005/10/09,205,4,0.468258898,4411,205,3,1
54104,2014/03/31,2011/01/13,681,2,0.525,3934,681,2,0
54105,2014/03/31,2012/10/13,534,2,0.525,3934,534,2,0
54106,2014/03/31,2012/09/21,536,2,0.525,3934,536,2,0
54107,2014/03/31,2007/07/02,678,2,0.525,3934,678,2,0
54108,2014/03/31,2012/11/08,457,2,0.525,3934,457,2,0
54109,2014/03/31,2007/11/01,486,2,0.525,3934,486,2,0
54110,2014/03/31,2012/05/22,670,2,0.525,3934,670,2,0
54111,2014/03/31,2006/01/15,526,2,0.525,3934,526,2,0
54112,2014/03/31,2012/08/19,40,3,0.35,5901,40,1,2
54113,2014/03/31,2009/07/22,693,2,0.525,3934,693,2,0
54114,2014/03/31,2012/01/26,312,3,0.637014189,3242,312,0,3
54115,2014/03/31,2007/05/31,264,3,0.45952826,4494,264,1,2
54116,2014/03/31,2008/04/08,663,2,1.0,2065,663,2,0
54117,2014/03/31,2011/07/01,50,2,0.67,3082,50,0,2
54118,2014/03/31,2008/03/04,139,2,0.598333816,3451,139,0,2
54119,2014/03/31,2009/11/22,192,2,0.598333816,3451,192,0,2
54120,2014/03/31,2013/03/02,128,7,0.508571429,4060,128,0,7
54121,2014/03/31,2008/04/14,401,6,0.496859206,4155,401,6,0
54122,2014/03/31,2008/08/29,14,3,0.589805714,3500,14,1,2
54123,2014/03/31,2007/01/12,256,4,0.771682243,2675,256,2,2
54124,2014/03/31,2013/01/10,15,2,0.801934732,2574,15,0,2
54125,2014/03/31,2010/09/15,2,2,0.75,2752,2,0,2
54126,2014/03/31,2012/02/07,454,3,0.451739987,4569,454,3,0
54127,2014/03/31,2008/02/17,379,4,0.388516566,5312,379,4,0
54128,2014/03/31,2012/03/15,180,2,0.55,3752,180,0,2
54129,2014/03/31,2009/04/05,537,3,0.334061842,6177,537,3,0
54130,2014/03/31,2013/03/13,96,4,0.484387324,4260,96,2,2
54131,2014/03/31,2011/03/21,567,2,0.7896670490000001,2613,567,2,0
54132,2014/03/31,2007/07/15,159,4,0.3928927820000001,5251,159,2,2
54133,2014/03/31,2005/11/08,193,3,0.462096774,4464,193,2,1
54134,2014/03/31,2011/12/21,412,2,0.800388048,2577,412,2,0
54135,2014/03/31,2013/02/18,346,2,0.75,2750,346,0,2
54136,2014/03/31,2009/10/28,330,2,0.75,2750,330,1,1
54137,2014/03/31,2012/08/16,592,2,0.85,2426,592,2,0
54138,2014/03/31,2008/10/07,20,2,0.91,2266,20,0,2
54139,2014/03/31,2013/02/27,169,3,0.4676951,4408,169,2,1
54140,2014/03/31,2011/08/11,672,2,0.775,2660,672,2,0
54141,2014/03/31,2011/02/25,11,4,0.7752350509999999,2659,11,1,3
54142,2014/03/31,2012/11/12,367,2,0.75,2748,367,2,0
54143,2014/03/31,2012/09/30,535,2,0.80001941,2576,535,2,0
54144,2014/03/31,2011/07/02,176,2,0.92,2240,176,0,2
54145,2014/03/31,2009/09/29,641,2,0.4,5152,641,2,0
54146,2014/03/31,2012/09/04,539,2,0.4,5152,539,2,0
54147,2014/03/31,2012/10/07,176,4,0.3611461620000001,5706,176,2,2
54148,2014/03/31,2008/09/06,19,3,0.614551148,3353,19,0,3
54149,2014/03/31,2008/11/11,171,4,0.94,2192,171,0,4
54150,2014/03/31,2006/09/16,512,2,0.6,3434,512,2,0
54151,2014/03/31,2008/12/17,534,2,0.6,3434,534,2,0
54152,2014/03/31,2012/07/01,173,2,0.951667436,2165,173,1,1
54153,2014/03/31,2011/09/23,699,2,0.675,3052,699,2,0
54154,2014/03/31,2011/12/22,72,2,0.905087873,2276,72,0,2
54155,2014/03/31,2011/01/13,74,2,0.785,2624,74,0,2
54156,2014/03/31,2011/10/28,223,2,0.38,5420,223,0,2
54157,2014/03/31,2012/07/29,114,4,0.6521025970000001,3158,114,1,3
54158,2014/03/31,2012/04/28,484,3,0.613054481,3359,484,3,0
54159,2014/03/31,2007/10/10,606,2,0.8,2574,606,2,0
54160,2014/03/31,2006/03/27,229,3,0.77613268,2653,229,1,2
54161,2014/03/31,2011/04/29,648,4,0.8875,2320,648,4,0
54162,2014/03/31,2009/01/14,683,4,0.741180706,2778,683,4,0
54163,2014/03/31,2010/02/25,37,5,0.71,2900,37,2,3
54164,2014/03/31,2005/12/09,413,2,0.85,2422,413,2,0
54165,2014/03/31,2008/12/31,502,2,0.6549475020000001,3143,502,2,0
54166,2014/03/31,2011/09/27,105,4,0.480721794,4281,105,0,4
54167,2014/03/31,2012/07/12,608,2,0.8,2572,608,2,0
54168,2014/03/31,2011/08/10,145,4,0.513348303,4008,145,0,4
54169,2014/03/31,2010/04/12,502,2,0.59738676,3444,502,2,0
54170,2014/03/31,2006/10/28,349,3,0.889494163,2313,349,0,3
54171,2014/03/31,2011/09/13,274,3,0.830880452,2476,274,2,1
54172,2014/03/31,2007/10/25,7,3,0.493333333,4170,7,2,1
54173,2014/03/31,2011/03/07,142,3,0.573333333,3588,142,0,3
54174,2014/03/31,2009/08/01,633,2,0.674901575,3048,633,2,0
54175,2014/03/31,2013/03/24,295,2,0.432428001,4757,295,1,1
54176,2014/03/31,2012/09/04,564,3,0.7600886920000001,2706,564,3,0
54177,2014/03/31,2012/11/05,197,4,0.383635516,5361,197,3,1
54178,2014/03/31,2010/01/18,224,6,0.376666667,5460,224,4,2
54179,2014/03/31,2012/07/23,109,3,0.54661882,3762,109,0,3
54180,2014/03/31,2012/10/15,67,2,0.6906953309999999,2977,67,1,1
54181,2014/03/31,2013/03/24,313,2,0.6100890210000001,3370,313,1,1
54182,2014/03/31,2010/08/07,416,2,0.8,2570,416,2,0
54183,2014/03/31,2011/03/24,382,2,0.822071172,2501,382,2,0
54184,2014/03/31,2007/02/28,657,3,1.0,2056,657,3,0
54185,2014/03/31,2013/03/23,285,2,0.472419577,4352,285,0,2
54186,2014/03/31,2011/04/04,169,3,0.991292189,2074,169,2,1
54187,2014/03/31,2011/12/20,700,2,0.95,2164,700,2,0
54188,2014/03/31,2008/02/05,227,2,0.58204983,3532,227,0,2
54189,2014/03/31,2007/12/19,12,6,0.41288813,4979,12,1,5
54190,2014/03/31,2009/11/24,640,2,0.46860041,4387,640,2,0
54191,2014/03/31,2010/04/20,454,4,0.8875,2316,454,4,0
54192,2014/03/31,2012/03/21,645,4,0.680337637,3021,645,4,0
54193,2014/03/31,2012/07/19,117,2,0.910580416,2257,117,1,1
54194,2014/03/31,2010/05/09,642,2,0.623324234,3297,642,2,0
54195,2014/03/31,2010/03/31,256,2,0.732641711,2805,256,1,1
54196,2014/03/31,2012/07/04,350,3,0.9,2283,350,2,1
54197,2014/03/31,2009/12/28,43,4,0.555144556,3701,43,1,3
54198,2014/03/31,2012/05/27,297,3,0.61511976,3340,297,2,1
54199,2014/03/31,2011/08/18,437,2,0.8461285009999999,2428,437,2,0
54200,2014/03/31,2009/03/28,517,4,0.493371758,4164,517,4,0
54201,2014/03/31,2006/09/05,79,2,0.560630459,3664,79,0,2
54202,2014/03/31,2008/05/19,39,2,0.607106119,3383,39,0,2
54203,2014/03/31,2009/12/27,610,3,0.636442516,3227,610,3,0
54204,2014/03/31,2011/10/04,137,4,0.537068515,3824,137,1,3
54205,2014/03/31,2011/07/13,667,2,0.55,3734,667,2,0
54206,2014/03/31,2011/01/04,153,2,0.785,2616,153,1,1
54207,2014/03/31,2011/09/01,195,2,0.785,2616,195,0,2
54208,2014/03/31,2009/07/23,7,2,0.7478332120000001,2746,7,0,2
54209,2014/03/31,2011/02/24,520,4,0.507262846,4048,520,4,0
54210,2014/03/31,2011/11/16,403,2,0.75020095,2737,403,2,0
54211,2014/03/31,2011/06/18,187,2,0.986167147,2082,187,1,1
54212,2014/03/31,2007/12/05,153,2,1.41,1456,153,0,2
54213,2014/03/31,2009/12/31,250,2,0.579083216,3545,250,0,2
54214,2014/03/31,2010/03/01,502,3,0.7333333329999999,2799,502,3,0
54215,2014/03/31,2009/01/13,105,3,0.683429903,3003,105,2,1
54216,2014/03/31,2012/05/08,29,2,0.5798022039999999,3539,29,1,1
54217,2014/03/31,2006/10/10,390,2,0.635066543,3231,390,2,0
54218,2014/03/31,2008/06/21,134,6,0.5464340879999999,3755,134,2,4
54219,2014/03/31,2006/01/25,284,3,0.25693926100000003,7985,284,2,1
54220,2014/03/31,2010/06/30,636,3,0.783333333,2619,636,3,0
54221,2014/03/31,2013/02/07,344,2,0.7511534240000001,2731,344,0,2
54222,2014/03/31,2012/07/03,604,2,0.9,2279,604,2,0
54223,2014/03/31,2013/03/01,53,3,0.599141104,3423,53,0,3
54224,2014/03/31,2013/01/30,57,2,0.905,2266,57,0,2
54225,2014/03/31,2008/11/30,687,2,0.582089129,3523,687,2,0
54226,2014/03/31,2012/03/30,282,3,0.676666667,3030,282,2,1
54227,2014/03/31,2011/12/12,258,3,0.464875283,4410,258,2,1
54228,2014/03/31,2010/02/11,533,4,0.475,4316,533,4,0
54229,2014/03/31,2008/03/27,140,2,0.7411135209999999,2766,140,0,2
54230,2014/03/31,2011/01/24,48,4,0.377469613,5430,48,2,2
54231,2014/03/31,2012/01/22,223,6,0.6233333329999999,3288,223,5,1
54232,2014/03/31,2007/09/01,344,3,0.8688083120000001,2358,344,2,1
54233,2014/03/31,2009/09/27,16,2,0.48,4268,16,0,2
54234,2014/03/31,2006/12/24,62,2,0.48,4268,62,0,2
54235,2014/03/31,2007/09/03,159,2,0.744814545,2750,159,1,1
54236,2014/03/31,2011/10/24,161,2,0.744814545,2750,161,1,1
54237,2014/03/31,2013/01/03,275,3,0.496663434,4124,275,2,1
54238,2014/03/31,2010/04/11,267,3,0.8847602590000001,2315,267,2,1
54239,2014/03/31,2010/07/04,130,3,0.53208106,3849,130,1,2
54240,2014/03/31,2010/05/24,58,2,0.823761062,2486,58,0,2
54241,2014/03/31,2010/09/16,51,2,0.74984621,2731,51,0,2
54242,2014/03/31,2006/04/30,321,2,0.7429426709999999,2756,321,1,1
54243,2014/03/31,2010/12/28,97,3,0.75,2730,97,1,2
54244,2014/03/31,2007/01/04,57,3,0.683163163,2997,57,0,3
54245,2014/03/31,2004/12/18,80,3,0.370141049,5530,80,2,1
54246,2014/03/31,2012/09/05,256,2,0.524272541,3904,256,1,1
54247,2014/03/31,2009/09/19,290,3,0.393580769,5200,290,2,1
54248,2014/03/31,2011/07/12,366,4,0.5668975070000001,3610,366,3,1
54249,2014/03/31,2007/06/18,18,2,0.748372348,2734,18,0,2
54250,2014/03/31,2012/06/25,347,3,0.87100894,2349,347,2,1
54251,2014/03/31,2008/02/23,635,3,0.420773344,4862,635,3,0
54252,2014/03/31,2008/01/08,391,2,0.7694883370000001,2658,391,2,0
54253,2014/03/31,2010/11/25,213,3,0.7128511679999999,2869,213,0,3
54254,2014/03/31,2013/01/14,412,2,0.912946429,2240,412,2,0
54255,2014/03/31,2011/05/26,137,3,0.446666667,4578,137,0,3
54256,2014/03/31,2006/02/28,192,2,0.6828256509999999,2994,192,1,1
54257,2014/03/31,2012/09/26,21,4,0.8825,2316,21,3,1
54258,2014/03/31,2005/03/22,188,2,0.782657985,2611,188,1,1
54259,2014/03/31,2012/07/28,354,2,0.516245579,3958,354,1,1
54260,2014/03/31,2012/04/06,136,3,0.73,2799,136,2,1
54261,2014/03/31,2012/02/14,182,3,0.510377217,4003,182,1,2
54262,2014/03/31,2008/07/23,296,4,0.645651075,3164,296,2,2
54263,2014/03/31,2012/06/18,649,4,0.6043491120000001,3380,649,4,0
54264,2014/03/31,2008/03/20,156,2,0.850308077,2402,156,0,2
54265,2014/03/31,2011/07/10,643,3,0.33654416600000003,6068,643,3,0
54266,2014/03/31,2013/03/01,285,2,0.49,4167,285,0,2
54267,2014/03/31,2013/03/01,13,3,0.6533791999999999,3125,13,1,2
54268,2014/03/31,2011/07/06,591,2,0.7673055240000001,2661,591,2,0
54269,2014/03/31,2008/02/02,158,4,0.5000416360000001,4083,158,1,3
54270,2014/03/31,2009/11/07,307,3,0.65,3141,307,2,1
54271,2014/03/31,2012/05/26,674,2,0.814684757,2506,674,2,0
54272,2014/03/31,2010/06/14,352,2,0.500478058,4079,352,1,1
54273,2014/03/31,2011/12/10,600,3,0.7090309140000001,2879,600,3,0
54274,2014/03/31,2011/09/03,11,5,0.71271648,2864,11,1,4
54275,2014/03/31,2008/03/19,28,4,0.430597046,4740,28,1,3
54276,2014/03/31,2011/11/18,276,2,0.6637235770000001,3075,276,0,2
54277,2014/03/31,2007/10/27,218,4,0.4358061070000001,4683,218,2,2
54278,2014/03/31,2012/07/17,26,4,0.724217252,2817,26,2,2
54279,2014/03/31,2011/05/07,688,2,1.0,2040,688,2,0
54280,2014/03/31,2007/12/23,311,3,0.675621067,3019,311,1,2
54281,2014/03/31,2012/10/28,196,3,0.610041879,3343,196,2,1
54282,2014/03/31,2012/10/10,125,2,0.790632028,2579,125,1,1
54283,2014/03/31,2008/10/18,26,2,0.705,2892,26,0,2
54284,2014/03/31,2010/07/08,16,2,0.531629726,3835,16,1,1
54285,2014/03/31,2012/10/03,188,3,0.596369222,3418,188,2,1
54286,2014/03/31,2012/09/22,44,3,0.726666667,2805,44,2,1
54287,2014/03/31,2009/11/01,132,4,0.718431442,2837,132,0,4
54288,2014/03/31,2010/03/04,8,2,0.578506954,3523,8,0,2
54289,2014/03/31,2008/06/10,659,2,0.96172723,2119,659,2,0
54290,2014/03/31,2007/09/13,61,2,0.750456722,2715,61,1,1
54291,2014/03/31,2006/11/12,533,4,0.50244143,4055,533,4,0
54292,2014/03/31,2008/07/07,168,3,0.423989594,4805,168,0,3
54293,2014/03/31,2012/11/21,482,3,0.517662008,3935,482,3,0
54294,2014/03/31,2011/06/03,121,5,0.657408005,3098,121,4,1
54295,2014/03/31,2009/04/11,71,2,0.6,3394,71,0,2
54296,2014/03/31,2011/12/04,60,3,0.606239952,3359,60,0,3
54297,2014/03/31,2010/10/22,69,2,0.976494005,2085,69,1,1
54298,2014/03/31,2011/03/16,2,2,0.694819113,2930,2,0,2
54299,2014/03/31,2012/11/20,151,4,0.382945824,5316,151,1,3
54300,2014/03/31,2012/04/04,717,3,0.7564102559999999,2691,717,3,0
54301,2014/03/31,2011/04/03,46,2,0.49,4154,46,1,1
54302,2014/03/31,2012/06/13,183,2,0.71290718,2855,183,0,2
54303,2014/03/31,2012/12/23,448,4,0.485623956,4191,448,4,0
54304,2014/03/31,2005/09/09,225,2,0.54563807,3730,225,1,1
54305,2014/03/31,2012/05/05,611,2,0.7746859540000001,2627,611,2,0
54306,2014/03/31,2009/07/27,609,2,0.7746859540000001,2627,609,2,0
54307,2014/03/31,2008/05/01,215,2,0.974968855,2087,215,0,2
54308,2014/03/31,2007/02/01,652,2,0.774476589,2627,652,2,0
54309,2014/03/31,2013/02/11,150,3,0.493331717,4124,150,0,3
54310,2014/03/31,2008/07/01,217,2,1.253419593,1623,217,1,1
54311,2014/03/31,2011/11/29,71,3,0.893333333,2277,71,0,3
54312,2014/03/31,2010/08/15,10,3,0.623571429,3262,10,0,3
54313,2014/03/31,2005/07/25,493,2,0.6,3390,493,2,0
54314,2014/03/31,2011/02/06,623,2,0.6,3390,623,2,0
54315,2014/03/31,2007/09/03,24,3,0.726666667,2799,24,2,1
54316,2014/03/31,2008/06/13,624,3,0.639280101,3181,624,3,0
54317,2014/03/31,2012/11/09,506,2,0.666874385,3049,506,2,0
54318,2014/03/31,2010/11/19,189,2,0.265,7672,189,1,1
54319,2014/03/31,2009/07/11,35,4,0.65161859,3120,35,2,2
54320,2014/03/31,2007/09/24,50,3,0.607930622,3344,50,0,3
54321,2014/03/31,2011/08/06,675,3,0.477755582,4255,675,3,0
54322,2014/03/31,2012/06/21,322,2,0.6200122029999999,3278,322,1,1
54323,2014/03/31,2005/10/18,242,2,0.757785235,2682,242,1,1
54324,2014/03/31,2013/01/28,354,2,0.45,4516,354,1,1
54325,2014/03/31,2009/05/13,135,4,0.379043089,5361,135,2,2
54326,2014/03/31,2010/09/22,95,3,0.696115108,2919,95,1,2
54327,2014/03/31,2012/02/12,64,2,0.275,7388,64,1,1
54328,2014/03/31,2012/05/07,520,3,0.822510121,2470,520,3,0
54329,2014/03/31,2009/08/23,209,4,0.92,2208,209,0,4
54330,2014/03/31,2008/01/19,520,4,0.7625,2664,520,4,0
54331,2014/03/31,2007/03/10,536,3,0.7004310340000001,2900,536,3,0
54332,2014/03/31,2012/07/09,318,4,0.592300962,3429,318,2,2
54333,2014/03/31,2012/09/18,120,2,0.538124006,3774,120,1,1
54334,2014/03/31,2004/12/05,122,4,0.460287851,4412,122,0,4
54335,2014/03/31,2005/11/12,39,2,1.138335202,1784,39,1,1
54336,2014/03/31,2012/12/28,37,3,0.512168979,3965,37,0,3
54337,2014/03/31,2005/10/21,298,4,0.544126474,3732,298,2,2
54338,2014/03/31,2012/01/12,121,3,0.6,3384,121,1,2
54339,2014/03/31,2013/02/15,86,3,0.295063953,6880,86,0,3
54340,2014/03/31,2012/07/21,504,2,0.725,2800,504,2,0
54341,2014/03/31,2008/11/02,604,3,0.77480916,2620,604,3,0
54342,2014/03/31,2010/12/20,525,2,0.7,2900,525,2,0
54343,2014/03/31,2013/01/01,52,2,0.620036652,3274,52,0,2
54344,2014/03/31,2011/10/02,251,2,0.38,5342,251,0,2
54345,2014/03/31,2012/08/13,219,2,0.38,5342,219,0,2
54346,2014/03/31,2007/01/10,20,2,0.38,5342,20,0,2
54347,2014/03/31,2011/06/07,498,3,0.387237696,5242,498,3,0
54348,2014/03/31,2011/12/13,29,2,0.640858857,3167,29,1,1
54349,2014/03/31,2011/04/28,676,3,0.440534086,4606,676,3,0
54350,2014/03/31,2006/06/08,489,3,0.585232189,3467,489,3,0
54351,2014/03/31,2011/11/24,453,4,0.4,5072,453,4,0
54352,2014/03/31,2010/10/07,402,4,0.606698565,3344,402,4,0
54353,2014/03/31,2010/11/17,69,2,0.6641977729999999,3054,69,0,2
54354,2014/03/31,2012/12/26,119,3,0.376142433,5392,119,2,1
54355,2014/03/31,2013/02/09,138,2,0.92,2204,138,0,2
54356,2014/03/31,2012/03/20,367,2,0.4,5069,367,2,0
54357,2014/03/31,2006/07/19,630,3,0.544441461,3724,630,3,0
54358,2014/03/31,2012/01/17,586,3,0.833333333,2433,586,3,0
54359,2014/03/31,2012/05/07,497,2,0.775,2616,497,2,0
54360,2014/03/31,2011/10/02,445,2,0.775,2616,445,2,0
54361,2014/03/31,2012/06/06,663,2,0.775,2616,663,2,0
54362,2014/03/31,2008/07/16,663,2,0.775,2616,663,2,0
54363,2014/03/31,2011/07/19,210,3,0.587098175,3453,210,0,3
54364,2014/03/31,2012/03/15,17,3,0.682288792,2971,17,2,1
54365,2014/03/31,2012/01/09,537,4,0.732845264,2766,537,4,0
54366,2014/03/31,2010/10/17,293,3,0.533291239,3801,293,0,3
54367,2014/03/31,2012/08/25,102,2,0.50789777,3991,102,0,2
54368,2014/03/31,2012/11/21,33,2,0.487125691,4161,33,0,2
54369,2014/03/31,2011/08/24,154,3,0.735662432,2755,154,2,1
54370,2014/03/31,2011/10/05,219,3,0.571325063,3547,219,1,2
54371,2014/03/31,2005/10/27,727,2,0.899422992,2253,727,2,0
54372,2014/03/31,2010/06/28,214,2,0.668518641,3031,214,0,2
54373,2014/03/31,2012/11/28,63,2,0.71266268,2843,63,0,2
54374,2014/03/31,2010/04/16,36,3,0.402481128,5034,36,0,3
54375,2014/03/31,2008/03/07,151,4,0.58,3492,151,3,1
54376,2014/03/31,2008/06/21,275,2,0.5473594589999999,3700,275,1,1
54377,2014/03/31,2009/02/16,625,2,1.0,2025,625,2,0
54378,2014/03/31,2008/09/04,357,5,0.654899741,3092,357,4,1
54379,2014/03/31,2012/01/20,314,3,0.682355915,2967,314,2,1
54380,2014/03/31,2010/05/17,442,2,0.7,2892,442,2,0
54381,2014/03/31,2011/05/13,647,2,0.7,2892,647,2,0
54382,2014/03/31,2012/04/28,210,3,0.50978343,3971,210,0,3
54383,2014/03/31,2010/11/20,106,3,0.763007916,2653,106,1,2
54384,2014/03/31,2008/04/20,287,2,0.7510909090000001,2695,287,1,1
54385,2014/03/31,2008/10/03,193,2,0.6877879709999999,2943,193,0,2
54386,2014/03/31,2010/03/08,303,3,0.5738871560000001,3527,303,1,2
54387,2014/03/31,2009/08/29,383,3,0.374186391,5408,383,3,0
54388,2014/03/31,2011/06/30,504,3,0.538528081,3757,504,3,0
54389,2014/03/31,2010/07/14,1,3,0.38,5324,1,0,3
54390,2014/03/31,2011/01/12,524,3,0.568361899,3559,524,3,0
54391,2014/03/31,2012/11/16,463,2,0.4984598320000001,4058,463,2,0
54392,2014/03/31,2011/01/15,557,2,0.755829596,2676,557,2,0
54393,2014/03/31,2013/02/10,111,3,0.316666667,6387,111,1,2
54394,2014/03/31,2007/03/05,497,3,0.928178063,2179,497,3,0
54395,2014/03/31,2011/03/28,403,2,0.8241238790000001,2454,403,2,0
54396,2014/03/31,2006/04/29,268,3,0.593223819,3409,268,2,1
54397,2014/03/31,2009/11/22,346,3,0.581731876,3476,346,1,2
54398,2014/03/31,2011/09/28,133,3,0.490043626,4126,133,1,2
54399,2014/03/31,2005/08/02,319,2,0.919326967,2199,319,1,1
54400,2014/03/31,2012/12/04,23,2,0.735025455,2750,23,1,1
54401,2014/03/31,2013/02/02,42,3,0.353488982,5718,42,0,3
54402,2014/03/31,2006/01/28,138,2,0.693618263,2913,138,0,2
54403,2014/03/31,2011/04/13,36,2,0.711182682,2841,36,1,1
54404,2014/03/31,2012/06/21,554,3,0.8404326120000001,2404,554,3,0
54405,2014/03/31,2012/07/01,377,3,0.629769327,3208,377,3,0
54406,2014/03/31,2012/07/14,18,3,0.586726692,3443,18,2,1
54407,2014/03/31,2008/03/21,704,2,1.0,2020,704,2,0
54408,2014/03/31,2005/11/27,702,2,1.0,2020,702,2,0
54409,2014/03/31,2007/10/27,403,2,0.85,2376,403,2,0
54410,2014/03/31,2010/04/21,338,3,0.732583454,2756,338,2,1
54411,2014/03/31,2012/01/01,135,3,0.569647192,3543,135,1,2
54412,2014/03/31,2012/02/07,255,4,0.882795276,2286,255,0,4
54413,2014/03/31,2009/12/12,628,2,1.0,2018,628,2,0
54414,2014/03/31,2013/01/30,107,5,0.606,3330,107,1,4
54415,2014/03/31,2012/10/08,134,2,0.660107949,3057,134,0,2
54416,2014/03/31,2012/07/25,98,3,0.418304312,4824,98,2,1
54417,2014/03/31,2011/07/24,112,2,0.625,3228,112,0,2
54418,2014/03/31,2012/05/19,238,3,0.647320282,3116,238,2,1
54419,2014/03/31,2011/02/07,579,2,0.546679317,3689,579,2,0
54420,2014/03/31,2010/03/20,197,3,0.586065097,3441,197,1,2
54421,2014/03/31,2010/03/19,530,3,0.7548670909999999,2671,530,3,0
54422,2014/03/31,2012/06/30,74,4,0.43322948,4654,74,3,1
54423,2014/03/31,2010/05/08,122,2,0.894855748,2253,122,0,2
54424,2014/03/31,2008/11/15,23,3,0.8279466120000001,2435,23,0,3
54425,2014/03/31,2011/08/13,604,2,0.9,2240,604,2,0
54426,2014/03/31,2013/03/18,371,3,0.944262295,2135,371,3,0
54427,2014/03/31,2007/03/10,32,2,0.56,3600,32,0,2
54428,2014/03/31,2012/07/03,576,2,0.7,2880,576,2,0
54429,2014/03/31,2012/07/14,627,2,0.64781491,3112,627,2,0
54430,2014/03/31,2011/10/25,130,2,0.6715323120000001,3002,130,1,1
54431,2014/03/31,2012/04/19,226,2,0.725,2780,226,1,1
54432,2014/03/31,2011/01/18,655,3,0.65608724,3072,655,3,0
54433,2014/03/31,2012/07/28,213,3,0.973333333,2070,213,2,1
54434,2014/03/31,2012/06/02,204,3,0.973333333,2070,204,2,1
54435,2014/03/31,2011/02/23,565,2,0.7,2878,565,2,0
54436,2014/03/31,2013/01/01,308,2,0.476264775,4230,308,0,2
54437,2014/03/31,2011/06/23,47,4,0.385,5232,47,3,1
54438,2014/03/31,2011/06/09,92,3,0.482659957,4173,92,0,3
54439,2014/03/31,2011/10/07,228,4,0.718444524,2803,228,3,1
54440,2014/03/31,2013/01/01,89,3,0.7078101929999999,2845,89,0,3
54441,2014/03/31,2011/10/20,74,3,0.6749413340000001,2983,74,2,1
54442,2014/03/31,2011/01/24,156,4,0.46560592,4324,156,0,4
54443,2014/03/31,2013/03/31,55,3,0.7562471829999999,2662,55,0,3
54444,2014/03/31,2006/06/05,143,4,0.637025316,3160,143,2,2
54445,2014/03/31,2010/11/19,112,3,0.409030685,4921,112,0,3
54446,2014/03/31,2012/08/25,557,3,0.967227295,2081,557,3,0
54447,2014/03/31,2008/08/28,300,3,0.694010345,2900,300,0,3
54448,2014/03/31,2011/09/27,27,2,0.572357793,3516,27,0,2
54449,2014/03/31,2013/02/03,299,3,0.477914489,4210,299,0,3
54450,2014/03/31,2007/11/27,553,2,0.775636083,2594,553,2,0
54451,2014/03/31,2012/07/18,548,3,0.8816827340000001,2282,548,3,0
54452,2014/03/31,2013/01/22,376,2,0.55,3658,376,2,0
54453,2014/03/31,2011/12/09,177,2,0.7571321040000001,2657,177,1,1
54454,2014/03/31,2007/12/01,446,4,0.851651143,2362,446,4,0
54455,2014/03/31,2008/06/06,22,2,0.597170428,3368,22,0,2
54456,2014/03/31,2011/05/11,86,2,0.506586902,3970,86,0,2
54457,2014/03/31,2013/01/07,143,3,0.6033333329999999,3333,143,1,2
54458,2014/03/31,2009/05/13,79,2,0.44,4570,79,1,1
54459,2014/03/31,2011/12/23,5,4,0.6275,3204,5,0,4
54460,2014/03/31,2012/07/24,541,2,0.8,2513,541,2,0
54461,2014/03/31,2012/02/23,96,3,0.92856351,2165,96,0,3
54462,2014/03/31,2012/10/19,140,2,0.869822588,2311,140,0,2
54463,2014/03/31,2013/01/24,156,2,0.695,2892,156,0,2
54464,2014/03/31,2009/11/07,88,2,0.695,2892,88,0,2
54465,2014/03/31,2009/04/05,26,2,0.486766772,4129,26,0,2
54466,2014/03/31,2007/04/01,296,3,0.58,3465,296,2,1
54467,2014/03/31,2011/06/22,542,2,0.8,2512,542,2,0
54468,2014/03/31,2012/01/16,266,4,0.91345,2200,266,3,1
54469,2014/03/31,2007/10/10,114,4,0.388559273,5171,114,0,4
54470,2014/03/31,2011/02/14,181,3,0.678062774,2963,181,2,1
54471,2014/03/31,2010/07/12,17,3,0.4866666670000001,4128,17,0,3
54472,2014/03/31,2012/11/23,349,2,0.763259878,2632,349,1,1
54473,2014/03/31,2009/11/14,341,3,0.470236423,4272,341,2,1
54474,2014/03/31,2009/07/18,31,4,0.555481195,3616,31,1,3
54475,2014/03/31,2008/08/27,141,2,0.446940365,4494,141,0,2
54476,2014/03/31,2012/05/30,183,3,0.495177515,4056,183,2,1
54477,2014/03/31,2012/05/29,590,2,0.748769575,2682,590,2,0
54478,2014/03/31,2011/11/09,130,3,0.7003487970000001,2867,130,2,1
54479,2014/03/31,2006/04/04,49,6,0.4094472770000001,4903,49,2,4
54480,2014/03/31,2011/11/29,648,3,0.485020536,4139,648,3,0
54481,2014/03/31,2012/10/26,328,2,0.775057915,2590,328,1,1
54482,2014/03/31,2009/07/06,242,6,0.478331745,4196,242,4,2
54483,2014/03/31,2012/03/09,225,2,0.536068376,3744,225,1,1
54484,2014/03/31,2012/05/03,268,2,0.690299278,2907,268,1,1
54485,2014/03/31,2010/10/25,249,3,0.76844121,2611,249,1,2
54486,2014/03/31,2012/04/04,712,2,0.409292126,4902,712,2,0
54487,2014/03/31,2008/02/07,3,3,0.5110188489999999,3926,3,2,1
54488,2014/03/31,2012/10/27,108,2,0.453182742,4427,108,1,1
54489,2014/03/31,2009/12/08,339,2,1.0,2006,339,1,1
54490,2014/03/31,2009/11/07,462,3,0.716666667,2799,462,3,0
54491,2014/03/31,2013/01/09,433,2,0.724936755,2767,433,2,0
54492,2014/03/31,2012/04/08,320,3,0.572893459,3501,320,1,2
54493,2014/03/31,2011/02/21,82,4,0.473360869,4237,82,2,2
54494,2014/03/31,2013/01/29,368,2,0.580828265,3453,368,2,0
54495,2014/03/31,2008/11/14,387,2,0.525,3820,387,2,0
54496,2014/03/31,2010/06/18,22,4,0.7725,2596,22,0,4
54497,2014/03/31,2008/12/18,412,3,0.956679389,2096,412,3,0
54498,2014/03/31,2011/09/19,549,2,1.0,2005,549,2,0
54499,2014/03/31,2012/09/18,57,3,0.871290743,2301,57,1,2
54500,2014/03/31,2009/03/18,385,3,0.836357947,2397,385,3,0
54501,2014/03/31,2012/09/06,288,4,0.7029242640000001,2852,288,3,1
54502,2014/03/31,2012/06/13,36,3,0.530725443,3777,36,2,1
54503,2014/03/31,2007/03/03,502,2,1.0,2004,502,2,0
54504,2014/03/31,2008/07/15,172,2,0.835,2400,172,0,2
54505,2014/03/31,2010/02/01,19,7,0.817275693,2452,19,4,3
54506,2014/03/31,2009/12/24,15,5,0.426631893,4697,15,4,1
54507,2014/03/31,2008/03/08,364,2,0.689301686,2907,364,1,1
54508,2014/03/31,2013/02/12,383,3,0.673093719,2977,383,3,0
54509,2014/03/31,2012/04/01,366,2,0.375023395,5343,366,1,1
54510,2014/03/31,2010/12/10,213,6,0.356530249,5620,213,3,3
54511,2014/03/31,2012/06/26,358,3,0.493996548,4056,358,2,1
54512,2014/03/31,2010/10/24,338,3,0.68683579,2917,338,1,2
54513,2014/03/31,2009/10/25,498,3,0.25,8013,498,3,0
54514,2014/03/31,2009/01/02,126,3,0.5072018229999999,3949,126,0,3
54515,2014/03/31,2013/02/17,397,2,0.447575419,4475,397,2,0
54516,2014/03/31,2011/12/10,162,3,0.531653836,3767,162,1,2
54517,2014/03/31,2010/07/08,379,4,0.45126183,4438,379,4,0
54518,2014/03/31,2011/10/07,321,3,0.5330449829999999,3757,321,0,3
54519,2014/03/31,2007/09/30,123,2,0.810441117,2471,123,0,2
54520,2014/03/31,2012/07/20,120,3,0.435209737,4601,120,1,2
54521,2014/03/31,2005/05/17,127,4,0.458376832,4368,127,0,4
54522,2014/03/31,2009/01/17,275,4,0.8675,2308,275,3,1
54523,2014/03/31,2012/07/13,204,3,0.652591265,3068,204,0,3
54524,2014/03/31,2007/12/09,611,2,0.68869969,2907,611,2,0
54525,2014/03/31,2007/03/20,8,3,0.605568663,3306,8,1,2
54526,2014/03/31,2010/05/18,371,3,0.916666667,2184,371,3,0
54527,2014/03/31,2012/02/24,198,2,0.384168106,5211,198,1,1
54528,2014/03/31,2012/06/07,661,2,0.4,5004,661,2,0
54529,2014/03/31,2012/06/07,661,2,0.4,5004,661,2,0
54530,2014/03/31,2012/08/04,184,2,0.49,4084,184,0,2
54531,2014/03/31,2011/07/22,322,3,0.407691524,4908,322,1,2
54532,2014/03/31,2009/04/04,292,3,0.441558155,4531,292,1,2
54533,2014/03/31,2010/11/21,189,5,0.690676796,2896,189,3,2
54534,2014/03/31,2005/08/05,34,4,0.463760723,4313,34,1,3
54535,2014/03/31,2012/09/08,547,2,0.7143214290000001,2800,547,2,0
54536,2014/03/31,2012/04/06,715,2,0.5,4000,715,2,0
54537,2014/03/31,2012/03/13,133,2,0.5128,3900,133,1,1
54538,2014/03/31,2010/12/20,592,2,0.7,2857,592,2,0
54539,2014/03/31,2011/11/07,81,3,0.446162427,4482,81,0,3
54540,2014/03/31,2010/04/23,345,3,0.52941488,3777,345,2,1
54541,2014/03/31,2007/04/15,23,5,0.620661285,3221,23,1,4
54542,2014/03/31,2007/08/17,96,2,0.8801849409999999,2271,96,1,1
54543,2014/03/31,2012/10/16,132,7,0.7514285709999999,2660,132,2,5
54544,2014/03/31,2011/12/03,307,3,0.510720675,3913,307,2,1
54545,2014/03/31,2011/11/13,208,3,0.5931463339999999,3369,208,1,2
54546,2014/03/31,2009/03/22,23,5,0.548222222,3645,23,0,5
54547,2014/03/31,2012/03/08,409,5,0.69,2895,409,5,0
54548,2014/03/31,2012/07/29,510,3,0.828589212,2410,510,3,0
54549,2014/03/31,2012/02/11,297,3,0.713333333,2799,297,2,1
54550,2014/03/31,2005/07/24,218,2,0.774422033,2578,218,0,2
54551,2014/03/31,2006/12/31,527,2,0.776507196,2571,527,2,0
54552,2014/03/31,2007/11/29,124,4,0.523514293,3813,124,2,2
54553,2014/03/31,2008/08/05,22,4,0.708541001,2817,22,0,4
54554,2014/03/31,2011/12/04,57,4,0.716024399,2787,57,2,2
54555,2014/03/31,2010/04/26,44,2,0.69,2892,44,0,2
54556,2014/03/31,2007/05/04,706,2,0.662080982,3013,706,2,0
54557,2014/03/31,2008/07/19,336,3,0.860068995,2319,336,0,3
54558,2014/03/31,2007/07/02,9,2,0.88,2266,9,0,2
54559,2014/03/31,2010/09/05,120,2,0.51287037,3888,120,1,1
54560,2014/03/31,2011/02/26,197,5,0.7619526179999999,2617,197,3,2
54561,2014/03/31,2008/05/05,20,2,0.48,4154,20,0,2
54562,2014/03/31,2012/08/14,296,3,0.953443329,2091,296,2,1
54563,2014/03/31,2009/08/28,343,4,0.460415704,4330,343,3,1
54564,2014/03/31,2012/01/12,71,3,0.7269948940000001,2742,71,0,3
54565,2014/03/31,2005/06/24,234,2,0.963218946,2069,234,1,1
54566,2014/03/31,2010/12/20,179,4,0.489390963,4072,179,2,2
54567,2014/03/31,2008/02/21,209,3,0.441470979,4514,209,2,1
54568,2014/03/31,2012/03/10,2,3,0.72857404,2735,2,0,3
54569,2014/03/31,2013/03/24,286,4,0.890764417,2237,286,1,3
54570,2014/03/31,2010/12/06,244,2,0.5659074129999999,3521,244,0,2
54571,2014/03/31,2013/02/27,329,2,0.692802503,2876,329,1,1
54572,2014/03/31,2010/11/17,4,4,0.7675,2596,4,0,4
54573,2014/03/31,2011/12/24,45,2,0.839591235,2373,45,0,2
54574,2014/03/31,2013/03/04,375,3,0.608722884,3273,375,3,0
54575,2014/03/31,2013/03/25,110,2,0.46480168,4286,110,1,1
54576,2014/03/31,2008/07/10,275,3,0.54502052,3655,275,1,2
54577,2014/03/31,2012/05/17,198,3,0.8008363490000001,2487,198,2,1
54578,2014/03/31,2010/09/18,127,8,0.38125,5224,127,0,8
54579,2014/03/31,2010/09/25,530,2,0.660766423,3014,530,2,0
54580,2014/03/31,2008/05/01,214,4,0.584653553,3406,214,1,3
54581,2014/03/31,2010/09/16,213,2,0.521382561,3819,213,0,2
54582,2014/03/31,2011/06/21,321,2,0.552121464,3606,321,1,1
54583,2014/03/31,2010/12/30,18,3,0.628654878,3167,18,0,3
54584,2014/03/31,2011/08/23,605,2,0.814566285,2444,605,2,0
54585,2014/03/31,2012/08/11,593,2,0.85,2342,593,2,0
54586,2014/03/31,2012/07/08,373,2,0.85,2342,373,2,0
54587,2014/03/31,2010/06/23,200,6,0.803333333,2478,200,5,1
54588,2014/03/31,2005/04/26,151,2,0.8905771809999999,2235,151,1,1
54589,2014/03/31,2009/07/18,152,3,0.98080828,2029,152,2,1
54590,2014/03/31,2006/11/03,40,2,0.716353492,2778,40,0,2
54591,2014/03/31,2010/03/13,502,3,0.6759510870000001,2944,502,3,0
54592,2014/03/31,2011/07/22,457,3,0.411765315,4832,457,3,0
54593,2014/03/31,2011/04/27,348,2,0.35,5684,348,0,2
54594,2014/03/31,2009/11/09,457,2,0.35,5684,457,2,0
54595,2014/03/31,2009/03/07,432,2,0.5801399829999999,3429,432,2,0
54596,2014/03/31,2009/06/30,368,2,0.481670702,4130,368,2,0
54597,2014/03/31,2012/10/02,411,3,0.7073968709999999,2812,411,3,0
54598,2014/03/31,2006/12/20,576,2,1.0,1989,576,2,0
54599,2014/03/31,2013/03/21,357,2,0.513953488,3870,357,1,1
54600,2014/03/31,2010/12/19,325,2,0.625,3182,325,0,2
54601,2014/03/31,2012/04/24,698,2,0.45350057,4385,698,2,0
54602,2014/03/31,2008/11/07,211,5,0.399957763,4972,211,2,3
54603,2014/03/31,2009/03/01,61,2,0.76,2616,61,0,2
54604,2014/03/31,2012/08/14,2,4,0.38,5232,2,2,2
54605,2014/03/31,2009/11/07,308,3,0.475280899,4183,308,2,1
54606,2014/03/31,2009/03/13,507,4,0.407470793,4879,507,4,0
54607,2014/03/31,2006/05/18,438,3,0.907762557,2190,438,3,0
54608,2014/03/31,2013/01/28,401,3,0.53583558,3710,401,3,0
54609,2014/03/31,2013/02/27,78,2,0.691168289,2876,78,0,2
54610,2014/03/31,2009/04/24,308,5,0.63,3155,308,4,1
54611,2014/03/31,2009/01/01,714,2,0.95,2092,714,2,0
54612,2014/03/31,2012/04/26,354,3,0.384019324,5175,354,2,1
54613,2014/03/31,2010/02/20,304,2,0.643966299,3086,304,1,1
54614,2014/03/31,2006/06/06,350,2,0.533776524,3723,350,1,1
54615,2014/03/31,2011/08/07,52,6,0.6,3312,52,3,3
54616,2014/03/31,2006/12/10,160,2,0.66995617,2966,160,1,1
54617,2014/03/31,2012/02/27,51,3,0.34,5844,51,0,3
54618,2014/03/31,2011/07/17,38,5,0.347696885,5714,38,3,2
54619,2014/03/31,2007/10/30,372,2,0.724279985,2743,372,2,0
54620,2014/03/31,2012/05/10,67,3,0.744505247,2668,67,1,2
54621,2014/03/31,2006/12/31,168,2,0.895778078,2217,168,0,2
54622,2014/03/31,2013/02/26,250,3,0.454005487,4374,250,0,3
54623,2014/03/31,2011/12/15,86,2,0.795246296,2497,86,1,1
54624,2014/03/31,2006/03/31,11,2,0.929171736,2137,11,0,2
54625,2014/03/31,2011/12/12,297,2,0.956819277,2075,297,1,1
54626,2014/03/31,2012/11/21,493,3,0.584226015,3398,493,3,0
54627,2014/03/31,2010/09/25,551,2,0.921448468,2154,551,2,0
54628,2014/03/31,2012/12/01,4,4,0.656099174,3025,4,1,3
54629,2014/03/31,2012/06/29,598,2,0.862695652,2300,598,2,0
54630,2014/03/31,2012/07/13,196,4,0.594391851,3338,196,3,1
54631,2014/03/31,2010/10/15,219,4,0.496,4000,219,0,4
54632,2014/03/31,2011/05/06,496,2,0.4,4960,496,2,0
54633,2014/03/31,2010/01/01,485,3,0.6512967829999999,3046,485,3,0
54634,2014/03/31,2010/04/15,715,2,0.65,3052,715,2,0
54635,2014/03/31,2007/06/29,617,2,0.65,3052,617,2,0
54636,2014/03/31,2009/04/02,266,3,0.553333333,3585,266,1,2
54637,2014/03/31,2012/05/09,690,2,0.825,2404,690,2,0
54638,2014/03/31,2011/05/20,1,2,0.880288504,2253,1,0,2
54639,2014/03/31,2013/02/28,13,2,0.880288504,2253,13,0,2
54640,2014/03/31,2010/11/19,569,3,0.612824475,3236,569,3,0
54641,2014/03/31,2007/02/14,402,2,0.928711944,2135,402,2,0
54642,2014/03/31,2008/06/20,32,2,0.8800577009999999,2253,32,0,2
54643,2014/03/31,2012/07/10,113,3,0.415843121,4768,113,0,3
54644,2014/03/31,2011/11/27,482,2,0.627644079,3158,482,2,0
54645,2014/03/31,2012/11/27,49,3,0.715036075,2772,49,0,3
54646,2014/03/31,2012/08/18,349,3,0.574825986,3448,349,2,1
54647,2014/03/31,2012/05/19,21,2,0.810228945,2446,21,0,2
54648,2014/03/31,2012/12/23,223,2,0.72,2752,223,0,2
54649,2014/03/31,2009/01/15,578,3,0.808384333,2451,578,3,0
54650,2014/03/31,2011/01/24,444,2,0.525,3774,444,2,0
54651,2014/03/31,2013/03/20,253,2,0.7130777540000001,2778,253,1,1
54652,2014/03/31,2012/09/25,1,3,0.480096946,4126,1,0,3
54653,2014/03/31,2010/08/18,273,2,0.5763252839999999,3437,273,0,2
54654,2014/03/31,2012/10/29,430,2,0.7213401309999999,2746,430,2,0
54655,2014/03/31,2009/11/27,219,3,0.686940687,2883,219,1,2
54656,2014/03/31,2011/08/15,1,3,0.956666667,2070,1,2,1
54657,2014/03/31,2010/07/26,62,4,0.855,2316,62,0,4
54658,2014/03/31,2013/02/22,256,2,0.556506464,3558,256,1,1
54659,2014/03/31,2012/11/04,486,2,0.623590551,3175,486,2,0
54660,2014/03/31,2011/12/28,445,5,0.560662702,3531,445,5,0
54661,2014/03/31,2009/08/15,102,3,0.653333333,3030,102,0,3
54662,2014/03/31,2013/03/26,228,2,0.602391966,3286,228,0,2
54663,2014/03/31,2005/05/15,38,3,0.590292276,3353,38,0,3
54664,2014/03/31,2011/11/29,605,3,0.65,3045,605,3,0
54665,2014/03/31,2009/08/27,75,3,0.781658768,2532,75,0,3
54666,2014/03/31,2012/11/06,500,2,0.936931818,2112,500,2,0
54667,2014/03/31,2008/03/25,19,2,0.715113842,2767,19,0,2
54668,2014/03/31,2013/01/20,52,4,0.7376510070000001,2682,52,2,2
54669,2014/03/31,2010/07/11,220,2,0.963643449,2053,220,0,2
54670,2014/03/31,2009/07/06,58,2,0.583750369,3389,58,0,2
54671,2014/03/31,2012/04/30,16,3,0.5043574710000001,3922,16,0,3
54672,2014/03/31,2012/09/24,554,2,0.426915605,4633,554,2,0
54673,2014/03/31,2009/02/18,721,2,0.675,2930,721,2,0
54674,2014/03/31,2010/11/02,93,2,0.675,2930,93,0,2
54675,2014/03/31,2006/05/01,691,2,0.675,2930,691,2,0
54676,2014/03/31,2011/11/19,289,2,0.432484146,4573,289,0,2
54677,2014/03/31,2011/09/07,104,3,0.422336608,4682,104,0,3
54678,2014/03/31,2012/12/05,291,2,0.37,5344,291,1,1
54679,2014/03/31,2009/11/24,109,2,0.652329264,3031,109,0,2
54680,2014/03/31,2012/08/04,238,4,0.436833849,4526,238,1,3
54681,2014/03/31,2012/10/07,197,2,0.28,7061,197,0,2
54682,2014/03/31,2011/09/09,252,3,0.500863947,3947,252,2,1
54683,2014/03/31,2007/06/07,16,2,0.649645087,3043,16,0,2
54684,2014/03/31,2012/05/12,507,3,0.7105859090000001,2782,507,3,0
54685,2014/03/31,2010/04/19,25,5,0.770366329,2566,25,0,5
54686,2014/03/31,2012/12/22,450,2,0.427025275,4629,450,2,0
54687,2014/03/31,2012/11/20,195,3,0.421014061,4694,195,2,1
54688,2014/03/31,2012/09/26,541,2,1.0,1976,541,2,0
54689,2014/03/31,2010/12/01,338,2,1.0,1976,338,0,2
54690,2014/03/31,2012/10/31,6,3,0.378040566,5226,6,1,2
54691,2014/03/31,2005/03/02,104,3,0.598678788,3300,104,0,3
54692,2014/03/31,2012/12/26,47,3,0.583108028,3388,47,2,1
54693,2014/03/31,2006/02/21,191,2,0.956127783,2066,191,1,1
54694,2014/03/31,2011/09/29,61,2,0.755,2616,61,0,2
54695,2014/03/31,2012/12/07,65,3,0.5033333329999999,3924,65,0,3
54696,2014/03/31,2011/03/21,279,2,0.706330472,2796,279,0,2
54697,2014/03/31,2009/12/24,278,5,0.505946708,3903,278,3,2
54698,2014/03/31,2009/04/11,147,4,0.388126597,5087,147,3,1
54699,2014/03/31,2010/03/11,342,4,0.5318965520000001,3712,342,2,2
54700,2014/03/31,2009/07/06,200,2,0.7706206090000001,2562,200,1,1
54701,2014/03/31,2010/11/29,180,2,0.58,3404,180,0,2
54702,2014/03/31,2010/08/27,86,2,0.8281082209999999,2384,86,1,1
54703,2014/03/31,2013/03/29,161,3,0.643481095,3068,161,0,3
54704,2014/03/31,2006/02/01,12,3,0.418680806,4715,12,0,3
54705,2014/03/31,2010/01/08,299,3,0.798704978,2471,299,2,1
54706,2014/03/31,2008/01/12,166,2,0.784632207,2515,166,0,2
54707,2014/03/31,2012/11/30,415,2,0.475,4154,415,2,0
54708,2014/03/31,2012/11/30,415,2,0.475,4154,415,2,0
54709,2014/03/31,2012/03/25,415,2,0.475,4154,415,2,0
54710,2014/03/31,2012/11/30,415,2,0.475,4154,415,2,0
54711,2014/03/31,2011/08/10,383,2,0.475,4154,383,2,0
54712,2014/03/31,2011/06/03,23,3,0.743603468,2653,23,0,3
54713,2014/03/31,2013/03/08,265,4,0.742983051,2655,265,1,3
54714,2014/03/31,2012/05/15,442,4,0.559602837,3525,442,4,0
54715,2014/03/31,2007/01/04,113,2,0.577943159,3413,113,1,1
54716,2014/03/31,2012/10/27,426,3,0.5,3945,426,3,0
54717,2014/03/31,2012/01/21,599,2,0.6,3287,599,2,0
54718,2014/03/31,2006/04/04,76,3,0.493997996,3992,76,0,3
54719,2014/03/31,2006/07/12,145,2,0.933693182,2112,145,0,2
54720,2014/03/31,2012/01/02,153,4,0.494792974,3985,153,1,3
54721,2014/03/31,2012/07/25,108,3,0.566889017,3478,108,2,1
54722,2014/03/31,2006/02/08,69,2,0.505,3904,69,0,2
54723,2014/03/31,2012/11/16,497,2,0.767419229,2569,497,2,0
54724,2014/03/31,2012/04/08,279,3,0.508043814,3880,279,2,1
54725,2014/03/31,2013/03/21,365,2,1.15,1714,365,1,1
54726,2014/03/31,2011/11/07,152,4,0.615,3204,152,0,4
54727,2014/03/31,2010/12/18,382,4,0.46589404,4228,382,4,0
54728,2014/03/31,2012/05/10,683,2,0.7,2814,683,2,0
54729,2014/03/31,2008/11/20,523,2,0.7898155570000001,2494,523,2,0
54730,2014/03/31,2013/02/14,408,2,0.525,3752,408,2,0
54731,2014/03/31,2010/03/27,506,2,0.749790636,2627,506,2,0
54732,2014/03/31,2011/10/12,346,2,0.653066976,3016,346,1,1
54733,2014/03/31,2012/03/09,235,2,0.719291454,2738,235,0,2
54734,2014/03/31,2009/07/17,77,2,0.8767943009999999,2246,77,0,2
54735,2014/03/31,2011/09/24,400,2,0.514420063,3828,400,2,0
54736,2014/03/31,2011/03/30,190,2,0.700031994,2813,190,0,2
54737,2014/03/31,2005/07/21,707,2,0.45,4375,707,2,0
54738,2014/03/31,2011/04/29,602,3,0.881989247,2232,602,3,0
54739,2014/03/31,2007/09/05,169,2,0.6264258429999999,3142,169,1,1
54740,2014/03/31,2012/11/21,496,2,0.653436255,3012,496,2,0
54741,2014/03/31,2012/10/16,129,4,0.491446054,4004,129,3,1
54742,2014/03/31,2013/02/14,207,2,0.435139319,4522,207,1,1
54743,2014/03/31,2013/03/31,8,4,0.625460903,3146,8,0,4
54744,2014/03/31,2007/08/06,287,3,0.796631579,2470,287,0,3
54745,2014/03/31,2011/03/07,38,3,0.51,3858,38,0,3
54746,2014/03/31,2012/07/14,369,3,0.530180544,3711,369,3,0
54747,2014/03/31,2008/05/25,161,2,0.620810981,3169,161,1,1
54748,2014/03/31,2005/02/14,604,2,0.5,3934,604,2,0
54749,2014/03/31,2013/01/26,404,2,0.5,3934,404,2,0
54750,2014/03/31,2006/11/03,522,2,0.5,3934,522,2,0
54751,2014/03/31,2007/10/29,492,2,1.0,1967,492,2,0
54752,2014/03/31,2011/06/23,648,2,0.5,3934,648,2,0
54753,2014/03/31,2012/10/13,402,2,0.5,3934,402,2,0
54754,2014/03/31,2007/11/21,132,2,0.740116673,2657,132,0,2
54755,2014/03/31,2012/10/25,119,3,0.476741028,4124,119,2,1
54756,2014/03/31,2007/01/11,277,3,0.8615162140000001,2282,277,2,1
54757,2014/03/31,2012/11/06,27,5,0.866,2270,27,0,5
54758,2014/03/31,2009/03/16,425,4,0.761604029,2581,425,4,0
54759,2014/03/31,2012/04/08,317,2,0.666745843,2947,317,1,1
54760,2014/03/31,2012/12/29,352,3,0.428649356,4583,352,2,1
54761,2014/03/31,2013/01/01,352,2,0.809666117,2426,352,1,1
54762,2014/03/31,2010/04/27,209,3,0.7728650140000001,2541,209,2,1
54763,2014/03/31,2011/09/11,172,2,0.6963475179999999,2820,172,0,2
54764,2014/03/31,2012/08/13,58,4,0.563628014,3484,58,1,3
54765,2014/03/31,2007/06/13,102,2,0.488991283,4015,102,0,2
54766,2014/03/31,2013/02/23,145,2,0.6735094340000001,2915,145,1,1
54767,2014/03/31,2010/04/26,348,3,0.655863682,2993,348,2,1
54768,2014/03/31,2012/03/02,221,4,0.8475,2316,221,0,4
54769,2014/03/31,2012/02/08,330,3,0.70528207,2783,330,2,1
54770,2014/03/31,2012/10/23,468,4,0.43968414,4464,468,4,0
54771,2014/03/31,2011/09/20,593,3,0.316011914,6211,593,3,0
54772,2014/03/31,2011/11/14,575,2,0.584484812,3358,575,2,0
54773,2014/03/31,2011/03/25,3,4,0.682891441,2874,3,3,1
54774,2014/03/31,2011/05/20,394,4,0.454914233,4314,394,4,0
54775,2014/03/31,2012/10/22,84,2,0.571389051,3434,84,1,1
54776,2014/03/31,2012/12/06,49,3,0.983463659,1995,49,0,3
54777,2014/03/31,2013/03/19,367,2,0.75,2616,367,2,0
54778,2014/03/31,2011/12/15,17,2,0.75,2616,17,0,2
54779,2014/03/31,2012/03/13,441,2,0.75,2616,441,2,0
54780,2014/03/31,2009/02/28,437,2,0.75,2616,437,2,0
54781,2014/03/31,2006/01/26,686,2,0.75,2616,686,2,0
54782,2014/03/31,2011/01/13,673,2,0.75,2616,673,2,0
54783,2014/03/31,2011/08/23,312,3,0.6711939790000001,2923,312,2,1
54784,2014/03/31,2008/08/16,298,4,0.810285006,2421,298,1,3
54785,2014/03/31,2009/03/07,10,4,0.578298939,3392,10,0,4
54786,2014/03/31,2012/10/23,5,2,0.561798911,3491,5,0,2
54787,2014/03/31,2012/03/05,530,2,1.0,1961,530,2,0
54788,2014/03/31,2007/07/25,727,2,1.0,1961,727,2,0
54789,2014/03/31,2012/05/12,679,4,0.314708714,6231,679,4,0
54790,2014/03/31,2012/09/19,303,3,0.432049361,4538,303,0,3
54791,2014/03/31,2013/01/26,160,3,0.553049365,3545,160,0,3
54792,2014/03/31,2008/05/17,360,3,0.55,3564,360,2,1
54793,2014/03/31,2010/02/22,51,2,0.825,2376,51,0,2
54794,2014/03/31,2012/10/17,119,3,0.6038508929999999,3246,119,1,2
54795,2014/03/31,2005/01/20,351,3,0.70179019,2793,351,2,1
54796,2014/03/31,2007/11/23,644,2,0.7,2800,644,2,0
54797,2014/03/31,2009/12/30,570,2,0.7,2800,570,2,0
54798,2014/03/31,2012/07/10,524,2,0.7,2800,524,2,0
54799,2014/03/31,2007/09/21,627,2,0.7,2800,627,2,0
54800,2014/03/31,2008/12/09,675,2,1.0,1960,675,2,0
54801,2014/03/31,2010/04/26,60,3,0.41411367,4733,60,2,1
54802,2014/03/31,2007/03/13,459,2,0.625,3136,459,2,0
54803,2014/03/31,2007/11/06,351,2,0.7,2800,351,1,1
54804,2014/03/31,2008/06/02,656,2,0.7,2800,656,2,0
54805,2014/03/31,2012/06/22,521,2,1.0,1960,521,2,0
54806,2014/03/31,2008/03/14,216,2,0.846070812,2316,216,1,1
54807,2014/03/31,2012/12/08,38,3,0.657269373,2981,38,0,3
54808,2014/03/31,2010/12/29,472,2,0.627160691,3124,472,2,0
54809,2014/03/31,2012/05/29,61,2,0.916393826,2138,61,1,1
54810,2014/03/31,2007/05/13,123,2,0.848488523,2309,123,0,2
54811,2014/03/31,2011/10/25,49,2,0.65,3014,49,0,2
54812,2014/03/31,2011/11/20,558,3,1.0,1959,558,3,0
54813,2014/03/31,2008/12/12,496,3,1.0,1959,496,3,0
54814,2014/03/31,2012/05/10,35,2,0.66559633,2943,35,1,1
54815,2014/03/31,2009/04/02,230,3,0.974952713,2009,230,2,1
54816,2014/03/31,2010/07/17,106,3,0.484048443,4046,106,0,3
54817,2014/03/31,2012/06/21,423,3,0.549957877,3561,423,3,0
54818,2014/03/31,2008/03/05,34,4,0.360250184,5436,34,0,4
54819,2014/03/31,2012/07/06,2,2,1.461246269,1340,2,1,1
54820,2014/03/31,2011/08/31,247,4,0.537305159,3644,247,3,1
54821,2014/03/31,2012/10/07,1,3,0.4866666670000001,4023,1,1,2
54822,2014/03/31,2008/08/12,149,3,0.836666667,2340,149,0,3
54823,2014/03/31,2011/05/01,513,2,0.575,3404,513,2,0
54824,2014/03/31,2011/09/20,203,4,0.400973161,4881,203,3,1
54825,2014/03/31,2008/04/17,348,2,0.767150137,2551,348,1,1
54826,2014/03/31,2010/09/26,302,3,0.433025006,4519,302,0,3
54827,2014/03/31,2005/01/01,524,3,0.4,4892,524,3,0
54828,2014/03/31,2011/02/02,14,3,0.42,4659,14,1,2
54829,2014/03/31,2007/10/01,44,3,0.482307123,4057,44,2,1
54830,2014/03/31,2013/01/01,256,2,0.843405172,2320,256,0,2
54831,2014/03/31,2010/12/20,178,2,0.55,3557,178,0,2
54832,2014/03/31,2010/12/06,57,2,0.697411765,2805,57,1,1
54833,2014/03/31,2013/02/26,397,2,0.768224666,2546,397,2,0
54834,2014/03/31,2005/05/03,107,4,0.453454672,4313,107,3,1
54835,2014/03/31,2011/08/11,202,2,0.822776609,2377,202,1,1
54836,2014/03/31,2013/03/20,60,2,0.537567345,3638,60,0,2
54837,2014/03/31,2012/07/25,231,2,0.621216645,3148,231,1,1
54838,2014/03/31,2010/07/15,252,2,0.771360947,2535,252,1,1
54839,2014/03/31,2012/04/02,712,2,0.8191872640000001,2387,712,2,0
54840,2014/03/31,2013/02/28,57,4,0.458887585,4261,57,0,4
54841,2014/03/31,2011/01/12,135,2,0.6157952760000001,3175,135,1,1
54842,2014/03/31,2009/03/26,100,3,0.593167476,3296,100,1,2
54843,2014/03/31,2012/01/20,49,3,0.531451876,3678,49,1,2
54844,2014/03/31,2011/04/06,285,2,0.974822943,2005,285,1,1
54845,2014/03/31,2005/02/12,627,2,0.626008969,3122,627,2,0
54846,2014/03/31,2011/09/30,153,3,0.640964251,3049,153,1,2
54847,2014/03/31,2010/12/28,619,2,1.0,1954,619,2,0
54848,2014/03/31,2012/03/24,231,2,0.71,2752,231,0,2
54849,2014/03/31,2010/05/18,180,3,0.48844,4000,180,2,1
54850,2014/03/31,2011/09/03,562,2,0.7425313570000001,2631,562,2,0
54851,2014/03/31,2013/02/21,326,2,0.5535562479999999,3529,326,1,1
54852,2014/03/31,2012/07/24,611,2,0.75,2604,611,2,0
54853,2014/03/31,2012/04/16,566,2,0.75,2604,566,2,0
54854,2014/03/31,2011/12/30,78,2,0.945159729,2066,78,1,1
54855,2014/03/31,2009/11/07,169,2,0.7100290909999999,2750,169,0,2
54856,2014/03/31,2008/06/09,322,2,0.656965007,2972,322,1,1
54857,2014/03/31,2012/01/22,556,2,0.388170974,5030,556,2,0
54858,2014/03/31,2009/01/26,443,2,0.550747532,3545,443,2,0
54859,2014/03/31,2006/05/23,441,2,0.528246753,3696,441,2,0
54860,2014/03/31,2012/09/06,190,2,0.82551797,2365,190,0,2
54861,2014/03/31,2009/04/09,340,2,0.475,4110,340,0,2
54862,2014/03/31,2012/05/09,661,2,0.475,4110,661,2,0
54863,2014/03/31,2011/08/26,486,6,0.716666667,2724,486,6,0
54864,2014/03/31,2012/07/18,555,3,0.681308901,2865,555,3,0
54865,2014/03/31,2010/03/15,442,3,0.629970949,3098,442,3,0
54866,2014/03/31,2005/08/24,20,3,0.7665278870000001,2546,20,0,3
54867,2014/03/31,2009/07/23,355,3,0.8589348590000001,2272,355,2,1
54868,2014/03/31,2008/12/23,237,2,0.55,3548,237,1,1
54869,2014/03/31,2007/11/26,218,3,0.92,2121,218,0,3
54870,2014/03/31,2011/12/16,125,3,0.414273885,4710,125,2,1
54871,2014/03/31,2010/01/17,415,2,0.7456995409999999,2616,415,2,0
54872,2014/03/31,2012/01/28,157,3,0.683715387,2853,157,0,3
54873,2014/03/31,2006/05/21,555,2,0.848738033,2298,555,2,0
54874,2014/03/31,2009/10/05,490,2,0.8817359859999999,2212,490,2,0
54875,2014/03/31,2008/05/28,663,3,0.650250083,2999,663,3,0
54876,2014/03/31,2007/04/12,299,3,0.719767442,2709,299,2,1
54877,2014/03/31,2010/04/13,265,6,0.280800807,6943,265,4,2
54878,2014/03/31,2007/06/06,296,3,0.813333333,2397,296,0,3
54879,2014/03/31,2012/01/28,13,4,0.561480415,3472,13,0,4
54880,2014/03/31,2011/01/13,47,4,0.3775,5164,47,0,4
54881,2014/03/31,2013/02/11,122,2,0.692461812,2815,122,0,2
54882,2014/03/31,2013/03/27,65,2,0.745,2616,65,0,2
54883,2014/03/31,2006/11/08,43,2,0.745,2616,43,0,2
54884,2014/03/31,2009/10/20,25,6,0.473176299,4118,25,1,5
54885,2014/03/31,2012/06/26,130,3,0.843467532,2310,130,1,2
54886,2014/03/31,2007/02/15,31,2,0.6772193259999999,2877,31,0,2
54887,2014/03/31,2010/03/19,434,3,0.874315222,2227,434,3,0
54888,2014/03/31,2013/02/07,314,2,0.632997399,3076,314,0,2
54889,2014/03/31,2007/10/13,314,2,1.5,1298,314,1,1
54890,2014/03/31,2012/02/15,289,3,1.0,1947,289,1,2
54891,2014/03/31,2012/12/22,352,4,0.75,2596,352,3,1
54892,2014/03/31,2005/10/14,492,3,1.0,1947,492,3,0
54893,2014/03/31,2008/04/17,367,2,0.86103494,2261,367,2,0
54894,2014/03/31,2009/02/16,572,2,0.65,2994,572,2,0
54895,2014/03/31,2011/02/27,567,2,0.65,2994,567,2,0
54896,2014/03/31,2010/06/07,687,2,0.7,2780,687,2,0
54897,2014/03/31,2009/04/14,486,2,0.646495017,3010,486,2,0
54898,2014/03/31,2010/04/20,298,2,0.536651958,3626,298,1,1
54899,2014/03/31,2012/09/03,340,2,0.560426267,3472,340,0,2
54900,2014/03/31,2008/03/12,30,2,1.41,1380,30,0,2
54901,2014/03/31,2010/01/15,297,2,1.41,1380,297,0,2
54902,2014/03/31,2012/11/20,254,3,0.316837649,6141,254,1,2
54903,2014/03/31,2010/01/05,258,5,0.672,2895,258,2,3
54904,2014/03/31,2006/11/30,259,2,0.507604384,3832,259,1,1
54905,2014/03/31,2007/11/13,645,2,0.630093942,3087,645,2,0
54906,2014/03/31,2007/12/11,31,3,0.537600884,3618,31,1,2
54907,2014/03/31,2011/05/12,382,3,0.7153365209999999,2719,382,3,0
54908,2014/03/31,2010/05/20,404,2,0.7,2778,404,2,0
54909,2014/03/31,2012/06/20,488,3,0.583333333,3333,488,3,0
54910,2014/03/31,2011/12/10,681,3,0.533667307,3643,681,3,0
54911,2014/03/31,2005/09/03,482,4,0.34598683,5619,482,4,0
54912,2014/03/31,2008/12/22,210,4,0.905,2148,210,1,3
54913,2014/03/31,2009/08/03,238,6,0.467982182,4153,238,2,4
54914,2014/03/31,2006/05/12,20,3,0.377561686,5147,20,2,1
54915,2014/03/31,2007/07/26,32,3,0.794152023,2447,32,1,2
54916,2014/03/31,2013/01/23,361,2,0.8,2429,361,1,1
54917,2014/03/31,2011/09/28,234,2,0.593150183,3276,234,1,1
54918,2014/03/31,2011/03/04,108,4,0.7436280140000001,2613,108,1,3
54919,2014/03/31,2012/02/24,402,4,0.8375,2320,402,4,0
54920,2014/03/31,2011/11/15,354,5,0.467059389,4159,354,4,1
54921,2014/03/31,2012/04/27,241,2,0.576409496,3370,241,0,2
54922,2014/03/31,2012/10/31,260,2,0.742082537,2617,260,1,1
54923,2014/03/31,2012/12/20,451,3,0.4777367770000001,4065,451,3,0
54924,2014/03/31,2008/05/27,138,2,0.6922352940000001,2805,138,1,1
54925,2014/03/31,2010/10/11,620,2,0.630185005,3081,620,2,0
54926,2014/03/31,2013/01/23,394,2,0.8325900509999999,2332,394,2,0
54927,2014/03/31,2013/03/03,282,2,0.45,4313,282,0,2
54928,2014/03/31,2012/03/20,13,3,0.693333333,2799,13,2,1
54929,2014/03/31,2012/11/23,484,3,0.937487923,2070,484,3,0
54930,2014/03/31,2012/08/13,243,2,0.494760326,3922,243,0,2
54931,2014/03/31,2009/02/19,94,2,0.60769809,3193,94,1,1
54932,2014/03/31,2011/01/27,173,4,0.661520627,2933,173,1,3
54933,2014/03/31,2012/04/10,709,2,0.85735749,2263,709,2,0
54934,2014/03/31,2012/11/30,165,4,0.516123969,3759,165,0,4
54935,2014/03/31,2012/03/06,275,3,0.616444233,3147,275,2,1
54936,2014/03/31,2009/10/04,338,3,0.953071253,2035,338,2,1
54937,2014/03/31,2007/10/28,569,2,0.459900403,4217,569,2,0
54938,2014/03/31,2010/05/25,136,3,0.64,3030,136,0,3
54939,2014/03/31,2012/11/25,429,2,0.5175340270000001,3747,429,2,0
54940,2014/03/31,2011/10/24,74,3,0.7790437929999999,2489,74,0,3
54941,2014/03/31,2013/03/20,139,3,0.8495749340000001,2282,139,0,3
54942,2014/03/31,2013/03/16,95,2,0.6825985920000001,2840,95,0,2
54943,2014/03/31,2012/07/13,494,3,0.8062396009999999,2404,494,3,0
54944,2014/03/31,2012/05/12,527,2,1.0,1938,527,2,0
54945,2014/03/31,2011/04/20,606,2,0.778858521,2488,606,2,0
54946,2014/03/31,2012/10/02,540,2,0.8,2422,540,2,0
54947,2014/03/31,2009/12/26,577,2,0.8,2422,577,2,0
54948,2014/03/31,2012/09/14,562,2,0.8,2422,562,2,0
54949,2014/03/31,2012/09/01,388,2,0.8,2422,388,2,0
54950,2014/03/31,2012/10/17,529,2,0.8,2422,529,2,0
54951,2014/03/31,2010/05/26,71,2,0.7609348000000001,2546,71,0,2
54952,2014/03/31,2011/01/13,195,2,0.67714086,2861,195,1,1
54953,2014/03/31,2012/01/10,629,3,0.762416372,2541,629,3,0
54954,2014/03/31,2005/12/08,372,2,0.475,4078,372,2,0
54955,2014/03/31,2011/02/27,408,4,0.6725347220000001,2880,408,4,0
54956,2014/03/31,2007/12/26,170,3,0.8373540859999999,2313,170,0,3
54957,2014/03/31,2011/06/19,85,4,0.347950054,5566,85,3,1
54958,2014/03/31,2013/03/23,287,2,0.6405755870000001,3023,287,1,1
54959,2014/03/31,2009/03/13,661,3,0.498096218,3887,661,3,0
54960,2014/03/31,2007/10/28,2,2,0.45819645,4225,2,1,1
54961,2014/03/31,2011/10/22,24,2,0.74,2616,24,1,1
54962,2014/03/31,2010/08/26,45,2,0.74,2616,45,1,1
54963,2014/03/31,2007/04/24,263,3,0.562250944,3443,263,1,2
54964,2014/03/31,2012/11/17,449,2,0.5509820670000001,3513,449,2,0
54965,2014/03/31,2012/11/18,135,3,0.8253219620000001,2345,135,0,3
54966,2014/03/31,2009/09/23,210,4,0.6828687370000001,2834,210,2,2
54967,2014/03/31,2009/07/02,114,2,0.588385528,3289,114,1,1
54968,2014/03/31,2011/03/06,480,3,0.7263888890000001,2664,480,3,0
54969,2014/03/31,2010/06/22,113,2,0.5254209670000001,3682,113,0,2
54970,2014/03/31,2006/08/31,560,3,0.67962052,2846,560,3,0
54971,2014/03/31,2012/07/09,172,2,0.32310056800000003,5986,172,1,1
54972,2014/03/31,2011/08/31,80,4,0.624484985,3097,80,0,4
54973,2014/03/31,2008/08/15,33,4,0.745,2596,33,0,4
54974,2014/03/31,2012/12/21,155,2,0.720566319,2684,155,0,2
54975,2014/03/31,2006/12/28,26,4,0.75425117,2564,26,0,4
54976,2014/03/31,2008/02/28,200,4,0.835,2316,200,0,4
54977,2014/03/31,2011/03/06,496,3,0.894886627,2161,496,3,0
54978,2014/03/31,2008/02/11,179,2,0.31,6238,179,0,2
54979,2014/03/31,2008/01/08,501,2,0.83784662,2308,501,2,0
54980,2014/03/31,2012/07/14,254,4,0.475234701,4069,254,2,2
54981,2014/03/31,2011/03/30,370,2,0.827782534,2336,370,2,0
54982,2014/03/31,2005/03/25,80,3,0.5833031670000001,3315,80,0,3
54983,2014/03/31,2009/08/28,138,2,0.555,3484,138,0,2
54984,2014/03/31,2013/01/09,309,3,0.495413784,3903,309,2,1
54985,2014/03/31,2008/11/25,616,2,0.560185453,3451,616,2,0
54986,2014/03/31,2011/10/16,657,2,0.560185453,3451,657,2,0
54987,2014/03/31,2012/09/01,34,4,0.9,2148,34,1,3
54988,2014/03/31,2007/05/30,702,2,0.9,2148,702,2,0
54989,2014/03/31,2012/04/20,171,2,0.5820776870000001,3321,171,1,1
54990,2014/03/31,2013/01/03,50,3,0.483131717,4001,50,0,3
54991,2014/03/31,2013/03/01,386,2,0.5,3866,386,2,0
54992,2014/03/31,2008/04/06,564,3,0.4678770270000001,4131,564,3,0
54993,2014/03/31,2012/09/30,185,3,0.60871811,3175,185,2,1
54994,2014/03/31,2007/05/01,171,2,0.34,5684,171,0,2
54995,2014/03/31,2010/02/17,502,2,0.933333333,2070,502,2,0
54996,2014/03/31,2012/01/24,402,3,0.966666667,1998,402,3,0
54997,2014/03/31,2009/12/19,368,2,0.325,5942,368,2,0
54998,2014/03/31,2013/03/18,59,3,0.460512759,4193,59,1,2
54999,2014/03/31,2010/11/03,65,2,0.53,3642,65,0,2
55000,2014/03/31,2008/02/12,75,2,0.59237876,3258,75,0,2
55001,2014/03/31,2012/10/17,19,2,0.593261605,3253,19,1,1
55002,2014/03/31,2013/01/10,28,3,0.523551275,3686,28,1,2
55003,2014/03/31,2009/03/15,503,3,0.700362976,2755,503,3,0
55004,2014/03/31,2011/08/13,60,2,1.105,1746,60,1,1
55005,2014/03/31,2008/09/02,13,2,0.6161545829999999,3131,13,0,2
55006,2014/03/31,2012/05/08,690,2,0.5,3858,690,2,0
55007,2014/03/31,2012/08/07,532,2,0.6818663840000001,2829,532,2,0
55008,2014/03/31,2008/04/26,99,4,0.483213928,3992,99,0,4
55009,2014/03/31,2012/09/08,468,3,0.71839851,2685,468,3,0
55010,2014/03/31,2010/07/02,274,6,0.778333333,2478,274,4,2
55011,2014/03/31,2012/08/21,64,3,0.6333333329999999,3045,64,0,3
55012,2014/03/31,2011/11/21,511,3,0.7320994679999999,2634,511,3,0
55013,2014/03/31,2012/08/28,85,2,0.674146853,2860,85,1,1
55014,2014/03/31,2006/04/25,137,2,0.828118557,2328,137,0,2
55015,2014/03/31,2012/10/09,129,3,0.775470636,2486,129,1,2
55016,2014/03/31,2012/07/01,106,3,0.7296744890000001,2642,106,1,2
55017,2014/03/31,2013/01/12,194,2,0.49,3934,194,0,2
55018,2014/03/31,2009/12/13,200,2,0.92,2095,200,0,2
55019,2014/03/31,2007/08/21,117,2,0.678204857,2841,117,0,2
55020,2014/03/31,2010/11/18,70,3,0.6173438,3121,70,0,3
55021,2014/03/31,2012/11/10,268,2,0.864100493,2229,268,1,1
55022,2014/03/31,2010/07/28,629,3,0.606980775,3173,629,3,0
55023,2014/03/31,2011/12/24,449,2,0.420603015,4577,449,2,0
55024,2014/03/31,2010/02/06,370,2,0.875,2200,370,2,0
55025,2014/03/31,2011/08/17,130,3,0.3666666670000001,5250,130,2,1
55026,2014/03/31,2012/11/22,425,2,0.7,2750,425,2,0
55027,2014/03/31,2012/04/08,11,3,0.6191251210000001,3109,11,1,2
55028,2014/03/31,2006/08/31,145,2,0.7219354840000001,2666,145,0,2
55029,2014/03/31,2010/10/06,669,4,0.375238838,5129,669,4,0
55030,2014/03/31,2007/10/30,375,4,0.7625,2524,375,4,0
55031,2014/03/31,2010/03/25,159,4,0.365,5272,159,0,4
55032,2014/03/31,2007/12/10,308,3,0.881470454,2183,308,2,1
55033,2014/03/31,2012/03/04,202,4,0.52761722,3647,202,1,3
55034,2014/03/31,2011/06/30,499,2,0.65,2960,499,2,0
55035,2014/03/31,2006/07/23,637,2,0.57931346,3321,637,2,0
55036,2014/03/31,2011/11/27,214,3,0.92,2091,214,0,3
55037,2014/03/31,2010/01/30,283,3,0.496666667,3873,283,2,1
55038,2014/03/31,2008/02/11,61,6,0.585,3288,61,1,5
55039,2014/03/31,2011/07/18,609,2,0.463135083,4153,609,2,0
55040,2014/03/31,2013/02/12,145,2,0.930968054,2066,145,0,2
55041,2014/03/31,2008/09/30,251,2,0.686892857,2800,251,1,1
55042,2014/03/31,2010/09/16,584,2,0.8,2404,584,2,0
55043,2014/03/31,2012/12/26,394,2,0.8,2404,394,2,0
55044,2014/03/31,2007/10/30,609,2,0.8,2404,609,2,0
55045,2014/03/31,2008/06/10,188,4,0.330340148,5821,188,1,3
55046,2014/03/31,2012/01/08,137,2,0.735,2616,137,1,1
55047,2014/03/31,2010/03/20,653,2,0.925,2078,653,2,0
55048,2014/03/31,2008/12/22,152,3,0.861932735,2230,152,2,1
55049,2014/03/31,2013/01/09,130,3,0.628140523,3060,130,1,2
55050,2014/03/31,2005/08/11,346,3,0.650033829,2956,346,2,1
55051,2014/03/31,2011/09/24,617,4,0.426242236,4508,617,4,0
55052,2014/03/31,2012/04/17,165,2,0.561824561,3420,165,0,2
55053,2014/03/31,2009/10/16,300,2,0.640890594,2998,300,1,1
55054,2014/03/31,2005/07/02,82,3,0.585943885,3279,82,0,3
55055,2014/03/31,2012/08/23,407,2,0.635140496,3025,407,2,0
55056,2014/03/31,2012/05/20,626,2,0.8,2401,626,2,0
55057,2014/03/31,2008/02/20,541,2,0.45,4268,541,2,0
55058,2014/03/31,2005/07/10,633,2,0.45,4268,633,2,0
55059,2014/03/31,2007/06/28,677,2,0.45,4268,677,2,0
55060,2014/03/31,2007/05/13,657,2,0.45,4268,657,2,0
55061,2014/03/31,2011/01/26,473,2,0.45,4268,473,2,0
55062,2014/03/31,2009/12/24,307,4,0.55,3492,307,2,2
55063,2014/03/31,2010/10/29,630,2,0.45,4268,630,2,0
55064,2014/03/31,2012/03/27,719,2,0.45,4268,719,2,0
55065,2014/03/31,2007/08/22,695,2,0.45,4268,695,2,0
55066,2014/03/31,2012/10/03,542,2,0.45,4268,542,2,0
55067,2014/03/31,2010/11/05,644,2,0.45,4268,644,2,0
55068,2014/03/31,2012/06/10,658,2,0.45,4268,658,2,0
55069,2014/03/31,2011/11/21,5,6,0.775,2478,5,4,2
55070,2014/03/31,2012/08/29,445,3,0.744186047,2580,445,3,0
55071,2014/03/31,2010/03/12,15,3,0.535097547,3588,15,0,3
55072,2014/03/31,2005/08/22,155,3,0.671090909,2860,155,2,1
55073,2014/03/31,2013/01/11,427,2,0.95,2020,427,2,0
55074,2014/03/31,2012/12/12,474,2,0.95,2020,474,2,0
55075,2014/03/31,2009/08/12,510,2,0.95,2020,510,2,0
55076,2014/03/31,2012/01/09,176,3,0.6333333329999999,3030,176,0,3
55077,2014/03/31,2009/03/05,101,2,0.462053937,4153,101,0,2
55078,2014/03/31,2012/08/14,121,2,0.58,3308,121,0,2
55079,2014/03/31,2013/03/03,268,4,0.64794664,2961,268,0,4
55080,2014/03/31,2013/03/27,370,2,0.386784274,4960,370,2,0
55081,2014/03/31,2010/11/17,128,2,1.088768445,1762,128,1,1
55082,2014/03/31,2011/01/04,461,2,0.54004786,3552,461,2,0
55083,2014/03/31,2010/05/05,159,2,0.535108817,3584,159,1,1
55084,2014/03/31,2012/10/19,94,5,0.504,3805,94,1,4
55085,2014/03/31,2006/07/26,36,2,0.663292978,2891,36,0,2
55086,2014/03/31,2011/08/25,129,4,0.677526502,2830,129,1,3
55087,2014/03/31,2011/04/21,541,2,0.926437893,2069,541,2,0
55088,2014/03/31,2011/08/26,37,2,0.64,2994,37,1,1
55089,2014/03/31,2009/08/18,583,4,0.582017011,3292,583,4,0
55090,2014/03/31,2009/08/23,473,4,0.48899949,3918,473,4,0
55091,2014/03/31,2012/08/22,587,2,0.8502885040000001,2253,587,2,0
55092,2014/03/31,2010/11/05,581,2,0.8502885040000001,2253,581,2,0
55093,2014/03/31,2008/06/17,505,2,0.822284242,2329,505,2,0
55094,2014/03/31,2011/12/26,646,2,0.569800655,3361,646,2,0
55095,2014/03/31,2007/12/02,144,3,0.494045408,3876,144,2,1
55096,2014/03/31,2011/11/21,357,3,0.929320388,2060,357,2,1
55097,2014/03/31,2012/12/05,17,3,0.504517659,3794,17,0,3
55098,2014/03/31,2007/06/14,684,4,0.866500679,2209,684,4,0
55099,2014/03/31,2010/01/16,624,3,1.1,1740,624,3,0
55100,2014/03/31,2006/04/27,394,2,0.800376412,2391,394,2,0
55101,2014/03/31,2012/07/19,597,3,0.4,4784,597,3,0
55102,2014/03/31,2007/05/09,19,2,0.714462285,2678,19,0,2
55103,2014/03/31,2010/09/28,112,2,0.678425532,2820,112,1,1
55104,2014/03/31,2008/02/07,352,2,0.709343715,2697,352,0,2
55105,2014/03/31,2012/02/01,335,2,0.55110919,3471,335,1,1
55106,2014/03/31,2013/02/12,72,2,0.695,2752,72,0,2
55107,2014/03/31,2005/03/11,471,3,0.306,6250,471,3,0
55108,2014/03/31,2006/03/01,28,3,0.547520756,3493,28,0,3
55109,2014/03/31,2013/02/23,94,2,0.801508801,2386,94,0,2
55110,2014/03/31,2010/09/23,283,3,0.560985626,3409,283,2,1
55111,2014/03/31,2012/02/22,4,2,0.7114285709999999,2688,4,0,2
55112,2014/03/31,2012/10/19,115,3,0.432651584,4420,115,0,3
55113,2014/03/31,2007/06/05,220,3,0.479729052,3986,220,1,2
55114,2014/03/31,2011/11/07,59,3,0.961800805,1988,59,1,2
55115,2014/03/31,2012/04/01,731,2,0.588669951,3248,731,2,0
55116,2014/03/31,2009/07/04,346,2,0.8,2390,346,1,1
55117,2014/03/31,2011/04/21,550,2,0.8,2390,550,2,0
55118,2014/03/31,2012/09/29,179,3,0.914160689,2091,179,1,2
55119,2014/03/31,2007/08/02,27,3,0.923333333,2070,27,0,3
55120,2014/03/31,2010/11/29,301,2,0.708924332,2696,301,0,2
55121,2014/03/31,2013/01/29,101,2,0.634906977,3010,101,1,1
55122,2014/03/31,2010/11/29,559,3,0.7,2730,559,3,0
55123,2014/03/31,2012/05/01,460,2,0.474063508,4031,460,2,0
55124,2014/03/31,2008/11/27,101,4,0.855353626,2234,101,0,4
55125,2014/03/31,2011/12/31,710,4,0.825,2316,710,4,0
55126,2014/03/31,2010/06/16,486,3,0.8833333329999999,2163,486,3,0
55127,2014/03/31,2013/02/10,398,2,0.558462438,3421,398,2,0
55128,2014/03/31,2010/08/20,30,2,0.457442529,4176,30,0,2
55129,2014/03/31,2007/07/05,195,2,0.534878185,3571,195,0,2
55130,2014/03/31,2011/04/29,399,2,1.0,1910,399,2,0
55131,2014/03/31,2011/10/30,400,2,1.0,1910,400,2,0
55132,2014/03/31,2011/09/09,413,2,1.0,1910,413,2,0
55133,2014/03/31,2007/07/07,417,3,0.666666667,2865,417,3,0
55134,2014/03/31,2012/10/19,253,3,0.757801587,2520,253,1,2
55135,2014/03/31,2010/11/23,550,3,0.712747294,2679,550,3,0
55136,2014/03/31,2006/12/07,153,2,0.942874074,2025,153,1,1
55137,2014/03/31,2013/01/30,287,2,0.558951684,3415,287,1,1
55138,2014/03/31,2012/08/24,265,3,0.450594901,4236,265,2,1
55139,2014/03/31,2009/08/18,21,4,0.5075,3760,21,2,2
55140,2014/03/31,2006/04/08,21,2,0.41,4654,21,0,2
55141,2014/03/31,2009/01/23,299,3,0.695349854,2744,299,1,2
55142,2014/03/31,2012/08/28,49,4,0.521881838,3656,49,2,2
55143,2014/03/31,2010/08/16,17,3,0.704311554,2709,17,0,3
55144,2014/03/31,2012/04/16,576,2,0.416299367,4583,576,2,0
55145,2014/03/31,2012/06/24,406,3,0.379028412,5033,406,3,0
55146,2014/03/31,2013/02/15,60,3,0.550380842,3466,60,0,3
55147,2014/03/31,2009/10/15,163,2,0.625,3052,163,0,2
55148,2014/03/31,2009/12/18,411,2,0.625,3052,411,2,0
55149,2014/03/31,2011/08/18,30,3,0.573339345,3327,30,0,3
55150,2014/03/31,2009/10/20,303,3,0.488402049,3905,303,0,3
55151,2014/03/31,2013/01/09,354,4,0.5375,3548,354,3,1
55152,2014/03/31,2012/12/22,206,2,0.976282642,1953,206,1,1
55153,2014/03/31,2013/03/26,231,2,0.8500490409999999,2243,231,0,2
55154,2014/03/31,2008/03/11,5,2,0.89261236,2136,5,0,2
55155,2014/03/31,2006/03/30,10,2,0.455792493,4183,10,0,2
55156,2014/03/31,2007/07/24,420,3,0.345693563,5515,420,3,0
55157,2014/03/31,2011/07/18,29,2,0.8222864540000001,2318,29,0,2
55158,2014/03/31,2006/10/23,522,2,0.906276748,2103,522,2,0
55159,2014/03/31,2007/11/26,174,2,0.8242647059999999,2312,174,1,1
55160,2014/03/31,2010/03/01,66,4,0.541073254,3522,66,0,4
55161,2014/03/31,2013/03/23,130,3,0.668124123,2852,130,0,3
55162,2014/03/31,2010/02/13,55,4,0.45694964,4170,55,0,4
55163,2014/03/31,2005/07/17,173,4,0.401699346,4743,173,0,4
55164,2014/03/31,2006/05/26,133,3,0.722332196,2637,133,0,3
55165,2014/03/31,2013/03/05,315,2,0.65,2930,315,1,1
55166,2014/03/31,2012/12/03,375,2,0.65,2930,375,2,0
55167,2014/03/31,2010/01/18,70,3,0.683333333,2787,70,1,2
55168,2014/03/31,2008/05/29,160,3,0.92,2070,160,0,3
55169,2014/03/31,2007/05/13,633,2,0.65805114,2894,633,2,0
55170,2014/03/31,2008/11/17,239,3,0.92,2070,239,0,3
55171,2014/03/31,2010/11/22,308,2,0.7274064170000001,2618,308,1,1
55172,2014/03/31,2008/08/08,678,2,0.724895318,2627,678,2,0
55173,2014/03/31,2010/04/09,66,4,0.688376717,2766,66,0,4
55174,2014/03/31,2011/11/03,154,2,0.697384615,2730,154,1,1
55175,2014/03/31,2012/12/11,155,3,0.651969178,2920,155,2,1
55176,2014/03/31,2007/07/17,37,2,0.62417377,3050,37,0,2
55177,2014/03/31,2012/08/24,516,2,0.360921502,5274,516,2,0
55178,2014/03/31,2013/03/03,7,4,0.404711886,4703,7,0,4
55179,2014/03/31,2009/04/21,43,3,0.29942102,6356,43,2,1
55180,2014/03/31,2009/07/02,304,4,0.783148148,2430,304,3,1
55181,2014/03/31,2009/02/23,495,4,0.7875,2416,495,4,0
55182,2014/03/31,2011/06/22,133,3,0.4375758970000001,4348,133,2,1
55183,2014/03/31,2007/07/28,1,3,0.592826426,3209,1,2,1
55184,2014/03/31,2012/06/08,659,2,0.550434028,3456,659,2,0
55185,2014/03/31,2009/10/05,705,2,0.55,3458,705,2,0
55186,2014/03/31,2011/02/04,340,4,0.700755343,2714,340,2,2
55187,2014/03/31,2008/10/02,672,2,0.501913434,3789,672,2,0
55188,2014/03/31,2013/03/01,45,4,0.7325,2596,45,1,3
55189,2014/03/31,2012/08/19,555,3,0.533333333,3564,555,3,0
55190,2014/03/31,2008/02/07,72,2,0.611505792,3108,72,0,2
55191,2014/03/31,2012/12/27,426,2,0.966192171,1967,426,2,0
55192,2014/03/31,2012/09/14,29,2,0.6926020409999999,2744,29,1,1
55193,2014/03/31,2011/10/27,378,3,0.787339412,2413,378,3,0
55194,2014/03/31,2013/03/23,75,2,0.565693865,3358,75,1,1
55195,2014/03/31,2005/02/03,415,3,0.535287486,3548,415,3,0
55196,2014/03/31,2010/04/29,274,4,0.82,2316,274,1,3
55197,2014/03/31,2011/07/19,139,4,0.82,2316,139,0,4
55198,2014/03/31,2012/06/26,307,2,0.579877863,3275,307,1,1
55199,2014/03/31,2011/03/14,430,3,0.769448947,2468,430,3,0
55200,2014/03/31,2006/06/19,133,2,0.6546931029999999,2900,133,1,1
55201,2014/03/31,2011/10/13,125,4,0.3664466320000001,5181,125,2,2
55202,2014/03/31,2012/10/16,449,4,0.4,4746,449,4,0
55203,2014/03/31,2011/07/09,290,2,0.718546556,2642,290,1,1
55204,2014/03/31,2005/08/06,316,3,0.734313346,2585,316,2,1
55205,2014/03/31,2009/04/19,307,3,0.734313346,2585,307,1,2
55206,2014/03/31,2011/11/16,292,4,0.535,3548,292,3,1
55207,2014/03/31,2011/07/24,344,4,0.492897949,3851,344,3,1
55208,2014/03/31,2011/04/22,300,5,0.57,3330,300,3,2
55209,2014/03/31,2006/01/14,636,2,1.0,1898,636,2,0
55210,2014/03/31,2011/12/29,510,3,0.7531349209999999,2520,510,3,0
55211,2014/03/31,2011/12/01,28,2,0.576476306,3292,28,0,2
55212,2014/03/31,2005/10/13,228,3,0.7910295959999999,2399,228,2,1
55213,2014/03/31,2013/02/02,87,4,0.374112776,5072,87,0,4
55214,2014/03/31,2012/07/19,306,2,1.25,1518,306,1,1
55215,2014/03/31,2006/06/29,13,2,0.9138921,2076,13,0,2
55216,2014/03/31,2011/04/15,348,3,0.579944971,3271,348,1,2
55217,2014/03/31,2007/09/10,317,2,0.35,5420,317,0,2
55218,2014/03/31,2010/04/23,134,2,0.65407931,2900,134,1,1
55219,2014/03/31,2010/10/20,111,2,0.6518178689999999,2910,111,0,2
55220,2014/03/31,2007/08/15,12,2,0.725,2616,12,0,2
55221,2014/03/31,2009/10/14,464,2,0.725,2616,464,2,0
55222,2014/03/31,2005/01/01,666,2,0.725,2616,666,2,0
55223,2014/03/31,2005/04/15,527,2,0.725,2616,527,2,0
55224,2014/03/31,2012/08/27,232,3,0.483333333,3924,232,1,2
55225,2014/03/31,2010/07/26,193,3,0.7336247579999999,2585,193,0,3
55226,2014/03/31,2013/02/03,116,2,0.741905321,2556,116,1,1
55227,2014/03/31,2013/01/19,184,3,0.49,3870,184,2,1
55228,2014/03/31,2008/04/12,96,4,0.615043789,3083,96,0,4
55229,2014/03/31,2011/05/13,213,3,0.92,2061,213,0,3
55230,2014/03/31,2013/03/23,88,2,0.5044080870000001,3759,88,0,2
55231,2014/03/31,2012/09/06,573,2,0.917739593,2066,573,2,0
55232,2014/03/31,2010/05/11,447,2,0.8,2370,447,2,0
55233,2014/03/31,2011/01/26,69,3,0.451744103,4197,69,0,3
55234,2014/03/31,2012/02/15,198,2,0.388354845,4881,198,1,1
55235,2014/03/31,2009/07/08,234,2,0.7126513729999999,2659,234,1,1
55236,2014/03/31,2010/03/21,8,7,0.725714286,2611,8,0,7
55237,2014/03/31,2013/02/01,422,2,0.850067295,2229,422,2,0
55238,2014/03/31,2013/02/16,184,3,0.5666267939999999,3344,184,2,1
55239,2014/03/31,2009/09/22,330,2,0.90785817,2087,330,1,1
55240,2014/03/31,2011/08/20,410,2,0.849932705,2229,410,2,0
55241,2014/03/31,2012/09/27,545,2,0.4,4736,545,2,0
55242,2014/03/31,2010/08/11,710,2,0.55,3444,710,2,0
55243,2014/03/31,2012/05/14,281,4,0.41,4620,281,2,2
55244,2014/03/31,2008/12/30,349,2,1.222724338,1549,349,0,2
55245,2014/03/31,2009/10/23,107,2,1.2,1578,107,0,2
55246,2014/03/31,2009/10/17,370,3,0.769090171,2462,370,3,0
55247,2014/03/31,2008/07/02,133,3,0.912806172,2074,133,0,3
55248,2014/03/31,2012/07/11,629,2,0.660732984,2865,629,2,0
55249,2014/03/31,2013/02/27,206,3,0.549808307,3443,206,0,3
55250,2014/03/31,2005/03/12,78,3,0.44,4302,78,0,3
55251,2014/03/31,2007/08/23,236,3,0.863394161,2192,236,1,2
55252,2014/03/31,2012/04/24,689,2,0.4,4731,689,2,0
55253,2014/03/31,2013/02/12,82,3,0.723340979,2616,82,0,3
55254,2014/03/31,2007/06/23,16,2,0.662324116,2857,16,0,2
55255,2014/03/31,2012/09/11,70,2,0.835,2266,70,0,2
55256,2014/03/31,2012/05/09,684,2,0.55,3440,684,2,0
55257,2014/03/31,2012/05/10,677,2,0.55,3440,677,2,0
55258,2014/03/31,2012/09/14,551,2,0.55,3440,551,2,0
55259,2014/03/31,2011/12/13,169,2,0.934237037,2025,169,1,1
55260,2014/03/31,2010/05/16,20,2,0.5481483629999999,3451,20,1,1
55261,2014/03/31,2008/12/25,436,3,0.3891380370000001,4861,436,3,0
55262,2014/03/31,2011/11/01,367,4,0.396030582,4774,367,4,0
55263,2014/03/31,2007/11/13,103,3,0.913333333,2070,103,0,3
55264,2014/03/31,2006/11/14,509,3,0.890857681,2122,509,3,0
55265,2014/03/31,2013/03/21,312,2,0.7204268290000001,2624,312,1,1
55266,2014/03/31,2011/04/27,27,2,0.5611728029999999,3368,27,0,2
55267,2014/03/31,2012/03/14,320,2,1.0,1890,320,1,1
55268,2014/03/31,2006/09/06,158,5,0.6961325970000001,2715,158,4,1
55269,2014/03/31,2008/04/03,242,2,0.807521368,2340,242,0,2
55270,2014/03/31,2008/03/12,500,2,0.8,2362,500,2,0
55271,2014/03/31,2012/08/31,197,3,0.626276525,3016,197,2,1
55272,2014/03/31,2010/09/23,556,2,0.55,3434,556,2,0
55273,2014/03/31,2011/01/17,429,2,0.55,3434,429,2,0
55274,2014/03/31,2007/05/01,161,2,0.45,4197,161,0,2
55275,2014/03/31,2011/02/25,34,4,0.7275,2596,34,2,2
55276,2014/03/31,2010/12/13,171,2,1.455,1298,171,1,1
55277,2014/03/31,2007/05/01,165,2,0.804559012,2347,165,1,1
55278,2014/03/31,2011/03/18,565,2,0.8,2360,565,2,0
55279,2014/03/31,2010/11/30,210,3,0.718914699,2626,210,2,1
55280,2014/03/31,2008/07/16,10,2,0.806666667,2340,10,0,2
55281,2014/03/31,2011/11/14,6,6,0.413333333,4566,6,2,4
55282,2014/03/31,2011/06/01,270,4,0.465415536,4055,270,0,4
55283,2014/03/31,2012/04/02,307,2,1.0,1887,307,1,1
55284,2014/03/31,2010/11/05,51,3,0.6325779420000001,2983,51,2,1
55285,2014/03/31,2013/01/01,43,3,0.640044098,2948,43,1,2
55286,2014/03/31,2012/02/23,156,4,0.44925,4200,156,3,1
55287,2014/03/31,2010/10/31,298,2,0.397817837,4743,298,1,1
55288,2014/03/31,2008/10/25,558,3,0.798011844,2364,558,3,0
55289,2014/03/31,2011/04/12,371,4,0.603841229,3124,371,4,0
55290,2014/03/31,2012/04/03,513,2,0.63428043,2974,513,2,0
55291,2014/03/31,2012/11/13,71,3,0.5062560389999999,3726,71,0,3
55292,2014/03/31,2010/02/09,240,3,0.763042071,2472,240,1,2
55293,2014/03/31,2012/08/14,129,2,0.882231057,2138,129,1,1
55294,2014/03/31,2010/05/06,301,2,0.571935093,3297,301,0,2
55295,2014/03/31,2009/11/13,234,3,0.8633333329999999,2184,234,1,2
55296,2014/03/31,2012/11/04,481,2,0.744060773,2534,481,2,0
55297,2014/03/31,2013/03/01,276,2,0.687117347,2744,276,1,1
55298,2014/03/31,2008/12/08,125,2,0.52046396,3621,125,1,1
55299,2014/03/31,2012/09/21,441,2,0.81285591,2318,441,2,0
55300,2014/03/31,2012/04/16,529,3,0.6956240770000001,2708,529,3,0
55301,2014/03/31,2007/09/06,105,2,0.6849890909999999,2750,105,1,1
55302,2014/03/31,2012/12/13,234,4,0.372419929,5058,234,2,2
55303,2014/03/31,2009/09/27,39,2,0.8842253520000001,2130,39,0,2
55304,2014/03/31,2012/05/11,667,3,0.401321398,4692,667,3,0
55305,2014/03/31,2011/11/16,153,3,0.826549605,2278,153,2,1
55306,2014/03/31,2010/06/18,713,2,0.9,2092,713,2,0
55307,2014/03/31,2011/12/05,385,2,0.9,2092,385,2,0
55308,2014/03/31,2008/05/01,355,2,0.9,2092,355,0,2
55309,2014/03/31,2011/10/11,329,4,0.8643939390000001,2178,329,0,4
55310,2014/03/31,2013/03/29,135,2,0.66,2852,135,0,2
55311,2014/03/31,2012/12/16,269,2,0.357840304,5260,269,1,1
55312,2014/03/31,2009/10/22,519,3,0.966666667,1947,519,3,0
55313,2014/03/31,2012/12/27,148,4,0.725,2596,148,2,2
55314,2014/03/31,2012/11/16,40,2,0.648270159,2902,40,1,1
55315,2014/03/31,2011/07/23,67,2,0.834798047,2253,67,1,1
55316,2014/03/31,2008/05/01,173,2,0.415,4532,173,0,2
55317,2014/03/31,2007/05/31,83,2,0.83,2266,83,0,2
55318,2014/03/31,2010/12/16,95,2,0.6770086390000001,2778,95,1,1
55319,2014/03/31,2011/03/08,167,2,0.821091703,2290,167,0,2
55320,2014/03/31,2012/04/26,654,3,0.71163891,2642,654,3,0
55321,2014/03/31,2007/07/19,30,2,0.65,2892,30,0,2
55322,2014/03/31,2008/02/26,571,3,0.701586413,2679,571,3,0
55323,2014/03/31,2010/01/14,619,4,0.875,2148,619,4,0
55324,2014/03/31,2011/08/17,341,4,0.875,2148,341,2,2
55325,2014/03/31,2008/05/13,184,3,0.689182252,2727,184,1,2
55326,2014/03/31,2013/03/30,5,2,0.657773889,2857,5,1,1
55327,2014/03/31,2011/10/01,34,2,0.7019088529999999,2677,34,1,1
55328,2014/03/31,2010/04/15,536,2,0.8896306820000001,2112,536,2,0
55329,2014/03/31,2007/09/08,210,2,0.762410714,2464,210,0,2
55330,2014/03/31,2008/10/27,469,3,0.483414822,3886,469,3,0
55331,2014/03/31,2010/01/31,245,4,0.705,2664,245,2,2
55332,2014/03/31,2010/01/26,354,3,0.481363753,3901,354,2,1
55333,2014/03/31,2010/11/03,337,2,0.925,2030,337,0,2
55334,2014/03/31,2013/01/01,180,4,0.5451916379999999,3444,180,1,3
55335,2014/03/31,2012/08/14,46,2,0.73,2572,46,0,2
55336,2014/03/31,2012/04/29,477,4,0.487776046,3849,477,4,0
55337,2014/03/31,2009/08/28,259,6,0.317898391,5905,259,2,4
55338,2014/03/31,2011/10/22,264,3,0.716666667,2619,264,1,2
55339,2014/03/31,2013/02/25,231,4,0.604103637,3107,231,0,4
55340,2014/03/31,2012/10/23,186,2,0.713520913,2630,186,1,1
55341,2014/03/31,2012/03/21,507,2,0.675,2780,507,2,0
55342,2014/03/31,2009/12/19,644,2,0.678398409,2766,644,2,0
55343,2014/03/31,2012/07/01,634,3,0.7409952609999999,2532,634,3,0
55344,2014/03/31,2013/03/21,17,2,0.79191642,2369,17,1,1
55345,2014/03/31,2010/06/25,572,2,0.5,3752,572,2,0
55346,2014/03/31,2011/11/27,369,3,0.604495649,3103,369,3,0
55347,2014/03/31,2012/10/10,166,2,0.432233233,4339,166,0,2
55348,2014/03/31,2013/02/16,185,2,0.72746315,2578,185,1,1
55349,2014/03/31,2006/05/24,629,4,0.5375,3488,629,4,0
55350,2014/03/31,2013/03/08,353,3,0.8666666670000001,2163,353,2,1
55351,2014/03/31,2005/07/30,125,2,0.663803116,2824,125,0,2
55352,2014/03/31,2013/01/23,367,2,0.6721046970000001,2789,367,2,0
55353,2014/03/31,2009/10/22,560,2,0.481083162,3896,560,2,0
55354,2014/03/31,2013/01/08,325,7,0.45,4165,325,5,2
55355,2014/03/31,2007/02/20,118,5,0.684,2740,118,0,5
55356,2014/03/31,2008/06/23,229,3,0.864095941,2168,229,1,2
55357,2014/03/31,2006/11/26,163,4,0.721054657,2598,163,3,1
55358,2014/03/31,2011/10/24,558,2,0.4,4683,558,2,0
55359,2014/03/31,2008/01/16,207,2,0.92,2036,207,0,2
55360,2014/03/31,2013/03/01,378,2,0.582597201,3215,378,2,0
55361,2014/03/31,2012/08/19,548,3,0.723724884,2588,548,3,0
55362,2014/03/31,2013/02/05,320,4,0.401802188,4661,320,3,1
55363,2014/03/31,2011/10/16,94,2,0.44,4256,94,0,2
55364,2014/03/31,2009/03/02,504,2,0.658635244,2843,504,2,0
55365,2014/03/31,2010/06/23,264,2,0.846491863,2212,264,0,2
55366,2014/03/31,2009/07/04,537,4,0.775,2416,537,4,0
55367,2014/03/31,2011/10/29,433,3,0.4,4681,433,3,0
55368,2014/03/31,2009/09/26,588,4,0.775,2416,588,4,0
55369,2014/03/31,2012/08/21,107,4,0.394157895,4750,107,2,2
55370,2014/03/31,2006/08/28,473,2,0.55,3404,473,2,0
55371,2014/03/31,2008/12/06,673,2,0.55,3404,673,2,0
55372,2014/03/31,2012/01/01,364,3,0.731860829,2558,364,1,2
55373,2014/03/31,2010/12/02,13,4,0.615,3044,13,2,2
55374,2014/03/31,2013/01/24,373,2,0.725,2582,373,2,0
55375,2014/03/31,2012/04/07,7,4,0.49,3820,7,0,4
55376,2014/03/31,2011/01/13,294,2,0.49,3820,294,1,1
55377,2014/03/31,2013/03/17,163,2,0.359056025,5212,163,1,1
55378,2014/03/31,2012/08/25,93,2,0.3,6238,93,0,2
55379,2014/03/31,2013/03/12,44,2,0.625,2994,44,0,2
55380,2014/03/31,2005/08/02,519,2,0.7526146420000001,2486,519,2,0
55381,2014/03/31,2011/09/11,44,4,0.5131239710000001,3646,44,1,3
55382,2014/03/31,2013/01/23,20,5,0.61033279,3065,20,1,4
55383,2014/03/31,2011/11/02,59,2,0.5741651320000001,3258,59,0,2
55384,2014/03/31,2009/12/22,20,3,0.45336888,4126,20,1,2
55385,2014/03/31,2009/09/21,251,4,0.362722513,5157,251,2,2
55386,2014/03/31,2012/09/24,90,5,0.404174589,4628,90,1,4
55387,2014/03/31,2006/08/03,319,3,0.483333333,3870,319,1,2
55388,2014/03/31,2012/09/18,554,2,0.5,3741,554,2,0
55389,2014/03/31,2004/12/18,184,2,0.715,2616,184,1,1
55390,2014/03/31,2010/08/08,109,2,0.77065513,2427,109,0,2
55391,2014/03/31,2012/04/25,686,2,0.9,2078,686,2,0
55392,2014/03/31,2012/03/25,232,5,0.6459999999999999,2895,232,3,2
55393,2014/03/31,2012/08/14,17,2,0.69,2710,17,1,1
55394,2014/03/31,2012/06/28,75,3,0.92606736,2019,75,1,2
55395,2014/03/31,2011/08/21,344,2,0.35,5342,344,0,2
55396,2014/03/31,2013/01/29,244,4,0.330902655,5650,244,2,2
55397,2014/03/31,2007/06/11,17,3,0.788456348,2371,17,0,3
55398,2014/03/31,2012/12/30,395,3,0.695442708,2688,395,3,0
55399,2014/03/31,2008/10/02,76,2,0.419127803,4460,76,0,2
55400,2014/03/31,2013/03/25,364,2,0.45,4154,364,1,1
55401,2014/03/31,2008/03/04,688,2,0.45,4154,688,2,0
55402,2014/03/31,2007/11/02,133,3,0.453806749,4119,133,1,2
55403,2014/03/31,2012/01/17,401,2,0.45,4153,401,2,0
55404,2014/03/31,2012/01/24,405,2,0.559856201,3338,405,2,0
55405,2014/03/31,2008/07/29,22,3,0.6140946429999999,3043,22,2,1
55406,2014/03/31,2007/06/27,450,2,0.475,3934,450,2,0
55407,2014/03/31,2012/06/21,488,2,0.475,3934,488,2,0
55408,2014/03/31,2012/08/24,376,2,0.475,3934,376,2,0
55409,2014/03/31,2006/03/22,535,2,0.475,3934,535,2,0
55410,2014/03/31,2012/04/23,441,2,0.475,3934,441,2,0
55411,2014/03/31,2009/04/15,481,2,0.475,3934,481,2,0
55412,2014/03/31,2012/08/08,534,2,0.475,3934,534,2,0
55413,2014/03/31,2007/08/07,438,2,0.475,3934,438,2,0
55414,2014/03/31,2012/05/21,577,2,0.475,3934,577,2,0
55415,2014/03/31,2012/08/01,478,2,0.475,3934,478,2,0
55416,2014/03/31,2012/11/28,476,2,0.475,3934,476,2,0
55417,2014/03/31,2012/09/07,565,2,0.475,3934,565,2,0
55418,2014/03/31,2011/11/21,519,2,0.475,3934,519,2,0
55419,2014/03/31,2009/01/01,325,3,0.316666667,5901,325,1,2
55420,2014/03/31,2006/03/06,54,3,0.357978927,5220,54,2,1
55421,2014/03/31,2012/02/06,321,3,0.6180946079999999,3023,321,2,1
55422,2014/03/31,2011/10/01,261,3,0.657866197,2840,261,2,1
55423,2014/03/31,2013/02/06,389,2,0.85,2198,389,2,0
55424,2014/03/31,2008/07/17,414,2,0.76557377,2440,414,2,0
55425,2014/03/31,2011/04/15,402,2,0.559769254,3337,402,2,0
55426,2014/03/31,2012/03/26,530,2,0.724272974,2579,530,2,0
55427,2014/03/31,2005/10/22,236,2,0.657697183,2840,236,0,2
55428,2014/03/31,2012/03/01,592,2,0.72503882,2576,592,2,0
55429,2014/03/31,2011/10/17,309,5,0.398113409,4691,309,0,5
55430,2014/03/31,2009/02/12,395,2,0.652708843,2861,395,2,0
55431,2014/03/31,2010/06/23,114,2,0.711856653,2623,114,1,1
55432,2014/03/31,2011/03/21,338,2,0.726741923,2569,338,0,2
55433,2014/03/31,2010/08/14,359,5,0.475133622,3929,359,3,2
55434,2014/03/31,2012/10/09,391,2,0.55,3394,391,2,0
55435,2014/03/31,2012/11/14,501,2,0.6341488279999999,2943,501,2,0
55436,2014/03/31,2012/06/02,402,3,0.473174442,3944,402,3,0
55437,2014/03/31,2006/08/16,187,4,0.890739857,2095,187,2,2
55438,2014/03/31,2013/03/19,361,2,0.688325341,2711,361,1,1
55439,2014/03/31,2012/01/16,539,2,1.0,1866,539,2,0
55440,2014/03/31,2011/05/22,652,2,1.0,1866,652,2,0
55441,2014/03/31,2012/05/18,616,2,1.0,1866,616,2,0
55442,2014/03/31,2007/11/21,532,2,1.0,1866,532,2,0
55443,2014/03/31,2011/02/21,720,2,1.0,1866,720,2,0
55444,2014/03/31,2012/04/04,685,2,1.0,1866,685,2,0
55445,2014/03/31,2007/12/27,673,2,1.0,1866,673,2,0
55446,2014/03/31,2008/02/20,593,2,1.0,1866,593,2,0
55447,2014/03/31,2007/11/27,682,2,1.0,1866,682,2,0
55448,2014/03/31,2011/11/18,686,2,1.0,1866,686,2,0
55449,2014/03/31,2012/11/01,513,2,1.0,1866,513,2,0
55450,2014/03/31,2010/02/19,558,2,1.0,1866,558,2,0
55451,2014/03/31,2009/10/27,621,2,1.0,1866,621,2,0
55452,2014/03/31,2012/11/06,507,2,1.0,1866,507,2,0
55453,2014/03/31,2008/10/31,501,2,1.0,1866,501,2,0
55454,2014/03/31,2006/07/03,313,2,1.0,1866,313,1,1
55455,2014/03/31,2012/09/30,544,2,1.0,1866,544,2,0
55456,2014/03/31,2011/02/01,654,2,1.0,1866,654,2,0
55457,2014/03/31,2013/03/26,207,2,0.710251237,2627,207,0,2
55458,2014/03/31,2012/04/16,443,3,0.7580251929999999,2461,443,3,0
55459,2014/03/31,2012/06/19,277,3,0.850652075,2193,277,0,3
55460,2014/03/31,2011/06/14,144,4,0.414450122,4501,144,0,4
55461,2014/03/31,2006/08/01,39,3,0.7704956629999999,2421,39,0,3
55462,2014/03/31,2012/04/06,406,2,0.5626545999999999,3315,406,2,0
55463,2014/03/31,2012/04/06,406,2,0.5626545999999999,3315,406,2,0
55464,2014/03/31,2013/01/11,272,2,0.77,2422,272,0,2
55465,2014/03/31,2006/04/21,161,2,0.7418019090000001,2514,161,0,2
55466,2014/03/31,2006/10/01,706,2,0.725,2572,706,2,0
55467,2014/03/31,2006/12/09,650,2,0.725,2572,650,2,0
55468,2014/03/31,2011/06/30,652,2,0.55,3390,652,2,0
55469,2014/03/31,2010/08/24,100,2,0.58,3214,100,0,2
55470,2014/03/31,2010/10/17,324,3,0.541732055,3441,324,2,1
55471,2014/03/31,2012/11/29,7,3,0.463333333,4023,7,0,3
55472,2014/03/31,2009/03/06,53,2,0.830164811,2245,53,1,1
55473,2014/03/31,2010/09/22,52,3,0.478838643,3892,52,0,3
55474,2014/03/31,2012/09/01,537,2,0.6,3106,537,2,0
55475,2014/03/31,2008/11/15,24,2,0.65635435,2839,24,1,1
55476,2014/03/31,2012/01/05,393,3,0.540984321,3444,393,3,0
55477,2014/03/31,2012/07/09,194,2,0.775,2404,194,1,1
55478,2014/03/31,2011/08/28,382,3,0.9,2070,382,3,0
55479,2014/03/31,2011/11/21,667,3,0.33699348799999995,5528,667,3,0
55480,2014/03/31,2011/06/17,27,3,0.5963188220000001,3124,27,1,2
55481,2014/03/31,2011/06/09,506,2,0.553252153,3367,506,2,0
55482,2014/03/31,2013/03/31,350,2,1.231944444,1512,350,1,1
55483,2014/03/31,2012/10/10,25,3,0.956666667,1947,25,2,1
55484,2014/03/31,2007/08/03,125,3,0.956666667,1947,125,2,1
55485,2014/03/31,2005/08/09,72,4,0.459740805,4051,72,0,4
55486,2014/03/31,2012/05/08,496,3,0.65,2865,496,3,0
55487,2014/03/31,2007/05/11,515,3,0.792784163,2349,515,3,0
55488,2014/03/31,2012/04/30,544,2,0.95,1960,544,2,0
55489,2014/03/31,2012/06/27,317,2,1.0,1862,317,1,1
55490,2014/03/31,2007/09/26,655,4,0.7375,2524,655,4,0
55491,2014/03/31,2010/06/22,246,2,0.677365357,2748,246,1,1
55492,2014/03/31,2012/04/15,442,3,0.724785826,2568,442,3,0
55493,2014/03/31,2011/11/21,18,3,0.751631664,2476,18,0,3
55494,2014/03/31,2010/07/19,620,3,0.696649195,2671,620,3,0
55495,2014/03/31,2007/05/10,244,2,0.635,2930,244,0,2
55496,2014/03/31,2009/08/22,147,2,0.5329533089999999,3491,147,0,2
55497,2014/03/31,2008/11/08,455,2,0.546474736,3404,455,2,0
55498,2014/03/31,2013/03/03,62,2,0.54905549,3388,62,1,1
55499,2014/03/31,2010/11/27,167,2,0.745192308,2496,167,0,2
55500,2014/03/31,2010/09/25,211,3,0.395367772,4704,211,1,2
55501,2014/03/31,2005/10/05,552,2,0.539182135,3448,552,2,0
55502,2014/03/31,2009/12/02,569,2,0.689065975,2698,569,2,0
55503,2014/03/31,2012/04/09,720,2,0.5,3718,720,2,0
55504,2014/03/31,2012/04/09,720,2,0.5,3718,720,2,0
55505,2014/03/31,2011/03/04,288,2,0.861808067,2157,288,0,2
55506,2014/03/31,2013/01/19,81,4,0.468271605,3969,81,0,4
55507,2014/03/31,2010/11/19,611,2,0.75,2478,611,2,0
55508,2014/03/31,2012/09/27,289,5,0.589429115,3153,289,4,1
55509,2014/03/31,2009/08/25,193,2,0.92,2020,193,0,2
55510,2014/03/31,2007/07/29,251,2,0.92,2020,251,0,2
55511,2014/03/31,2011/01/15,228,2,0.92,2020,228,0,2
55512,2014/03/31,2006/11/01,226,2,0.92,2020,226,0,2
55513,2014/03/31,2013/03/23,121,2,0.821923927,2261,121,0,2
55514,2014/03/31,2012/11/09,414,2,0.791418228,2348,414,2,0
55515,2014/03/31,2010/06/09,662,2,0.915369458,2030,662,2,0
55516,2014/03/31,2012/04/13,294,2,0.619373333,3000,294,1,1
55517,2014/03/31,2007/06/24,207,5,0.391219204,4749,207,3,2
55518,2014/03/31,2011/12/23,222,3,0.386086866,4812,222,2,1
55519,2014/03/31,2010/12/06,178,2,0.92,2019,178,0,2
55520,2014/03/31,2010/01/04,252,2,0.71,2616,252,0,2
55521,2014/03/31,2013/02/16,45,4,0.355,5232,45,2,2
55522,2014/03/31,2012/10/01,121,6,0.513333333,3618,121,2,4
55523,2014/03/31,2011/11/16,537,3,0.83264574,2230,537,3,0
55524,2014/03/31,2009/03/10,262,3,0.919638435,2019,262,2,1
55525,2014/03/31,2011/08/09,362,2,0.934843907,1986,362,1,1
55526,2014/03/31,2010/02/10,37,2,0.537668694,3453,37,1,1
55527,2014/03/31,2012/02/02,177,2,0.6750690909999999,2750,177,0,2
55528,2014/03/31,2008/02/22,199,2,0.526940108,3523,199,0,2
55529,2014/03/31,2008/12/04,82,2,0.55,3374,82,0,2
55530,2014/03/31,2008/05/17,350,3,0.439379588,4223,350,2,1
55531,2014/03/31,2010/11/05,46,4,0.518811521,3576,46,2,2
55532,2014/03/31,2008/09/12,646,2,0.591562998,3135,646,2,0
55533,2014/03/31,2011/07/31,5,4,0.592043423,3132,5,0,4
55534,2014/03/31,2013/03/15,271,2,0.504703321,3674,271,0,2
55535,2014/03/31,2012/03/31,466,3,0.784073604,2364,466,3,0
55536,2014/03/31,2013/02/14,400,2,0.7880102040000001,2352,400,2,0
55537,2014/03/31,2010/06/12,440,2,0.7880102040000001,2352,440,2,0
55538,2014/03/31,2008/12/15,689,4,0.8,2316,689,4,0
55539,2014/03/31,2011/11/03,351,2,0.8637762240000001,2145,351,1,1
55540,2014/03/31,2012/11/12,187,2,0.91,2036,187,0,2
55541,2014/03/31,2013/01/02,339,2,0.75,2470,339,0,2
55542,2014/03/31,2008/05/13,546,3,0.5166666670000001,3585,546,3,0
55543,2014/03/31,2006/10/20,292,3,0.446477821,4148,292,1,2
55544,2014/03/31,2012/04/30,288,5,0.692528048,2674,288,4,1
55545,2014/03/31,2012/02/01,128,3,0.5338812,3468,128,2,1
55546,2014/03/31,2011/04/08,529,2,0.794976385,2329,529,2,0
55547,2014/03/31,2011/10/21,210,4,0.396321987,4671,210,3,1
55548,2014/03/31,2012/09/16,14,2,0.64,2892,14,1,1
55549,2014/03/31,2010/07/20,503,2,0.7,2644,503,2,0
55550,2014/03/31,2013/03/01,140,3,0.801897747,2308,140,1,2
55551,2014/03/31,2013/02/11,349,2,1.0,1850,349,1,1
55552,2014/03/31,2012/05/01,492,2,1.0,1850,492,2,0
55553,2014/03/31,2012/05/01,540,2,1.0,1850,540,2,0
55554,2014/03/31,2013/02/05,241,2,0.786741812,2351,241,1,1
55555,2014/03/31,2012/12/27,460,2,0.45,4110,460,2,0
55556,2014/03/31,2008/12/31,122,2,0.575247278,3215,122,0,2
55557,2014/03/31,2009/06/06,241,5,0.5955136879999999,3105,241,2,3
55558,2014/03/31,2012/03/27,289,5,0.413380282,4473,289,2,3
55559,2014/03/31,2011/03/10,299,4,0.730818182,2530,299,0,4
55560,2014/03/31,2011/10/15,709,2,0.8,2311,709,2,0
55561,2014/03/31,2011/02/21,296,3,0.943644717,1959,296,1,2
55562,2014/03/31,2005/02/24,200,3,0.807884615,2288,200,2,1
55563,2014/03/31,2012/01/30,7,4,0.815,2268,7,1,3
55564,2014/03/31,2011/12/16,145,2,1.168198483,1582,145,1,1
55565,2014/03/31,2012/08/20,583,2,0.431171255,4286,583,2,0
55566,2014/03/31,2007/07/24,161,3,0.906771344,2038,161,0,3
55567,2014/03/31,2012/09/19,18,4,0.402741935,4588,18,0,4
55568,2014/03/31,2011/10/29,215,2,0.545,3390,215,1,1
55569,2014/03/31,2011/07/29,588,2,0.64571828,2861,588,2,0
55570,2014/03/31,2010/01/07,11,3,0.676666667,2730,11,2,1
55571,2014/03/31,2011/07/25,23,5,0.638,2895,23,1,4
55572,2014/03/31,2011/11/25,21,3,0.716666667,2577,21,1,2
55573,2014/03/31,2008/03/17,267,2,0.703704268,2624,267,1,1
55574,2014/03/31,2012/07/13,488,4,0.707142857,2611,488,4,0
55575,2014/03/31,2007/08/13,128,5,0.388866891,4748,128,3,2
55576,2014/03/31,2011/09/07,2,2,0.7763961309999999,2378,2,0,2
55577,2014/03/31,2008/07/31,222,5,0.49262877,3747,222,0,5
55578,2014/03/31,2012/08/09,31,2,0.700432638,2635,31,1,1
55579,2014/03/31,2011/04/03,33,2,0.645985299,2857,33,1,1
55580,2014/03/31,2012/05/31,71,3,0.608637863,3032,71,2,1
55581,2014/03/31,2008/01/04,393,3,0.7,2636,393,3,0
55582,2014/03/31,2006/12/08,131,2,0.37,4986,131,1,1
55583,2014/03/31,2006/09/05,104,2,0.523053587,3527,104,0,2
55584,2014/03/31,2011/05/30,230,2,0.655776751,2813,230,1,1
55585,2014/03/31,2006/09/07,219,3,0.591622835,3118,219,0,3
55586,2014/03/31,2011/01/13,355,2,0.6,3074,355,1,1
55587,2014/03/31,2012/10/15,179,3,0.288240075,6398,179,2,1
55588,2014/03/31,2009/04/07,512,4,0.437541528,4214,512,4,0
55589,2014/03/31,2009/10/25,222,2,0.594566269,3101,222,1,1
55590,2014/03/31,2010/02/15,672,3,0.51612542,3572,672,3,0
55591,2014/03/31,2008/04/12,84,3,0.783143585,2354,84,2,1
55592,2014/03/31,2009/07/02,441,3,0.548304581,3362,441,3,0
55593,2014/03/31,2011/08/01,224,3,0.946666667,1947,224,1,2
55594,2014/03/31,2011/05/24,132,2,0.8726988640000001,2112,132,0,2
55595,2014/03/31,2008/11/23,318,3,0.476720124,3866,318,0,3
55596,2014/03/31,2012/07/10,224,2,0.34,5420,224,0,2
55597,2014/03/31,2007/11/24,457,2,0.7297425740000001,2525,457,2,0
55598,2014/03/31,2008/01/14,457,2,0.7297425740000001,2525,457,2,0
55599,2014/03/31,2010/08/13,198,2,0.535,3444,198,0,2
55600,2014/03/31,2006/12/21,125,4,0.39,4724,125,0,4
55601,2014/03/31,2011/03/31,72,3,0.578599246,3184,72,1,2
55602,2014/03/31,2007/09/13,106,3,0.8985658540000001,2050,106,0,3
55603,2014/03/31,2006/03/13,165,3,0.726062278,2537,165,2,1
55604,2014/03/31,2008/03/29,387,2,1.5,1228,387,2,0
55605,2014/03/31,2009/06/30,2,4,0.7675,2400,2,1,3
55606,2014/03/31,2010/03/30,15,4,0.605,3044,15,1,3
55607,2014/03/31,2012/11/20,82,2,0.784897698,2346,82,0,2
55608,2014/03/31,2011/08/15,68,2,0.615,2994,68,1,1
55609,2014/03/31,2012/10/21,379,2,0.7003042979999999,2629,379,2,0
55610,2014/03/31,2012/02/13,52,4,1.025,1796,52,0,4
55611,2014/03/31,2008/02/05,145,3,0.797893368,2307,145,0,3
55612,2014/03/31,2009/08/23,107,2,0.5371453589999999,3426,107,1,1
55613,2014/03/31,2011/05/06,454,3,0.7228004709999999,2546,454,3,0
55614,2014/03/31,2010/08/02,481,2,0.870070922,2115,481,2,0
55615,2014/03/31,2010/07/31,290,3,0.850651872,2163,290,2,1
55616,2014/03/31,2011/10/21,87,3,0.701540809,2622,87,1,2
55617,2014/03/31,2012/04/16,716,2,0.890319458,2066,716,2,0
55618,2014/03/31,2013/03/01,182,2,0.807020623,2279,182,1,1
55619,2014/03/31,2011/08/22,63,2,0.618654105,2972,63,0,2
55620,2014/03/31,2012/12/30,447,3,0.656571429,2800,447,3,0
55621,2014/03/31,2008/08/17,592,3,0.5123745820000001,3588,592,3,0
55622,2014/03/31,2009/04/30,368,2,0.7318272290000001,2512,368,2,0
55623,2014/03/31,2007/04/18,26,3,0.9060276,2029,26,1,2
55624,2014/03/31,2008/02/16,28,2,0.91,2020,28,0,2
55625,2014/03/31,2007/04/19,252,2,0.91,2020,252,0,2
55626,2014/03/31,2012/09/08,389,2,0.6421208939999999,2862,389,2,0
55627,2014/03/31,2012/10/02,8,2,0.83,2214,8,0,2
55628,2014/03/31,2012/04/06,109,2,0.758390425,2423,109,1,1
55629,2014/03/31,2006/03/30,85,3,0.550755396,3336,85,1,2
55630,2014/03/31,2011/02/07,207,3,0.582091255,3156,207,1,2
55631,2014/03/31,2011/03/22,533,3,0.8240915209999999,2229,533,3,0
55632,2014/03/31,2007/08/19,675,2,1.4,1312,675,2,0
55633,2014/03/31,2008/07/06,47,2,0.441377073,4161,47,0,2
55634,2014/03/31,2009/09/12,490,3,0.530583646,3461,490,3,0
55635,2014/03/31,2006/05/24,99,2,0.626766815,2929,99,0,2
55636,2014/03/31,2012/11/08,339,3,0.474534643,3868,339,2,1
55637,2014/03/31,2012/04/24,702,2,0.8608818009999999,2132,702,2,0
55638,2014/03/31,2009/07/23,123,3,0.561763085,3267,123,1,2
55639,2014/03/31,2011/10/10,300,5,0.512126709,3583,300,3,2
55640,2014/03/31,2007/11/18,67,2,0.7911297970000001,2319,67,0,2
55641,2014/03/31,2011/05/26,277,3,0.54293282,3379,277,2,1
55642,2014/03/31,2011/06/05,634,2,0.85,2158,634,2,0
55643,2014/03/31,2011/10/06,322,4,0.425,4316,322,2,2
55644,2014/03/31,2006/03/01,714,2,0.85,2158,714,2,0
55645,2014/03/31,2005/08/27,418,3,0.676364307,2712,418,3,0
55646,2014/03/31,2008/11/01,9,2,0.655,2800,9,0,2
55647,2014/03/31,2012/03/09,13,3,0.544950966,3365,13,2,1
55648,2014/03/31,2011/02/01,530,2,0.5,3667,530,2,0
55649,2014/03/31,2007/04/11,420,3,0.7,2619,420,3,0
55650,2014/03/31,2012/03/30,720,3,0.4,4583,720,3,0
55651,2014/03/31,2009/08/21,662,3,0.7253858329999999,2527,662,3,0
55652,2014/03/31,2013/03/15,289,3,0.546680585,3353,289,2,1
55653,2014/03/31,2008/05/24,674,2,1.0,1833,674,2,0
55654,2014/03/31,2011/12/10,297,2,0.7445044679999999,2462,297,1,1
55655,2014/03/31,2009/07/13,90,2,0.372929807,4915,90,0,2
55656,2014/03/31,2012/07/25,214,3,0.353333333,5187,214,1,2
55657,2014/03/31,2012/06/24,24,2,0.841855765,2177,24,1,1
55658,2014/03/31,2013/01/25,148,4,0.8138055059999999,2252,148,1,3
55659,2014/03/31,2013/03/15,69,2,0.7234938809999999,2533,69,0,2
55660,2014/03/31,2012/04/23,694,2,0.596355353,3073,694,2,0
55661,2014/03/31,2008/11/18,137,2,0.4093521,4476,137,0,2
55662,2014/03/31,2010/07/29,80,2,0.637737557,2873,80,1,1
55663,2014/03/31,2008/03/20,195,4,0.421098598,4351,195,2,2
55664,2014/03/31,2011/01/28,161,3,0.82109368,2231,161,2,1
55665,2014/03/31,2012/08/15,517,2,0.65115535,2813,517,2,0
55666,2014/03/31,2011/11/09,199,2,0.516834086,3544,199,0,2
55667,2014/03/31,2012/12/26,371,2,0.8898931000000001,2058,371,2,0
55668,2014/03/31,2012/04/19,292,3,0.736637168,2486,292,2,1
55669,2014/03/31,2011/01/15,717,2,0.625,2930,717,2,0
55670,2014/03/31,2008/03/22,641,2,0.7,2616,641,2,0
55671,2014/03/31,2005/09/22,312,2,0.7,2616,312,1,1
55672,2014/03/31,2011/11/29,590,2,0.6,3052,590,2,0
55673,2014/03/31,2010/02/22,360,2,0.7,2616,360,0,2
55674,2014/03/31,2013/01/28,426,2,0.7,2616,426,2,0
55675,2014/03/31,2012/02/22,424,2,0.7,2616,424,2,0
55676,2014/03/31,2006/12/15,508,2,0.7,2616,508,2,0
55677,2014/03/31,2012/03/14,683,2,0.7,2616,683,2,0
55678,2014/03/31,2012/12/19,466,3,0.726299088,2521,466,3,0
55679,2014/03/31,2012/09/16,563,2,0.756257745,2421,563,2,0
55680,2014/03/31,2005/08/18,10,3,0.653340471,2802,10,0,3
55681,2014/03/31,2012/07/24,592,2,0.9,2034,592,2,0
55682,2014/03/31,2005/07/05,173,2,0.64343761,2845,173,1,1
55683,2014/03/31,2012/02/10,4,2,1.41,1298,4,0,2
55684,2014/03/31,2011/11/07,250,3,1.123327195,1629,250,2,1
55685,2014/03/31,2007/12/10,320,2,0.647029703,2828,320,1,1
55686,2014/03/31,2011/01/08,444,4,0.6208856460000001,2947,444,4,0
55687,2014/03/31,2012/10/12,209,2,0.975808,1875,209,1,1
55688,2014/03/31,2011/12/12,175,2,0.465,3934,175,0,2
55689,2014/03/31,2011/11/08,584,2,0.890891378,2053,584,2,0
55690,2014/03/31,2007/10/19,36,2,0.716123727,2554,36,0,2
55691,2014/03/31,2013/01/04,450,2,0.8,2286,450,2,0
55692,2014/03/31,2012/04/20,651,2,0.8,2286,651,2,0
55693,2014/03/31,2012/07/27,607,2,0.8,2286,607,2,0
55694,2014/03/31,2012/03/07,69,2,0.905,2020,69,0,2
55695,2014/03/31,2008/11/17,61,2,0.905,2020,61,0,2
55696,2014/03/31,2011/03/14,107,2,0.4,4570,107,0,2
55697,2014/03/31,2011/12/12,580,2,0.4,4570,580,2,0
55698,2014/03/31,2011/10/18,48,4,0.405423691,4508,48,0,4
55699,2014/03/31,2013/01/11,235,2,0.8061932070000001,2267,235,0,2
55700,2014/03/31,2012/09/27,545,2,0.8130841120000001,2247,545,2,0
55701,2014/03/31,2013/01/09,417,2,0.517214043,3532,417,2,0
55702,2014/03/31,2009/02/28,163,2,0.5301160770000001,3446,163,0,2
55703,2014/03/31,2007/07/20,29,2,0.679508929,2688,29,0,2
55704,2014/03/31,2010/06/04,292,2,0.7008867559999999,2605,292,0,2
55705,2014/03/31,2012/11/02,280,2,0.617241379,2958,280,0,2
55706,2014/03/31,2006/03/14,5,3,0.607762983,3004,5,0,3
55707,2014/03/31,2013/01/08,401,2,0.427100398,4273,401,2,0
55708,2014/03/31,2013/02/28,258,4,0.785865633,2322,258,0,4
55709,2014/03/31,2012/11/07,508,3,0.587681159,3105,508,3,0
55710,2014/03/31,2013/01/06,286,3,0.601235585,3035,286,2,1
55711,2014/03/31,2011/08/23,224,3,0.4240585770000001,4302,224,2,1
55712,2014/03/31,2010/01/13,12,2,0.805,2266,12,0,2
55713,2014/03/31,2012/11/13,36,2,0.580828025,3140,36,0,2
55714,2014/03/31,2009/06/26,397,2,0.835586618,2182,397,2,0
55715,2014/03/31,2012/03/04,229,2,0.733071974,2487,229,1,1
55716,2014/03/31,2009/07/01,120,4,0.582444871,3129,120,2,2
55717,2014/03/31,2012/07/17,574,3,0.629195442,2896,574,3,0
55718,2014/03/31,2009/11/05,433,2,0.608347245,2995,433,2,0
55719,2014/03/31,2012/04/24,338,2,0.72297619,2520,338,1,1
55720,2014/03/31,2012/10/30,139,2,0.67,2719,139,0,2
55721,2014/03/31,2011/09/30,347,3,0.489572696,3721,347,1,2
55722,2014/03/31,2011/05/14,541,2,0.6957792209999999,2618,541,2,0
55723,2014/03/31,2008/11/05,372,2,0.85,2143,372,2,0
55724,2014/03/31,2011/08/02,672,2,0.378218439,4816,672,2,0
55725,2014/03/31,2011/08/08,442,3,0.590723321,3083,442,3,0
55726,2014/03/31,2012/04/21,10,3,0.326133596,5584,10,0,3
55727,2014/03/31,2013/03/05,106,2,0.613973019,2965,106,1,1
55728,2014/03/31,2007/03/05,191,2,0.8546244129999999,2130,191,0,2
55729,2014/03/31,2007/03/11,643,2,1.0,1820,643,2,0
55730,2014/03/31,2007/06/12,324,2,0.65,2800,324,0,2
55731,2014/03/31,2011/10/19,559,3,0.487085118,3736,559,3,0
55732,2014/03/31,2012/02/07,463,2,0.75,2426,463,2,0
55733,2014/03/31,2008/01/04,7,2,0.55,3308,7,0,2
55734,2014/03/31,2005/09/09,377,3,0.65,2799,377,3,0
55735,2014/03/31,2005/07/31,673,2,0.985907859,1845,673,2,0
55736,2014/03/31,2005/10/22,68,2,0.654758819,2778,68,0,2
55737,2014/03/31,2013/03/15,243,2,0.67,2714,243,0,2
55738,2014/03/31,2011/05/08,248,3,0.7566666670000001,2403,248,2,1
55739,2014/03/31,2011/01/26,502,3,0.6,3030,502,3,0
55740,2014/03/31,2006/01/24,8,4,0.3825,4752,8,3,1
55741,2014/03/31,2009/07/23,446,2,0.700887003,2593,446,2,0
55742,2014/03/31,2010/11/19,33,3,0.586049661,3101,33,0,3
55743,2014/03/31,2007/06/20,383,3,0.933333333,1947,383,3,0
55744,2014/03/31,2011/10/30,152,2,0.985957678,1843,152,1,1
55745,2014/03/31,2009/11/03,6,2,0.34,5344,6,0,2
55746,2014/03/31,2011/05/02,677,2,0.75,2422,677,2,0
55747,2014/03/31,2012/05/06,695,2,0.75,2422,695,2,0
55748,2014/03/31,2011/08/09,348,4,0.525108413,3459,348,3,1
55749,2014/03/31,2010/02/24,373,3,0.5360979929999999,3388,373,3,0
55750,2014/03/31,2005/03/22,389,4,1.0,1816,389,4,0
55751,2014/03/31,2008/10/31,358,4,0.35712881,5085,358,2,2
55752,2014/03/31,2009/08/21,201,2,0.7191564359999999,2525,201,0,2
55753,2014/03/31,2008/10/19,360,2,0.7543415040000001,2407,360,1,1
55754,2014/03/31,2012/09/02,123,3,0.33358442,5443,123,1,2
55755,2014/03/31,2006/04/09,83,2,0.67,2710,83,0,2
55756,2014/03/31,2007/12/28,80,2,0.67,2710,80,0,2
55757,2014/03/31,2012/12/01,119,3,0.572541785,3171,119,0,3
55758,2014/03/31,2011/06/07,309,3,0.540193452,3360,309,1,2
55759,2014/03/31,2006/02/22,706,2,0.775,2342,706,2,0
55760,2014/03/31,2011/03/10,366,2,0.70506993,2574,366,1,1
55761,2014/03/31,2008/05/31,411,2,0.95,1910,411,2,0
55762,2014/03/31,2006/02/18,346,2,0.8049689440000001,2254,346,0,2
55763,2014/03/31,2012/08/25,251,2,0.8590625,2112,251,1,1
55764,2014/03/31,2012/01/08,301,3,0.343740053,5278,301,2,1
55765,2014/03/31,2010/11/01,89,2,0.731532258,2480,89,0,2
55766,2014/03/31,2012/12/08,90,3,0.766832981,2365,90,1,2
55767,2014/03/31,2005/12/03,281,2,0.923177189,1964,281,1,1
55768,2014/03/31,2012/02/27,115,2,0.597971636,3032,115,1,1
55769,2014/03/31,2008/04/04,178,3,0.813333333,2229,178,0,3
55770,2014/03/31,2006/04/20,154,3,0.431709931,4199,154,0,3
55771,2014/03/31,2011/09/14,220,2,0.686647727,2640,220,0,2
55772,2014/03/31,2009/04/09,440,3,0.862732032,2101,440,3,0
55773,2014/03/31,2012/12/09,134,3,0.6842129109999999,2649,134,0,3
55774,2014/03/31,2010/12/13,108,3,0.453997996,3992,108,0,3
55775,2014/03/31,2007/11/24,377,3,0.323740622,5598,377,3,0
55776,2014/03/31,2012/09/19,208,3,0.449018831,4036,208,2,1
55777,2014/03/31,2011/09/07,219,2,0.910145655,1991,219,0,2
55778,2014/03/31,2013/01/24,104,4,0.68,2664,104,1,3
55779,2014/03/31,2012/12/26,125,3,0.429265403,4220,125,0,3
55780,2014/03/31,2011/11/27,156,4,0.595,3044,156,2,2
55781,2014/03/31,2004/12/21,115,3,0.447897601,4043,115,0,3
55782,2014/03/31,2011/12/10,399,3,0.731932094,2474,399,3,0
55783,2014/03/31,2012/12/10,175,3,0.391896104,4620,175,2,1
55784,2014/03/31,2012/10/31,95,4,0.819918478,2208,95,1,3
55785,2014/03/31,2008/12/01,255,2,0.8061113590000001,2245,255,0,2
55786,2014/03/31,2011/09/11,555,2,0.757513604,2389,555,2,0
55787,2014/03/31,2005/11/22,50,4,0.573412548,3156,50,0,4
55788,2014/03/31,2010/08/01,56,2,0.621136286,2913,56,1,1
55789,2014/03/31,2005/12/20,587,2,0.902844311,2004,587,2,0
55790,2014/03/31,2011/03/18,306,2,0.902844311,2004,306,0,2
55791,2014/03/31,2009/10/29,43,3,0.494587206,3658,43,0,3
55792,2014/03/31,2011/10/16,20,2,0.613254237,2950,20,1,1
55793,2014/03/31,2013/01/01,334,2,1.5,1206,334,0,2
55794,2014/03/31,2012/11/23,433,3,0.655124955,2761,433,3,0
55795,2014/03/31,2009/11/23,102,2,0.660284775,2739,102,1,1
55796,2014/03/31,2012/09/04,540,2,0.825,2192,540,2,0
55797,2014/03/31,2013/03/27,345,2,0.8,2260,345,1,1
55798,2014/03/31,2012/11/18,490,2,0.8,2260,490,2,0
55799,2014/03/31,2009/03/13,679,2,0.8,2260,679,2,0
55800,2014/03/31,2013/01/24,247,2,0.625,2892,247,0,2
55801,2014/03/31,2013/01/18,277,2,0.749834025,2410,277,0,2
55802,2014/03/31,2010/11/23,49,2,0.65,2780,49,0,2
55803,2014/03/31,2012/10/12,529,3,1.0,1807,529,3,0
55804,2014/03/31,2011/10/16,38,3,0.965,1872,38,2,1
55805,2014/03/31,2012/07/14,375,2,0.8071045579999999,2238,375,2,0
55806,2014/03/31,2011/09/08,90,2,0.778186127,2321,90,0,2
55807,2014/03/31,2012/08/22,495,4,0.475849802,3795,495,4,0
55808,2014/03/31,2007/08/30,70,3,0.538434238,3353,70,2,1
55809,2014/03/31,2005/07/29,5,2,0.672533532,2684,5,0,2
55810,2014/03/31,2005/05/24,66,2,0.69,2616,66,0,2
55811,2014/03/31,2008/07/31,252,3,0.46,3924,252,2,1
55812,2014/03/31,2007/09/21,333,2,0.801154017,2253,333,0,2
55813,2014/03/31,2012/12/26,376,2,0.8694605009999999,2076,376,2,0
55814,2014/03/31,2009/10/09,296,2,0.845679475,2134,296,1,1
55815,2014/03/31,2006/08/09,378,6,0.737173203,2448,378,6,0
55816,2014/03/31,2013/01/14,415,2,0.8,2255,415,2,0
55817,2014/03/31,2012/10/05,541,2,0.908690176,1985,541,2,0
55818,2014/03/31,2012/10/18,529,2,0.943799058,1911,529,2,0
55819,2014/03/31,2011/10/06,517,4,0.541236495,3332,517,4,0
55820,2014/03/31,2012/11/02,464,4,0.4,4508,464,4,0
55821,2014/03/31,2012/01/04,322,2,0.35,5152,322,0,2
55822,2014/03/31,2012/09/20,554,2,0.75,2404,554,2,0
55823,2014/03/31,2012/10/04,61,7,0.47,3836,61,2,5
55824,2014/03/31,2012/05/15,98,3,0.70973622,2540,98,2,1
55825,2014/03/31,2012/08/11,595,2,0.6500540929999999,2773,595,2,0
55826,2014/03/31,2012/05/29,487,3,0.833333333,2163,487,3,0
55827,2014/03/31,2010/01/29,656,2,0.8,2253,656,2,0
55828,2014/03/31,2005/04/15,74,3,0.51,3534,74,2,1
55829,2014/03/31,2013/03/19,49,2,0.88,2048,49,0,2
55830,2014/03/31,2011/01/03,250,5,0.396,4550,250,4,1
55831,2014/03/31,2007/06/09,275,3,0.543034961,3318,275,1,2
55832,2014/03/31,2012/03/01,213,3,0.445744681,4042,213,0,3
55833,2014/03/31,2005/03/04,153,2,0.797828977,2257,153,0,2
55834,2014/03/31,2012/10/14,532,2,0.7,2572,532,2,0
55835,2014/03/31,2011/03/07,503,2,0.7,2572,503,2,0
55836,2014/03/31,2013/02/23,44,2,0.676823308,2660,44,0,2
55837,2014/03/31,2011/05/25,540,2,1.0,1800,540,2,0
55838,2014/03/31,2012/09/19,524,2,1.0,1800,524,2,0
55839,2014/03/31,2010/10/15,632,3,1.0,1800,632,3,0
55840,2014/03/31,2013/02/06,334,3,0.666666667,2700,334,2,1
55841,2014/03/31,2010/08/02,211,5,0.488981255,3681,211,1,4
55842,2014/03/31,2011/09/15,700,2,0.798845983,2253,700,2,0
55843,2014/03/31,2009/09/16,647,3,0.4,4499,647,3,0
55844,2014/03/31,2012/12/17,202,3,0.509326352,3533,202,1,2
55845,2014/03/31,2007/03/09,526,2,0.714331084,2519,526,2,0
55846,2014/03/31,2013/03/27,261,2,0.49091678,3665,261,1,1
55847,2014/03/31,2010/04/27,245,4,0.33,5452,245,0,4
55848,2014/03/31,2011/10/25,574,3,0.547141119,3288,574,3,0
55849,2014/03/31,2010/05/16,714,2,0.6731287429999999,2672,714,2,0
55850,2014/03/31,2011/07/19,225,3,0.3401059,5288,225,0,3
55851,2014/03/31,2007/11/01,217,3,0.587156383,3063,217,2,1
55852,2014/03/31,2011/07/05,559,4,0.775,2320,559,4,0
55853,2014/03/31,2009/01/14,603,2,1.0,1798,603,2,0
55854,2014/03/31,2010/08/02,670,3,0.381174475,4717,670,3,0
55855,2014/03/31,2011/11/30,42,4,0.6925,2596,42,3,1
55856,2014/03/31,2006/01/23,60,3,0.923333333,1947,60,0,3
55857,2014/03/31,2007/11/27,637,4,0.334605361,5372,637,4,0
55858,2014/03/31,2010/12/04,497,2,0.686330661,2619,497,2,0
55859,2014/03/31,2009/09/19,244,2,0.866859624,2073,244,1,1
55860,2014/03/31,2011/01/13,524,2,0.631938094,2843,524,2,0
55861,2014/03/31,2006/10/03,44,2,0.6402066999999999,2806,44,0,2
55862,2014/03/31,2011/10/31,539,2,0.4,4491,539,2,0
55863,2014/03/31,2013/03/01,397,2,0.6451149429999999,2784,397,2,0
55864,2014/03/31,2007/06/28,19,3,0.5033333329999999,3567,19,0,3
55865,2014/03/31,2008/09/15,189,5,0.466786271,3846,189,3,2
55866,2014/03/31,2005/02/28,164,4,0.446125746,4024,164,1,3
55867,2014/03/31,2008/05/22,557,2,0.666827637,2692,557,2,0
55868,2014/03/31,2012/02/21,347,3,0.625784519,2868,347,2,1
55869,2014/03/31,2013/03/15,254,3,0.877589242,2045,254,0,3
55870,2014/03/31,2012/08/31,150,3,0.492892063,3641,150,0,3
55871,2014/03/31,2011/02/17,254,2,0.785,2286,254,1,1
55872,2014/03/31,2011/03/17,339,3,0.484084165,3707,339,1,2
55873,2014/03/31,2012/02/17,244,4,0.689896194,2601,244,3,1
55874,2014/03/31,2011/10/18,516,3,0.8666666670000001,2070,516,3,0
55875,2014/03/31,2011/04/09,524,3,0.8666666670000001,2070,524,3,0
55876,2014/03/31,2012/10/04,416,3,0.8666666670000001,2070,416,3,0
55877,2014/03/31,2009/11/16,508,2,0.75,2392,508,2,0
55878,2014/03/31,2010/04/10,195,3,0.524836161,3418,195,0,3
55879,2014/03/31,2007/11/15,237,2,0.7470553940000001,2401,237,1,1
55880,2014/03/31,2006/12/05,21,2,0.835,2148,21,0,2
55881,2014/03/31,2013/01/02,44,3,0.35008588700000004,5123,44,2,1
55882,2014/03/31,2012/07/24,75,3,0.5426444779999999,3305,75,2,1
55883,2014/03/31,2009/12/30,49,3,0.657894351,2726,49,0,3
55884,2014/03/31,2004/11/01,561,3,0.400290179,4480,561,3,0
55885,2014/03/31,2007/09/06,118,3,0.6756970609999999,2654,118,2,1
55886,2014/03/31,2013/01/22,288,3,0.548031785,3272,288,0,3
55887,2014/03/31,2012/09/07,491,2,0.696620047,2574,491,2,0
55888,2014/03/31,2013/03/18,378,2,0.484752636,3699,378,2,0
55889,2014/03/31,2011/01/21,37,2,0.67332332,2663,37,0,2
55890,2014/03/31,2011/12/31,15,3,0.706469661,2538,15,0,3
55891,2014/03/31,2008/07/26,49,3,0.517520208,3464,49,0,3
55892,2014/03/31,2013/01/01,260,2,0.491257879,3649,260,1,1
55893,2014/03/31,2012/11/19,477,3,0.588090551,3048,477,3,0
55894,2014/03/31,2013/03/13,277,3,0.525790554,3409,277,2,1
55895,2014/03/31,2010/11/29,2,3,1.006921348,1780,2,1,2
55896,2014/03/31,2012/10/23,268,4,0.434781659,4122,268,2,2
55897,2014/03/31,2008/01/14,502,2,0.8,2240,502,2,0
55898,2014/03/31,2008/07/10,249,2,0.64,2800,249,1,1
55899,2014/03/31,2011/03/20,590,2,0.8,2240,590,2,0
55900,2014/03/31,2012/12/17,280,2,0.64,2800,280,0,2
55901,2014/03/31,2010/06/26,94,2,0.40875,4384,94,0,2
55902,2014/03/31,2012/08/28,153,2,0.717617141,2497,153,0,2
55903,2014/03/31,2010/12/13,383,3,0.372758477,4807,383,3,0
55904,2014/03/31,2008/02/08,195,2,0.838764045,2136,195,1,1
55905,2014/03/31,2013/02/23,300,2,0.441790382,4055,300,1,1
55906,2014/03/31,2007/06/01,251,2,0.96,1866,251,1,1
55907,2014/03/31,2011/01/15,194,3,0.92,1947,194,0,3
55908,2014/03/31,2005/09/07,33,4,0.5325929229999999,3363,33,0,4
55909,2014/03/31,2013/03/11,153,2,0.942093635,1901,153,0,2
55910,2014/03/31,2010/01/14,1,2,0.570152818,3141,1,1,1
55911,2014/03/31,2007/03/12,14,4,0.355297619,5040,14,1,3
55912,2014/03/31,2006/09/30,74,2,0.76,2356,74,0,2
55913,2014/03/31,2011/11/30,66,2,0.76,2356,66,0,2
55914,2014/03/31,2012/08/30,388,4,0.649401523,2757,388,4,0
55915,2014/03/31,2007/12/16,207,5,0.426533238,4197,207,3,2
55916,2014/03/31,2007/03/07,478,2,0.7202414490000001,2485,478,2,0
55917,2014/03/31,2008/02/08,507,3,0.549018405,3260,507,3,0
55918,2014/03/31,2013/01/30,123,3,0.6116473000000001,2926,123,1,2
55919,2014/03/31,2009/11/24,196,2,0.628290028,2848,196,0,2
55920,2014/03/31,2009/12/15,225,4,0.7725,2316,225,2,2
55921,2014/03/31,2012/09/17,280,2,0.547280514,3269,280,1,1
55922,2014/03/31,2013/03/03,53,3,0.474755839,3768,53,0,3
55923,2014/03/31,2013/03/20,265,2,0.5905744470000001,3029,265,1,1
55924,2014/03/31,2011/05/10,669,3,0.429174664,4168,669,3,0
55925,2014/03/31,2010/07/20,49,2,0.65,2752,49,0,2
55926,2014/03/31,2012/05/01,545,3,0.783333333,2283,545,3,0
55927,2014/03/31,2011/10/13,117,2,0.492606061,3630,117,0,2
55928,2014/03/31,2012/04/10,639,2,0.8,2235,639,2,0
55929,2014/03/31,2013/03/17,374,2,0.75,2384,374,2,0
55930,2014/03/31,2012/10/20,147,4,0.335010305,5337,147,0,4
55931,2014/03/31,2009/12/27,32,4,0.7813636359999999,2288,32,0,4
55932,2014/03/31,2012/07/12,106,2,0.58,3082,106,0,2
55933,2014/03/31,2011/09/04,428,2,0.625,2860,428,2,0
55934,2014/03/31,2007/08/12,37,2,0.519563953,3440,37,1,1
55935,2014/03/31,2011/04/11,324,4,0.324945455,5500,324,2,2
55936,2014/03/31,2008/10/05,89,2,0.7051104970000001,2534,89,0,2
55937,2014/03/31,2013/03/03,177,6,0.6216666670000001,2874,177,1,5
55938,2014/03/31,2012/08/12,168,2,0.537940379,3321,168,1,1
55939,2014/03/31,2008/02/20,11,2,0.43,4154,11,0,2
55940,2014/03/31,2008/01/13,350,2,0.590284204,3026,350,0,2
55941,2014/03/31,2011/04/29,410,3,0.367414112,4861,410,3,0
55942,2014/03/31,2013/01/31,240,2,0.8103266790000001,2204,240,0,2
55943,2014/03/31,2012/01/29,541,2,0.575,3106,541,2,0
55944,2014/03/31,2012/06/30,638,2,0.575,3106,638,2,0
55945,2014/03/31,2006/09/01,221,3,0.92,1941,221,0,3
55946,2014/03/31,2006/11/09,304,2,0.838356808,2130,304,1,1
55947,2014/03/31,2010/08/21,534,3,0.801436266,2228,534,3,0
55948,2014/03/31,2007/12/17,37,2,0.7116141890000001,2509,37,0,2
55949,2014/03/31,2012/02/20,497,2,0.611019849,2922,497,2,0
55950,2014/03/31,2007/04/04,191,3,0.392818482,4545,191,2,1
55951,2014/03/31,2010/08/29,459,3,1.0,1785,459,3,0
55952,2014/03/31,2009/12/19,207,3,0.812827869,2196,207,1,2
55953,2014/03/31,2011/12/02,295,2,0.779750983,2289,295,1,1
55954,2014/03/31,2010/10/25,480,5,0.55,3245,480,5,0
55955,2014/03/31,2007/08/06,37,3,0.916666667,1947,37,0,3
55956,2014/03/31,2007/05/20,558,3,0.916666667,1947,558,3,0
55957,2014/03/31,2006/09/05,259,2,0.7610490409999999,2345,259,1,1
55958,2014/03/31,2012/09/28,470,3,0.499607953,3571,470,3,0
55959,2014/03/31,2012/07/25,441,3,0.658302583,2710,441,3,0
55960,2014/03/31,2008/06/28,21,2,0.5166174339999999,3453,21,0,2
55961,2014/03/31,2011/06/26,34,3,0.7926133329999999,2250,34,2,1
55962,2014/03/31,2011/06/28,347,2,0.425,4196,347,0,2
55963,2014/03/31,2012/01/02,363,2,0.682172915,2614,363,1,1
55964,2014/03/31,2009/10/15,34,7,0.682857143,2611,34,4,3
55965,2014/03/31,2009/12/01,446,2,0.762901155,2337,446,2,0
55966,2014/03/31,2008/06/02,250,3,0.553333333,3222,250,1,2
55967,2014/03/31,2013/01/04,285,4,0.83,2148,285,1,3
55968,2014/03/31,2012/11/28,480,3,0.449042821,3970,480,3,0
55969,2014/03/31,2011/12/18,691,2,0.472468187,3772,691,2,0
55970,2014/03/31,2011/07/20,22,2,0.955,1866,22,1,1
55971,2014/03/31,2012/05/06,532,3,0.5,3564,532,3,0
55972,2014/03/31,2010/07/24,137,3,0.880795848,2023,137,0,3
55973,2014/03/31,2012/03/29,506,4,0.7375,2416,506,4,0
55974,2014/03/31,2012/11/21,179,9,0.7689771259999999,2317,179,2,7
55975,2014/03/31,2011/04/16,130,3,0.534696879,3332,130,1,2
55976,2014/03/31,2008/05/18,128,3,0.7827372579999999,2276,128,2,1
55977,2014/03/31,2008/04/11,215,2,0.735646427,2421,215,0,2
55978,2014/03/31,2009/05/27,27,7,0.438571429,4060,27,1,6
55979,2014/03/31,2006/02/26,217,3,0.678194286,2625,217,2,1
55980,2014/03/31,2012/04/13,716,2,0.5,3560,716,2,0
55981,2014/03/31,2013/01/21,82,2,0.6757479120000001,2634,82,0,2
55982,2014/03/31,2009/11/22,645,2,0.525,3390,645,2,0
55983,2014/03/31,2012/05/05,226,5,0.784,2270,226,0,5
55984,2014/03/31,2006/12/27,696,2,0.7,2542,696,2,0
55985,2014/03/31,2007/05/24,5,4,0.532420706,3342,5,0,4
55986,2014/03/31,2012/03/02,445,2,0.907190209,1961,445,2,0
55987,2014/03/31,2012/07/15,237,3,0.55870603,3184,237,2,1
55988,2014/03/31,2011/06/12,436,2,0.506939299,3509,436,2,0
55989,2014/03/31,2012/10/22,275,2,0.753997457,2359,275,1,1
55990,2014/03/31,2012/10/30,55,2,0.675952109,2631,55,1,1
55991,2014/03/31,2008/12/17,52,3,0.521786972,3408,52,0,3
55992,2014/03/31,2007/10/14,632,2,0.85,2092,632,2,0
55993,2014/03/31,2010/04/04,66,4,0.413601675,4298,66,3,1
55994,2014/03/31,2005/05/25,149,3,0.92,1932,149,0,3
55995,2014/03/31,2006/03/30,32,2,0.464785565,3824,32,0,2
55996,2014/03/31,2005/03/30,313,2,0.618052174,2875,313,0,2
55997,2014/03/31,2012/10/24,505,2,0.693501171,2562,505,2,0
55998,2014/03/31,2012/06/04,258,2,0.734497726,2419,258,0,2
55999,2014/03/31,2007/04/26,651,2,0.480438312,3696,651,2,0
56000,2014/03/31,2011/07/02,13,2,0.66829507,2657,13,0,2
56001,2014/03/31,2012/04/06,716,2,0.55,3228,716,2,0
56002,2014/03/31,2010/10/06,400,2,0.55,3228,400,2,0
56003,2014/03/31,2011/11/17,522,2,0.55,3228,522,2,0
56004,2014/03/31,2011/06/14,145,3,0.557690858,3183,145,0,3
56005,2014/03/31,2013/03/02,391,3,0.736820257,2409,391,3,0
56006,2014/03/31,2012/11/19,282,3,0.38854641,4568,282,1,2
56007,2014/03/31,2007/02/15,215,3,0.7626815640000001,2327,215,1,2
56008,2014/03/31,2012/11/01,20,3,0.625890653,2835,20,0,3
56009,2014/03/31,2012/02/21,372,3,0.655822551,2705,372,3,0
56010,2014/03/31,2010/09/21,494,2,1.0,1774,494,2,0
56011,2014/03/31,2008/05/24,398,2,1.0,1774,398,2,0
56012,2014/03/31,2012/09/18,560,2,1.0,1774,560,2,0
56013,2014/03/31,2013/01/03,8,3,0.8483692009999999,2091,8,0,3
56014,2014/03/31,2012/12/15,355,4,0.598431174,2964,355,2,2
56015,2014/03/31,2013/02/25,401,2,0.655208718,2707,401,2,0
56016,2014/03/31,2012/01/07,434,4,0.529402985,3350,434,4,0
56017,2014/03/31,2012/12/20,330,2,1.0,1773,330,1,1
56018,2014/03/31,2007/12/23,356,2,0.671731717,2639,356,0,2
56019,2014/03/31,2009/10/18,673,2,0.95,1866,673,2,0
56020,2014/03/31,2008/03/01,417,2,0.95,1866,417,2,0
56021,2014/03/31,2009/06/11,414,2,0.95,1866,414,2,0
56022,2014/03/31,2008/10/29,559,2,0.95,1866,559,2,0
56023,2014/03/31,2011/04/27,611,2,0.6901869159999999,2568,611,2,0
56024,2014/03/31,2009/08/04,170,3,0.638012959,2778,170,1,2
56025,2014/03/31,2011/10/16,179,4,0.667765637,2654,179,0,4
56026,2014/03/31,2007/05/23,577,3,0.55,3222,577,3,0
56027,2014/03/31,2012/05/10,223,2,0.49,3616,223,0,2
56028,2014/03/31,2013/01/16,241,2,0.629119318,2816,241,0,2
56029,2014/03/31,2013/03/29,279,2,0.74,2394,279,1,1
56030,2014/03/31,2008/10/28,276,3,0.7519142609999999,2356,276,2,1
56031,2014/03/31,2013/03/28,264,2,0.721364562,2455,264,0,2
56032,2014/03/31,2011/12/23,12,2,0.661962617,2675,12,1,1
56033,2014/03/31,2010/11/17,123,4,0.5775375079999999,3066,123,0,4
56034,2014/03/31,2012/11/03,56,2,0.64504918,2745,56,1,1
56035,2014/03/31,2007/02/02,22,2,0.485981334,3643,22,0,2
56036,2014/03/31,2011/01/01,48,2,0.57,3106,48,0,2
56037,2014/03/31,2006/10/02,133,3,0.483176856,3664,133,2,1
56038,2014/03/31,2009/10/30,364,4,0.326151437,5428,364,3,1
56039,2014/03/31,2010/07/29,350,2,0.45,3934,350,0,2
56040,2014/03/31,2007/01/29,453,3,0.837813535,2113,453,3,0
56041,2014/03/31,2012/03/16,621,2,0.45,3934,621,2,0
56042,2014/03/31,2010/11/29,227,2,0.45,3934,227,0,2
56043,2014/03/31,2011/04/23,229,2,0.45,3934,229,0,2
56044,2014/03/31,2012/10/01,543,2,0.5688303339999999,3112,543,2,0
56045,2014/03/31,2007/04/29,469,2,1.0,1770,469,2,0
56046,2014/03/31,2010/03/17,590,2,0.675,2622,590,2,0
56047,2014/03/31,2010/09/12,224,3,0.525169139,3370,224,2,1
56048,2014/03/31,2007/09/21,40,2,0.5785321999999999,3059,40,0,2
56049,2014/03/31,2008/05/24,273,2,0.468519989,3777,273,1,1
56050,2014/03/31,2008/12/19,38,3,0.337542923,5242,38,0,3
56051,2014/03/31,2012/10/27,128,5,0.521385205,3393,128,1,4
56052,2014/03/31,2008/05/08,59,2,0.896629498,1973,59,0,2
56053,2014/03/31,2012/09/06,451,3,0.783392383,2258,451,3,0
56054,2014/03/31,2011/09/14,49,2,0.651647015,2714,49,0,2
56055,2014/03/31,2013/02/06,248,5,0.6659999999999999,2655,248,0,5
56056,2014/03/31,2012/05/06,687,2,0.638800578,2768,687,2,0
56057,2014/03/31,2011/10/21,18,3,0.87141449,2029,18,1,2
56058,2014/03/31,2008/03/24,67,2,0.7799073670000001,2267,67,0,2
56059,2014/03/31,2012/10/28,255,3,0.6918512720000001,2555,255,2,1
56060,2014/03/31,2012/08/24,541,3,0.583333333,3030,541,3,0
56061,2014/03/31,2012/01/05,668,2,0.875,2020,668,2,0
56062,2014/03/31,2010/08/25,662,2,0.899796334,1964,662,2,0
56063,2014/03/31,2007/07/12,173,3,0.8658500729999999,2041,173,1,2
56064,2014/03/31,2008/11/29,588,6,0.775,2280,588,6,0
56065,2014/03/31,2012/11/18,210,2,0.735,2404,210,1,1
56066,2014/03/31,2013/01/26,97,2,0.735,2404,97,1,1
56067,2014/03/31,2010/07/08,154,2,0.67,2637,154,0,2
56068,2014/03/31,2009/07/08,8,2,0.81002751,2181,8,0,2
56069,2014/03/31,2007/01/07,22,2,0.647076923,2730,22,0,2
56070,2014/03/31,2012/06/01,57,4,0.3375,5232,57,2,2
56071,2014/03/31,2005/12/17,17,2,0.675,2616,17,0,2
56072,2014/03/31,2010/09/13,491,2,0.425,4154,491,2,0
56073,2014/03/31,2011/05/17,615,2,0.655609212,2692,615,2,0
56074,2014/03/31,2008/09/04,559,2,0.852875785,2069,559,2,0
56075,2014/03/31,2013/03/24,176,2,0.545256489,3236,176,0,2
56076,2014/03/31,2005/03/29,151,3,0.597628726,2952,151,0,3
56077,2014/03/31,2013/01/13,11,2,0.77,2291,11,0,2
56078,2014/03/31,2012/04/17,399,2,0.585980066,3010,399,2,0
56079,2014/03/31,2009/07/20,109,5,0.627580071,2810,109,0,5
56080,2014/03/31,2012/12/25,220,3,0.441929825,3990,220,0,3
56081,2014/03/31,2010/03/24,570,3,0.6857253990000001,2571,570,3,0
56082,2014/03/31,2007/06/28,407,4,0.703792415,2505,407,4,0
56083,2014/03/31,2012/01/02,307,2,1.243300423,1418,307,1,1
56084,2014/03/31,2012/10/13,425,3,0.326351852,5400,425,3,0
56085,2014/03/31,2007/01/17,107,3,0.384574422,4582,107,0,3
56086,2014/03/31,2008/10/10,226,2,0.3,5873,226,0,2
56087,2014/03/31,2010/01/05,90,3,0.7182551979999999,2453,90,2,1
56088,2014/03/31,2011/09/25,192,2,0.547482909,3218,192,0,2
56089,2014/03/31,2012/11/02,375,3,0.3559608,4949,375,3,0
56090,2014/03/31,2010/05/08,220,2,0.677025365,2602,220,0,2
56091,2014/03/31,2011/08/29,154,2,0.43239568,4074,154,0,2
56092,2014/03/31,2008/01/08,149,2,0.527404192,3340,149,1,1
56093,2014/03/31,2011/01/06,110,2,0.960720131,1833,110,1,1
56094,2014/03/31,2011/02/01,431,2,0.585211034,3009,431,2,0
56095,2014/03/31,2010/01/27,44,5,0.464,3795,44,2,3
56096,2014/03/31,2011/05/30,317,3,0.766166232,2298,317,0,3
56097,2014/03/31,2012/09/30,398,2,0.908462332,1938,398,2,0
56098,2014/03/31,2006/09/02,253,2,0.669410646,2630,253,1,1
56099,2014/03/31,2006/06/20,494,2,0.6,2934,494,2,0
56100,2014/03/31,2012/03/31,249,6,0.914018692,1926,249,5,1
56101,2014/03/31,2006/03/08,404,4,0.556688805,3162,404,4,0
56102,2014/03/31,2007/11/04,313,3,0.539607603,3262,313,0,3
56103,2014/03/31,2012/01/22,291,3,0.682999612,2577,291,2,1
56104,2014/03/31,2009/07/22,7,2,1.234186536,1426,7,1,1
56105,2014/03/31,2008/07/03,366,4,0.366080716,4807,366,3,1
56106,2014/03/31,2011/01/13,658,2,0.7409473679999999,2375,658,2,0
56107,2014/03/31,2011/11/18,235,4,0.480136426,3665,235,3,1
56108,2014/03/31,2011/01/09,124,2,0.823416004,2137,124,0,2
56109,2014/03/31,2012/10/06,540,2,0.779787234,2256,540,2,0
56110,2014/03/31,2006/05/29,207,6,0.535,3288,207,3,3
56111,2014/03/31,2012/08/14,357,2,0.721809602,2437,357,1,1
56112,2014/03/31,2009/03/15,21,3,0.604163518,2911,21,2,1
56113,2014/03/31,2008/01/10,701,2,0.6742331290000001,2608,701,2,0
56114,2014/03/31,2008/03/01,701,2,0.6742331290000001,2608,701,2,0
56115,2014/03/31,2011/02/22,23,2,0.720045045,2442,23,1,1
56116,2014/03/31,2012/05/19,649,3,0.4051036870000001,4340,649,3,0
56117,2014/03/31,2011/03/20,89,5,0.536,3280,89,0,5
56118,2014/03/31,2011/01/28,587,2,0.6,2930,587,2,0
56119,2014/03/31,2005/03/14,124,5,0.801641587,2193,124,2,3
56120,2014/03/31,2011/06/20,462,2,0.422434511,4161,462,2,0
56121,2014/03/31,2011/02/28,123,2,0.675,2604,123,0,2
56122,2014/03/31,2006/05/22,652,2,0.95,1850,652,2,0
56123,2014/03/31,2012/05/01,542,2,0.95,1850,542,2,0
56124,2014/03/31,2010/12/06,112,4,0.532070845,3303,112,2,2
56125,2014/03/31,2008/08/30,42,2,0.87,2020,42,0,2
56126,2014/03/31,2010/12/20,520,2,0.745840407,2356,520,2,0
56127,2014/03/31,2007/04/22,583,2,0.7426880809999999,2366,583,2,0
56128,2014/03/31,2010/02/14,496,2,0.45,3904,496,2,0
56129,2014/03/31,2010/04/01,190,2,0.45,3904,190,0,2
56130,2014/03/31,2011/06/04,36,4,0.358187194,4904,36,1,3
56131,2014/03/31,2010/11/19,158,2,0.59866394,2934,158,0,2
56132,2014/03/31,2007/09/07,191,2,0.683709615,2569,191,1,1
56133,2014/03/31,2012/11/20,120,2,0.51,3444,120,0,2
56134,2014/03/31,2008/12/17,144,2,0.895,1962,144,0,2
56135,2014/03/31,2010/07/29,145,3,0.802046597,2189,145,0,3
56136,2014/03/31,2012/05/07,225,3,0.35034524,5011,225,0,3
56137,2014/03/31,2013/02/27,32,2,0.595345997,2948,32,1,1
56138,2014/03/31,2012/07/13,182,3,0.761692708,2304,182,1,2
56139,2014/03/31,2012/08/15,518,3,0.7666666670000001,2289,518,3,0
56140,2014/03/31,2011/08/29,61,3,0.376666667,4659,61,2,1
56141,2014/03/31,2012/07/14,23,2,0.583123961,3009,23,0,2
56142,2014/03/31,2010/09/27,681,3,0.587608841,2986,681,3,0
56143,2014/03/31,2013/03/29,222,3,0.803333333,2184,222,1,2
56144,2014/03/31,2012/12/26,15,4,0.361591096,4852,15,2,2
56145,2014/03/31,2008/02/08,336,2,0.712012987,2464,336,1,1
56146,2014/03/31,2012/08/09,60,3,0.933672166,1879,60,2,1
56147,2014/03/31,2007/07/27,526,3,0.348163954,5038,526,3,0
56148,2014/03/31,2012/08/16,161,3,0.444699467,3943,161,2,1
56149,2014/03/31,2007/10/26,186,2,0.781868867,2242,186,1,1
56150,2014/03/31,2012/05/31,436,2,0.535563703,3273,436,2,0
56151,2014/03/31,2012/04/05,716,2,0.4,4382,716,2,0
56152,2014/03/31,2013/02/02,287,2,0.67,2616,287,1,1
56153,2014/03/31,2012/12/20,42,4,0.335,5232,42,2,2
56154,2014/03/31,2010/03/05,242,2,0.67,2616,242,0,2
56155,2014/03/31,2010/09/06,103,2,0.8039449540000001,2180,103,1,1
56156,2014/03/31,2008/08/30,43,3,0.559677419,3131,43,2,1
56157,2014/03/31,2012/11/23,491,2,0.55,3186,491,2,0
56158,2014/03/31,2010/04/08,359,4,0.675,2596,359,2,2
56159,2014/03/31,2012/12/08,213,2,0.458117647,3825,213,1,1
56160,2014/03/31,2012/06/01,608,2,0.510725736,3431,608,2,0
56161,2014/03/31,2008/05/26,723,2,0.3,5840,723,2,0
56162,2014/03/31,2011/01/13,14,3,0.4828224920000001,3628,14,1,2
56163,2014/03/31,2005/06/02,224,2,0.538364587,3253,224,1,1
56164,2014/03/31,2009/11/14,517,2,0.882241814,1985,517,2,0
56165,2014/03/31,2012/10/22,517,2,0.882241814,1985,517,2,0
56166,2014/03/31,2009/10/13,127,2,0.686152038,2552,127,1,1
56167,2014/03/31,2008/03/03,343,2,0.7469069970000001,2344,343,0,2
56168,2014/03/31,2012/10/30,239,3,0.521985689,3354,239,1,2
56169,2014/03/31,2013/01/01,298,2,0.532723676,3286,298,0,2
56170,2014/03/31,2011/09/26,369,2,0.9,1945,369,2,0
56171,2014/03/31,2009/01/29,454,3,0.7666666670000001,2283,454,3,0
56172,2014/03/31,2011/09/25,497,3,0.950678979,1841,497,3,0
56173,2014/03/31,2012/09/25,512,3,0.64180418,2727,512,3,0
56174,2014/03/31,2012/08/14,168,4,0.407654321,4293,168,0,4
56175,2014/03/31,2012/09/20,370,2,0.625,2800,370,2,0
56176,2014/03/31,2007/10/19,355,2,0.625,2800,355,1,1
56177,2014/03/31,2012/08/23,544,2,0.684892368,2555,544,2,0
56178,2014/03/31,2008/10/24,686,2,0.731048893,2393,686,2,0
56179,2014/03/31,2012/04/02,528,2,0.703822938,2485,528,2,0
56180,2014/03/31,2011/12/18,616,2,1.0,1749,616,2,0
56181,2014/03/31,2011/04/11,477,2,0.502846463,3478,477,2,0
56182,2014/03/31,2012/07/13,195,3,0.978076063,1788,195,2,1
56183,2014/03/31,2013/02/05,231,2,0.885,1976,231,0,2
56184,2014/03/31,2006/11/06,687,3,0.641614679,2725,687,3,0
56185,2014/03/31,2006/10/24,185,2,0.698481822,2503,185,0,2
56186,2014/03/31,2010/03/08,353,2,0.510245184,3426,353,1,1
56187,2014/03/31,2006/01/16,727,3,0.624062835,2801,727,3,0
56188,2014/03/31,2011/11/10,104,2,0.726049024,2407,104,1,1
56189,2014/03/31,2008/03/04,222,3,0.8680327870000001,2013,222,2,1
56190,2014/03/31,2007/11/20,199,2,0.8238095240000001,2121,199,1,1
56191,2014/03/31,2012/07/29,419,3,0.8,2184,419,3,0
56192,2014/03/31,2007/05/13,151,2,0.835,2092,151,0,2
56193,2014/03/31,2010/09/08,89,4,0.622480399,2806,89,2,2
56194,2014/03/31,2013/03/13,84,2,0.28,6238,84,0,2
56195,2014/03/31,2007/04/16,719,2,0.651230425,2682,719,2,0
56196,2014/03/31,2012/12/26,403,2,1.0,1746,403,2,0
56197,2014/03/31,2012/06/23,646,2,1.0,1746,646,2,0
56198,2014/03/31,2008/05/05,624,2,0.9,1940,624,2,0
56199,2014/03/31,2013/01/09,404,2,1.0,1746,404,2,0
56200,2014/03/31,2009/09/10,482,3,0.756239168,2308,482,3,0
56201,2014/03/31,2011/01/27,310,2,0.35,4986,310,0,2
56202,2014/03/31,2005/10/29,48,2,0.935,1866,48,1,1
56203,2014/03/31,2006/01/07,84,2,0.573706018,3041,84,1,1
56204,2014/03/31,2012/09/22,196,4,0.476935484,3658,196,0,4
56205,2014/03/31,2012/10/23,210,2,0.65,2684,210,0,2
56206,2014/03/31,2008/06/22,321,4,0.656833584,2656,321,3,1
56207,2014/03/31,2012/04/19,140,3,0.748909403,2329,140,2,1
56208,2014/03/31,2012/03/14,350,3,0.7319345359999999,2383,350,2,1
56209,2014/03/31,2011/12/22,615,2,0.93024,1875,615,2,0
56210,2014/03/31,2009/08/19,529,2,0.8,2180,529,2,0
56211,2014/03/31,2011/01/13,398,2,1.0,1744,398,2,0
56212,2014/03/31,2012/09/26,305,2,0.585560779,2978,305,1,1
56213,2014/03/31,2007/11/27,124,3,0.753765672,2313,124,0,3
56214,2014/03/31,2012/02/07,38,2,0.74,2356,38,0,2
56215,2014/03/31,2012/12/20,100,3,0.479340115,3637,100,1,2
56216,2014/03/31,2009/01/01,143,2,0.7034382570000001,2478,143,0,2
56217,2014/03/31,2008/02/04,582,2,0.675,2582,582,2,0
56218,2014/03/31,2009/12/09,193,2,0.97410844,1789,193,1,1
56219,2014/03/31,2010/04/26,152,2,0.80699861,2159,152,1,1
56220,2014/03/31,2013/02/09,284,2,0.614308886,2836,284,1,1
56221,2014/03/31,2011/03/21,128,4,0.381612267,4565,128,2,2
56222,2014/03/31,2008/02/28,69,4,0.796898445,2186,69,1,3
56223,2014/03/31,2009/04/24,537,2,0.632268603,2755,537,2,0
56224,2014/03/31,2005/11/02,352,2,0.684112333,2546,352,1,1
56225,2014/03/31,2011/09/24,33,2,0.521143028,3342,33,0,2
56226,2014/03/31,2011/03/20,163,2,0.7695978790000001,2263,163,1,1
56227,2014/03/31,2012/10/18,166,2,0.675,2580,166,1,1
56228,2014/03/31,2013/01/25,359,2,0.675,2580,359,1,1
56229,2014/03/31,2010/12/10,457,3,0.857881773,2030,457,3,0
56230,2014/03/31,2012/11/02,344,2,0.645441067,2698,344,1,1
56231,2014/03/31,2009/09/03,127,3,0.735337838,2368,127,1,2
56232,2014/03/31,2012/10/01,198,4,0.677455253,2570,198,3,1
56233,2014/03/31,2004/12/05,12,3,0.754358752,2308,12,0,3
56234,2014/03/31,2006/05/22,34,2,0.705445705,2468,34,0,2
56235,2014/03/31,2012/04/06,197,2,0.6436229210000001,2705,197,1,1
56236,2014/03/31,2013/02/06,400,3,0.7,2487,400,3,0
56237,2014/03/31,2007/09/17,395,4,0.322747497,5394,395,4,0
56238,2014/03/31,2012/07/09,87,3,0.6455860529999999,2696,87,1,2
56239,2014/03/31,2010/08/11,409,2,0.7,2486,409,2,0
56240,2014/03/31,2010/04/14,32,3,0.665460803,2615,32,0,3
56241,2014/03/31,2011/07/23,282,3,0.632975628,2749,282,2,1
56242,2014/03/31,2011/03/05,441,4,0.75,2320,441,4,0
56243,2014/03/31,2008/10/23,307,2,1.0,1740,307,0,2
56244,2014/03/31,2011/05/10,635,3,1.0,1740,635,3,0
56245,2014/03/31,2010/07/08,223,2,0.7031204529999999,2474,223,0,2
56246,2014/03/31,2013/01/30,115,6,0.556916427,3123,115,1,5
56247,2014/03/31,2009/03/14,275,3,0.824594595,2109,275,0,3
56248,2014/03/31,2011/10/16,158,3,0.355914859,4886,158,2,1
56249,2014/03/31,2011/09/20,488,2,0.84494655,2058,488,2,0
56250,2014/03/31,2011/08/01,166,4,0.39,4458,166,0,4
56251,2014/03/31,2009/04/16,172,4,0.49,3548,172,2,2
56252,2014/03/31,2013/01/26,187,2,0.6335459179999999,2744,187,1,1
56253,2014/03/31,2011/06/22,163,2,0.880141772,1975,163,1,1
56254,2014/03/31,2012/11/07,87,2,0.485,3584,87,0,2
56255,2014/03/31,2010/02/25,421,2,0.6360043910000001,2733,421,2,0
56256,2014/03/31,2012/06/24,156,2,0.498880597,3484,156,1,1
56257,2014/03/31,2013/01/08,153,3,0.530054895,3279,153,1,2
56258,2014/03/31,2013/01/01,146,2,0.92,1889,146,0,2
56259,2014/03/31,2012/05/16,645,4,0.593493852,2928,645,4,0
56260,2014/03/31,2011/02/24,482,2,0.941788618,1845,482,2,0
56261,2014/03/31,2010/11/25,330,2,0.625,2780,330,0,2
56262,2014/03/31,2010/03/05,537,2,0.873115578,1990,537,2,0
56263,2014/03/31,2008/04/10,83,2,0.86,2020,83,0,2
56264,2014/03/31,2012/06/04,621,3,0.8334932820000001,2084,621,3,0
56265,2014/03/31,2009/07/09,373,2,1.5,1158,373,2,0
56266,2014/03/31,2011/11/01,443,3,1.0,1737,443,3,0
56267,2014/03/31,2011/06/07,599,3,1.0,1737,599,3,0
56268,2014/03/31,2011/09/30,402,2,1.5,1158,402,2,0
56269,2014/03/31,2012/10/17,529,2,1.5,1158,529,2,0
56270,2014/03/31,2008/10/22,574,2,1.5,1158,574,2,0
56271,2014/03/31,2013/02/05,326,4,0.75,2316,326,1,3
56272,2014/03/31,2012/09/11,103,4,0.620786276,2798,103,2,2
56273,2014/03/31,2006/08/29,360,2,0.325,5344,360,1,1
56274,2014/03/31,2009/08/08,51,3,0.359933679,4825,51,2,1
56275,2014/03/31,2007/05/24,167,2,0.974545455,1782,167,1,1
56276,2014/03/31,2009/09/29,471,2,0.659263478,2634,471,2,0
56277,2014/03/31,2012/04/25,325,2,0.675,2572,325,1,1
56278,2014/03/31,2012/12/12,171,5,0.442736547,3921,171,2,3
56279,2014/03/31,2011/06/29,1,4,0.594258815,2921,1,3,1
56280,2014/03/31,2008/10/03,515,3,0.50008643,3471,515,3,0
56281,2014/03/31,2007/12/16,229,3,0.4029039,4308,229,1,2
56282,2014/03/31,2010/05/04,208,3,0.65,2670,208,2,1
56283,2014/03/31,2011/05/30,457,2,0.884505607,1962,457,2,0
56284,2014/03/31,2007/11/26,124,2,0.93,1866,124,0,2
56285,2014/03/31,2011/04/18,338,2,0.846852123,2049,338,1,1
56286,2014/03/31,2012/09/16,563,2,0.453846154,3822,563,2,0
56287,2014/03/31,2012/10/03,439,5,0.84,2065,439,5,0
56288,2014/03/31,2009/07/01,19,6,0.775,2238,19,4,2
56289,2014/03/31,2011/10/14,438,4,0.575,3016,438,4,0
56290,2014/03/31,2012/03/24,574,3,0.840931135,2062,574,3,0
56291,2014/03/31,2010/12/13,49,2,0.7694229920000001,2253,49,0,2
56292,2014/03/31,2011/01/13,330,2,0.9,1926,330,0,2
56293,2014/03/31,2010/08/13,224,2,0.66387208,2611,224,1,1
56294,2014/03/31,2010/04/12,75,2,0.6396162360000001,2710,75,0,2
56295,2014/03/31,2012/04/27,310,2,0.836842105,2071,310,1,1
56296,2014/03/31,2007/08/21,597,3,1.115186615,1554,597,3,0
56297,2014/03/31,2007/05/31,199,2,0.772894737,2242,199,0,2
56298,2014/03/31,2012/10/11,251,3,0.89,1947,251,1,2
56299,2014/03/31,2005/04/26,527,2,0.725,2390,527,2,0
56300,2014/03/31,2012/05/29,577,3,0.543273754,3189,577,3,0
56301,2014/03/31,2012/06/11,410,3,0.5,3465,410,3,0
56302,2014/03/31,2012/06/01,148,2,0.460361414,3763,148,1,1
56303,2014/03/31,2010/04/15,718,2,0.8782961459999999,1972,718,2,0
56304,2014/03/31,2010/11/17,41,2,0.67,2585,41,0,2
56305,2014/03/31,2008/06/30,657,3,0.7,2474,657,3,0
56306,2014/03/31,2011/08/09,148,2,0.634554782,2729,148,1,1
56307,2014/03/31,2007/12/17,63,2,0.63,2748,63,0,2
56308,2014/03/31,2011/11/26,126,3,0.376507177,4598,126,1,2
56309,2014/03/31,2009/10/07,23,2,0.613829787,2820,23,0,2
56310,2014/03/31,2011/02/28,16,2,0.44,3934,16,1,1
56311,2014/03/31,2013/03/08,276,2,0.389345332,4445,276,1,1
56312,2014/03/31,2012/07/10,508,3,0.65848877,2627,508,3,0
56313,2014/03/31,2012/08/23,72,3,0.8906488159999999,1942,72,0,3
56314,2014/03/31,2010/03/26,335,2,0.670511826,2579,335,1,1
56315,2014/03/31,2010/03/09,188,3,0.793852158,2178,188,1,2
56316,2014/03/31,2012/04/20,702,2,0.95,1820,702,2,0
56317,2014/03/31,2006/11/10,655,2,0.483771684,3574,655,2,0
56318,2014/03/31,2012/03/13,99,5,0.91,1900,99,1,4
56319,2014/03/31,2012/12/24,47,2,0.6256026060000001,2763,47,0,2
56320,2014/03/31,2012/07/16,582,3,0.960222222,1800,582,3,0
56321,2014/03/31,2011/06/21,137,2,0.8484977909999999,2037,137,1,1
56322,2014/03/31,2011/04/21,117,3,0.771357143,2240,117,1,2
56323,2014/03/31,2007/12/16,558,2,0.55,3141,558,2,0
56324,2014/03/31,2010/11/19,238,2,0.445,3882,238,1,1
56325,2014/03/31,2010/11/20,125,2,0.924748394,1868,125,0,2
56326,2014/03/31,2010/06/19,228,2,0.681879195,2533,228,0,2
56327,2014/03/31,2008/03/22,9,2,0.64393736,2682,9,1,1
56328,2014/03/31,2013/01/28,261,5,0.404137608,4273,261,1,4
56329,2014/03/31,2012/01/27,176,2,0.5498121020000001,3140,176,0,2
56330,2014/03/31,2009/10/30,192,3,0.533333333,3237,192,1,2
56331,2014/03/31,2010/07/11,96,3,0.8866666670000001,1947,96,0,3
56332,2014/03/31,2008/06/14,586,2,0.6480105110000001,2664,586,2,0
56333,2014/03/31,2012/04/07,523,2,0.7124638879999999,2423,523,2,0
56334,2014/03/31,2012/12/03,74,3,0.6166666670000001,2799,74,1,2
56335,2014/03/31,2012/10/28,482,3,0.904612159,1908,482,3,0
56336,2014/03/31,2006/10/13,8,2,0.645121495,2675,8,0,2
56337,2014/03/31,2012/11/02,516,2,0.7902885940000001,2183,516,2,0
56338,2014/03/31,2012/07/08,15,4,0.5716136510000001,3018,15,1,3
56339,2014/03/31,2008/06/05,372,2,0.746473388,2311,372,2,0
56340,2014/03/31,2013/01/14,443,2,0.948844884,1818,443,2,0
56341,2014/03/31,2008/05/02,143,3,0.661330521,2608,143,0,3
56342,2014/03/31,2009/08/19,422,2,0.513672922,3357,422,2,0
56343,2014/03/31,2012/04/12,650,2,0.738099315,2336,650,2,0
56344,2014/03/31,2007/06/18,147,3,0.781927438,2205,147,0,3
56345,2014/03/31,2011/05/26,696,2,0.725,2378,696,2,0
56346,2014/03/31,2011/01/04,364,2,0.684087302,2520,364,1,1
56347,2014/03/31,2010/06/07,142,3,0.667262873,2583,142,1,2
56348,2014/03/31,2012/02/21,705,2,0.445514478,3868,705,2,0
56349,2014/03/31,2011/07/16,377,2,0.4,4308,377,2,0
56350,2014/03/31,2011/08/19,505,3,0.483333333,3564,505,3,0
56351,2014/03/31,2012/12/26,104,3,0.618037316,2787,104,1,2
56352,2014/03/31,2006/09/29,299,2,0.832368294,2069,299,0,2
56353,2014/03/31,2012/06/13,569,2,0.6866626790000001,2508,569,2,0
56354,2014/03/31,2011/11/12,568,2,0.479026426,3595,568,2,0
56355,2014/03/31,2012/06/26,521,3,0.5547519329999999,3104,521,3,0
56356,2014/03/31,2008/09/14,276,2,0.715209805,2407,276,0,2
56357,2014/03/31,2010/12/13,57,3,0.739106913,2329,57,0,3
56358,2014/03/31,2012/08/19,248,2,0.663271676,2595,248,1,1
56359,2014/03/31,2006/08/26,276,3,0.979510529,1757,276,1,2
56360,2014/03/31,2010/05/17,98,2,0.62145901,2769,98,0,2
56361,2014/03/31,2012/01/28,125,4,0.36,4780,125,3,1
56362,2014/03/31,2008/05/18,160,3,0.6202667629999999,2774,160,1,2
56363,2014/03/31,2008/03/19,9,2,0.512499255,3357,9,0,2
56364,2014/03/31,2012/04/06,722,2,0.5,3440,722,2,0
56365,2014/03/31,2007/09/02,23,2,0.625,2752,23,0,2
56366,2014/03/31,2011/12/30,719,2,0.9,1911,719,2,0
56367,2014/03/31,2012/09/10,551,3,0.8833333329999999,1947,551,3,0
56368,2014/03/31,2011/10/25,356,5,0.53,3245,356,4,1
56369,2014/03/31,2012/12/14,264,3,0.8833333329999999,1947,264,1,2
56370,2014/03/31,2012/07/18,403,4,0.376819377,4562,403,4,0
56371,2014/03/31,2012/07/28,574,2,0.45,3820,574,2,0
56372,2014/03/31,2009/09/28,315,3,0.358199625,4799,315,2,1
56373,2014/03/31,2007/01/10,286,2,0.45,3820,286,0,2
56374,2014/03/31,2012/10/14,47,3,0.440535623,3902,47,1,2
56375,2014/03/31,2008/03/17,39,2,0.625032727,2750,39,0,2
56376,2014/03/31,2011/06/11,566,2,0.625,2750,566,2,0
56377,2014/03/31,2004/11/26,431,2,0.625,2750,431,2,0
56378,2014/03/31,2005/08/22,221,2,0.6248727270000001,2750,221,1,1
56379,2014/03/31,2012/10/27,290,4,0.478343541,3592,290,2,2
56380,2014/03/31,2011/09/20,317,2,0.83483965,2058,317,0,2
56381,2014/03/31,2011/01/14,669,2,1.0,1718,669,2,0
56382,2014/03/31,2011/01/14,118,2,0.44,3904,118,0,2
56383,2014/03/31,2013/01/15,44,2,0.46,3734,44,0,2
56384,2014/03/31,2006/10/01,39,4,0.560705191,3063,39,1,3
56385,2014/03/31,2011/06/27,49,2,0.914949387,1877,49,1,1
56386,2014/03/31,2005/09/06,618,4,0.713398421,2407,618,4,0
56387,2014/03/31,2012/11/09,508,2,0.85,2020,508,2,0
56388,2014/03/31,2008/03/17,316,2,0.85,2020,316,1,1
56389,2014/03/31,2008/11/19,586,2,0.85,2020,586,2,0
56390,2014/03/31,2010/02/10,310,2,0.85,2020,310,0,2
56391,2014/03/31,2008/06/13,519,2,0.5,3434,519,2,0
56392,2014/03/31,2006/12/15,469,4,0.425,4040,469,4,0
56393,2014/03/31,2010/05/17,580,2,0.85,2020,580,2,0
56394,2014/03/31,2012/06/08,642,3,0.416597913,4121,642,3,0
56395,2014/03/31,2006/11/12,187,2,0.92,1866,187,0,2
56396,2014/03/31,2008/08/25,209,2,0.92,1866,209,0,2
56397,2014/03/31,2012/02/16,190,2,0.92,1866,190,0,2
56398,2014/03/31,2006/11/01,154,2,0.92,1866,154,0,2
56399,2014/03/31,2006/11/03,218,2,0.92,1866,218,0,2
56400,2014/03/31,2007/05/08,205,2,0.92,1866,205,0,2
56401,2014/03/31,2011/02/22,283,2,0.92,1866,283,0,2
56402,2014/03/31,2013/03/22,272,2,0.784597806,2188,272,0,2
56403,2014/03/31,2011/10/01,222,2,0.572582583,2997,222,1,1
56404,2014/03/31,2008/08/25,670,2,0.4,4290,670,2,0
56405,2014/03/31,2008/03/14,16,3,0.782750912,2192,16,0,3
56406,2014/03/31,2006/07/05,666,2,0.875,1960,666,2,0
56407,2014/03/31,2012/10/16,128,2,0.5943812820000001,2885,128,0,2
56408,2014/03/31,2012/05/11,665,2,0.75,2286,665,2,0
56409,2014/03/31,2009/07/30,295,2,0.3,5715,295,0,2
56410,2014/03/31,2011/11/01,359,2,0.892347736,1921,359,1,1
56411,2014/03/31,2010/09/17,2,2,0.505,3394,2,0,2
56412,2014/03/31,2013/03/21,94,2,0.75735749,2263,94,1,1
56413,2014/03/31,2006/10/21,186,4,0.464310485,3691,186,2,2
56414,2014/03/31,2012/04/22,522,3,0.474024896,3615,522,3,0
56415,2014/03/31,2012/07/09,263,3,0.289162728,5924,263,2,1
56416,2014/03/31,2007/07/19,187,2,0.907985154,1886,187,0,2
56417,2014/03/31,2012/07/25,245,2,0.72,2378,245,0,2
56418,2014/03/31,2007/08/25,276,5,0.43441766,3941,276,3,2
56419,2014/03/31,2013/02/15,94,2,0.475183232,3602,94,0,2
56420,2014/03/31,2008/05/17,140,5,0.92,1860,140,0,5
56421,2014/03/31,2007/07/15,222,2,0.92,1860,222,0,2
56422,2014/03/31,2012/09/19,179,2,0.761455274,2247,179,1,1
56423,2014/03/31,2007/02/15,46,2,0.77,2222,46,0,2
56424,2014/03/31,2011/03/28,301,3,0.967911715,1767,301,2,1
56425,2014/03/31,2009/07/19,120,3,0.505378251,3384,120,2,1
56426,2014/03/31,2007/12/02,570,2,0.511714542,3342,570,2,0
56427,2014/03/31,2013/02/08,362,2,0.8264378929999999,2069,362,1,1
56428,2014/03/31,2009/08/24,220,2,0.67,2552,220,0,2
56429,2014/03/31,2009/06/17,582,2,0.937849698,1823,582,2,0
56430,2014/03/31,2011/12/22,79,2,0.604091873,2830,79,1,1
56431,2014/03/31,2012/08/07,549,2,0.926558266,1845,549,2,0
56432,2014/03/31,2011/03/08,571,5,0.8448838359999999,2023,571,5,0
56433,2014/03/31,2007/08/18,4,4,0.739467763,2311,4,2,2
56434,2014/03/31,2012/11/05,27,5,0.525927978,3249,27,4,1
56435,2014/03/31,2012/03/24,81,2,0.66508369,2569,81,1,1
56436,2014/03/31,2011/09/11,412,2,0.794604651,2150,412,2,0
56437,2014/03/31,2013/03/03,1,4,0.514864376,3318,1,0,4
56438,2014/03/31,2006/04/29,587,2,0.55,3106,587,2,0
56439,2014/03/31,2013/02/24,249,3,0.843173741,2026,249,2,1
56440,2014/03/31,2012/04/23,552,2,0.715626309,2387,552,2,0
56441,2014/03/31,2009/03/30,39,3,0.420004918,4067,39,1,2
56442,2014/03/31,2006/04/05,398,2,0.650209364,2627,398,2,0
56443,2014/03/31,2010/09/26,489,2,0.856090226,1995,489,2,0
56444,2014/03/31,2011/10/19,292,2,0.652633792,2616,292,1,1
56445,2014/03/31,2009/12/10,613,3,0.639105204,2671,613,3,0
56446,2014/03/31,2012/06/25,74,2,0.845,2020,74,1,1
56447,2014/03/31,2009/03/10,59,2,0.71,2404,59,0,2
56448,2014/03/31,2007/02/18,28,3,0.499613583,3416,28,0,3
56449,2014/03/31,2012/12/04,140,3,0.5844349320000001,2920,140,1,2
56450,2014/03/31,2009/03/14,64,2,0.59,2892,64,1,1
56451,2014/03/31,2011/11/10,375,3,0.8167065579999999,2089,375,3,0
56452,2014/03/31,2006/06/16,295,2,0.454616205,3752,295,1,1
56453,2014/03/31,2010/02/07,162,2,0.415,4110,162,1,1
56454,2014/03/31,2011/07/31,130,2,0.3,5684,130,0,2
56455,2014/03/31,2012/07/15,614,2,0.3,5684,614,2,0
56456,2014/03/31,2011/03/14,197,2,0.832945774,2047,197,0,2
56457,2014/03/31,2012/05/18,212,4,0.395,4316,212,3,1
56458,2014/03/31,2012/02/04,111,3,0.642033898,2655,111,2,1
56459,2014/03/31,2011/09/06,528,2,0.7,2435,528,2,0
56460,2014/03/31,2012/01/08,156,2,0.653242622,2609,156,0,2
56461,2014/03/31,2008/01/30,537,2,0.644104308,2646,537,2,0
56462,2014/03/31,2009/03/23,394,4,0.291632444,5844,394,4,0
56463,2014/03/31,2012/02/13,315,2,0.7910863509999999,2154,315,1,1
56464,2014/03/31,2008/07/06,458,2,0.6820056040000001,2498,458,2,0
56465,2014/03/31,2012/07/24,262,4,0.57,2988,262,2,2
56466,2014/03/31,2012/03/03,233,3,0.587478441,2899,233,2,1
56467,2014/03/31,2008/12/01,305,2,0.96,1774,305,0,2
56468,2014/03/31,2011/12/26,24,3,0.64,2661,24,0,3
56469,2014/03/31,2010/08/15,158,3,0.67572619,2520,158,0,3
56470,2014/03/31,2012/03/12,638,4,0.524976873,3243,638,4,0
56471,2014/03/31,2013/01/19,435,2,0.8,2128,435,2,0
56472,2014/03/31,2013/02/01,402,2,0.8668024440000001,1964,402,2,0
56473,2014/03/31,2008/05/05,655,2,0.815229885,2088,655,2,0
56474,2014/03/31,2009/07/29,507,2,0.5,3404,507,2,0
56475,2014/03/31,2012/08/31,151,2,0.7372790290000001,2308,151,1,1
56476,2014/03/31,2010/10/05,132,3,0.6982519490000001,2437,132,0,3
56477,2014/03/31,2007/09/10,728,2,0.627433628,2712,728,2,0
56478,2014/03/31,2012/10/09,525,2,0.333588235,5100,525,2,0
56479,2014/03/31,2011/12/04,68,3,0.362585251,4692,68,2,1
56480,2014/03/31,2008/03/29,436,2,0.779986245,2181,436,2,0
56481,2014/03/31,2012/06/20,108,8,0.44375,3832,108,4,4
56482,2014/03/31,2005/10/29,154,2,0.65,2616,154,0,2
56483,2014/03/31,2010/03/23,537,3,0.65,2616,537,3,0
56484,2014/03/31,2012/12/08,127,3,0.92012987,1848,127,1,2
56485,2014/03/31,2013/02/10,79,3,0.8733333329999999,1947,79,2,1
56486,2014/03/31,2010/05/19,123,2,0.751356606,2263,123,1,1
56487,2014/03/31,2011/10/14,315,2,0.662329568,2567,315,1,1
56488,2014/03/31,2009/12/18,349,3,0.671406003,2532,349,2,1
56489,2014/03/31,2013/02/12,56,3,0.588891199,2886,56,0,3
56490,2014/03/31,2007/09/07,53,2,0.75,2266,53,0,2
56491,2014/03/31,2012/12/25,191,6,0.483073642,3517,191,3,3
56492,2014/03/31,2013/03/19,65,2,0.455,3734,65,0,2
56493,2014/03/31,2012/02/22,712,2,0.817027417,2079,712,2,0
56494,2014/03/31,2012/05/08,458,4,0.4246,4000,458,4,0
56495,2014/03/31,2012/04/06,522,3,0.85,1998,522,3,0
56496,2014/03/31,2008/05/09,6,2,0.943952196,1799,6,0,2
56497,2014/03/31,2012/06/16,79,2,0.91,1866,79,0,2
56498,2014/03/31,2012/01/08,414,2,1.0,1698,414,2,0
56499,2014/03/31,2008/01/07,35,3,0.606407143,2800,35,1,2
56500,2014/03/31,2009/06/29,715,2,0.73153813,2321,715,2,0
56501,2014/03/31,2008/07/15,96,4,0.3675,4620,96,0,4
56502,2014/03/31,2010/12/08,144,2,0.932868132,1820,144,0,2
56503,2014/03/31,2012/07/25,65,4,0.3662524270000001,4635,65,1,3
56504,2014/03/31,2012/01/13,83,2,0.909180503,1867,83,0,2
56505,2014/03/31,2010/03/24,66,3,0.7457908609999999,2276,66,0,3
56506,2014/03/31,2008/06/18,24,3,0.747051056,2272,24,0,3
56507,2014/03/31,2007/03/05,100,3,0.695012285,2442,100,0,3
56508,2014/03/31,2011/10/05,198,3,0.939225235,1807,198,2,1
56509,2014/03/31,2007/03/25,508,3,0.5270496889999999,3220,508,3,0
56510,2014/03/31,2008/09/03,5,2,0.84,2020,5,0,2
56511,2014/03/31,2013/01/16,408,2,0.5,3393,408,2,0
56512,2014/03/31,2012/12/16,82,2,0.487525151,3479,82,1,1
56513,2014/03/31,2009/09/29,326,2,0.933379196,1817,326,0,2
56514,2014/03/31,2009/06/21,205,2,0.61,2780,205,0,2
56515,2014/03/31,2011/09/29,38,2,0.61,2780,38,1,1
56516,2014/03/31,2012/02/12,436,2,0.535781991,3165,436,2,0
56517,2014/03/31,2012/08/27,166,2,0.919094851,1845,166,1,1
56518,2014/03/31,2009/09/03,1,2,0.628510007,2698,1,0,2
56519,2014/03/31,2008/05/07,158,2,0.38,4462,158,0,2
56520,2014/03/31,2011/03/25,431,4,0.650326045,2607,431,4,0
56521,2014/03/31,2011/03/17,75,2,0.34,4986,75,0,2
56522,2014/03/31,2011/06/11,107,3,0.556666667,3045,107,1,2
56523,2014/03/31,2012/05/25,674,2,0.75,2260,674,2,0
56524,2014/03/31,2011/06/09,380,2,0.570639731,2970,380,2,0
56525,2014/03/31,2011/07/19,456,4,0.5875,2884,456,4,0
56526,2014/03/31,2012/12/10,70,4,0.385,4400,70,1,3
56527,2014/03/31,2009/10/09,122,3,0.87,1947,122,0,3
56528,2014/03/31,2008/02/06,63,2,0.625,2710,63,0,2
56529,2014/03/31,2010/07/13,313,3,0.35998937299999995,4705,313,1,2
56530,2014/03/31,2009/12/10,244,2,0.693023732,2444,244,1,1
56531,2014/03/31,2011/08/01,10,3,0.475091164,3565,10,0,3
56532,2014/03/31,2005/10/27,348,2,0.659283768,2569,348,1,1
56533,2014/03/31,2011/08/27,335,3,0.482080843,3513,335,2,1
56534,2014/03/31,2010/01/04,683,2,0.6018123670000001,2814,683,2,0
56535,2014/03/31,2006/06/06,47,5,0.618,2740,47,0,5
56536,2014/03/31,2006/08/19,314,2,0.3,5644,314,0,2
56537,2014/03/31,2013/02/02,41,3,0.513460722,3297,41,0,3
56538,2014/03/31,2012/08/07,600,2,0.818375242,2068,600,2,0
56539,2014/03/31,2013/03/16,159,2,0.7488362829999999,2260,159,1,1
56540,2014/03/31,2010/08/15,610,2,1.0,1692,610,2,0
56541,2014/03/31,2008/06/19,80,2,0.585,2892,80,1,1
56542,2014/03/31,2009/08/20,163,2,0.489849406,3453,163,1,1
56543,2014/03/31,2005/11/01,125,2,0.747432612,2263,125,0,2
56544,2014/03/31,2009/08/16,116,4,0.695182902,2433,116,2,2
56545,2014/03/31,2010/10/24,29,2,0.844805195,2002,29,1,1
56546,2014/03/31,2010/11/06,399,5,0.5446698870000001,3105,399,5,0
56547,2014/03/31,2013/02/09,411,3,0.723929795,2336,411,3,0
56548,2014/03/31,2009/09/15,127,2,0.614938182,2750,127,1,1
56549,2014/03/31,2009/10/27,682,2,0.475,3560,682,2,0
56550,2014/03/31,2011/04/10,101,2,0.49,3451,101,0,2
56551,2014/03/31,2011/07/01,256,2,0.7802584220000001,2167,256,0,2
56552,2014/03/31,2012/04/18,659,2,0.917417254,1843,659,2,0
56553,2014/03/31,2010/06/28,261,3,0.973333333,1737,261,2,1
56554,2014/03/31,2012/08/27,444,2,0.425,3978,444,2,0
56555,2014/03/31,2008/06/14,296,3,0.520153846,3250,296,0,3
56556,2014/03/31,2012/07/15,598,2,0.750288504,2253,598,2,0
56557,2014/03/31,2013/03/22,183,2,0.633870968,2666,183,0,2
56558,2014/03/31,2005/12/03,62,3,0.988163743,1710,62,1,2
56559,2014/03/31,2008/12/29,47,2,0.417823937,4044,47,1,1
56560,2014/03/31,2011/12/20,45,3,0.375882091,4495,45,0,3
56561,2014/03/31,2007/12/25,664,3,0.636308851,2655,664,3,0
56562,2014/03/31,2009/08/14,308,2,0.34364320600000003,4916,308,1,1
56563,2014/03/31,2008/02/16,351,2,0.55,3071,351,1,1
56564,2014/03/31,2009/04/27,77,3,0.458856289,3681,77,1,2
56565,2014/03/31,2009/10/30,237,3,0.528938303,3193,237,2,1
56566,2014/03/31,2013/01/01,297,2,0.538158062,3138,297,0,2
56567,2014/03/31,2010/03/28,5,3,0.972176166,1737,5,0,3
56568,2014/03/31,2007/07/04,194,3,0.7979962190000001,2116,194,1,2
56569,2014/03/31,2009/09/28,398,2,0.45,3752,398,2,0
56570,2014/03/31,2009/03/01,656,2,0.648099808,2605,656,2,0
56571,2014/03/31,2012/06/09,412,2,0.624315828,2704,412,2,0
56572,2014/03/31,2011/01/13,262,4,0.80578043,2095,262,2,2
56573,2014/03/31,2012/03/10,267,2,0.7491344870000001,2253,267,0,2
56574,2014/03/31,2012/04/06,726,2,0.7491344870000001,2253,726,2,0
56575,2014/03/31,2007/06/27,671,2,0.497435897,3393,671,2,0
56576,2014/03/31,2013/03/09,251,3,0.5553701879999999,3039,251,0,3
56577,2014/03/31,2012/11/02,324,3,0.25,6750,324,2,1
56578,2014/03/31,2007/01/19,1,2,0.614512017,2746,1,0,2
56579,2014/03/31,2013/02/04,48,3,0.499985185,3375,48,1,2
56580,2014/03/31,2011/06/06,49,3,0.8666666670000001,1947,49,1,2
56581,2014/03/31,2012/01/21,400,3,0.8666666670000001,1947,400,3,0
56582,2014/03/31,2009/08/03,553,3,0.708672827,2381,553,3,0
56583,2014/03/31,2007/06/28,492,2,0.717346939,2352,492,2,0
56584,2014/03/31,2010/11/12,87,3,0.34,4962,87,0,3
56585,2014/03/31,2011/04/24,156,2,0.77,2191,156,0,2
56586,2014/03/31,2011/09/05,360,2,0.531762295,3172,360,1,1
56587,2014/03/31,2012/06/09,662,2,0.4,4216,662,2,0
56588,2014/03/31,2013/01/26,27,3,0.47,3588,27,0,3
56589,2014/03/31,2007/09/28,722,2,0.495590829,3402,722,2,0
56590,2014/03/31,2013/01/04,38,2,0.694079868,2429,38,0,2
56591,2014/03/31,2011/09/15,609,2,0.634600904,2656,609,2,0
56592,2014/03/31,2012/03/25,572,2,0.95,1774,572,2,0
56593,2014/03/31,2011/09/27,353,2,0.95,1774,353,1,1
56594,2014/03/31,2007/03/30,27,2,0.681435503,2473,27,0,2
56595,2014/03/31,2011/08/20,57,2,0.647383788,2603,57,0,2
56596,2014/03/31,2010/11/15,170,6,0.68,2478,170,0,6
56597,2014/03/31,2012/08/25,215,3,0.643333333,2619,215,2,1
56598,2014/03/31,2011/07/19,149,3,0.643333333,2619,149,0,3
56599,2014/03/31,2008/05/22,7,2,0.8158401940000001,2065,7,0,2
56600,2014/03/31,2009/10/01,721,2,0.7252260009999999,2323,721,2,0
56601,2014/03/31,2009/12/26,165,4,0.645189583,2611,165,3,1
56602,2014/03/31,2012/04/30,67,3,0.377281075,4465,67,1,2
56603,2014/03/31,2011/11/09,216,2,0.91296477,1845,216,1,1
56604,2014/03/31,2008/06/24,37,3,0.305707025,5509,37,1,2
56605,2014/03/31,2012/02/27,540,3,0.7767066420000001,2168,540,3,0
56606,2014/03/31,2012/02/16,551,3,0.6877450979999999,2448,551,3,0
56607,2014/03/31,2012/05/25,591,3,0.524306638,3209,591,3,0
56608,2014/03/31,2012/01/22,104,4,0.450165908,3737,104,3,1
56609,2014/03/31,2006/10/24,167,3,0.5931593789999999,2836,167,1,2
56610,2014/03/31,2007/05/05,57,3,0.736666667,2283,57,0,3
56611,2014/03/31,2007/12/10,299,2,0.666484344,2523,299,1,1
56612,2014/03/31,2012/06/18,287,5,0.32682410100000003,5145,287,4,1
56613,2014/03/31,2011/08/22,322,2,0.540327763,3112,322,1,1
56614,2014/03/31,2013/03/23,201,3,0.8633333329999999,1947,201,1,2
56615,2014/03/31,2012/05/26,85,3,0.8633333329999999,1947,85,1,2
56616,2014/03/31,2012/04/13,696,2,0.460646753,3649,696,2,0
56617,2014/03/31,2009/12/17,248,2,0.4870356420000001,3451,248,1,1
56618,2014/03/31,2013/02/27,267,5,0.480045701,3501,267,4,1
56619,2014/03/31,2008/08/08,705,2,0.6,2801,705,2,0
56620,2014/03/31,2008/10/24,504,2,0.607775769,2765,504,2,0
56621,2014/03/31,2007/12/28,332,3,0.966858458,1738,332,1,2
56622,2014/03/31,2012/12/06,144,3,0.71259542,2358,144,2,1
56623,2014/03/31,2011/01/24,626,2,0.4,4200,626,2,0
56624,2014/03/31,2009/09/07,316,2,0.85,1976,316,0,2
56625,2014/03/31,2013/01/19,434,3,0.668078759,2514,434,3,0
56626,2014/03/31,2006/11/08,363,3,0.490078786,3427,363,2,1
56627,2014/03/31,2006/09/22,438,2,0.9,1866,438,2,0
56628,2014/03/31,2012/12/31,411,3,0.6,2799,411,3,0
56629,2014/03/31,2010/05/23,149,3,0.693232865,2422,149,2,1
56630,2014/03/31,2012/09/16,433,2,0.653014391,2571,433,2,0
56631,2014/03/31,2010/04/06,337,2,0.643464929,2609,337,1,1
56632,2014/03/31,2007/04/28,332,3,0.55606161,3019,332,2,1
56633,2014/03/31,2005/03/21,66,2,0.43,3904,66,0,2
56634,2014/03/31,2012/04/17,82,2,0.43,3904,82,0,2
56635,2014/03/31,2011/05/31,175,2,0.61,2752,175,0,2
56636,2014/03/31,2007/08/25,377,3,0.333518776,5033,377,3,0
56637,2014/03/31,2006/04/16,137,2,0.4,4196,137,0,2
56638,2014/03/31,2012/06/28,204,4,0.389681913,4307,204,2,2
56639,2014/03/31,2007/07/10,119,2,0.763196908,2199,119,0,2
56640,2014/03/31,2011/12/15,248,4,0.6425,2612,248,2,2
56641,2014/03/31,2012/12/12,35,4,0.48613847,3452,35,2,2
56642,2014/03/31,2006/07/22,559,2,0.476512354,3521,559,2,0
56643,2014/03/31,2012/05/11,689,2,0.9,1864,689,2,0
56644,2014/03/31,2005/09/15,533,3,0.8,2097,533,3,0
56645,2014/03/31,2012/05/15,239,3,0.678334007,2473,239,1,2
56646,2014/03/31,2012/11/12,332,3,0.666693164,2516,332,1,2
56647,2014/03/31,2008/07/02,368,3,0.433333333,3870,368,3,0
56648,2014/03/31,2012/07/10,6,3,0.510782821,3283,6,2,1
56649,2014/03/31,2007/11/20,72,3,0.507683924,3303,72,1,2
56650,2014/03/31,2012/12/16,1,2,0.295,5684,1,1,1
56651,2014/03/31,2011/07/12,177,2,0.96,1746,177,1,1
56652,2014/03/31,2013/03/12,48,2,0.6972046590000001,2404,48,0,2
56653,2014/03/31,2005/11/09,1,2,0.855,1960,1,1,1
56654,2014/03/31,2007/07/08,158,2,0.782638954,2141,158,1,1
56655,2014/03/31,2008/08/02,126,2,0.621290323,2697,126,0,2
56656,2014/03/31,2011/05/27,627,2,0.8,2094,627,2,0
56657,2014/03/31,2012/02/13,445,2,0.582070883,2878,445,2,0
56658,2014/03/31,2011/03/24,245,2,0.8,2094,245,1,1
56659,2014/03/31,2011/08/17,74,2,0.725,2310,74,0,2
56660,2014/03/31,2011/10/17,217,3,0.602854572,2778,217,2,1
56661,2014/03/31,2012/04/26,429,3,0.749910434,2233,429,3,0
56662,2014/03/31,2008/07/21,298,2,0.92,1820,298,0,2
56663,2014/03/31,2011/08/01,193,2,0.92,1820,193,0,2
56664,2014/03/31,2012/09/05,273,4,0.312723198,5354,273,3,1
56665,2014/03/31,2007/04/01,71,2,0.64,2616,71,0,2
56666,2014/03/31,2012/04/07,693,3,0.7333333329999999,2283,693,3,0
56667,2014/03/31,2010/01/02,445,3,0.7333333329999999,2283,445,3,0
56668,2014/03/31,2007/06/01,262,2,0.75,2232,262,1,1
56669,2014/03/31,2011/02/15,417,2,0.530554675,3155,417,2,0
56670,2014/03/31,2012/12/01,86,4,0.574406314,2914,86,2,2
56671,2014/03/31,2009/02/22,37,2,0.542163913,3087,37,0,2
56672,2014/03/31,2012/06/15,653,2,0.8,2092,653,2,0
56673,2014/03/31,2009/09/25,647,2,0.8,2092,647,2,0
56674,2014/03/31,2007/02/05,612,2,0.8,2092,612,2,0
56675,2014/03/31,2012/04/24,672,2,0.8,2092,672,2,0
56676,2014/03/31,2007/08/01,691,2,0.52891909,3164,691,2,0
56677,2014/03/31,2005/07/11,76,3,0.494065545,3387,76,1,2
56678,2014/03/31,2010/04/25,145,4,0.7225,2316,145,1,3
56679,2014/03/31,2006/05/18,264,3,0.8416498990000001,1988,264,2,1
56680,2014/03/31,2008/04/18,563,2,0.4,4182,563,2,0
56681,2014/03/31,2012/12/02,216,2,0.92,1818,216,0,2
56682,2014/03/31,2012/09/28,479,2,0.775,2158,479,2,0
56683,2014/03/31,2006/12/22,432,3,0.326891496,5115,432,3,0
56684,2014/03/31,2011/01/04,165,4,0.508509732,3288,165,2,2
56685,2014/03/31,2011/07/16,331,2,0.425,3934,331,0,2
56686,2014/03/31,2012/09/08,562,2,0.425,3934,562,2,0
56687,2014/03/31,2012/10/25,520,2,0.425,3934,520,2,0
56688,2014/03/31,2011/06/21,477,2,0.425,3934,477,2,0
56689,2014/03/31,2007/09/20,489,2,0.425,3934,489,2,0
56690,2014/03/31,2008/08/20,7,2,0.600510057,2784,7,0,2
56691,2014/03/31,2012/08/02,353,2,0.65,2572,353,1,1
56692,2014/03/31,2006/09/13,56,4,0.422804755,3954,56,0,4
56693,2014/03/31,2012/10/10,477,2,0.75,2229,477,2,0
56694,2014/03/31,2013/02/22,269,2,0.75,2229,269,1,1
56695,2014/03/31,2009/09/28,375,2,0.944968909,1769,375,2,0
56696,2014/03/31,2010/09/16,98,3,0.6501205760000001,2571,98,0,3
56697,2014/03/31,2010/04/19,44,2,0.875,1910,44,0,2
56698,2014/03/31,2012/12/22,65,5,0.318817245,5242,65,1,4
56699,2014/03/31,2007/03/15,117,2,0.723467532,2310,117,0,2
56700,2014/03/31,2010/01/05,56,3,0.910201525,1836,56,0,3
56701,2014/03/31,2010/04/12,173,2,0.513719643,3253,173,1,1
56702,2014/03/31,2011/12/19,313,2,1.0,1671,313,0,2
56703,2014/03/31,2009/04/24,79,2,0.78888102,2118,79,1,1
56704,2014/03/31,2012/04/30,682,2,0.451364496,3701,682,2,0
56705,2014/03/31,2012/11/28,34,3,0.6840049140000001,2442,34,0,3
56706,2014/03/31,2013/01/24,79,2,0.944222725,1769,79,1,1
56707,2014/03/31,2011/02/05,659,2,1.0,1670,659,2,0
56708,2014/03/31,2009/08/11,96,2,0.740923213,2253,96,0,2
56709,2014/03/31,2011/02/21,204,3,0.605644283,2755,204,2,1
56710,2014/03/31,2011/11/02,169,5,0.8079999999999999,2065,169,1,4
56711,2014/03/31,2008/03/29,29,2,0.43,3880,29,0,2
56712,2014/03/31,2010/06/15,149,3,0.496606133,3359,149,1,2
56713,2014/03/31,2012/07/22,266,2,0.491623932,3393,266,1,1
56714,2014/03/31,2012/10/27,453,2,0.621923937,2682,453,2,0
56715,2014/03/31,2011/08/31,512,2,0.6244852120000001,2671,512,2,0
56716,2014/03/31,2009/06/24,116,3,0.856666667,1947,116,0,3
56717,2014/03/31,2006/11/27,117,3,0.274444627,6077,117,0,3
56718,2014/03/31,2008/06/01,1,3,0.801745192,2080,1,0,3
56719,2014/03/31,2011/09/30,15,3,0.400942534,4159,15,0,3
56720,2014/03/31,2012/07/01,19,4,0.670599356,2486,19,0,4
56721,2014/03/31,2008/11/03,385,2,0.825,2020,385,2,0
56722,2014/03/31,2012/04/21,564,2,0.825,2020,564,2,0
56723,2014/03/31,2011/04/23,642,2,0.825,2020,642,2,0
56724,2014/03/31,2007/01/16,166,2,0.648156359,2571,166,0,2
56725,2014/03/31,2011/08/23,513,2,0.6545168889999999,2546,513,2,0
56726,2014/03/31,2012/10/17,44,2,0.55916443,2980,44,1,1
56727,2014/03/31,2006/03/03,493,2,0.6876599259999999,2423,493,2,0
56728,2014/03/31,2006/03/11,133,4,0.736204154,2263,133,3,1
56729,2014/03/31,2012/09/19,312,3,0.6046823960000001,2755,312,1,2
56730,2014/03/31,2011/03/25,594,2,0.94977195,1754,594,2,0
56731,2014/03/31,2012/06/05,419,2,0.5957618029999999,2796,419,2,0
56732,2014/03/31,2006/04/28,188,2,0.708222789,2352,188,0,2
56733,2014/03/31,2008/01/29,495,2,0.675699797,2465,495,2,0
56734,2014/03/31,2010/12/08,165,2,0.92,1810,165,0,2
56735,2014/03/31,2008/04/10,135,2,0.92,1810,135,0,2
56736,2014/03/31,2011/08/25,253,2,0.740417964,2249,253,0,2
56737,2014/03/31,2011/07/24,445,3,0.52277865,3185,445,3,0
56738,2014/03/31,2011/03/07,676,2,0.657743975,2531,676,2,0
56739,2014/03/31,2012/10/29,516,2,0.775,2148,516,2,0
56740,2014/03/31,2012/10/16,530,2,0.7,2378,530,2,0
56741,2014/03/31,2011/04/04,629,2,0.7,2378,629,2,0
56742,2014/03/31,2011/04/04,629,2,0.7,2378,629,2,0
56743,2014/03/31,2007/01/15,606,3,0.7480665470000001,2224,606,3,0
56744,2014/03/31,2011/05/08,12,3,0.920387382,1807,12,0,3
56745,2014/03/31,2006/10/10,457,2,0.5774652779999999,2880,457,2,0
56746,2014/03/31,2012/06/13,58,3,0.4934362020000001,3370,58,2,1
56747,2014/03/31,2012/06/21,18,2,0.815434036,2039,18,0,2
56748,2014/03/31,2005/01/18,30,2,0.46249235,3595,30,1,1
56749,2014/03/31,2007/05/10,52,2,0.475,3500,52,0,2
56750,2014/03/31,2012/09/27,322,2,0.475,3500,322,1,1
56751,2014/03/31,2010/06/24,330,3,0.316666667,5250,330,1,2
56752,2014/03/31,2012/11/22,235,2,0.973067916,1708,235,1,1
56753,2014/03/31,2007/10/08,196,2,0.535,3106,196,0,2
56754,2014/03/31,2011/02/16,3,3,0.35666666700000005,4659,3,1,2
56755,2014/03/31,2010/03/24,225,2,0.535,3106,225,0,2
56756,2014/03/31,2013/02/12,389,2,0.4,4154,389,2,0
56757,2014/03/31,2013/01/10,399,2,0.4,4154,399,2,0
56758,2014/03/31,2012/10/16,530,2,0.4,4154,530,2,0
56759,2014/03/31,2012/11/13,498,2,0.4,4154,498,2,0
56760,2014/03/31,2004/12/05,385,2,0.4,4154,385,2,0
56761,2014/03/31,2012/10/01,543,2,0.4,4154,543,2,0
56762,2014/03/31,2012/10/30,443,2,0.4,4154,443,2,0
56763,2014/03/31,2005/11/16,401,2,0.4,4154,401,2,0
56764,2014/03/31,2007/12/18,518,2,0.4,4154,518,2,0
56765,2014/03/31,2008/10/05,97,2,0.4,4154,97,0,2
56766,2014/03/31,2012/11/15,496,2,0.4,4154,496,2,0
56767,2014/03/31,2008/09/17,398,2,0.4,4154,398,2,0
56768,2014/03/31,2010/06/05,439,2,0.4,4154,439,2,0
56769,2014/03/31,2007/11/15,138,2,0.4,4154,138,1,1
56770,2014/03/31,2008/07/20,491,2,0.4,4154,491,2,0
56771,2014/03/31,2009/02/19,559,2,0.4,4154,559,2,0
56772,2014/03/31,2010/03/02,554,2,0.4,4154,554,2,0
56773,2014/03/31,2010/08/23,520,2,0.4,4154,520,2,0
56774,2014/03/31,2010/08/31,491,2,0.4,4154,491,2,0
56775,2014/03/31,2012/12/26,258,2,0.6088457310000001,2729,258,1,1
56776,2014/03/31,2009/07/10,545,2,0.6901952640000001,2407,545,2,0
56777,2014/03/31,2011/10/15,627,3,1.0,1661,627,3,0
56778,2014/03/31,2009/01/24,523,2,0.806677999,2059,523,2,0
56779,2014/03/31,2006/12/20,51,3,0.564897959,2940,51,1,2
56780,2014/03/31,2012/12/07,458,2,0.4,4152,458,2,0
56781,2014/03/31,2007/12/15,347,2,0.539905722,3076,347,1,1
56782,2014/03/31,2012/02/27,253,3,0.593333333,2799,253,2,1
56783,2014/03/31,2009/01/10,256,3,0.6506739810000001,2552,256,0,3
56784,2014/03/31,2009/04/15,227,2,0.67,2478,227,0,2
56785,2014/03/31,2010/05/26,81,4,0.7686111109999999,2160,81,0,4
56786,2014/03/31,2012/03/22,417,3,0.732201147,2267,417,3,0
56787,2014/03/31,2005/07/07,170,3,0.410459941,4044,170,0,3
56788,2014/03/31,2012/03/13,558,2,0.727663306,2281,558,2,0
56789,2014/03/31,2010/03/31,3,4,0.665918941,2492,3,0,4
56790,2014/03/31,2007/05/27,490,2,0.571906239,2901,490,2,0
56791,2014/03/31,2013/01/23,352,2,0.629086083,2637,352,1,1
56792,2014/03/31,2009/08/04,47,5,0.5720000000000001,2900,47,1,4
56793,2014/03/31,2012/01/13,579,3,0.6333333329999999,2619,579,3,0
56794,2014/03/31,2010/12/12,97,3,0.7844560079999999,2114,97,2,1
56795,2014/03/31,2012/08/27,393,3,0.744968553,2226,393,3,0
56796,2014/03/31,2013/01/05,446,2,0.489433294,3388,446,2,0
56797,2014/03/31,2010/06/12,76,3,0.563333333,2943,76,0,3
56798,2014/03/31,2007/11/30,343,2,0.35,4736,343,0,2
56799,2014/03/31,2005/08/21,489,3,0.441942369,3748,489,3,0
56800,2014/03/31,2011/01/12,18,3,0.546666667,3030,18,0,3
56801,2014/03/31,2011/04/01,540,3,0.7160830090000001,2313,540,3,0
56802,2014/03/31,2008/05/19,536,3,0.616604617,2686,536,3,0
56803,2014/03/31,2012/05/23,225,2,0.81619517,2029,225,1,1
56804,2014/03/31,2012/09/13,514,2,0.6,2760,514,2,0
56805,2014/03/31,2009/11/14,103,3,0.953333333,1737,103,1,2
56806,2014/03/31,2010/12/29,32,3,0.6669069670000001,2483,32,2,1
56807,2014/03/31,2013/03/23,307,2,0.7205831159999999,2298,307,1,1
56808,2014/03/31,2012/10/30,183,3,0.441932728,3746,183,1,2
56809,2014/03/31,2011/09/26,357,3,0.45692796,3623,357,2,1
56810,2014/03/31,2012/10/08,538,2,0.6,2758,538,2,0
56811,2014/03/31,2006/09/07,453,3,0.72293578,2289,453,3,0
56812,2014/03/31,2013/03/23,142,3,0.789041488,2097,142,0,3
56813,2014/03/31,2006/08/13,198,2,0.48,3444,198,0,2
56814,2014/03/31,2004/12/28,234,2,0.551959933,2995,234,1,1
56815,2014/03/31,2011/01/14,27,3,0.628691518,2629,27,1,2
56816,2014/03/31,2013/01/02,49,3,0.7566666670000001,2184,49,2,1
56817,2014/03/31,2012/09/19,560,2,0.680156443,2429,560,2,0
56818,2014/03/31,2005/10/20,207,3,0.7279594540000001,2269,207,2,1
56819,2014/03/31,2012/02/27,497,2,0.5719182829999999,2888,497,2,0
56820,2014/03/31,2011/08/29,509,2,0.566603774,2915,509,2,0
56821,2014/03/31,2011/10/24,46,4,0.369487696,4470,46,1,3
56822,2014/03/31,2007/09/25,181,3,0.539562235,3061,181,2,1
56823,2014/03/31,2010/04/18,151,3,0.584423213,2826,151,0,3
56824,2014/03/31,2007/01/17,99,2,0.8240918159999999,2004,99,1,1
56825,2014/03/31,2010/02/03,208,2,0.885,1866,208,0,2
56826,2014/03/31,2011/07/22,376,2,1.183763441,1395,376,2,0
56827,2014/03/31,2011/02/25,371,2,0.7043515359999999,2344,371,2,0
56828,2014/03/31,2013/02/07,303,2,0.579298246,2850,303,1,1
56829,2014/03/31,2013/01/29,193,3,0.51,3237,193,1,2
56830,2014/03/31,2007/03/16,336,3,0.40007271,4126,336,1,2
56831,2014/03/31,2012/09/06,25,3,0.503435021,3278,25,2,1
56832,2014/03/31,2008/11/24,64,3,0.496285714,3325,64,1,2
56833,2014/03/31,2010/05/08,150,2,0.478405335,3449,150,0,2
56834,2014/03/31,2010/11/17,565,2,0.541694025,3046,565,2,0
56835,2014/03/31,2011/10/11,604,2,0.6,2750,604,2,0
56836,2014/03/31,2010/12/11,671,2,0.6,2750,671,2,0
56837,2014/03/31,2007/12/13,257,3,0.293364154,5624,257,0,3
56838,2014/03/31,2009/02/25,29,4,0.663427192,2486,29,3,1
56839,2014/03/31,2013/03/23,235,2,0.96,1718,235,1,1
56840,2014/03/31,2010/07/08,195,3,0.46,3585,195,1,2
56841,2014/03/31,2007/02/13,228,2,0.972861357,1695,228,1,1
56842,2014/03/31,2009/06/14,5,2,0.625,2638,5,0,2
56843,2014/03/31,2012/11/27,71,3,0.915911111,1800,71,1,2
56844,2014/03/31,2012/02/14,618,2,0.75,2198,618,2,0
56845,2014/03/31,2011/12/05,109,3,0.846666667,1947,109,0,3
56846,2014/03/31,2013/02/20,321,3,0.702022998,2348,321,1,2
56847,2014/03/31,2012/08/02,28,2,0.8009183670000001,2058,28,0,2
56848,2014/03/31,2010/04/25,117,3,0.431350432,3821,117,0,3
56849,2014/03/31,2005/04/08,158,2,0.63,2616,158,0,2
56850,2014/03/31,2006/03/02,519,3,1.0,1648,519,3,0
56851,2014/03/31,2006/10/23,218,2,0.573000695,2876,218,1,1
56852,2014/03/31,2010/11/17,35,2,0.81,2034,35,1,1
56853,2014/03/31,2013/02/11,178,4,0.396464501,4155,178,1,3
56854,2014/03/31,2008/09/21,68,2,0.57571828,2861,68,0,2
56855,2014/03/31,2007/04/04,510,2,0.55,2994,510,2,0
56856,2014/03/31,2011/10/23,650,2,0.55,2994,650,2,0
56857,2014/03/31,2013/03/29,195,3,0.781837607,2106,195,1,2
56858,2014/03/31,2012/11/01,103,3,0.543333333,3030,103,1,2
56859,2014/03/31,2012/11/12,7,4,0.775,2124,7,2,2
56860,2014/03/31,2008/10/16,57,2,0.64,2572,57,1,1
56861,2014/03/31,2011/01/24,80,5,0.510244885,3226,80,2,3
56862,2014/03/31,2007/09/18,524,2,1.0,1646,524,2,0
56863,2014/03/31,2011/06/18,366,2,0.6265702320000001,2627,366,1,1
56864,2014/03/31,2012/08/23,213,2,0.589964158,2790,213,1,1
56865,2014/03/31,2012/08/08,583,2,0.5984,2750,583,2,0
56866,2014/03/31,2007/04/21,321,3,0.617717718,2664,321,2,1
56867,2014/03/31,2011/09/16,522,3,0.867827004,1896,522,3,0
56868,2014/03/31,2012/05/01,372,3,0.689254294,2387,372,3,0
56869,2014/03/31,2012/10/16,180,3,0.4521077220000001,3639,180,0,3
56870,2014/03/31,2011/07/12,513,2,0.5855464579999999,2809,513,2,0
56871,2014/03/31,2005/11/09,207,2,0.76,2164,207,0,2
56872,2014/03/31,2012/10/12,532,2,0.4,4111,532,2,0
56873,2014/03/31,2011/06/11,164,2,0.81,2030,164,0,2
56874,2014/03/31,2012/08/28,36,5,0.324,5075,36,4,1
56875,2014/03/31,2007/06/28,13,3,0.8269768609999999,1988,13,2,1
56876,2014/03/31,2005/01/29,1,3,0.538235102,3054,1,0,3
56877,2014/03/31,2011/12/17,343,2,0.470839301,3491,343,1,1
56878,2014/03/31,2013/03/09,30,2,0.28,5870,30,0,2
56879,2014/03/31,2012/11/26,163,3,0.779265055,2109,163,1,2
56880,2014/03/31,2012/05/12,142,4,0.55,2988,142,1,3
56881,2014/03/31,2012/10/04,499,2,0.704847705,2331,499,2,0
56882,2014/03/31,2013/01/15,373,2,0.6253140460000001,2627,373,2,0
56883,2014/03/31,2007/08/16,480,2,0.73990991,2220,480,2,0
56884,2014/03/31,2010/01/21,219,2,0.408468043,4021,219,1,1
56885,2014/03/31,2012/08/15,593,2,0.8,2053,593,2,0
56886,2014/03/31,2007/03/04,96,2,0.35,4692,96,0,2
56887,2014/03/31,2008/02/21,354,2,0.632588598,2596,354,1,1
56888,2014/03/31,2012/12/30,49,2,0.7868567320000001,2087,49,0,2
56889,2014/03/31,2012/10/17,362,3,0.814937965,2015,362,1,2
56890,2014/03/31,2012/07/21,606,2,0.5489802739999999,2991,606,2,0
56891,2014/03/31,2007/07/27,211,3,0.629252587,2609,211,0,3
56892,2014/03/31,2009/11/22,126,3,0.87,1887,126,0,3
56893,2014/03/31,2013/01/12,439,2,0.624895318,2627,439,2,0
56894,2014/03/31,2011/01/26,221,2,0.823632715,1993,221,1,1
56895,2014/03/31,2008/03/16,46,4,0.7979824990000001,2057,46,3,1
56896,2014/03/31,2007/07/31,233,2,0.833998984,1968,233,0,2
56897,2014/03/31,2012/08/31,576,2,1.5,1094,576,2,0
56898,2014/03/31,2010/11/05,65,3,0.488538255,3359,65,0,3
56899,2014/03/31,2010/11/14,371,2,0.6571485779999999,2497,371,2,0
56900,2014/03/31,2011/12/20,371,3,0.4,4102,371,3,0
56901,2014/03/31,2007/07/28,574,3,0.837442573,1959,574,3,0
56902,2014/03/31,2010/04/13,408,2,0.78565613,2088,408,2,0
56903,2014/03/31,2009/02/25,208,2,0.8185778440000001,2004,208,0,2
56904,2014/03/31,2008/05/30,361,3,0.468685714,3500,361,2,1
56905,2014/03/31,2009/05/05,413,5,0.5,3280,413,5,0
56906,2014/03/31,2012/11/22,477,2,0.575,2852,477,2,0
56907,2014/03/31,2012/01/23,52,2,0.635,2582,52,1,1
56908,2014/03/31,2010/02/03,506,3,0.60884101,2692,506,3,0
56909,2014/03/31,2012/07/25,375,4,0.40546759,4042,375,4,0
56910,2014/03/31,2011/01/16,474,2,0.625,2622,474,2,0
56911,2014/03/31,2011/04/15,443,2,0.801222494,2045,443,2,0
56912,2014/03/31,2008/11/25,243,4,0.855,1916,243,2,2
56913,2014/03/31,2012/12/30,296,3,0.6233333329999999,2628,296,1,2
56914,2014/03/31,2009/11/14,67,2,0.9,1820,67,0,2
56915,2014/03/31,2006/12/15,725,2,0.9,1820,725,2,0
56916,2014/03/31,2012/01/08,238,4,0.31386237300000003,5217,238,0,4
56917,2014/03/31,2006/09/05,221,3,0.376231618,4352,221,1,2
56918,2014/03/31,2012/11/11,4,2,0.646787831,2531,4,1,1
56919,2014/03/31,2006/04/25,105,3,0.644749902,2539,105,2,1
56920,2014/03/31,2011/05/24,198,4,0.61350075,2668,198,3,1
56921,2014/03/31,2011/10/15,27,4,0.289853019,5647,27,2,2
56922,2014/03/31,2012/07/31,45,3,0.556666667,2940,45,2,1
56923,2014/03/31,2012/08/05,262,2,0.835,1960,262,0,2
56924,2014/03/31,2010/04/07,49,2,0.784877698,2085,49,1,1
56925,2014/03/31,2012/11/17,248,2,0.626009946,2614,248,1,1
56926,2014/03/31,2007/03/27,659,3,0.451614684,3623,659,3,0
56927,2014/03/31,2009/12/21,224,2,0.594923636,2750,224,1,1
56928,2014/03/31,2013/03/22,350,3,1.0,1636,350,1,2
56929,2014/03/31,2010/12/15,636,2,0.475,3444,636,2,0
56930,2014/03/31,2012/11/11,441,3,0.7405160709999999,2209,441,3,0
56931,2014/03/31,2012/11/05,288,3,0.5168088470000001,3165,288,1,2
56932,2014/03/31,2008/07/25,552,2,0.625,2616,552,2,0
56933,2014/03/31,2009/07/17,364,2,0.625,2616,364,1,1
56934,2014/03/31,2012/05/23,29,2,0.3936864920000001,4153,29,1,1
56935,2014/03/31,2011/12/13,528,2,0.523910256,3120,528,2,0
56936,2014/03/31,2010/11/18,47,2,0.695425532,2350,47,0,2
56937,2014/03/31,2011/07/24,563,2,0.922121896,1772,563,2,0
56938,2014/03/31,2007/07/24,401,2,1.0,1634,401,2,0
56939,2014/03/31,2010/03/13,649,2,0.6447513810000001,2534,649,2,0
56940,2014/03/31,2011/07/15,14,3,0.683556485,2390,14,0,3
56941,2014/03/31,2013/02/01,360,2,0.610426009,2676,360,1,1
56942,2014/03/31,2009/12/08,5,2,0.507956454,3215,5,0,2
56943,2014/03/31,2010/05/25,683,2,0.536928642,3041,683,2,0
56944,2014/03/31,2009/12/24,73,2,0.643590855,2537,73,0,2
56945,2014/03/31,2012/04/12,161,3,0.94,1737,161,2,1
56946,2014/03/31,2007/02/06,186,2,1.41,1158,186,0,2
56947,2014/03/31,2013/02/06,418,2,0.875,1866,418,2,0
56948,2014/03/31,2011/10/13,359,2,0.875,1866,359,1,1
56949,2014/03/31,2007/02/17,86,4,0.522788985,3123,86,0,4
56950,2014/03/31,2013/03/05,62,3,0.342224785,4769,62,0,3
56951,2014/03/31,2006/11/01,17,2,0.813519442,2006,17,0,2
56952,2014/03/31,2012/06/14,614,2,0.722674934,2258,614,2,0
56953,2014/03/31,2011/04/10,492,2,0.696881674,2341,492,2,0
56954,2014/03/31,2013/02/28,74,3,0.948964514,1719,74,0,3
56955,2014/03/31,2009/12/08,515,2,0.4,4078,515,2,0
56956,2014/03/31,2012/08/31,568,2,0.4,4078,568,2,0
56957,2014/03/31,2012/08/28,562,2,0.4,4078,562,2,0
56958,2014/03/31,2007/03/25,476,4,0.472616633,3451,476,4,0
56959,2014/03/31,2007/07/10,605,3,0.977231875,1669,605,3,0
56960,2014/03/31,2010/11/29,343,2,0.449834483,3625,343,1,1
56961,2014/03/31,2010/11/29,352,2,0.525,3106,352,0,2
56962,2014/03/31,2012/03/07,654,2,0.525,3106,654,2,0
56963,2014/03/31,2006/03/01,571,2,0.525,3106,571,2,0
56964,2014/03/31,2009/09/12,336,2,0.8443293629999999,1931,336,1,1
56965,2014/03/31,2012/05/22,571,2,0.825,1976,571,2,0
56966,2014/03/31,2012/05/30,603,2,0.925,1762,603,2,0
56967,2014/03/31,2013/03/08,387,2,0.925,1762,387,2,0
56968,2014/03/31,2012/09/17,183,3,0.713333333,2283,183,1,2
56969,2014/03/31,2012/05/26,531,2,0.65136,2500,531,2,0
56970,2014/03/31,2008/08/19,5,3,0.786666667,2070,5,0,3
56971,2014/03/31,2005/03/20,171,3,0.337086957,4830,171,0,3
56972,2014/03/31,2005/02/24,489,4,0.5802031360000001,2806,489,4,0
56973,2014/03/31,2010/09/26,195,3,0.490660036,3318,195,0,3
56974,2014/03/31,2011/12/08,37,3,0.492824705,3303,37,0,3
56975,2014/03/31,2010/10/21,295,5,0.582368515,2795,295,4,1
56976,2014/03/31,2009/07/16,257,2,0.57029082,2854,257,1,1
56977,2014/03/31,2011/06/24,84,3,0.7116484479999999,2287,84,1,2
56978,2014/03/31,2013/01/03,419,2,0.7268200090000001,2239,419,2,0
56979,2014/03/31,2012/11/07,343,3,0.5009852220000001,3248,343,2,1
56980,2014/03/31,2010/08/19,539,2,0.92559727,1758,539,2,0
56981,2014/03/31,2013/03/08,321,2,0.7139096090000001,2279,321,1,1
56982,2014/03/31,2011/04/28,528,2,0.85,1914,528,2,0
56983,2014/03/31,2005/09/14,515,2,0.880357143,1848,515,2,0
56984,2014/03/31,2008/08/25,97,2,0.7993955770000001,2035,97,1,1
56985,2014/03/31,2006/02/11,271,2,0.529339408,3073,271,1,1
56986,2014/03/31,2012/12/01,186,2,0.912716049,1782,186,1,1
56987,2014/03/31,2012/04/19,207,2,0.49689887,3273,207,1,1
56988,2014/03/31,2011/04/04,393,2,0.624261036,2605,393,2,0
56989,2014/03/31,2011/04/15,300,2,0.5838707360000001,2785,300,0,2
56990,2014/03/31,2005/06/23,293,2,0.7343902440000001,2214,293,1,1
56991,2014/03/31,2012/10/23,525,2,0.776085919,2095,525,2,0
56992,2014/03/31,2011/03/24,279,6,0.8153460379999999,1994,279,5,1
56993,2014/03/31,2009/09/01,426,2,0.9143982,1778,426,2,0
56994,2014/03/31,2010/01/27,168,3,0.583333333,2787,168,0,3
56995,2014/03/31,2008/10/26,130,2,0.669555189,2428,130,0,2
56996,2014/03/31,2012/10/16,345,3,0.70858762,2294,345,1,2
56997,2014/03/31,2007/09/18,530,3,0.563280166,2884,530,3,0
56998,2014/03/31,2013/01/04,263,3,0.638494497,2544,263,1,2
56999,2014/03/31,2012/10/02,39,2,0.59454978,2732,39,1,1
57000,2014/03/31,2012/04/12,715,2,0.455099468,3569,715,2,0
57001,2014/03/31,2012/06/01,644,2,0.8,2030,644,2,0
57002,2014/03/31,2013/03/28,239,2,0.58,2800,239,0,2
57003,2014/03/31,2013/02/11,348,3,1.0,1624,348,1,2
57004,2014/03/31,2009/02/17,252,2,0.58,2800,252,0,2
57005,2014/03/31,2012/05/09,663,3,0.933333333,1740,663,3,0
57006,2014/03/31,2012/01/13,448,2,0.659317905,2463,448,2,0
57007,2014/03/31,2012/12/29,45,3,0.62,2619,45,1,2
57008,2014/03/31,2010/01/17,655,2,0.475197542,3417,655,2,0
57009,2014/03/31,2008/03/01,490,2,0.9,1804,490,2,0
57010,2014/03/31,2012/11/04,422,2,0.85,1910,422,2,0
57011,2014/03/31,2011/03/01,367,2,1.0,1623,367,2,0
57012,2014/03/31,2008/12/04,621,2,1.0,1623,621,2,0
57013,2014/03/31,2006/07/09,347,3,0.763405456,2126,347,2,1
57014,2014/03/31,2012/07/17,509,4,0.625,2596,509,4,0
57015,2014/03/31,2006/03/24,22,3,0.393333333,4125,22,2,1
57016,2014/03/31,2010/11/30,553,2,0.55,2950,553,2,0
57017,2014/03/31,2011/05/31,588,3,0.833333333,1947,588,3,0
57018,2014/03/31,2012/04/17,704,2,0.55,2950,704,2,0
57019,2014/03/31,2012/07/12,418,2,0.635238841,2554,418,2,0
57020,2014/03/31,2011/12/07,52,3,0.53539604,3030,52,1,2
57021,2014/03/31,2007/06/01,555,2,1.0,1622,555,2,0
57022,2014/03/31,2007/10/23,708,2,1.0,1622,708,2,0
57023,2014/03/31,2010/03/06,578,2,1.0,1622,578,2,0
57024,2014/03/31,2011/07/15,631,2,1.0,1622,631,2,0
57025,2014/03/31,2006/10/25,709,2,1.0,1622,709,2,0
57026,2014/03/31,2011/08/25,413,2,1.0,1622,413,2,0
57027,2014/03/31,2012/02/13,615,2,1.0,1622,615,2,0
57028,2014/03/31,2010/12/03,639,2,1.0,1622,639,2,0
57029,2014/03/31,2007/12/06,402,2,1.0,1622,402,2,0
57030,2014/03/31,2012/06/23,476,2,1.0,1622,476,2,0
57031,2014/03/31,2012/08/14,72,2,0.62,2616,72,0,2
57032,2014/03/31,2007/11/20,68,2,0.62,2616,68,0,2
57033,2014/03/31,2010/03/22,494,2,0.45,3604,494,2,0
57034,2014/03/31,2011/12/21,439,2,0.629825243,2575,439,2,0
57035,2014/03/31,2010/10/06,71,2,0.59752395,2714,71,0,2
57036,2014/03/31,2005/03/09,348,2,0.844143675,1921,348,1,1
57037,2014/03/31,2010/03/01,304,3,0.359297585,4513,304,1,2
57038,2014/03/31,2011/01/14,15,3,0.783333333,2070,15,1,2
57039,2014/03/31,2006/06/14,186,3,0.574739454,2821,186,1,2
57040,2014/03/31,2011/05/11,525,2,0.775,2092,525,2,0
57041,2014/03/31,2010/11/27,578,3,0.933333333,1737,578,3,0
57042,2014/03/31,2013/01/19,425,3,0.933333333,1737,425,3,0
57043,2014/03/31,2011/09/11,558,3,0.933333333,1737,558,3,0
57044,2014/03/31,2012/07/20,485,2,0.516374642,3139,485,2,0
57045,2014/03/31,2007/08/06,188,2,0.6920239109999999,2342,188,1,1
57046,2014/03/31,2013/03/12,175,2,0.564054995,2873,175,0,2
57047,2014/03/31,2009/03/24,162,2,0.565,2868,162,0,2
57048,2014/03/31,2009/04/27,97,2,0.39,4154,97,0,2
57049,2014/03/31,2011/05/13,173,4,0.301946309,5364,173,2,2
57050,2014/03/31,2011/01/23,171,3,0.695708763,2328,171,1,2
57051,2014/03/31,2013/02/26,71,2,0.576461374,2809,71,1,1
57052,2014/03/31,2013/03/11,23,2,0.4719265520000001,3431,23,1,1
57053,2014/03/31,2012/03/25,598,2,0.468980006,3451,598,2,0
57054,2014/03/31,2006/02/15,604,2,0.468980006,3451,604,2,0
57055,2014/03/31,2012/09/26,548,2,0.662735463,2442,548,2,0
57056,2014/03/31,2011/04/21,302,2,0.662925031,2441,302,0,2
57057,2014/03/31,2009/12/08,323,2,0.948534584,1706,323,0,2
57058,2014/03/31,2013/02/21,225,2,0.38,4258,225,0,2
57059,2014/03/31,2012/10/04,248,2,0.485858859,3330,248,0,2
57060,2014/03/31,2012/04/15,456,2,0.531504599,3044,456,2,0
57061,2014/03/31,2011/05/08,190,2,0.510476491,3169,190,0,2
57062,2014/03/31,2012/07/28,115,4,0.479135071,3376,115,1,3
57063,2014/03/31,2010/07/14,232,2,0.7060148409999999,2291,232,1,1
57064,2014/03/31,2011/06/18,560,3,0.498075146,3247,560,3,0
57065,2014/03/31,2010/01/11,83,2,0.52573472,3076,83,0,2
57066,2014/03/31,2010/04/25,304,3,0.6771440540000001,2388,304,1,2
57067,2014/03/31,2005/02/28,384,2,0.458955436,3523,384,2,0
57068,2014/03/31,2011/12/04,203,3,0.39746988,4067,203,0,3
57069,2014/03/31,2012/05/16,521,4,0.348179664,4642,521,4,0
57070,2014/03/31,2011/07/05,203,3,0.7166962309999999,2255,203,1,2
57071,2014/03/31,2006/05/10,223,3,0.409852904,3943,223,1,2
57072,2014/03/31,2008/02/13,79,3,0.83,1947,79,1,2
57073,2014/03/31,2005/10/11,28,3,0.83,1947,28,2,1
57074,2014/03/31,2010/10/29,627,2,0.8,2020,627,2,0
57075,2014/03/31,2008/07/18,19,2,0.8,2020,19,0,2
57076,2014/03/31,2011/07/25,593,2,0.8,2020,593,2,0
57077,2014/03/31,2009/04/14,313,2,0.645227636,2504,313,1,1
57078,2014/03/31,2011/07/19,124,2,0.46531682,3472,124,1,1
57079,2014/03/31,2012/03/02,656,3,0.6061350839999999,2665,656,3,0
57080,2014/03/31,2012/05/26,153,5,0.372184332,4340,153,2,3
57081,2014/03/31,2010/08/14,317,2,0.7236559140000001,2232,317,0,2
57082,2014/03/31,2005/05/24,296,2,0.506444026,3189,296,0,2
57083,2014/03/31,2010/01/03,240,2,0.8649169790000001,1867,240,0,2
57084,2014/03/31,2007/03/27,280,2,0.598480356,2698,280,1,1
57085,2014/03/31,2010/07/29,31,2,0.568640366,2839,31,0,2
57086,2014/03/31,2007/06/22,534,2,0.5,3228,534,2,0
57087,2014/03/31,2012/11/06,315,5,0.406421556,3971,315,2,3
57088,2014/03/31,2011/07/07,678,2,0.8604799999999999,1875,678,2,0
57089,2014/03/31,2011/06/19,185,3,0.372179931,4335,185,2,1
57090,2014/03/31,2008/07/24,98,4,0.5384012020000001,2996,98,1,3
57091,2014/03/31,2007/06/01,3,7,0.6814575409999999,2367,3,0,7
57092,2014/03/31,2005/04/10,354,2,1.0,1613,354,0,2
57093,2014/03/31,2012/11/21,111,3,0.523270604,3082,111,0,3
57094,2014/03/31,2005/07/02,254,2,0.58,2780,254,0,2
57095,2014/03/31,2012/03/07,379,4,0.570488323,2826,379,4,0
57096,2014/03/31,2011/07/14,145,3,0.283167047,5693,145,2,1
57097,2014/03/31,2009/06/17,464,2,0.825,1954,464,2,0
57098,2014/03/31,2008/11/11,2,2,0.704669873,2287,2,0,2
57099,2014/03/31,2010/10/20,287,2,0.473941176,3400,287,0,2
57100,2014/03/31,2011/04/21,14,6,0.49,3288,14,1,5
57101,2014/03/31,2010/10/09,581,3,0.673213539,2393,581,3,0
57102,2014/03/31,2008/05/04,120,2,0.77,2092,120,0,2
57103,2014/03/31,2012/10/30,135,3,0.737157895,2185,135,2,1
57104,2014/03/31,2011/04/28,535,2,0.475,3390,535,2,0
57105,2014/03/31,2009/09/27,390,2,0.558535739,2882,390,2,0
57106,2014/03/31,2012/12/22,360,2,0.7306400359999999,2203,360,1,1
57107,2014/03/31,2008/09/29,131,6,0.413333333,3894,131,4,2
57108,2014/03/31,2009/09/19,615,2,0.559826087,2875,615,2,0
57109,2014/03/31,2012/03/24,20,2,0.442018676,3641,20,0,2
57110,2014/03/31,2012/12/15,294,2,0.6220216470000001,2587,294,0,2
57111,2014/03/31,2010/07/06,5,2,0.468317811,3436,5,0,2
57112,2014/03/31,2010/03/12,240,2,0.585134545,2750,240,1,1
57113,2014/03/31,2012/11/22,273,2,0.465939763,3453,273,1,1
57114,2014/03/31,2009/03/22,623,2,0.796041564,2021,623,2,0
57115,2014/03/31,2012/04/23,709,2,0.4,4022,709,2,0
57116,2014/03/31,2012/04/15,715,2,0.4,4022,715,2,0
57117,2014/03/31,2007/10/18,2,3,0.416874838,3859,2,0,3
57118,2014/03/31,2012/05/16,268,4,0.576840029,2788,268,3,1
57119,2014/03/31,2010/04/09,21,2,0.80238523,2004,21,0,2
57120,2014/03/31,2013/03/15,221,2,0.447883008,3590,221,1,1
57121,2014/03/31,2010/05/24,238,2,0.385,4176,238,0,2
57122,2014/03/31,2013/03/18,196,2,0.606679245,2650,196,0,2
57123,2014/03/31,2007/11/01,110,2,1.165,1380,110,0,2
57124,2014/03/31,2011/10/02,653,2,0.625,2572,653,2,0
57125,2014/03/31,2008/02/28,236,4,0.821400102,1957,236,2,2
57126,2014/03/31,2012/09/26,5,2,0.96016129,1674,5,0,2
57127,2014/03/31,2011/04/17,569,3,0.721085689,2229,569,3,0
57128,2014/03/31,2013/02/14,401,2,0.6,2678,401,2,0
57129,2014/03/31,2005/09/18,109,4,0.647296535,2482,109,0,4
57130,2014/03/31,2013/01/31,267,3,0.6133333329999999,2619,267,2,1
57131,2014/03/31,2005/10/29,21,4,0.492702454,3260,21,2,2
57132,2014/03/31,2012/05/02,700,2,0.45,3569,700,2,0
57133,2014/03/31,2012/12/27,363,3,0.55,2920,363,2,1
57134,2014/03/31,2010/06/17,116,2,1.41,1139,116,0,2
57135,2014/03/31,2008/08/27,360,2,0.453402033,3542,360,1,1
57136,2014/03/31,2013/03/22,192,2,0.795,2020,192,0,2
57137,2014/03/31,2011/12/13,181,5,0.365499659,4393,181,4,1
57138,2014/03/31,2006/10/08,159,2,0.675,2378,159,0,2
57139,2014/03/31,2010/04/23,660,2,0.67893401,2364,660,2,0
57140,2014/03/31,2011/01/12,399,2,0.705184534,2276,399,2,0
57141,2014/03/31,2012/07/06,208,2,0.652929211,2458,208,1,1
57142,2014/03/31,2012/02/23,219,2,0.86,1866,219,0,2
57143,2014/03/31,2009/09/11,9,2,0.715606601,2242,9,0,2
57144,2014/03/31,2005/08/16,223,2,0.5976602089999999,2684,223,0,2
57145,2014/03/31,2007/07/24,673,2,0.425,3774,673,2,0
57146,2014/03/31,2006/07/08,254,3,0.923333333,1737,254,1,2
57147,2014/03/31,2009/11/24,546,2,0.675,2376,546,2,0
57148,2014/03/31,2012/09/07,396,3,0.45,3564,396,3,0
57149,2014/03/31,2008/01/25,60,2,0.79,2030,60,0,2
57150,2014/03/31,2009/10/29,248,2,0.7088196290000001,2262,248,1,1
57151,2014/03/31,2009/07/17,30,2,0.662786275,2419,30,0,2
57152,2014/03/31,2008/04/26,348,5,0.562131837,2852,348,4,1
57153,2014/03/31,2012/11/02,424,2,0.8,2004,424,2,0
57154,2014/03/31,2013/03/29,247,3,0.620096712,2585,247,0,3
57155,2014/03/31,2012/03/27,429,2,0.4,4007,429,2,0
57156,2014/03/31,2008/02/23,477,2,0.6974760659999999,2298,477,2,0
57157,2014/03/31,2010/03/26,298,2,0.7294492490000001,2197,298,1,1
57158,2014/03/31,2008/05/10,499,2,0.644609815,2486,499,2,0
57159,2014/03/31,2010/12/06,43,3,0.552388831,2901,43,0,3
57160,2014/03/31,2008/12/24,454,2,0.85464,1875,454,2,0
57161,2014/03/31,2009/12/15,400,2,0.4,4006,400,2,0
57162,2014/03/31,2011/12/30,641,2,1.0,1602,641,2,0
57163,2014/03/31,2011/02/20,577,3,0.920689655,1740,577,3,0
57164,2014/03/31,2013/03/01,195,4,0.43562687,3677,195,2,2
57165,2014/03/31,2007/02/08,492,2,0.8681300809999999,1845,492,2,0
57166,2014/03/31,2011/02/05,701,2,0.655814906,2442,701,2,0
57167,2014/03/31,2005/10/07,309,2,0.626938136,2554,309,1,1
57168,2014/03/31,2013/01/08,108,3,0.510804084,3134,108,0,3
57169,2014/03/31,2011/10/28,459,3,0.6,2668,459,3,0
57170,2014/03/31,2009/03/12,261,2,0.7618705379999999,2101,261,0,2
57171,2014/03/31,2012/09/26,547,2,0.45,3556,547,2,0
57172,2014/03/31,2012/09/26,547,2,0.45,3556,547,2,0
57173,2014/03/31,2012/08/17,223,5,0.584,2740,223,2,3
57174,2014/03/31,2008/09/18,315,3,0.320982949,4985,315,0,3
57175,2014/03/31,2010/08/09,561,2,1.0,1600,561,2,0
57176,2014/03/31,2012/04/04,692,2,0.35,4570,692,2,0
57177,2014/03/31,2011/11/10,374,4,0.9080636,1761,374,4,0
57178,2014/03/31,2010/11/01,144,2,0.49690491,3218,144,0,2
57179,2014/03/31,2012/05/08,443,3,0.639344262,2501,443,3,0
57180,2014/03/31,2011/12/20,553,2,0.790801187,2022,553,2,0
57181,2014/03/31,2012/07/26,382,2,0.8841814159999999,1808,382,2,0
57182,2014/03/31,2011/07/12,723,2,0.575,2780,723,2,0
57183,2014/03/31,2010/08/21,614,2,0.575,2780,614,2,0
57184,2014/03/31,2008/09/24,600,3,0.7,2283,600,3,0
57185,2014/03/31,2010/01/08,210,3,0.92,1737,210,0,3
57186,2014/03/31,2012/12/24,349,2,0.8842280020000001,1807,349,1,1
57187,2014/03/31,2011/08/27,128,3,0.5430965329999999,2942,128,0,3
57188,2014/03/31,2007/06/10,237,3,0.490110429,3260,237,2,1
57189,2014/03/31,2012/11/29,148,3,0.914556382,1747,148,1,2
57190,2014/03/31,2012/10/27,37,6,0.3637704920000001,4392,37,2,4
57191,2014/03/31,2011/01/28,635,2,0.7971556890000001,2004,635,2,0
57192,2014/03/31,2010/06/01,686,2,0.7971556890000001,2004,686,2,0
57193,2014/03/31,2010/11/11,564,2,0.7971556890000001,2004,564,2,0
57194,2014/03/31,2011/11/21,509,3,0.716666667,2229,509,3,0
57195,2014/03/31,2012/10/02,517,2,0.669187264,2387,517,2,0
57196,2014/03/31,2013/03/22,285,3,0.565015918,2827,285,2,1
57197,2014/03/31,2012/01/09,291,2,0.85141258,1876,291,1,1
57198,2014/03/31,2005/04/28,207,2,0.854957173,1868,207,0,2
57199,2014/03/31,2009/10/29,43,5,0.91,1755,43,0,5
57200,2014/03/31,2012/11/12,347,2,0.9,1774,347,1,1
57201,2014/03/31,2011/08/24,675,2,0.9,1774,675,2,0
57202,2014/03/31,2011/11/26,299,4,0.432506096,3691,299,0,4
57203,2014/03/31,2007/04/12,112,2,0.761957041,2095,112,1,1
57204,2014/03/31,2013/03/19,24,2,0.79,2020,24,0,2
57205,2014/03/31,2011/01/14,67,2,0.784287119,2034,67,0,2
57206,2014/03/31,2012/08/27,552,3,0.853451043,1869,552,3,0
57207,2014/03/31,2010/04/07,309,3,0.7391566270000001,2158,309,2,1
57208,2014/03/31,2012/06/08,529,3,0.916666667,1740,529,3,0
57209,2014/03/31,2012/02/05,179,4,0.6875,2320,179,2,2
57210,2014/03/31,2013/03/19,303,2,0.7959081840000001,2004,303,1,1
57211,2014/03/31,2011/06/01,443,3,0.6121689060000001,2605,443,3,0
57212,2014/03/31,2009/10/05,141,3,0.34,4690,141,0,3
57213,2014/03/31,2011/11/11,309,2,0.60812357,2622,309,1,1
57214,2014/03/31,2008/11/21,19,2,0.38,4196,19,0,2
57215,2014/03/31,2012/07/10,6,2,0.38,4196,6,0,2
57216,2014/03/31,2009/07/11,61,3,0.895505618,1780,61,0,3
57217,2014/03/31,2009/02/21,88,2,1.155,1380,88,0,2
57218,2014/03/31,2011/08/26,581,2,0.7718159809999999,2065,581,2,0
57219,2014/03/31,2008/07/21,69,2,0.57,2796,69,0,2
57220,2014/03/31,2010/12/20,11,4,0.391365422,4072,11,0,4
57221,2014/03/31,2011/07/15,715,2,0.898083427,1774,715,2,0
57222,2014/03/31,2010/07/12,595,2,0.652683327,2441,595,2,0
57223,2014/03/31,2012/10/02,259,2,0.494269314,3223,259,0,2
57224,2014/03/31,2012/08/24,511,3,0.8009049770000001,1989,511,3,0
57225,2014/03/31,2009/08/16,118,2,0.492790842,3232,118,1,1
57226,2014/03/31,2006/06/07,24,4,0.717751239,2219,24,0,4
57227,2014/03/31,2012/05/26,674,2,0.875,1820,674,2,0
57228,2014/03/31,2012/08/09,598,2,0.658057851,2420,598,2,0
57229,2014/03/31,2006/06/13,134,3,0.391228501,4070,134,0,3
57230,2014/03/31,2006/10/25,154,2,0.9608449,1657,154,1,1
57231,2014/03/31,2007/12/22,282,2,0.595136449,2675,282,1,1
57232,2014/03/31,2010/07/13,217,3,0.401002771,3969,217,2,1
57233,2014/03/31,2012/11/11,18,3,0.449977382,3537,18,1,2
57234,2014/03/31,2012/10/30,397,2,0.4,3978,397,2,0
57235,2014/03/31,2010/11/05,503,2,0.920185078,1729,503,2,0
57236,2014/03/31,2012/11/02,283,2,0.92,1729,283,0,2
57237,2014/03/31,2013/02/05,73,2,0.39,4078,73,1,1
57238,2014/03/31,2012/11/24,211,2,0.58,2742,211,0,2
57239,2014/03/31,2010/12/28,538,2,0.425796519,3735,538,2,0
57240,2014/03/31,2012/01/27,639,2,1.0,1590,639,2,0
57241,2014/03/31,2013/02/14,97,2,0.569455587,2792,97,0,2
57242,2014/03/31,2011/02/04,258,3,0.474998506,3347,258,2,1
57243,2014/03/31,2010/11/11,9,2,0.68785807,2311,9,1,1
57244,2014/03/31,2011/09/26,484,2,0.4816666670000001,3300,484,2,0
57245,2014/03/31,2012/09/16,6,2,0.589940609,2694,6,1,1
57246,2014/03/31,2012/07/18,284,2,0.725,2192,284,1,1
57247,2014/03/31,2005/06/11,316,2,1.0,1589,316,1,1
57248,2014/03/31,2011/03/29,27,6,0.71,2238,27,1,5
57249,2014/03/31,2010/05/09,678,3,0.568743287,2793,678,3,0
57250,2014/03/31,2011/07/12,563,3,0.652856556,2433,563,3,0
57251,2014/03/31,2011/06/02,76,3,0.781155927,2033,76,2,1
57252,2014/03/31,2012/12/08,383,4,0.4,3970,383,4,0
57253,2014/03/31,2013/03/18,50,3,0.32,4962,50,0,3
57254,2014/03/31,2012/03/02,560,3,0.6936435120000001,2289,560,3,0
57255,2014/03/31,2012/08/30,450,2,0.479637462,3310,450,2,0
57256,2014/03/31,2008/07/03,15,2,0.5445660379999999,2915,15,0,2
57257,2014/03/31,2009/02/27,678,2,0.54737931,2900,678,2,0
57258,2014/03/31,2011/01/24,440,2,0.5285880789999999,3003,440,2,0
57259,2014/03/31,2008/10/13,559,3,0.4,3968,559,3,0
57260,2014/03/31,2007/05/19,236,2,0.796820693,1991,236,0,2
57261,2014/03/31,2011/02/03,76,3,0.913333333,1737,76,0,3
57262,2014/03/31,2007/12/07,260,2,0.657951058,2411,260,1,1
57263,2014/03/31,2012/08/08,36,4,0.3675,4316,36,3,1
57264,2014/03/31,2008/04/10,458,2,0.85,1866,458,2,0
57265,2014/03/31,2012/10/13,475,2,0.623466981,2544,475,2,0
57266,2014/03/31,2011/12/31,659,2,0.575,2758,659,2,0
57267,2014/03/31,2007/11/18,18,2,0.525936982,3015,18,0,2
57268,2014/03/31,2009/12/01,288,2,0.785,2020,288,0,2
57269,2014/03/31,2011/11/30,28,2,0.408970854,3877,28,0,2
57270,2014/03/31,2013/01/01,342,2,0.4,3963,342,0,2
57271,2014/03/31,2012/05/15,682,2,0.4,3963,682,2,0
57272,2014/03/31,2012/05/15,682,2,0.4,3963,682,2,0
57273,2014/03/31,2011/01/21,32,4,0.653322341,2426,32,0,4
57274,2014/03/31,2013/01/19,221,3,0.593602996,2670,221,0,3
57275,2014/03/31,2011/09/02,412,2,0.591343284,2680,412,2,0
57276,2014/03/31,2010/07/11,35,2,0.7489508509999999,2116,35,0,2
57277,2014/03/31,2011/07/06,190,2,0.713851351,2220,190,1,1
57278,2014/03/31,2012/05/26,662,3,0.78097585,2029,662,3,0
57279,2014/03/31,2011/12/03,3,2,0.7108209959999999,2229,3,1,1
57280,2014/03/31,2008/04/22,59,2,0.819643042,1933,59,0,2
57281,2014/03/31,2009/11/30,144,2,0.770919708,2055,144,1,1
57282,2014/03/31,2010/05/10,519,3,0.6,2640,519,3,0
57283,2014/03/31,2011/06/23,296,2,0.7902844309999999,2004,296,1,1
57284,2014/03/31,2012/11/27,489,2,0.65756128,2407,489,2,0
57285,2014/03/31,2013/01/12,1,2,0.530899027,2981,1,1,1
57286,2014/03/31,2005/02/15,174,2,0.5367401629999999,2948,174,0,2
57287,2014/03/31,2012/10/15,129,4,0.710480467,2227,129,3,1
57288,2014/03/31,2013/03/02,258,2,0.565,2800,258,1,1
57289,2014/03/31,2011/02/04,319,3,1.166666667,1356,319,2,1
57290,2014/03/31,2008/07/12,351,3,0.820088129,1929,351,2,1
57291,2014/03/31,2013/02/08,263,2,0.615,2572,263,0,2
57292,2014/03/31,2009/11/24,519,3,0.378656931,4177,519,3,0
57293,2014/03/31,2012/09/29,503,3,0.8,1977,503,3,0
57294,2014/03/31,2011/01/07,433,2,0.5,3163,433,2,0
57295,2014/03/31,2010/12/11,588,2,0.575,2750,588,2,0
57296,2014/03/31,2010/06/22,560,2,0.83595981,1891,560,2,0
57297,2014/03/31,2011/01/13,15,3,0.647174447,2442,15,0,3
57298,2014/03/31,2010/03/03,548,2,0.731166127,2161,548,2,0
57299,2014/03/31,2011/07/31,201,2,0.851671159,1855,201,0,2
57300,2014/03/31,2009/08/11,167,2,0.506189103,3120,167,0,2
57301,2014/03/31,2011/10/15,695,2,0.85,1858,695,2,0
57302,2014/03/31,2012/07/12,466,2,0.7,2256,466,2,0
57303,2014/03/31,2010/12/13,148,2,0.735,2148,148,1,1
57304,2014/03/31,2013/03/19,30,3,0.439032258,3596,30,0,3
57305,2014/03/31,2013/01/08,267,4,0.39625,3984,267,1,3
57306,2014/03/31,2008/05/12,443,3,0.86215183,1831,443,3,0
57307,2014/03/31,2008/01/07,1,2,0.38,4154,1,0,2
57308,2014/03/31,2009/08/29,279,2,0.38,4154,279,0,2
57309,2014/03/31,2007/02/15,89,2,0.38,4154,89,0,2
57310,2014/03/31,2009/03/20,14,2,0.38,4154,14,0,2
57311,2014/03/31,2008/10/29,247,2,0.38,4154,247,0,2
57312,2014/03/31,2006/11/07,179,2,0.38,4154,179,0,2
57313,2014/03/31,2012/09/11,191,2,0.38,4154,191,0,2
57314,2014/03/31,2012/11/06,80,2,0.38,4154,80,0,2
57315,2014/03/31,2009/01/01,28,2,0.38,4154,28,0,2
57316,2014/03/31,2009/12/10,220,2,0.38,4154,220,0,2
57317,2014/03/31,2012/07/24,240,3,0.473863705,3331,240,0,3
57318,2014/03/31,2010/09/27,174,3,0.486397535,3245,174,1,2
57319,2014/03/31,2008/07/16,34,2,0.7642954000000001,2065,34,0,2
57320,2014/03/31,2010/12/31,154,4,0.486558742,3243,154,2,2
57321,2014/03/31,2007/06/03,613,2,0.7,2254,613,2,0
57322,2014/03/31,2009/09/26,219,3,0.44,3585,219,0,3
57323,2014/03/31,2007/06/14,72,2,0.938910714,1680,72,1,1
57324,2014/03/31,2007/09/28,412,4,0.506161746,3116,412,4,0
57325,2014/03/31,2009/11/27,70,4,0.7503092290000001,2102,70,2,2
57326,2014/03/31,2010/03/17,539,2,1.0,1577,539,2,0
57327,2014/03/31,2011/10/23,550,2,1.0,1577,550,2,0
57328,2014/03/31,2013/02/15,223,2,0.92,1714,223,0,2
57329,2014/03/31,2006/10/17,181,2,0.845,1866,181,0,2
57330,2014/03/31,2006/03/29,297,2,0.845,1866,297,0,2
57331,2014/03/31,2011/02/28,698,3,0.471375187,3345,698,3,0
57332,2014/03/31,2009/09/30,104,4,0.4001878170000001,3940,104,1,3
57333,2014/03/31,2012/11/19,11,3,0.383635036,4110,11,1,2
57334,2014/03/31,2009/01/11,91,2,0.631895792,2495,91,0,2
57335,2014/03/31,2006/10/29,681,2,0.7,2252,681,2,0
57336,2014/03/31,2011/03/11,273,3,0.465824468,3384,273,2,1
57337,2014/03/31,2007/09/01,103,2,0.545,2892,103,1,1
57338,2014/03/31,2008/05/10,646,2,0.699422992,2253,646,2,0
57339,2014/03/31,2012/10/16,482,2,0.4,3939,482,2,0
57340,2014/03/31,2008/05/21,106,2,0.715367847,2202,106,1,1
57341,2014/03/31,2009/07/09,594,3,0.515749836,3054,594,3,0
57342,2014/03/31,2010/03/01,124,4,0.5740087460000001,2744,124,1,3
57343,2014/03/31,2010/05/21,156,2,0.8316050690000001,1894,156,1,1
57344,2014/03/31,2010/11/03,236,2,0.61,2582,236,1,1
57345,2014/03/31,2006/12/16,213,2,0.743081642,2119,213,0,2
57346,2014/03/31,2011/05/17,334,2,0.460412401,3419,334,1,1
57347,2014/03/31,2013/01/02,45,4,0.636261116,2474,45,1,3
57348,2014/03/31,2008/10/31,475,2,0.853116531,1845,475,2,0
57349,2014/03/31,2011/07/29,15,3,0.543022774,2898,15,2,1
57350,2014/03/31,2006/06/16,554,2,0.4,3934,554,2,0
57351,2014/03/31,2007/05/04,399,2,0.4,3934,399,2,0
57352,2014/03/31,2008/04/19,402,2,0.4,3934,402,2,0
57353,2014/03/31,2013/02/20,396,2,0.4,3934,396,2,0
57354,2014/03/31,2010/12/13,109,2,0.4,3934,109,0,2
57355,2014/03/31,2011/07/09,563,2,0.4,3934,563,2,0
57356,2014/03/31,2010/10/12,375,2,0.4,3934,375,2,0
57357,2014/03/31,2006/11/16,398,2,0.4,3934,398,2,0
57358,2014/03/31,2009/01/05,390,2,0.4,3934,390,2,0
57359,2014/03/31,2011/08/16,422,2,0.4,3934,422,2,0
57360,2014/03/31,2009/07/18,542,2,0.4,3934,542,2,0
57361,2014/03/31,2011/01/24,442,2,0.4,3934,442,2,0
57362,2014/03/31,2012/12/17,469,2,0.4,3934,469,2,0
57363,2014/03/31,2009/08/28,428,2,0.4,3934,428,2,0
57364,2014/03/31,2009/11/02,98,2,0.4,3934,98,0,2
57365,2014/03/31,2011/11/10,696,2,0.4,3934,696,2,0
57366,2014/03/31,2011/11/22,45,2,0.4,3934,45,0,2
57367,2014/03/31,2008/12/10,465,2,0.4,3934,465,2,0
57368,2014/03/31,2012/05/10,500,2,0.4,3934,500,2,0
57369,2014/03/31,2012/09/20,557,2,0.4,3934,557,2,0
57370,2014/03/31,2012/07/01,549,2,0.4,3934,549,2,0
57371,2014/03/31,2012/07/10,99,2,0.4,3934,99,0,2
57372,2014/03/31,2012/07/31,395,2,0.4,3934,395,2,0
57373,2014/03/31,2012/12/05,390,2,0.4,3934,390,2,0
57374,2014/03/31,2008/07/02,128,2,0.4,3934,128,0,2
57375,2014/03/31,2010/11/22,424,2,0.4,3934,424,2,0
57376,2014/03/31,2012/10/23,524,2,0.4,3934,524,2,0
57377,2014/03/31,2012/04/06,502,3,0.712109552,2209,502,3,0
57378,2014/03/31,2010/07/07,525,3,0.52444148,2999,525,3,0
57379,2014/03/31,2012/08/27,397,2,0.85,1850,397,2,0
57380,2014/03/31,2012/05/01,542,2,0.85,1850,542,2,0
57381,2014/03/31,2012/07/02,351,2,0.6975155279999999,2254,351,1,1
57382,2014/03/31,2006/03/05,632,2,1.0,1572,632,2,0
57383,2014/03/31,2006/04/02,38,2,0.4192,3750,38,0,2
57384,2014/03/31,2011/11/05,496,2,0.659823678,2382,496,2,0
57385,2014/03/31,2012/02/09,204,2,0.88779661,1770,204,0,2
57386,2014/03/31,2010/04/09,599,2,0.9,1746,599,2,0
57387,2014/03/31,2011/09/30,575,2,0.815784008,1926,575,2,0
57388,2014/03/31,2010/07/22,529,3,0.365202232,4302,529,3,0
57389,2014/03/31,2012/05/14,261,3,0.923333333,1701,261,2,1
57390,2014/03/31,2009/07/06,540,2,0.75,2094,540,2,0
57391,2014/03/31,2012/08/12,235,5,0.52,3020,235,2,3
57392,2014/03/31,2013/03/06,222,2,0.885,1774,222,1,1
57393,2014/03/31,2011/05/20,261,2,0.885,1774,261,0,2
57394,2014/03/31,2012/04/11,429,3,0.717199635,2189,429,3,0
57395,2014/03/31,2010/06/08,539,2,0.835,1880,539,2,0
57396,2014/03/31,2011/12/04,404,3,0.4,3924,404,3,0
57397,2014/03/31,2013/01/09,398,2,0.6,2616,398,2,0
57398,2014/03/31,2012/01/10,397,3,0.4,3924,397,3,0
57399,2014/03/31,2012/02/15,107,3,0.44,3567,107,0,3
57400,2014/03/31,2011/03/26,93,9,0.458888889,3420,93,3,6
57401,2014/03/31,2012/04/04,52,4,0.594867324,2638,52,0,4
57402,2014/03/31,2012/07/27,365,2,0.43996074,3566,365,1,1
57403,2014/03/31,2009/12/31,211,3,0.509642625,3078,211,2,1
57404,2014/03/31,2010/05/24,580,2,0.8983963340000001,1746,580,2,0
57405,2014/03/31,2012/02/19,433,2,0.6492135760000001,2416,433,2,0
57406,2014/03/31,2012/10/27,518,2,1.025,1530,518,2,0
57407,2014/03/31,2008/12/12,692,2,0.375,4182,692,2,0
57408,2014/03/31,2011/08/21,39,3,0.44,3564,39,1,2
57409,2014/03/31,2005/04/04,390,2,0.376832492,4161,390,2,0
57410,2014/03/31,2012/01/25,18,2,0.364218351,4305,18,0,2
57411,2014/03/31,2011/01/24,155,2,0.965988909,1623,155,1,1
57412,2014/03/31,2006/09/16,199,3,0.800245023,1959,199,0,3
57413,2014/03/31,2010/01/27,155,3,0.290407634,5397,155,1,2
57414,2014/03/31,2011/03/11,162,3,0.38,4124,162,0,3
57415,2014/03/31,2011/06/11,104,5,0.7576402320000001,2068,104,1,4
57416,2014/03/31,2007/09/20,507,3,0.8936109529999999,1753,507,3,0
57417,2014/03/31,2008/03/11,71,2,0.575545755,2721,71,0,2
57418,2014/03/31,2010/03/10,431,2,0.772189349,2028,431,2,0
57419,2014/03/31,2011/07/09,217,4,0.464090101,3374,217,3,1
57420,2014/03/31,2008/09/01,572,2,0.775,2020,572,2,0
57421,2014/03/31,2012/07/28,611,2,0.775,2020,611,2,0
57422,2014/03/31,2010/11/25,589,2,0.775,2020,589,2,0
57423,2014/03/31,2008/10/22,393,4,0.50431701,3104,393,4,0
57424,2014/03/31,2009/08/07,224,2,0.86,1820,224,0,2
57425,2014/03/31,2005/03/01,232,2,0.86,1820,232,1,1
57426,2014/03/31,2009/08/14,514,2,0.8912300679999999,1756,514,2,0
57427,2014/03/31,2012/10/11,356,2,0.641393443,2440,356,1,1
57428,2014/03/31,2013/01/25,292,3,0.462455674,3384,292,1,2
57429,2014/03/31,2004/12/30,48,2,1.134517766,1379,48,1,1
57430,2014/03/31,2011/01/13,409,3,0.487687032,3208,409,3,0
57431,2014/03/31,2011/12/14,590,2,0.837707552,1867,590,2,0
57432,2014/03/31,2008/09/02,251,3,0.8196016770000001,1908,251,1,2
57433,2014/03/31,2013/03/05,113,2,0.58,2696,113,0,2
57434,2014/03/31,2010/12/13,61,3,0.9,1737,61,0,3
57435,2014/03/31,2011/10/21,518,3,0.513230466,3046,518,3,0
57436,2014/03/31,2010/10/12,524,4,0.675,2316,524,4,0
57437,2014/03/31,2013/01/22,416,3,0.9,1737,416,3,0
57438,2014/03/31,2009/04/01,174,2,0.8,1954,174,0,2
57439,2014/03/31,2011/01/13,124,2,0.830994152,1881,124,1,1
57440,2014/03/31,2010/11/12,515,2,0.6547968160000001,2387,515,2,0
57441,2014/03/31,2012/01/03,108,2,0.582280179,2684,108,0,2
57442,2014/03/31,2011/01/15,194,4,0.743761905,2100,194,0,4
57443,2014/03/31,2010/03/18,644,2,0.461358936,3385,644,2,0
57444,2014/03/31,2009/07/16,178,2,0.54,2892,178,1,1
57445,2014/03/31,2009/09/13,411,2,0.4,3904,411,2,0
57446,2014/03/31,2011/04/18,229,2,0.650666667,2400,229,0,2
57447,2014/03/31,2012/09/14,163,6,0.543333333,2874,163,4,2
57448,2014/03/31,2012/04/18,75,4,0.565726713,2759,75,1,3
57449,2014/03/31,2013/01/16,148,3,0.8728131990000001,1788,148,0,3
57450,2014/03/31,2012/11/10,506,2,0.7,2229,506,2,0
57451,2014/03/31,2009/10/05,369,2,0.7,2229,369,2,0
57452,2014/03/31,2012/11/27,487,2,0.7,2229,487,2,0
57453,2014/03/31,2012/06/02,489,2,0.7,2229,489,2,0
57454,2014/03/31,2012/02/05,127,2,0.3,5201,127,0,2
57455,2014/03/31,2013/02/01,423,2,0.7,2229,423,2,0
57456,2014/03/31,2011/11/23,165,2,0.662484076,2355,165,1,1
57457,2014/03/31,2012/12/26,355,3,0.683333333,2283,355,2,1
57458,2014/03/31,2012/10/23,434,2,1.0,1560,434,2,0
57459,2014/03/31,2013/03/01,94,2,0.912656524,1709,94,1,1
57460,2014/03/31,2010/04/29,234,2,0.6925799290000001,2252,234,1,1
57461,2014/03/31,2013/01/29,37,4,0.3075,5072,37,1,3
57462,2014/03/31,2005/07/09,711,2,0.653920335,2385,711,2,0
57463,2014/03/31,2013/02/10,395,2,0.25,6238,395,2,0
57464,2014/03/31,2012/06/02,492,2,0.606967692,2569,492,2,0
57465,2014/03/31,2007/05/18,258,3,0.458192771,3403,258,2,1
57466,2014/03/31,2008/10/23,95,2,0.592836502,2630,95,1,1
57467,2014/03/31,2007/09/18,346,2,0.9,1732,346,1,1
57468,2014/03/31,2012/11/16,461,3,0.421585069,3697,461,3,0
57469,2014/03/31,2012/04/20,474,2,0.75,2078,474,2,0
57470,2014/03/31,2009/09/11,91,3,0.50484289,3087,91,0,3
57471,2014/03/31,2009/10/24,102,2,0.537358621,2900,102,0,2
57472,2014/03/31,2013/01/27,6,2,0.34,4583,6,0,2
57473,2014/03/31,2012/10/13,229,2,0.779,2000,229,1,1
57474,2014/03/31,2009/03/13,457,3,0.320448467,4861,457,3,0
57475,2014/03/31,2009/07/07,77,2,0.752105263,2071,77,1,1
57476,2014/03/31,2013/03/10,103,2,1.2,1298,103,1,1
57477,2014/03/31,2012/12/25,152,3,0.8,1947,152,0,3
57478,2014/03/31,2013/03/20,95,2,1.2,1298,95,1,1
57479,2014/03/31,2010/05/03,379,3,0.8,1947,379,3,0
57480,2014/03/31,2011/08/17,465,2,0.8,1947,465,2,0
57481,2014/03/31,2008/07/28,504,3,0.338898563,4594,504,3,0
57482,2014/03/31,2010/05/17,59,2,0.6467220610000001,2407,59,1,1
57483,2014/03/31,2011/01/13,71,2,0.595,2616,71,0,2
57484,2014/03/31,2009/11/24,20,2,0.665,2340,20,1,1
57485,2014/03/31,2005/06/16,1,2,0.605,2572,1,0,2
57486,2014/03/31,2007/05/08,40,2,0.594808869,2616,40,0,2
57487,2014/03/31,2008/05/10,85,2,0.522492442,2977,85,1,1
57488,2014/03/31,2008/05/20,348,3,0.391824137,3969,348,2,1
57489,2014/03/31,2009/08/18,176,3,0.378537001,4108,176,2,1
57490,2014/03/31,2007/11/12,26,4,0.7775,2000,26,0,4
57491,2014/03/31,2010/12/01,27,2,0.424309498,3664,27,0,2
57492,2014/03/31,2013/01/31,22,3,0.446302038,3483,22,0,3
57493,2014/03/31,2011/08/20,232,3,0.35603756299999995,4366,232,0,3
57494,2014/03/31,2005/11/01,528,2,0.48244879,3222,528,2,0
57495,2014/03/31,2012/06/30,157,4,0.648198499,2398,157,1,3
57496,2014/03/31,2007/10/25,144,2,0.8124725559999999,1913,144,0,2
57497,2014/03/31,2005/05/13,227,3,0.525962775,2955,227,1,2
57498,2014/03/31,2013/03/17,26,4,0.498613607,3116,26,0,4
57499,2014/03/31,2008/07/03,95,3,0.35270436,4404,95,0,3
57500,2014/03/31,2012/11/20,209,4,0.433897737,3579,209,0,4
57501,2014/03/31,2006/11/02,553,2,0.356789982,4352,553,2,0
57502,2014/03/31,2010/01/29,307,3,0.416720344,3726,307,0,3
57503,2014/03/31,2008/10/15,66,2,0.595976967,2605,66,0,2
57504,2014/03/31,2013/01/04,104,3,0.68,2283,104,1,2
57505,2014/03/31,2011/07/25,70,2,0.906764019,1712,70,0,2
57506,2014/03/31,2007/09/06,635,3,0.6936103659999999,2238,635,3,0
57507,2014/03/31,2011/07/28,12,2,0.462077999,3359,12,1,1
57508,2014/03/31,2008/02/01,8,2,0.913407887,1699,8,0,2
57509,2014/03/31,2013/02/02,14,2,0.555,2796,14,0,2
57510,2014/03/31,2010/06/10,404,2,0.939733495,1651,404,2,0
57511,2014/03/31,2012/10/12,295,2,0.835,1858,295,0,2
57512,2014/03/31,2006/03/03,216,2,0.92,1686,216,0,2
57513,2014/03/31,2013/03/16,65,3,0.796666667,1947,65,0,3
57514,2014/03/31,2006/06/07,142,2,0.577719821,2684,142,0,2
57515,2014/03/31,2013/03/21,8,2,0.73172723,2119,8,0,2
57516,2014/03/31,2010/04/26,556,2,0.654453356,2369,556,2,0
57517,2014/03/31,2010/12/20,18,3,0.557232207,2782,18,0,3
57518,2014/03/31,2012/03/09,29,3,0.681406593,2275,29,2,1
57519,2014/03/31,2012/07/10,212,3,0.491471148,3154,212,2,1
57520,2014/03/31,2011/03/23,284,2,0.45,3444,284,0,2
57521,2014/03/31,2013/01/15,106,2,0.29,5344,106,0,2
57522,2014/03/31,2010/06/23,203,4,0.433251328,3577,203,1,3
57523,2014/03/31,2012/01/16,77,3,0.276666667,5601,77,0,3
57524,2014/03/31,2010/12/13,258,2,0.496300448,3122,258,1,1
57525,2014/03/31,2011/10/17,705,2,0.68742236,2254,705,2,0
57526,2014/03/31,2007/12/14,6,2,0.915514184,1692,6,0,2
57527,2014/03/31,2008/01/13,69,3,0.472501525,3278,69,2,1
57528,2014/03/31,2009/09/28,558,2,0.6,2580,558,2,0
57529,2014/03/31,2011/05/27,558,2,0.759097597,2039,558,2,0
57530,2014/03/31,2010/09/19,289,2,0.822594365,1881,289,1,1
57531,2014/03/31,2010/10/17,708,2,1.036997319,1492,708,2,0
57532,2014/03/31,2011/04/23,24,2,0.81,1910,24,0,2
57533,2014/03/31,2009/11/20,678,2,0.85,1820,678,2,0
57534,2014/03/31,2012/12/28,84,3,0.393333333,3933,84,2,1
57535,2014/03/31,2011/04/08,626,2,0.65,2378,626,2,0
57536,2014/03/31,2013/03/23,354,3,0.683333333,2262,354,2,1
57537,2014/03/31,2008/07/28,256,3,0.3,5152,256,0,3
57538,2014/03/31,2013/02/02,225,2,0.771247505,2004,225,1,1
57539,2014/03/31,2011/05/01,81,4,0.504117455,3065,81,2,2
57540,2014/03/31,2005/06/07,298,4,0.58,2664,298,2,2
57541,2014/03/31,2011/04/01,365,3,0.542105263,2850,365,2,1
57542,2014/03/31,2012/08/29,89,2,0.739918582,2088,89,0,2
57543,2014/03/31,2008/03/14,609,2,0.617099481,2503,609,2,0
57544,2014/03/31,2012/08/24,452,3,0.433333333,3564,452,3,0
57545,2014/03/31,2012/10/23,255,2,0.65,2376,255,0,2
57546,2014/03/31,2005/12/27,167,2,0.620317397,2489,167,0,2
57547,2014/03/31,2009/08/01,233,3,0.38898967,3969,233,0,3
57548,2014/03/31,2010/11/24,204,3,0.72070028,2142,204,2,1
57549,2014/03/31,2008/08/25,664,2,0.6,2572,664,2,0
57550,2014/03/31,2009/09/20,562,2,0.6,2572,562,2,0
57551,2014/03/31,2013/01/30,422,2,0.6,2572,422,2,0
57552,2014/03/31,2005/12/17,104,2,0.77,2004,104,0,2
57553,2014/03/31,2008/06/26,24,2,0.6264920829999999,2463,24,1,1
57554,2014/03/31,2008/09/29,127,2,0.555,2780,127,0,2
57555,2014/03/31,2010/11/21,611,2,0.825,1870,611,2,0
57556,2014/03/31,2012/01/17,546,2,0.9,1714,546,2,0
57557,2014/03/31,2013/03/10,14,2,0.835934959,1845,14,0,2
57558,2014/03/31,2010/09/24,16,2,0.684509543,2253,16,1,1
57559,2014/03/31,2006/06/28,432,2,0.5600799129999999,2753,432,2,0
57560,2014/03/31,2006/08/05,12,2,0.459296991,3357,12,0,2
57561,2014/03/31,2009/06/09,152,3,0.517355705,2980,152,0,3
57562,2014/03/31,2008/08/10,621,2,0.526519809,2928,621,2,0
57563,2014/03/31,2007/11/07,347,3,0.944607843,1632,347,2,1
57564,2014/03/31,2013/01/24,268,2,0.490104928,3145,268,0,2
57565,2014/03/31,2008/01/15,429,2,0.886766398,1738,429,2,0
57566,2014/03/31,2012/09/03,41,2,0.538086592,2864,41,0,2
57567,2014/03/31,2013/01/01,342,2,0.4,3852,342,0,2
57568,2014/03/31,2010/06/01,371,2,0.4,3852,371,2,0
57569,2014/03/31,2012/04/15,714,2,0.4,3852,714,2,0
57570,2014/03/31,2008/09/14,550,2,0.499076774,3087,550,2,0
57571,2014/03/31,2008/08/06,504,2,0.65,2370,504,2,0
57572,2014/03/31,2011/06/18,201,2,0.56008,2750,201,0,2
57573,2014/03/31,2011/03/22,9,2,0.814027484,1892,9,0,2
57574,2014/03/31,2012/07/31,192,2,0.6356252579999999,2423,192,0,2
57575,2014/03/31,2010/09/20,3,2,0.74761165,2060,3,1,1
57576,2014/03/31,2011/11/10,339,3,0.3666666670000001,4200,339,1,2
57577,2014/03/31,2008/11/24,33,3,0.736456241,2091,33,0,3
57578,2014/03/31,2008/09/17,575,2,0.825,1866,575,2,0
57579,2014/03/31,2009/07/06,556,3,0.414583894,3713,556,3,0
57580,2014/03/31,2009/10/23,128,2,0.506342105,3040,128,0,2
57581,2014/03/31,2011/05/05,51,3,0.386850968,3979,51,1,2
57582,2014/03/31,2011/02/14,33,2,0.87,1769,33,0,2
57583,2014/03/31,2013/03/07,357,3,0.408656399,3766,357,1,2
57584,2014/03/31,2012/09/26,311,2,0.497816241,3091,311,0,2
57585,2014/03/31,2013/02/20,34,2,0.69,2230,34,1,1
57586,2014/03/31,2009/12/10,476,2,0.7,2198,476,2,0
57587,2014/03/31,2012/11/21,452,2,0.469664122,3275,452,2,0
57588,2014/03/31,2012/07/18,268,2,0.96,1602,268,1,1
57589,2014/03/31,2012/03/09,84,3,0.79455814,1935,84,0,3
57590,2014/03/31,2011/12/05,48,5,0.461929087,3328,48,2,3
57591,2014/03/31,2012/05/22,159,5,0.53,2900,159,3,2
57592,2014/03/31,2012/09/22,184,4,0.6625,2320,184,3,1
57593,2014/03/31,2011/11/21,274,2,0.37,4154,274,1,1
57594,2014/03/31,2007/06/08,35,2,0.37,4154,35,0,2
57595,2014/03/31,2011/06/27,376,4,0.6186996779999999,2484,376,4,0
57596,2014/03/31,2008/09/11,234,2,0.38,4044,234,0,2
57597,2014/03/31,2012/04/06,88,2,0.520715254,2950,88,1,1
57598,2014/03/31,2008/09/11,306,2,0.633924887,2423,306,1,1
57599,2014/03/31,2007/08/09,560,2,0.767232767,2002,560,2,0
57600,2014/03/31,2008/10/19,545,3,0.797792208,1925,545,3,0
57601,2014/03/31,2012/04/28,217,6,0.396304516,3875,217,4,2
57602,2014/03/31,2007/07/26,162,4,0.86317032,1779,162,2,2
57603,2014/03/31,2011/02/02,247,2,0.613962415,2501,247,0,2
57604,2014/03/31,2011/12/10,115,4,0.393617021,3901,115,2,2
57605,2014/03/31,2007/11/16,127,2,0.76,2020,127,0,2
57606,2014/03/31,2006/10/29,1,2,0.536588605,2861,1,0,2
57607,2014/03/31,2010/11/19,99,2,0.79004632,1943,99,0,2
57608,2014/03/31,2009/08/02,116,2,0.448935361,3419,116,1,1
57609,2014/03/31,2007/11/07,333,2,0.748950708,2049,333,1,1
57610,2014/03/31,2008/07/13,190,2,0.535,2868,190,0,2
57611,2014/03/31,2009/08/07,111,2,0.39,3934,111,0,2
57612,2014/03/31,2006/03/30,2,2,0.39,3934,2,1,1
57613,2014/03/31,2006/07/12,438,3,0.43798173,3503,438,3,0
57614,2014/03/31,2011/06/23,247,3,0.758299555,2023,247,1,2
57615,2014/03/31,2007/12/02,14,2,0.895,1714,14,0,2
57616,2014/03/31,2007/11/01,600,2,0.738921002,2076,600,2,0
57617,2014/03/31,2009/05/15,351,2,0.475,3228,351,1,1
57618,2014/03/31,2007/03/04,376,2,0.475,3228,376,2,0
57619,2014/03/31,2012/11/12,319,2,0.81466525,1882,319,1,1
57620,2014/03/31,2008/04/08,245,3,0.5356813420000001,2862,245,2,1
57621,2014/03/31,2011/05/09,185,2,0.679251218,2257,185,0,2
57622,2014/03/31,2012/11/19,496,2,0.629404517,2435,496,2,0
57623,2014/03/31,2012/12/30,156,2,0.8159637909999999,1878,156,0,2
57624,2014/03/31,2011/01/04,493,2,0.660715826,2319,493,2,0
57625,2014/03/31,2013/02/26,232,3,0.362046314,4232,232,0,3
57626,2014/03/31,2010/01/02,250,2,0.3,5107,250,0,2
57627,2014/03/31,2008/01/12,29,4,0.472080123,3245,29,1,3
57628,2014/03/31,2012/07/18,188,2,0.535414191,2861,188,1,1
57629,2014/03/31,2012/07/27,513,4,0.672366111,2278,513,4,0
57630,2014/03/31,2010/12/29,345,2,0.310166059,4938,345,0,2
57631,2014/03/31,2012/12/22,348,3,0.8466003320000001,1809,348,2,1
57632,2014/03/31,2010/03/26,398,2,0.8857142859999999,1729,398,2,0
57633,2014/03/31,2011/08/25,167,2,0.64,2392,167,1,1
57634,2014/03/31,2007/08/01,123,3,0.574527027,2664,123,0,3
57635,2014/03/31,2010/09/01,94,2,0.539640339,2836,94,0,2
57636,2014/03/31,2010/02/01,266,5,0.319149114,4795,266,3,2
57637,2014/03/31,2011/01/19,115,2,0.67,2284,115,0,2
57638,2014/03/31,2011/08/05,265,2,0.967180784,1582,265,0,2
57639,2014/03/31,2012/08/09,597,2,0.85,1800,597,2,0
57640,2014/03/31,2012/07/27,611,2,0.85,1800,611,2,0
57641,2014/03/31,2007/08/21,100,2,0.576020331,2656,100,0,2
57642,2014/03/31,2011/10/31,218,2,0.49,3122,218,0,2
57643,2014/03/31,2009/07/25,1,2,0.675,2266,1,0,2
57644,2014/03/31,2007/02/18,8,2,0.675,2266,8,0,2
57645,2014/03/31,2013/02/02,377,2,0.5404593639999999,2830,377,2,0
57646,2014/03/31,2008/08/29,367,2,0.375,4078,367,2,0
57647,2014/03/31,2011/02/28,550,2,0.375,4078,550,2,0
57648,2014/03/31,2011/11/26,38,3,0.935266055,1635,38,1,2
57649,2014/03/31,2008/08/18,601,2,0.55,2780,601,2,0
57650,2014/03/31,2012/04/30,555,2,0.55,2780,555,2,0
57651,2014/03/31,2011/01/22,445,2,1.0,1529,445,2,0
57652,2014/03/31,2008/02/21,656,2,0.8,1911,656,2,0
57653,2014/03/31,2012/02/27,55,2,0.584197248,2616,55,0,2
57654,2014/03/31,2012/12/31,279,2,0.967240506,1580,279,1,1
57655,2014/03/31,2009/10/05,496,2,0.4,3820,496,2,0
57656,2014/03/31,2013/02/01,157,2,0.845,1808,157,0,2
57657,2014/03/31,2010/12/06,49,2,0.875,1746,49,0,2
57658,2014/03/31,2011/03/10,399,2,0.875,1746,399,2,0
57659,2014/03/31,2006/08/16,52,2,0.875,1746,52,0,2
57660,2014/03/31,2009/12/15,166,2,0.58,2634,166,0,2
57661,2014/03/31,2010/04/01,7,2,0.67327457,2269,7,0,2
57662,2014/03/31,2012/11/25,488,2,0.45,3393,488,2,0
57663,2014/03/31,2010/07/07,157,3,0.4787394170000001,3189,157,0,3
57664,2014/03/31,2012/07/26,588,3,0.632677165,2413,588,3,0
57665,2014/03/31,2005/11/26,7,3,0.4370426570000001,3493,7,0,3
57666,2014/03/31,2008/08/23,177,4,0.661673169,2307,177,1,3
57667,2014/03/31,2007/03/05,178,3,0.747477963,2042,178,1,2
57668,2014/03/31,2006/11/18,185,2,0.92,1659,185,0,2
57669,2014/03/31,2012/09/11,332,2,1.0,1526,332,1,1
57670,2014/03/31,2012/02/06,691,2,1.0,1526,691,2,0
57671,2014/03/31,2005/09/07,503,2,0.5,3052,503,2,0
57672,2014/03/31,2013/01/21,46,2,0.875,1744,46,0,2
57673,2014/03/31,2011/04/30,584,2,0.5,3052,584,2,0
57674,2014/03/31,2013/03/06,92,2,0.596917058,2556,92,0,2
57675,2014/03/31,2012/10/01,99,2,0.45,3390,99,1,1
57676,2014/03/31,2012/11/25,492,2,0.45,3390,492,2,0
57677,2014/03/31,2005/11/10,6,2,1.175,1298,6,0,2
57678,2014/03/31,2010/07/26,6,2,0.755,2020,6,0,2
57679,2014/03/31,2010/04/15,38,3,0.526495166,2896,38,1,2
57680,2014/03/31,2010/05/29,413,2,0.5514104879999999,2765,413,2,0
57681,2014/03/31,2011/11/07,16,3,0.315622282,4829,16,1,2
57682,2014/03/31,2006/06/04,181,3,0.596053969,2557,181,1,2
57683,2014/03/31,2007/06/24,618,2,0.55,2770,618,2,0
57684,2014/03/31,2011/03/17,633,2,0.593032308,2569,633,2,0
57685,2014/03/31,2012/10/13,344,3,0.494883041,3078,344,2,1
57686,2014/03/31,2009/02/13,342,2,0.498119686,3058,342,1,1
57687,2014/03/31,2011/08/01,206,2,0.58,2626,206,0,2
57688,2014/03/31,2013/01/18,347,2,0.325582638,4677,347,1,1
57689,2014/03/31,2013/03/06,289,4,0.383513854,3970,289,2,2
57690,2014/03/31,2012/12/09,126,2,0.444534307,3425,126,1,1
57691,2014/03/31,2012/03/18,296,3,0.5,3045,296,2,1
57692,2014/03/31,2007/11/24,145,3,0.5,3045,145,0,3
57693,2014/03/31,2008/04/03,549,2,0.75,2030,549,2,0
57694,2014/03/31,2006/12/28,38,2,0.698033012,2181,38,0,2
57695,2014/03/31,2010/12/13,103,3,0.5037657179999999,3022,103,0,3
57696,2014/03/31,2012/05/25,475,2,1.0,1522,475,2,0
57697,2014/03/31,2013/02/10,401,2,1.0,1522,401,2,0
57698,2014/03/31,2013/03/02,342,3,0.694343066,2192,342,2,1
57699,2014/03/31,2010/11/24,434,2,1.0,1522,434,2,0
57700,2014/03/31,2008/10/07,698,2,1.0,1522,698,2,0
57701,2014/03/31,2005/09/12,185,2,0.7075732220000001,2151,185,1,1
57702,2014/03/31,2013/01/01,253,2,0.562632163,2705,253,1,1
57703,2014/03/31,2013/02/08,415,2,0.95,1602,415,2,0
57704,2014/03/31,2010/10/14,184,2,0.631485477,2410,184,1,1
57705,2014/03/31,2005/03/18,171,2,0.964996829,1577,171,1,1
57706,2014/03/31,2006/02/23,433,3,0.631589871,2409,433,3,0
57707,2014/03/31,2007/12/06,51,3,0.502537166,3027,51,1,2
57708,2014/03/31,2012/09/18,278,3,0.956603774,1590,278,2,1
57709,2014/03/31,2012/12/12,39,4,0.335,4540,39,0,4
57710,2014/03/31,2013/03/28,365,2,0.8356593409999999,1820,365,1,1
57711,2014/03/31,2008/06/03,194,3,0.844453082,1801,194,2,1
57712,2014/03/31,2010/11/15,268,4,0.525637746,2893,268,2,2
57713,2014/03/31,2010/12/13,662,2,0.6808777429999999,2233,662,2,0
57714,2014/03/31,2011/08/29,125,5,0.365718066,4157,125,1,4
57715,2014/03/31,2012/01/15,48,3,0.36818314,4128,48,2,1
57716,2014/03/31,2009/02/10,159,2,0.7138233909999999,2129,159,0,2
57717,2014/03/31,2012/07/13,21,3,0.504699435,3011,21,2,1
57718,2014/03/31,2013/03/08,277,3,0.419478045,3621,277,1,2
57719,2014/03/31,2012/10/08,63,2,0.635,2392,63,1,1
57720,2014/03/31,2009/12/23,281,3,0.78,1947,281,0,3
57721,2014/03/31,2008/03/22,115,3,0.78,1947,115,0,3
57722,2014/03/31,2012/04/15,350,2,0.8242671009999999,1842,350,1,1
57723,2014/03/31,2010/10/11,44,2,0.67,2266,44,0,2
57724,2014/03/31,2012/09/21,504,2,0.943567433,1609,504,2,0
57725,2014/03/31,2013/01/12,257,3,0.6526999139999999,2326,257,2,1
57726,2014/03/31,2008/05/05,565,2,0.725,2094,565,2,0
57727,2014/03/31,2010/01/01,537,2,0.725,2094,537,2,0
57728,2014/03/31,2012/09/03,499,2,1.0,1518,499,2,0
57729,2014/03/31,2009/01/26,564,2,1.0,1518,564,2,0
57730,2014/03/31,2010/12/06,22,2,0.876200924,1732,22,0,2
57731,2014/03/31,2012/06/02,277,3,0.621400491,2442,277,2,1
57732,2014/03/31,2013/02/10,86,2,0.630685786,2406,86,0,2
57733,2014/03/31,2009/10/07,142,2,0.482538168,3144,142,1,1
57734,2014/03/31,2010/07/18,517,2,0.61716843,2458,517,2,0
57735,2014/03/31,2012/03/21,569,3,0.326258606,4648,569,3,0
57736,2014/03/31,2012/07/21,69,2,0.8023386240000001,1890,69,1,1
57737,2014/03/31,2008/12/23,101,2,0.520150943,2915,101,1,1
57738,2014/03/31,2010/06/01,78,2,0.365,4154,78,0,2
57739,2014/03/31,2012/07/25,35,2,0.607152583,2497,35,1,1
57740,2014/03/31,2007/09/13,587,3,1.0,1516,587,3,0
57741,2014/03/31,2013/01/18,20,2,0.93,1630,20,0,2
57742,2014/03/31,2008/05/18,560,2,0.45,3368,560,2,0
57743,2014/03/31,2008/02/22,506,2,0.611581921,2478,506,2,0
57744,2014/03/31,2010/04/21,180,2,0.545,2780,180,1,1
57745,2014/03/31,2008/03/10,569,2,0.75,2020,569,2,0
57746,2014/03/31,2013/01/01,154,2,0.75,2020,154,0,2
57747,2014/03/31,2011/09/27,665,2,0.75,2020,665,2,0
57748,2014/03/31,2012/01/24,640,2,0.75,2020,640,2,0
57749,2014/03/31,2011/12/14,439,2,0.75,2020,439,2,0
57750,2014/03/31,2012/03/10,574,3,0.497242285,3046,574,3,0
57751,2014/03/31,2013/01/17,152,2,0.385,3934,152,1,1
57752,2014/03/31,2012/03/04,62,3,0.693333333,2184,62,2,1
57753,2014/03/31,2012/11/02,317,3,0.28001850100000003,5405,317,1,2
57754,2014/03/31,2011/05/18,343,2,0.4,3783,343,0,2
57755,2014/03/31,2012/10/31,94,6,0.5770175439999999,2622,94,0,6
57756,2014/03/31,2012/01/03,196,3,0.366679593,4126,196,0,3
57757,2014/03/31,2011/09/29,721,2,0.7322604070000001,2066,721,2,0
57758,2014/03/31,2012/06/20,271,2,0.747066667,2025,271,0,2
57759,2014/03/31,2013/02/28,365,2,0.588350836,2571,365,1,1
57760,2014/03/31,2012/11/01,512,2,0.55,2750,512,2,0
57761,2014/03/31,2011/10/15,715,2,0.55,2750,715,2,0
57762,2014/03/31,2008/03/07,124,2,1.165,1298,124,0,2
57763,2014/03/31,2007/08/11,109,2,1.165,1298,109,0,2
57764,2014/03/31,2008/12/08,261,2,0.5497818179999999,2750,261,0,2
57765,2014/03/31,2010/10/07,693,2,0.8,1889,693,2,0
57766,2014/03/31,2011/01/04,629,2,0.852284264,1773,629,2,0
57767,2014/03/31,2012/10/31,295,4,0.477283639,3166,295,3,1
57768,2014/03/31,2011/08/05,709,2,0.7,2158,709,2,0
57769,2014/03/31,2011/09/15,620,2,0.7,2158,620,2,0
57770,2014/03/31,2007/07/02,629,2,0.7,2158,629,2,0
57771,2014/03/31,2012/09/12,561,2,0.8,1888,561,2,0
57772,2014/03/31,2011/03/26,314,2,0.784215992,1926,314,1,1
57773,2014/03/31,2013/01/24,311,2,0.4,3776,311,0,2
57774,2014/03/31,2010/11/29,152,3,0.5097198789999999,2963,152,0,3
57775,2014/03/31,2010/06/03,646,2,0.4,3775,646,2,0
57776,2014/03/31,2012/12/22,462,2,0.935895846,1613,462,2,0
57777,2014/03/31,2009/01/23,100,2,0.77,1960,100,0,2
57778,2014/03/31,2008/08/29,124,3,0.661020587,2283,124,0,3
57779,2014/03/31,2010/01/17,72,2,0.88,1714,72,0,2
57780,2014/03/31,2012/06/27,537,2,0.574990469,2623,537,2,0
57781,2014/03/31,2009/09/21,31,2,0.33,4570,31,0,2
57782,2014/03/31,2012/07/03,637,2,1.3,1160,637,2,0
57783,2014/03/31,2011/07/20,372,2,0.85,1774,372,2,0
57784,2014/03/31,2012/11/13,400,3,0.503422371,2995,400,3,0
57785,2014/03/31,2011/08/01,392,2,0.575,2622,392,2,0
57786,2014/03/31,2013/02/24,271,2,0.952819216,1582,271,1,1
57787,2014/03/31,2008/08/21,662,2,0.725,2078,662,2,0
57788,2014/03/31,2012/12/28,226,2,0.72,2092,226,0,2
57789,2014/03/31,2012/12/27,11,2,0.72,2092,11,0,2
57790,2014/03/31,2009/07/09,581,3,0.334477015,4503,581,3,0
57791,2014/03/31,2007/03/16,172,2,0.955003171,1577,172,1,1
57792,2014/03/31,2012/12/30,203,2,0.436296726,3451,203,1,1
57793,2014/03/31,2011/01/14,644,3,0.8666666670000001,1737,644,3,0
57794,2014/03/31,2012/11/15,196,2,0.523180396,2877,196,0,2
57795,2014/03/31,2012/04/15,167,2,0.435864466,3453,167,1,1
57796,2014/03/31,2006/12/09,391,4,0.310821974,4842,391,4,0
57797,2014/03/31,2005/09/15,203,4,0.550849195,2732,203,2,2
57798,2014/03/31,2013/03/25,373,2,0.475624407,3163,373,2,0
57799,2014/03/31,2007/08/19,397,2,0.575,2616,397,2,0
57800,2014/03/31,2013/02/12,400,2,0.575,2616,400,2,0
57801,2014/03/31,2013/02/06,406,2,0.575,2616,406,2,0
57802,2014/03/31,2005/07/12,54,3,0.6266666670000001,2400,54,0,3
57803,2014/03/31,2010/12/23,598,2,0.8,1880,598,2,0
57804,2014/03/31,2012/04/29,698,2,0.8,1880,698,2,0
57805,2014/03/31,2013/02/26,350,2,0.521592092,2883,350,1,1
57806,2014/03/31,2012/09/11,325,3,0.369650762,4066,325,2,1
57807,2014/03/31,2012/12/08,479,2,0.831543996,1807,479,2,0
57808,2014/03/31,2011/09/30,496,2,0.509186441,2950,496,2,0
57809,2014/03/31,2012/08/02,401,2,1.0,1502,401,2,0
57810,2014/03/31,2013/03/08,304,2,0.567946293,2644,304,1,1
57811,2014/03/31,2012/02/18,661,2,0.525,2860,661,2,0
57812,2014/03/31,2010/09/01,442,2,0.825,1820,442,2,0
57813,2014/03/31,2013/03/20,312,2,0.63893617,2350,312,1,1
57814,2014/03/31,2008/03/12,170,2,0.623004149,2410,170,0,2
57815,2014/03/31,2012/07/01,397,3,0.539805825,2781,397,3,0
57816,2014/03/31,2011/11/06,644,2,0.6762162159999999,2220,644,2,0
57817,2014/03/31,2007/04/24,198,3,0.8509977320000001,1764,198,0,3
57818,2014/03/31,2012/11/24,363,3,0.39797136,3771,363,1,2
57819,2014/03/31,2006/07/03,280,2,0.641307692,2340,280,0,2
57820,2014/03/31,2010/08/25,709,2,0.55,2728,709,2,0
57821,2014/03/31,2012/08/07,404,2,0.925,1622,404,2,0
57822,2014/03/31,2011/07/31,460,2,0.524309682,2861,460,2,0
57823,2014/03/31,2012/02/26,454,3,0.614250614,2442,454,3,0
57824,2014/03/31,2013/03/10,93,2,0.675,2222,93,0,2
57825,2014/03/31,2013/02/10,49,5,0.726,2065,49,2,3
57826,2014/03/31,2013/03/14,174,4,0.425664395,3522,174,0,4
57827,2014/03/31,2012/10/14,129,3,0.77,1947,129,1,2
57828,2014/03/31,2012/10/16,110,3,0.563333333,2661,110,0,3
57829,2014/03/31,2012/06/22,392,2,0.52460623,2857,392,2,0
57830,2014/03/31,2012/07/26,369,2,0.76595092,1956,369,2,0
57831,2014/03/31,2011/04/17,200,3,0.625515658,2395,200,2,1
57832,2014/03/31,2006/10/15,284,2,0.7941357370000001,1886,284,1,1
57833,2014/03/31,2005/09/05,41,2,0.545,2748,41,0,2
57834,2014/03/31,2007/07/07,69,3,0.492439987,3041,69,0,3
57835,2014/03/31,2007/08/30,20,2,0.625093946,2395,20,0,2
57836,2014/03/31,2008/08/28,706,2,0.5,2994,706,2,0
57837,2014/03/31,2013/01/19,261,3,0.584293521,2562,261,1,2
57838,2014/03/31,2013/03/16,170,3,0.88,1701,170,1,2
57839,2014/03/31,2006/08/16,223,2,0.918300613,1630,223,1,1
57840,2014/03/31,2011/11/28,143,4,0.410416781,3647,143,2,2
57841,2014/03/31,2010/05/28,325,2,0.482741935,3100,325,1,1
57842,2014/03/31,2007/12/12,88,2,0.826740331,1810,88,1,1
57843,2014/03/31,2011/02/21,479,2,0.463506815,3228,479,2,0
57844,2014/03/31,2010/02/23,70,2,0.53,2823,70,0,2
57845,2014/03/31,2011/07/05,161,3,0.76609319,1953,161,1,2
57846,2014/03/31,2013/03/12,383,2,0.647102076,2312,383,2,0
57847,2014/03/31,2012/01/14,242,4,0.6825,2192,242,2,2
57848,2014/03/31,2012/05/01,545,2,0.8,1870,545,2,0
57849,2014/03/31,2006/12/12,1,3,0.390263501,3833,1,1,2
57850,2014/03/31,2008/10/01,21,2,0.28,5342,21,0,2
57851,2014/03/31,2012/10/23,515,2,0.6067748479999999,2465,515,2,0
57852,2014/03/31,2013/02/27,247,2,0.38,3934,247,0,2
57853,2014/03/31,2012/09/19,288,2,0.38,3934,288,0,2
57854,2014/03/31,2011/09/19,358,2,0.641037736,2332,358,0,2
57855,2014/03/31,2013/03/01,35,2,0.48,3114,35,0,2
57856,2014/03/31,2013/01/14,72,2,0.683107861,2188,72,0,2
57857,2014/03/31,2008/01/15,143,2,0.51,2930,143,0,2
57858,2014/03/31,2012/10/29,154,2,0.572467433,2610,154,1,1
57859,2014/03/31,2007/12/10,454,2,1.0,1494,454,2,0
57860,2014/03/31,2013/02/05,402,2,1.0,1494,402,2,0
57861,2014/03/31,2009/10/20,539,2,1.0,1494,539,2,0
57862,2014/03/31,2012/06/04,583,2,1.0,1494,583,2,0
57863,2014/03/31,2011/01/26,95,2,0.79047619,1890,95,1,1
57864,2014/03/31,2010/04/12,709,2,1.0,1494,709,2,0
57865,2014/03/31,2008/11/13,191,2,0.45381531,3292,191,0,2
57866,2014/03/31,2012/11/03,66,2,0.56436343,2647,66,1,1
57867,2014/03/31,2012/11/19,217,2,0.964364106,1549,217,1,1
57868,2014/03/31,2006/06/06,256,2,0.625,2390,256,0,2
57869,2014/03/31,2012/04/05,720,2,0.625,2390,720,2,0
57870,2014/03/31,2013/02/20,380,2,0.4,3734,380,2,0
57871,2014/03/31,2010/06/24,641,2,0.4,3734,641,2,0
57872,2014/03/31,2010/11/17,401,2,0.4,3734,401,2,0
57873,2014/03/31,2010/07/14,20,2,0.6767285909999999,2207,20,0,2
57874,2014/03/31,2012/11/28,88,2,0.970350877,1539,88,1,1
57875,2014/03/31,2012/11/11,212,2,0.844024873,1769,212,1,1
57876,2014/03/31,2008/07/22,686,2,0.8429700729999999,1771,686,2,0
57877,2014/03/31,2006/06/18,343,2,0.8,1866,343,0,2
57878,2014/03/31,2010/04/12,488,3,0.7666666670000001,1947,488,3,0
57879,2014/03/31,2010/08/01,261,3,0.7242503640000001,2061,261,1,2
57880,2014/03/31,2011/09/20,131,2,0.6185661,2413,131,0,2
57881,2014/03/31,2008/04/17,194,2,0.616702479,2420,194,1,1
57882,2014/03/31,2007/06/01,248,2,0.92,1622,248,0,2
57883,2014/03/31,2007/06/08,191,3,0.872625731,1710,191,1,2
57884,2014/03/31,2011/01/29,383,2,1.0,1492,383,2,0
57885,2014/03/31,2008/07/28,308,4,0.335280899,4450,308,3,1
57886,2014/03/31,2012/07/31,107,2,0.58,2572,107,0,2
57887,2014/03/31,2007/03/04,93,2,0.58,2572,93,0,2
57888,2014/03/31,2008/04/23,243,2,0.457576687,3260,243,1,1
57889,2014/03/31,2007/08/16,706,2,0.25,5966,706,2,0
57890,2014/03/31,2012/07/21,47,3,0.489802956,3045,47,2,1
57891,2014/03/31,2009/04/18,189,2,0.57,2616,189,1,1
57892,2014/03/31,2006/10/08,119,2,0.415892857,3584,119,0,2
57893,2014/03/31,2011/05/15,71,2,0.7146330940000001,2085,71,0,2
57894,2014/03/31,2009/01/04,229,2,0.645,2310,229,1,1
57895,2014/03/31,2011/06/30,105,2,0.34,4382,105,0,2
57896,2014/03/31,2009/10/24,141,2,0.637381258,2337,141,0,2
57897,2014/03/31,2008/10/09,30,2,0.87,1712,30,0,2
57898,2014/03/31,2012/03/13,256,2,0.6301735079999999,2363,256,1,1
57899,2014/03/31,2008/12/09,29,2,0.5186415879999999,2871,29,1,1
57900,2014/03/31,2012/04/24,629,2,1.0,1489,629,2,0
57901,2014/03/31,2013/01/08,423,2,0.75,1985,423,2,0
57902,2014/03/31,2011/01/03,215,3,0.3913459520000001,3804,215,2,1
57903,2014/03/31,2012/04/20,702,2,0.45,3308,702,2,0
57904,2014/03/31,2012/01/20,514,3,0.6862148459999999,2169,514,3,0
57905,2014/03/31,2006/06/22,32,2,0.82047409,1814,32,0,2
57906,2014/03/31,2008/07/21,32,2,0.549800517,2707,32,0,2
57907,2014/03/31,2009/12/09,322,3,0.7120574159999999,2090,322,0,3
57908,2014/03/31,2012/06/26,284,2,0.949559668,1567,284,1,1
57909,2014/03/31,2011/11/05,29,2,0.5400435570000001,2755,29,1,1
57910,2014/03/31,2010/11/29,197,2,0.535,2780,197,0,2
57911,2014/03/31,2011/05/08,209,3,0.67144921,2215,209,1,2
57912,2014/03/31,2011/04/01,307,3,0.514889197,2888,307,2,1
57913,2014/03/31,2012/04/07,721,3,0.5419096210000001,2744,721,3,0
57914,2014/03/31,2008/09/20,423,2,0.6136607510000001,2423,423,2,0
57915,2014/03/31,2009/07/03,162,2,0.467922568,3177,162,1,1
57916,2014/03/31,2012/05/09,690,2,0.8,1858,690,2,0
57917,2014/03/31,2012/11/12,500,2,0.8,1858,500,2,0
57918,2014/03/31,2011/09/16,294,2,0.862180974,1724,294,1,1
57919,2014/03/31,2013/02/01,423,2,0.8,1858,423,2,0
57920,2014/03/31,2012/07/19,621,2,0.8,1858,621,2,0
57921,2014/03/31,2012/07/17,620,2,0.8,1858,620,2,0
57922,2014/03/31,2008/03/14,515,2,0.8,1858,515,2,0
57923,2014/03/31,2010/12/10,673,2,0.8,1858,673,2,0
57924,2014/03/31,2012/05/21,590,2,0.8,1858,590,2,0
57925,2014/03/31,2012/09/02,563,2,0.8,1858,563,2,0
57926,2014/03/31,2011/05/31,503,2,0.553482309,2685,503,2,0
57927,2014/03/31,2012/07/15,591,2,0.913692308,1625,591,2,0
57928,2014/03/31,2009/11/10,91,2,0.588335315,2523,91,1,1
57929,2014/03/31,2013/03/16,195,2,0.63,2356,195,0,2
57930,2014/03/31,2012/01/09,668,2,0.85,1746,668,2,0
57931,2014/03/31,2012/05/17,638,2,0.519989488,2854,638,2,0
57932,2014/03/31,2012/07/04,584,3,0.65,2283,584,3,0
57933,2014/03/31,2010/07/01,60,5,0.41173141,3604,60,4,1
57934,2014/03/31,2007/12/13,116,2,0.795,1866,116,0,2
57935,2014/03/31,2011/03/29,350,2,0.784761905,1890,350,1,1
57936,2014/03/31,2012/09/11,427,2,0.784761905,1890,427,2,0
57937,2014/03/31,2008/08/27,244,2,0.366735905,4044,244,1,1
57938,2014/03/31,2009/08/29,46,5,0.498252688,2976,46,3,2
57939,2014/03/31,2008/01/04,43,2,0.865,1714,43,0,2
57940,2014/03/31,2013/01/01,352,2,0.563259878,2632,352,1,1
57941,2014/03/31,2012/10/16,138,2,0.83191358,1782,138,0,2
57942,2014/03/31,2013/02/07,247,3,0.566666667,2616,247,2,1
57943,2014/03/31,2007/02/19,401,2,0.85,1744,401,2,0
57944,2014/03/31,2012/12/19,195,2,0.698769448,2121,195,1,1
57945,2014/03/31,2012/05/26,546,4,0.975,1520,546,4,0
57946,2014/03/31,2012/04/29,576,2,1.0,1482,576,2,0
57947,2014/03/31,2013/03/03,393,2,1.0,1482,393,2,0
57948,2014/03/31,2008/04/23,80,2,0.7932441109999999,1868,80,1,1
57949,2014/03/31,2007/07/08,524,2,0.526733025,2813,524,2,0
57950,2014/03/31,2012/06/20,647,2,0.927489042,1597,647,2,0
57951,2014/03/31,2006/10/26,192,2,0.908466258,1630,192,0,2
57952,2014/03/31,2008/02/02,41,2,0.5572487770000001,2657,41,0,2
57953,2014/03/31,2012/10/04,401,2,0.775,1910,401,2,0
57954,2014/03/31,2007/10/17,349,2,0.614190871,2410,349,1,1
57955,2014/03/31,2010/06/30,580,2,0.410582524,3605,580,2,0
57956,2014/03/31,2008/11/23,119,3,0.87,1701,119,0,3
57957,2014/03/31,2012/04/26,555,3,0.85,1740,555,3,0
57958,2014/03/31,2011/11/08,668,2,0.575,2572,668,2,0
57959,2014/03/31,2010/08/17,539,2,0.575,2572,539,2,0
57960,2014/03/31,2012/02/22,559,2,0.575,2572,559,2,0
57961,2014/03/31,2006/10/30,501,2,0.575,2572,501,2,0
57962,2014/03/31,2007/07/18,101,3,0.378602151,3906,101,2,1
57963,2014/03/31,2011/08/14,71,3,0.373250883,3962,71,2,1
57964,2014/03/31,2010/03/01,273,2,0.685,2158,273,1,1
57965,2014/03/31,2011/09/21,550,2,0.925,1598,550,2,0
57966,2014/03/31,2009/10/29,197,2,0.906797546,1630,197,1,1
57967,2014/03/31,2007/06/05,488,2,0.540779363,2733,488,2,0
57968,2014/03/31,2013/02/21,358,2,0.6747945209999999,2190,358,1,1
57969,2014/03/31,2005/08/16,317,2,0.468140051,3156,317,1,1
57970,2014/03/31,2011/07/14,115,3,0.405998901,3639,115,2,1
57971,2014/03/31,2007/03/17,93,2,0.419537063,3521,93,0,2
57972,2014/03/31,2010/12/05,281,2,0.654145261,2258,281,1,1
57973,2014/03/31,2006/12/23,714,2,1.0,1477,714,2,0
57974,2014/03/31,2012/04/28,44,2,0.41691135,3542,44,1,1
57975,2014/03/31,2011/01/10,64,4,0.6375,2316,64,0,4
57976,2014/03/31,2011/01/13,3,3,0.616450939,2395,3,0,3
57977,2014/03/31,2011/12/19,45,3,0.6466666670000001,2283,45,0,3
57978,2014/03/31,2008/02/09,137,2,0.91,1622,137,0,2
57979,2014/03/31,2013/02/12,14,3,0.452203494,3263,14,0,3
57980,2014/03/31,2007/03/03,531,2,0.779012672,1894,531,2,0
57981,2014/03/31,2012/09/11,528,2,0.753498468,1958,528,2,0
57982,2014/03/31,2011/04/10,641,2,0.475,3106,641,2,0
57983,2014/03/31,2007/10/20,361,2,0.375,3934,361,1,1
57984,2014/03/31,2012/06/13,380,2,0.375,3934,380,2,0
57985,2014/03/31,2008/05/25,17,2,0.51,2892,17,0,2
57986,2014/03/31,2011/01/08,642,2,0.8133204629999999,1813,642,2,0
57987,2014/03/31,2010/03/26,122,2,0.855780615,1723,122,1,1
57988,2014/03/31,2011/02/01,12,2,0.7157233009999999,2060,12,0,2
57989,2014/03/31,2006/02/09,124,2,0.799105691,1845,124,0,2
57990,2014/03/31,2012/11/12,501,2,0.45,3276,501,2,0
57991,2014/03/31,2010/06/21,7,2,0.79,1866,7,0,2
57992,2014/03/31,2007/12/27,235,2,0.528694405,2788,235,1,1
57993,2014/03/31,2012/12/16,423,3,0.455579598,3235,423,3,0
57994,2014/03/31,2008/11/19,178,2,0.845,1744,178,0,2
57995,2014/03/31,2013/01/16,349,2,0.5656813820000001,2605,349,1,1
57996,2014/03/31,2011/12/25,228,4,0.682222222,2160,228,2,2
57997,2014/03/31,2011/12/19,572,2,0.8065681440000001,1827,572,2,0
57998,2014/03/31,2008/02/09,608,2,0.7352295409999999,2004,608,2,0
57999,2014/03/31,2005/12/25,430,3,0.6634684679999999,2220,430,3,0
58000,2014/03/31,2008/01/24,5,2,0.809197802,1820,5,0,2
58001,2014/03/31,2011/08/20,480,2,0.506501548,2907,480,2,0
58002,2014/03/31,2011/01/15,471,2,0.5863799279999999,2511,471,2,0
58003,2014/03/31,2013/02/02,30,2,0.535,2752,30,0,2
58004,2014/03/31,2012/08/26,16,3,0.455479579,3232,16,0,3
58005,2014/03/31,2011/09/14,157,3,0.449841076,3272,157,1,2
58006,2014/03/31,2011/09/25,550,2,0.6,2453,550,2,0
58007,2014/03/31,2011/05/15,316,2,0.548769575,2682,316,1,1
58008,2014/03/31,2011/02/14,297,2,0.725,2030,297,1,1
58009,2014/03/31,2006/05/26,707,2,0.725,2030,707,2,0
58010,2014/03/31,2012/10/25,233,3,0.717440273,2051,233,2,1
58011,2014/03/31,2012/12/26,33,3,0.526959169,2792,33,0,3
58012,2014/03/31,2012/03/22,147,2,0.535,2750,147,0,2
58013,2014/03/31,2010/06/10,126,2,0.534967273,2750,126,0,2
58014,2014/03/31,2010/09/13,152,2,0.906038201,1623,152,0,2
58015,2014/03/31,2012/11/11,443,2,0.679819695,2163,443,2,0
58016,2014/03/31,2010/08/15,22,2,0.535,2748,22,0,2
58017,2014/03/31,2011/02/01,418,3,1.0,1470,418,3,0
58018,2014/03/31,2009/08/08,647,2,1.5,980,647,2,0
58019,2014/03/31,2012/10/17,362,4,0.5647635520000001,2601,362,2,2
58020,2014/03/31,2013/01/13,169,2,0.500456559,2935,169,1,1
58021,2014/03/31,2011/03/27,4,2,0.416762202,3524,4,0,2
58022,2014/03/31,2011/06/27,399,2,0.4,3671,399,2,0
58023,2014/03/31,2013/01/27,397,2,0.432478632,3393,397,2,0
58024,2014/03/31,2008/04/03,690,2,0.4,3667,690,2,0
58025,2014/03/31,2013/01/01,456,2,0.4,3667,456,2,0
58026,2014/03/31,2011/04/06,14,3,0.444742268,3298,14,0,3
58027,2014/03/31,2013/01/19,280,2,1.13,1298,280,1,1
58028,2014/03/31,2011/01/04,185,2,1.13,1298,185,0,2
58029,2014/03/31,2012/07/21,196,3,0.36565445,4011,196,1,2
58030,2014/03/31,2010/06/23,144,3,0.505037879,2904,144,2,1
58031,2014/03/31,2012/01/17,339,2,0.614390448,2387,339,1,1
58032,2014/03/31,2013/02/27,290,2,0.66,2222,290,0,2
58033,2014/03/31,2007/12/20,310,2,0.7,2094,310,0,2
58034,2014/03/31,2009/02/16,557,2,0.753935185,1944,557,2,0
58035,2014/03/31,2008/08/22,242,2,0.56,2616,242,0,2
58036,2014/03/31,2009/01/30,166,2,0.96,1526,166,0,2
58037,2014/03/31,2013/03/26,43,6,0.4216666670000001,3474,43,1,5
58038,2014/03/31,2012/02/17,27,2,0.7301794620000001,2006,27,1,1
58039,2014/03/31,2012/04/22,707,2,0.725,2020,707,2,0
58040,2014/03/31,2012/07/08,614,2,0.725,2020,614,2,0
58041,2014/03/31,2007/12/03,336,2,0.7,2092,336,1,1
58042,2014/03/31,2012/02/14,397,3,0.466666667,3138,397,3,0
58043,2014/03/31,2005/10/15,27,2,0.604574732,2422,27,1,1
58044,2014/03/31,2012/03/24,617,2,0.5,2928,617,2,0
58045,2014/03/31,2012/01/20,673,2,0.825,1774,673,2,0
58046,2014/03/31,2010/10/12,56,2,0.725582548,2017,56,0,2
58047,2014/03/31,2010/07/12,3,3,0.604099917,2422,3,0,3
58048,2014/03/31,2011/06/02,395,5,0.77,1900,395,5,0
58049,2014/03/31,2005/04/22,686,4,0.9625,1520,686,4,0
58050,2014/03/31,2010/03/31,185,3,0.61956798,2361,185,1,2
58051,2014/03/31,2011/04/30,413,3,0.361619283,4045,413,3,0
58052,2014/03/31,2012/08/26,21,2,0.627421707,2331,21,1,1
58053,2014/03/31,2007/03/08,497,2,0.5,2925,497,2,0
58054,2014/03/31,2009/10/30,279,2,0.615,2378,279,0,2
58055,2014/03/31,2012/09/11,542,2,0.648757764,2254,542,2,0
58056,2014/03/31,2010/02/13,10,2,0.706669889,2069,10,0,2
58057,2014/03/31,2009/03/21,599,3,1.0,1462,599,3,0
58058,2014/03/31,2008/02/06,570,2,0.575,2542,570,2,0
58059,2014/03/31,2006/02/25,69,2,0.72,2030,69,0,2
58060,2014/03/31,2010/05/21,273,2,0.645,2266,273,1,1
58061,2014/03/31,2012/01/31,254,4,0.464944321,3143,254,1,3
58062,2014/03/31,2011/03/10,314,2,0.518743344,2817,314,1,1
58063,2014/03/31,2011/11/27,202,3,0.7539938079999999,1938,202,1,2
58064,2014/03/31,2010/06/28,292,4,0.483444739,3022,292,2,2
58065,2014/03/31,2011/07/09,192,2,0.648442077,2253,192,0,2
58066,2014/03/31,2010/03/01,350,2,0.8804400240000001,1659,350,1,1
58067,2014/03/31,2011/10/08,568,3,0.75,1947,568,3,0
58068,2014/03/31,2012/11/11,269,3,0.375817246,3885,269,2,1
58069,2014/03/31,2013/03/11,114,3,0.333333333,4380,114,1,2
58070,2014/03/31,2012/08/01,389,2,0.5297351229999999,2756,389,2,0
58071,2014/03/31,2013/02/13,337,2,0.9,1622,337,0,2
58072,2014/03/31,2011/09/22,496,3,0.589104116,2478,496,3,0
58073,2014/03/31,2012/04/01,722,2,0.9,1622,722,2,0
58074,2014/03/31,2007/05/30,228,2,0.7574831340000001,1927,228,0,2
58075,2014/03/31,2013/03/17,323,2,0.425,3434,323,0,2
58076,2014/03/31,2013/01/14,254,2,0.51080154,2857,254,1,1
58077,2014/03/31,2012/04/29,549,2,0.6014432989999999,2425,549,2,0
58078,2014/03/31,2011/11/15,59,2,0.753664083,1935,59,0,2
58079,2014/03/31,2011/11/15,59,2,0.753664083,1935,59,0,2
58080,2014/03/31,2008/04/03,88,2,0.818271605,1782,88,0,2
58081,2014/03/31,2007/07/17,13,3,0.556666667,2619,13,0,3
58082,2014/03/31,2013/01/06,192,3,0.7066602040000001,2063,192,0,3
58083,2014/03/31,2011/09/03,94,2,0.530251,2749,94,1,1
58084,2014/03/31,2012/05/24,630,3,0.600494438,2427,630,3,0
58085,2014/03/31,2005/08/02,271,3,0.856666667,1701,271,0,3
58086,2014/03/31,2009/04/27,634,3,0.65,2241,634,3,0
58087,2014/03/31,2010/04/17,275,3,0.8112869079999999,1795,275,0,3
58088,2014/03/31,2010/11/12,305,3,0.484766977,3004,305,0,3
58089,2014/03/31,2011/09/24,673,2,1.0,1456,673,2,0
58090,2014/03/31,2012/06/09,658,2,0.8,1820,658,2,0
58091,2014/03/31,2012/06/09,658,2,0.8,1820,658,2,0
58092,2014/03/31,2011/10/24,692,2,1.0,1456,692,2,0
58093,2014/03/31,2012/12/22,456,2,1.0,1456,456,2,0
58094,2014/03/31,2011/05/24,468,2,1.0,1456,468,2,0
58095,2014/03/31,2011/06/23,44,5,0.502,2900,44,0,5
58096,2014/03/31,2011/09/25,65,2,0.478212878,3044,65,1,1
58097,2014/03/31,2006/07/22,104,2,0.37,3934,104,0,2
58098,2014/03/31,2007/10/08,150,2,0.37,3934,150,0,2
58099,2014/03/31,2012/06/29,313,4,0.5375,2708,313,3,1
58100,2014/03/31,2008/07/16,275,3,0.375416559,3877,275,1,2
58101,2014/03/31,2012/10/06,537,2,0.910131332,1599,537,2,0
58102,2014/03/31,2012/04/17,693,2,0.75,1940,693,2,0
58103,2014/03/31,2010/12/14,112,2,0.72,2020,112,0,2
58104,2014/03/31,2008/11/23,152,2,0.72,2020,152,0,2
58105,2014/03/31,2008/04/21,9,2,0.72,2020,9,0,2
58106,2014/03/31,2009/08/18,131,3,0.6142965779999999,2367,131,0,3
58107,2014/03/31,2005/02/09,308,2,0.35,4154,308,0,2
58108,2014/03/31,2013/02/11,345,2,0.35,4154,345,0,2
58109,2014/03/31,2008/12/07,315,2,0.35,4154,315,0,2
58110,2014/03/31,2012/10/24,511,2,0.4,3634,511,2,0
58111,2014/03/31,2006/09/22,480,2,0.623327616,2332,480,2,0
58112,2014/03/31,2012/10/24,511,2,0.4,3634,511,2,0
58113,2014/03/31,2009/07/26,91,3,0.6366666670000001,2283,91,1,2
58114,2014/03/31,2008/10/21,159,3,0.836666667,1737,159,0,3
58115,2014/03/31,2010/12/13,164,3,0.7742035159999999,1877,164,2,1
58116,2014/03/31,2012/02/21,324,3,0.885466179,1641,324,2,1
58117,2014/03/31,2005/10/25,144,2,0.34,4273,144,0,2
58118,2014/03/31,2012/04/22,584,2,0.8539682540000001,1701,584,2,0
58119,2014/03/31,2009/01/06,7,3,0.542499066,2677,7,2,1
58120,2014/03/31,2012/03/19,153,2,0.954113009,1522,153,1,1
58121,2014/03/31,2013/03/22,303,3,0.608273984,2387,303,0,3
58122,2014/03/31,2011/07/31,9,2,0.555,2616,9,0,2
58123,2014/03/31,2012/10/31,217,2,0.555,2616,217,0,2
58124,2014/03/31,2009/06/12,152,2,0.555,2616,152,0,2
58125,2014/03/31,2005/02/18,102,2,0.555,2616,102,0,2
58126,2014/03/31,2011/03/19,18,2,0.555,2616,18,0,2
58127,2014/03/31,2011/01/22,212,2,0.845,1718,212,0,2
58128,2014/03/31,2008/04/24,100,2,0.416676234,3484,100,1,1
58129,2014/03/31,2012/10/16,73,2,0.38,3820,73,0,2
58130,2014/03/31,2010/04/28,68,6,0.665524989,2181,68,2,4
58131,2014/03/31,2011/08/03,95,2,0.765553797,1896,95,0,2
58132,2014/03/31,2006/06/27,129,2,0.37581564,3862,129,1,1
58133,2014/03/31,2011/01/24,3,4,0.451836862,3212,3,2,2
58134,2014/03/31,2013/02/12,341,2,0.474558535,3058,341,1,1
58135,2014/03/31,2012/12/26,97,3,0.44536855,3256,97,0,3
58136,2014/03/31,2008/04/16,545,2,0.95,1526,545,2,0
58137,2014/03/31,2012/11/23,376,2,0.475,3052,376,2,0
58138,2014/03/31,2011/02/28,638,2,0.475,3052,638,2,0
58139,2014/03/31,2009/01/10,413,2,0.95,1526,413,2,0
58140,2014/03/31,2008/08/16,333,4,0.6,2416,333,1,3
58141,2014/03/31,2012/04/09,710,2,1.2,1208,710,2,0
58142,2014/03/31,2007/11/29,719,2,0.7589005240000001,1910,719,2,0
58143,2014/03/31,2009/07/28,67,2,0.6941810340000001,2088,67,1,1
58144,2014/03/31,2012/06/26,265,2,0.57352592,2527,265,1,1
58145,2014/03/31,2012/12/07,259,2,0.7128873590000001,2033,259,0,2
58146,2014/03/31,2012/03/25,596,3,0.8333525009999999,1739,596,3,0
58147,2014/03/31,2011/12/04,56,2,0.715585185,2025,56,0,2
58148,2014/03/31,2012/07/12,547,2,1.188269073,1219,547,2,0
58149,2014/03/31,2011/12/29,10,2,0.97278039,1489,10,1,1
58150,2014/03/31,2013/03/04,38,2,0.525,2758,38,0,2
58151,2014/03/31,2012/01/12,440,2,0.648075201,2234,440,2,0
58152,2014/03/31,2013/01/04,124,2,0.6835616440000001,2117,124,1,1
58153,2014/03/31,2013/01/04,124,2,0.6835616440000001,2117,124,1,1
58154,2014/03/31,2010/01/16,86,2,0.483018364,2995,86,1,1
58155,2014/03/31,2012/04/27,102,2,0.483018364,2995,102,1,1
58156,2014/03/31,2013/03/20,265,3,0.5550959320000001,2606,265,1,2
58157,2014/03/31,2012/08/14,22,6,0.5033333329999999,2874,22,1,5
58158,2014/03/31,2012/07/17,529,4,0.4,3616,529,4,0
58159,2014/03/31,2008/05/23,33,2,0.626344738,2309,33,0,2
58160,2014/03/31,2006/07/06,524,3,0.8392919329999999,1723,524,3,0
58161,2014/03/31,2010/03/07,452,3,0.6333333329999999,2283,452,3,0
58162,2014/03/31,2012/10/15,533,2,0.95,1522,533,2,0
58163,2014/03/31,2007/11/23,491,2,0.95,1522,491,2,0
58164,2014/03/31,2007/05/27,702,2,0.95,1522,702,2,0
58165,2014/03/31,2012/09/25,267,3,0.446666667,3237,267,2,1
58166,2014/03/31,2012/07/21,477,2,0.783577236,1845,477,2,0
58167,2014/03/31,2012/11/20,88,2,0.693247002,2085,88,0,2
58168,2014/03/31,2012/11/21,493,2,0.825,1752,493,2,0
58169,2014/03/31,2011/02/24,609,3,0.7333333329999999,1971,609,3,0
58170,2014/03/31,2009/11/05,144,2,0.721247505,2004,144,0,2
58171,2014/03/31,2013/02/24,49,3,0.7614594309999999,1898,49,0,3
58172,2014/03/31,2011/07/18,6,4,0.441294656,3275,6,0,4
58173,2014/03/31,2007/04/12,37,2,0.67,2157,37,0,2
58174,2014/03/31,2009/03/18,168,2,0.525,2752,168,0,2
58175,2014/03/31,2011/07/20,48,2,0.909068597,1589,48,0,2
58176,2014/03/31,2011/12/08,6,2,0.504259777,2864,6,1,1
58177,2014/03/31,2008/06/28,156,3,0.681160377,2120,156,0,3
58178,2014/03/31,2009/08/20,655,3,0.70338529,2053,655,3,0
58179,2014/03/31,2010/08/19,599,4,0.95,1520,599,4,0
58180,2014/03/31,2011/09/26,66,2,0.613941327,2352,66,0,2
58181,2014/03/31,2006/03/10,377,2,0.525,2750,377,2,0
58182,2014/03/31,2013/02/11,173,3,0.259363881,5565,173,2,1
58183,2014/03/31,2013/02/27,361,2,0.925721616,1559,361,1,1
58184,2014/03/31,2009/03/30,413,2,0.925721616,1559,413,2,0
58185,2014/03/31,2009/04/21,371,3,0.349951503,4124,371,3,0
58186,2014/03/31,2012/12/15,310,2,0.542443609,2660,310,1,1
58187,2014/03/31,2008/08/02,3,3,0.493447332,2924,3,0,3
58188,2014/03/31,2012/01/26,487,2,0.732385787,1970,487,2,0
58189,2014/03/31,2009/02/16,249,2,0.911795196,1582,249,1,1
58190,2014/03/31,2007/06/23,351,2,0.617137356,2337,351,1,1
58191,2014/03/31,2007/11/28,646,3,0.552143951,2612,646,3,0
58192,2014/03/31,2012/06/22,646,2,0.55,2622,646,2,0
58193,2014/03/31,2009/02/05,382,2,0.95,1518,382,2,0
58194,2014/03/31,2009/08/15,404,2,1.0,1442,404,2,0
58195,2014/03/31,2011/09/02,29,2,0.656851936,2195,29,0,2
58196,2014/03/31,2009/02/07,197,3,0.763831479,1887,197,2,1
58197,2014/03/31,2009/04/06,531,2,0.6299169579999999,2288,531,2,0
58198,2014/03/31,2007/11/08,125,3,0.3650443370000001,3947,125,1,2
58199,2014/03/31,2012/06/10,470,2,0.809780776,1779,470,2,0
58200,2014/03/31,2008/10/29,501,2,0.825,1746,501,2,0
58201,2014/03/31,2013/03/14,346,2,0.375652061,3834,346,1,1
58202,2014/03/31,2006/10/20,16,3,0.846666667,1701,16,1,2
58203,2014/03/31,2012/12/03,373,2,0.5,2880,373,2,0
58204,2014/03/31,2012/08/30,568,2,0.5,2880,568,2,0
58205,2014/03/31,2013/02/11,348,2,1.0,1440,348,0,2
58206,2014/03/31,2012/04/19,664,2,0.775,1858,664,2,0
58207,2014/03/31,2012/03/16,188,2,0.7425270759999999,1939,188,0,2
58208,2014/03/31,2012/07/27,200,3,0.374787816,3841,200,1,2
58209,2014/03/31,2010/10/28,708,2,0.489041794,2943,708,2,0
58210,2014/03/31,2012/05/29,136,3,0.876516443,1642,136,0,3
58211,2014/03/31,2012/04/08,596,2,0.55,2616,596,2,0
58212,2014/03/31,2012/04/24,316,2,0.55,2616,316,1,1
58213,2014/03/31,2013/02/12,19,2,0.55,2616,19,0,2
58214,2014/03/31,2012/09/11,329,2,0.55,2616,329,0,2
58215,2014/03/31,2011/05/22,388,2,0.55,2616,388,2,0
58216,2014/03/31,2004/12/10,87,2,0.55,2616,87,0,2
58217,2014/03/31,2012/11/23,491,2,0.25,5754,491,2,0
58218,2014/03/31,2010/05/13,271,2,0.520141049,2765,271,1,1
58219,2014/03/31,2012/05/10,137,3,0.6882814740000001,2089,137,2,1
58220,2014/03/31,2012/04/14,665,2,0.505878212,2841,665,2,0
58221,2014/03/31,2012/08/19,143,2,0.970398379,1481,143,1,1
58222,2014/03/31,2009/07/16,137,2,0.467922501,3071,137,0,2
58223,2014/03/31,2007/12/25,8,2,0.45588702,3151,8,0,2
58224,2014/03/31,2011/01/13,406,2,0.6,2394,406,2,0
58225,2014/03/31,2009/10/06,670,2,1.0,1436,670,2,0
58226,2014/03/31,2009/02/03,382,2,0.618965517,2320,382,2,0
58227,2014/03/31,2007/03/06,434,3,0.877750611,1636,434,3,0
58228,2014/03/31,2011/08/26,343,3,0.408231447,3517,343,2,1
58229,2014/03/31,2005/08/16,301,3,0.471659001,3044,301,0,3
58230,2014/03/31,2010/02/09,4,3,0.350417379,4097,4,0,3
58231,2014/03/31,2012/12/26,46,3,0.396125828,3624,46,0,3
58232,2014/03/31,2008/04/03,639,2,0.825,1740,639,2,0
58233,2014/03/31,2013/01/16,434,2,0.75,1914,434,2,0
58234,2014/03/31,2010/04/10,330,2,0.577433628,2486,330,0,2
58235,2014/03/31,2009/02/09,95,2,0.34,4222,95,0,2
58236,2014/03/31,2007/04/28,184,2,0.665,2158,184,0,2
58237,2014/03/31,2007/12/16,452,2,0.50262697,2855,452,2,0
58238,2014/03/31,2005/07/29,64,2,0.6422694720000001,2234,64,1,1
58239,2014/03/31,2011/08/09,32,3,0.557609794,2573,32,0,3
58240,2014/03/31,2011/09/30,68,3,0.427891441,3353,68,2,1
58241,2014/03/31,2012/03/14,210,3,0.385874126,3718,210,1,2
58242,2014/03/31,2010/06/06,84,2,0.446242613,3215,84,0,2
58243,2014/03/31,2012/03/15,2,2,0.6579999999999999,2180,2,0,2
58244,2014/03/31,2009/12/13,241,3,0.494858523,2898,241,0,3
58245,2014/03/31,2013/03/21,23,2,0.6,2390,23,0,2
58246,2014/03/31,2006/01/29,715,2,0.6,2390,715,2,0
58247,2014/03/31,2008/03/11,31,5,0.640406431,2239,31,1,4
58248,2014/03/31,2012/10/29,518,2,0.45,3186,518,2,0
58249,2014/03/31,2009/11/22,442,2,0.935770235,1532,442,2,0
58250,2014/03/31,2012/09/05,516,3,0.697663096,2054,516,3,0
58251,2014/03/31,2011/07/04,26,2,0.589687243,2430,26,0,2
58252,2014/03/31,2011/11/20,350,2,0.833081395,1720,350,1,1
58253,2014/03/31,2011/07/26,19,2,0.6482805429999999,2210,19,0,2
58254,2014/03/31,2008/02/14,57,2,0.58,2470,57,0,2
58255,2014/03/31,2009/01/27,376,2,0.375,3820,376,2,0
58256,2014/03/31,2006/05/17,606,3,0.72949567,1963,606,3,0
58257,2014/03/31,2013/03/31,89,3,0.28,5114,89,0,3
58258,2014/03/31,2007/11/06,381,4,0.5375,2664,381,4,0
58259,2014/03/31,2010/02/10,1,2,0.82,1746,1,0,2
58260,2014/03/31,2013/01/28,47,2,0.918280949,1559,47,1,1
58261,2014/03/31,2012/12/28,79,2,0.751401575,1905,79,1,1
58262,2014/03/31,2007/06/01,350,3,0.458782051,3120,350,2,1
58263,2014/03/31,2010/01/05,217,2,0.7271646340000001,1968,217,0,2
58264,2014/03/31,2009/05/25,158,2,0.52,2752,158,1,1
58265,2014/03/31,2009/08/18,157,3,0.34666666700000004,4128,157,0,3
58266,2014/03/31,2010/05/10,136,2,0.65605227,2181,136,0,2
58267,2014/03/31,2012/04/20,60,3,0.823333333,1737,60,1,2
58268,2014/03/31,2011/07/20,63,2,0.912610083,1567,63,0,2
58269,2014/03/31,2009/07/11,487,4,0.435062367,3287,487,4,0
58270,2014/03/31,2007/05/10,531,2,0.609224542,2347,531,2,0
58271,2014/03/31,2008/11/03,126,2,0.630705779,2267,126,0,2
58272,2014/03/31,2010/06/19,139,2,0.519869091,2750,139,1,1
58273,2014/03/31,2011/08/28,268,3,0.755581395,1892,268,0,3
58274,2014/03/31,2008/05/26,66,2,0.46,3106,66,0,2
58275,2014/03/31,2012/03/29,253,2,0.790641948,1807,253,0,2
58276,2014/03/31,2007/09/03,613,2,0.462666019,3087,613,2,0
58277,2014/03/31,2011/03/30,560,2,0.47839196,2985,560,2,0
58278,2014/03/31,2012/09/12,480,2,1.1,1298,480,2,0
58279,2014/03/31,2011/10/02,27,2,0.605,2360,27,0,2
58280,2014/03/31,2011/01/06,589,3,0.7333333329999999,1947,589,3,0
58281,2014/03/31,2012/03/01,84,3,0.40706872,3507,84,1,2
58282,2014/03/31,2013/01/17,165,2,0.55927116,2552,165,1,1
58283,2014/03/31,2006/11/12,296,2,0.34,4196,296,0,2
58284,2014/03/31,2012/08/02,420,3,0.981017882,1454,420,3,0
58285,2014/03/31,2009/10/17,117,3,0.577315789,2470,117,1,2
58286,2014/03/31,2012/05/15,220,2,0.38,3752,220,0,2
58287,2014/03/31,2013/01/05,301,3,0.621473409,2294,301,2,1
58288,2014/03/31,2009/03/01,346,5,0.8,1782,346,3,2
58289,2014/03/31,2012/12/11,229,2,0.693620438,2055,229,0,2
58290,2014/03/31,2008/06/07,99,3,0.604478372,2358,99,0,3
58291,2014/03/31,2007/11/06,426,2,0.812136752,1755,426,2,0
58292,2014/03/31,2011/07/09,229,2,0.357282527,3989,229,1,1
58293,2014/03/31,2012/03/16,686,2,0.4,3562,686,2,0
58294,2014/03/31,2010/04/14,147,2,0.8835421840000001,1612,147,1,1
58295,2014/03/31,2013/01/04,289,2,0.705,2020,289,0,2
58296,2014/03/31,2009/07/21,139,2,0.705,2020,139,0,2
58297,2014/03/31,2011/03/15,222,2,0.49,2906,222,0,2
58298,2014/03/31,2009/11/18,184,2,0.778944201,1828,184,1,1
58299,2014/03/31,2012/04/30,674,2,0.7,2034,674,2,0
58300,2014/03/31,2012/01/18,712,2,0.857590361,1660,712,2,0
58301,2014/03/31,2012/10/10,232,3,0.521528032,2729,232,1,2
58302,2014/03/31,2012/02/06,602,3,0.579007323,2458,602,3,0
58303,2014/03/31,2012/06/05,237,2,0.690485437,2060,237,1,1
58304,2014/03/31,2007/08/17,706,3,0.494747826,2875,706,3,0
58305,2014/03/31,2009/11/26,75,9,0.858888889,1656,75,6,3
58306,2014/03/31,2009/10/27,134,3,0.576122366,2468,134,2,1
58307,2014/03/31,2012/05/15,145,2,0.6011923889999999,2365,145,0,2
58308,2014/03/31,2011/12/06,330,2,0.88133912,1613,330,0,2
58309,2014/03/31,2010/07/08,686,3,0.5643509329999999,2519,686,3,0
58310,2014/03/31,2006/07/21,276,2,0.8030508470000001,1770,276,1,1
58311,2014/03/31,2007/07/01,23,5,0.748,1900,23,0,5
58312,2014/03/31,2006/03/05,176,3,0.34772449200000005,4087,176,0,3
58313,2014/03/31,2012/02/17,61,2,0.563403411,2521,61,0,2
58314,2014/03/31,2005/03/24,30,2,0.827651515,1716,30,0,2
58315,2014/03/31,2011/02/03,479,2,0.521958839,2721,479,2,0
58316,2014/03/31,2012/04/20,672,2,0.916817301,1549,672,2,0
58317,2014/03/31,2009/10/03,281,3,0.569130261,2495,281,2,1
58318,2014/03/31,2007/05/14,142,3,0.4548046120000001,3122,142,1,2
58319,2014/03/31,2010/07/22,137,2,0.495,2868,137,1,1
58320,2014/03/31,2007/04/21,164,2,0.671494797,2114,164,0,2
58321,2014/03/31,2007/04/08,77,3,0.7768253970000001,1827,77,0,3
58322,2014/03/31,2010/09/28,523,2,0.8,1774,523,2,0
58323,2014/03/31,2012/07/01,603,2,0.8,1774,603,2,0
58324,2014/03/31,2010/01/13,359,3,0.533333333,2661,359,2,1
58325,2014/03/31,2004/12/03,422,2,0.8,1774,422,2,0
58326,2014/03/31,2011/03/30,251,2,0.946133333,1500,251,1,1
58327,2014/03/31,2011/02/08,69,3,0.677070611,2096,69,0,3
58328,2014/03/31,2012/10/20,413,2,0.797639123,1779,413,2,0
58329,2014/03/31,2011/06/22,68,2,0.8311950790000001,1707,68,0,2
58330,2014/03/31,2007/06/05,326,2,0.68078215,2084,326,0,2
58331,2014/03/31,2006/09/22,545,2,0.938293651,1512,545,2,0
58332,2014/03/31,2013/01/18,428,2,0.938293651,1512,428,2,0
58333,2014/03/31,2012/11/02,225,2,0.585140264,2424,225,0,2
58334,2014/03/31,2010/04/20,683,2,0.843664485,1681,683,2,0
58335,2014/03/31,2013/01/12,156,2,0.76,1866,156,1,1
58336,2014/03/31,2008/04/02,209,2,0.76,1866,209,1,1
58337,2014/03/31,2012/04/07,637,2,0.52247605,2714,637,2,0
58338,2014/03/31,2013/02/15,44,3,0.883271028,1605,44,0,3
58339,2014/03/31,2009/05/17,713,2,1.25,1134,713,2,0
58340,2014/03/31,2006/03/16,2,2,0.6287577639999999,2254,2,0,2
58341,2014/03/31,2007/03/13,7,10,0.77,1840,7,6,4
58342,2014/03/31,2012/01/28,26,2,0.52201916,2714,26,1,1
58343,2014/03/31,2012/12/25,332,3,0.316875419,4471,332,1,2
58344,2014/03/31,2010/05/03,13,2,0.31,4570,13,0,2
58345,2014/03/31,2012/10/02,116,4,0.5057372370000001,2801,116,2,2
58346,2014/03/31,2012/11/12,498,2,0.774466922,1829,498,2,0
58347,2014/03/31,2011/09/10,328,2,0.625,2266,328,1,1
58348,2014/03/31,2008/08/19,35,2,0.625,2266,35,0,2
58349,2014/03/31,2006/08/01,8,2,0.36,3934,8,0,2
58350,2014/03/31,2011/11/07,167,2,0.36,3934,167,0,2
58351,2014/03/31,2010/11/12,494,2,0.640235081,2212,494,2,0
58352,2014/03/31,2013/03/27,180,2,0.265,5344,180,0,2
58353,2014/03/31,2011/11/25,162,2,0.563501791,2513,162,0,2
58354,2014/03/31,2012/08/10,57,3,0.36,3933,57,0,3
58355,2014/03/31,2011/12/01,610,4,0.516380883,2741,610,4,0
58356,2014/03/31,2007/10/29,337,2,1.0,1415,337,1,1
58357,2014/03/31,2004/11/30,713,2,1.0,1415,713,2,0
58358,2014/03/31,2012/01/14,554,2,0.6560037089999999,2157,554,2,0
58359,2014/03/31,2013/02/12,92,2,0.542523006,2608,92,0,2
58360,2014/03/31,2012/04/23,142,3,0.596424958,2372,142,0,3
58361,2014/03/31,2009/10/29,476,2,0.55,2572,476,2,0
58362,2014/03/31,2011/04/18,687,2,0.55,2572,687,2,0
58363,2014/03/31,2011/05/05,380,2,0.681710843,2075,380,2,0
58364,2014/03/31,2013/01/02,73,2,0.762815534,1854,73,0,2
58365,2014/03/31,2013/03/07,264,2,0.642668182,2200,264,1,1
58366,2014/03/31,2012/10/11,534,2,0.650575242,2173,534,2,0
58367,2014/03/31,2013/03/12,61,3,0.45,3141,61,0,3
58368,2014/03/31,2010/07/12,587,2,0.7293085659999999,1938,587,2,0
58369,2014/03/31,2012/11/26,434,2,0.83184226,1699,434,2,0
58370,2014/03/31,2009/01/10,457,2,0.7709492640000001,1833,457,2,0
58371,2014/03/31,2011/05/19,692,2,1.5,942,692,2,0
58372,2014/03/31,2012/09/26,487,2,0.6624472570000001,2133,487,2,0
58373,2014/03/31,2006/10/16,272,2,0.422800718,3342,272,1,1
58374,2014/03/31,2012/10/11,219,3,0.36,3924,219,2,1
58375,2014/03/31,2011/11/10,143,2,0.680419075,2076,143,1,1
58376,2014/03/31,2008/11/01,117,2,0.34,4154,117,0,2
58377,2014/03/31,2013/03/26,96,3,0.517723607,2728,96,0,3
58378,2014/03/31,2008/04/27,44,2,0.945,1494,44,0,2
58379,2014/03/31,2013/03/14,20,3,0.697937685,2022,20,1,2
58380,2014/03/31,2011/02/22,583,3,0.460692132,3063,583,3,0
58381,2014/03/31,2007/12/11,421,2,0.875853507,1611,421,2,0
58382,2014/03/31,2008/09/25,2,3,0.383161325,3682,2,0,3
58383,2014/03/31,2012/05/03,346,2,0.719403366,1961,346,1,1
58384,2014/03/31,2013/01/01,90,3,0.509848211,2767,90,1,2
58385,2014/03/31,2012/08/07,443,3,0.403402917,3497,443,3,0
58386,2014/03/31,2012/03/25,332,3,0.536777017,2628,332,1,2
58387,2014/03/31,2007/06/03,568,2,0.642460137,2195,568,2,0
58388,2014/03/31,2006/06/08,430,2,0.896819338,1572,430,2,0
58389,2014/03/31,2013/02/26,391,2,0.8,1762,391,2,0
58390,2014/03/31,2006/02/20,270,2,0.637647059,2210,270,1,1
58391,2014/03/31,2012/05/03,30,2,0.52,2710,30,1,1
58392,2014/03/31,2009/11/04,613,2,0.864478528,1630,613,2,0
58393,2014/03/31,2011/01/25,155,3,0.413117302,3410,155,1,2
58394,2014/03/31,2009/01/15,90,2,0.33992278,4144,90,0,2
58395,2014/03/31,2010/12/06,42,3,0.42260126,3333,42,0,3
58396,2014/03/31,2012/10/17,292,2,0.867781885,1623,292,1,1
58397,2014/03/31,2011/06/11,116,3,0.400466439,3516,116,0,3
58398,2014/03/31,2008/03/05,443,2,0.5,2816,443,2,0
58399,2014/03/31,2012/12/10,448,2,0.384211245,3664,448,2,0
58400,2014/03/31,2007/09/23,209,2,0.755918367,1862,209,1,1
58401,2014/03/31,2012/10/16,23,2,0.406180716,3464,23,0,2
58402,2014/03/31,2011/03/08,105,2,0.535565284,2627,105,0,2
58403,2014/03/31,2013/03/26,86,3,0.648584601,2169,86,0,3
58404,2014/03/31,2005/12/25,97,3,0.6949703559999999,2024,97,1,2
58405,2014/03/31,2011/06/21,227,4,0.443582466,3171,227,2,2
58406,2014/03/31,2008/11/02,139,2,0.54,2604,139,0,2
58407,2014/03/31,2012/12/26,234,2,0.535188428,2627,234,0,2
58408,2014/03/31,2008/09/02,346,2,0.903470437,1556,346,1,1
58409,2014/03/31,2012/05/01,697,2,0.6,2342,697,2,0
58410,2014/03/31,2009/11/23,185,2,0.716404895,1961,185,0,2
58411,2014/03/31,2012/08/07,151,3,0.404276259,3475,151,0,3
58412,2014/03/31,2011/09/03,347,3,0.438604433,3203,347,0,3
58413,2014/03/31,2010/04/23,13,2,0.58,2422,13,0,2
58414,2014/03/31,2007/11/05,22,4,0.394539326,3560,22,1,3
58415,2014/03/31,2005/09/02,572,2,0.347279921,4044,572,2,0
58416,2014/03/31,2005/12/22,61,2,0.887692794,1582,61,1,1
58417,2014/03/31,2010/11/01,291,2,0.92,1526,291,0,2
58418,2014/03/31,2008/06/27,100,2,0.695,2020,100,0,2
58419,2014/03/31,2010/06/10,37,2,0.505,2780,37,0,2
58420,2014/03/31,2010/08/12,3,2,0.505,2780,3,0,2
58421,2014/03/31,2012/04/15,251,2,0.467422577,3003,251,0,2
58422,2014/03/31,2005/09/23,57,2,0.769342105,1824,57,0,2
58423,2014/03/31,2012/03/03,57,2,0.64,2192,57,1,1
58424,2014/03/31,2008/05/21,171,2,0.715,1962,171,0,2
58425,2014/03/31,2011/11/12,597,2,0.65,2158,597,2,0
58426,2014/03/31,2013/01/11,416,2,0.65,2158,416,2,0
58427,2014/03/31,2011/11/08,398,3,0.5,2805,398,3,0
58428,2014/03/31,2012/10/03,334,2,0.75,1870,334,0,2
58429,2014/03/31,2011/07/01,373,2,0.75,1870,373,2,0
58430,2014/03/31,2008/09/05,698,2,0.4,3503,698,2,0
58431,2014/03/31,2010/01/03,588,2,0.7148469390000001,1960,588,2,0
58432,2014/03/31,2008/08/21,196,2,0.75,1867,196,1,1
58433,2014/03/31,2012/03/08,539,2,0.5120153620000001,2734,539,2,0
58434,2014/03/31,2012/12/26,143,2,0.434965817,3218,143,1,1
58435,2014/03/31,2011/12/10,681,2,0.887507926,1577,681,2,0
58436,2014/03/31,2010/06/12,325,2,0.887507926,1577,325,1,1
58437,2014/03/31,2011/09/15,56,2,0.274427451,5100,56,0,2
58438,2014/03/31,2007/10/17,128,2,0.535,2616,128,0,2
58439,2014/03/31,2013/03/14,370,2,0.75,1866,370,2,0
58440,2014/03/31,2007/11/09,677,2,0.75,1866,677,2,0
58441,2014/03/31,2013/01/12,343,2,0.75,1866,343,1,1
58442,2014/03/31,2006/07/03,195,2,0.585,2392,195,0,2
58443,2014/03/31,2011/11/01,578,2,0.6794560470000001,2059,578,2,0
58444,2014/03/31,2011/01/14,114,2,0.589519595,2373,114,1,1
58445,2014/03/31,2012/10/31,330,4,0.525,2664,330,2,2
58446,2014/03/31,2009/03/03,20,2,0.512105456,2731,20,1,1
58447,2014/03/31,2009/04/06,282,2,0.65751763,2127,282,1,1
58448,2014/03/31,2011/03/29,155,4,0.360955085,3874,155,1,3
58449,2014/03/31,2012/04/03,161,2,0.936997319,1492,161,1,1
58450,2014/03/31,2013/02/02,424,2,0.764688184,1828,424,2,0
58451,2014/03/31,2010/02/05,60,2,0.94,1486,60,1,1
58452,2014/03/31,2006/06/06,586,2,0.7477516059999999,1868,586,2,0
58453,2014/03/31,2012/12/20,262,2,0.8,1746,262,1,1
58454,2014/03/31,2008/09/12,533,2,0.8,1746,533,2,0
58455,2014/03/31,2012/05/18,426,4,0.4,3492,426,4,0
58456,2014/03/31,2012/05/09,693,2,0.4,3491,693,2,0
58457,2014/03/31,2011/04/15,703,2,0.923412698,1512,703,2,0
58458,2014/03/31,2012/05/20,680,2,0.65,2148,680,2,0
58459,2014/03/31,2007/06/21,28,2,0.696586826,2004,28,0,2
58460,2014/03/31,2011/12/07,277,2,0.429065478,3253,277,0,2
58461,2014/03/31,2011/02/05,483,2,0.5462230920000001,2555,483,2,0
58462,2014/03/31,2005/08/10,390,2,0.657324541,2123,390,2,0
58463,2014/03/31,2009/08/27,397,2,0.8,1744,397,2,0
58464,2014/03/31,2012/05/01,540,2,0.8,1744,540,2,0
58465,2014/03/31,2011/11/20,468,2,0.605777585,2302,468,2,0
58466,2014/03/31,2013/02/06,15,2,0.34,4100,15,0,2
58467,2014/03/31,2012/07/06,93,2,0.34,4100,93,0,2
58468,2014/03/31,2009/04/03,255,2,0.34,4100,255,0,2
58469,2014/03/31,2012/09/06,97,3,0.520074655,2679,97,2,1
58470,2014/03/31,2013/03/11,51,4,0.5775,2412,51,0,4
58471,2014/03/31,2010/06/27,163,4,0.361463794,3853,163,2,2
58472,2014/03/31,2008/03/03,225,2,0.785,1774,225,0,2
58473,2014/03/31,2007/05/03,359,2,0.425,3276,359,0,2
58474,2014/03/31,2011/05/26,583,3,0.8,1740,583,3,0
58475,2014/03/31,2006/07/30,511,3,0.459389439,3030,511,3,0
58476,2014/03/31,2012/08/19,580,2,0.475,2930,580,2,0
58477,2014/03/31,2013/03/19,179,2,0.565030451,2463,179,0,2
58478,2014/03/31,2009/06/09,668,2,0.364102564,3822,668,2,0
58479,2014/03/31,2011/06/05,209,3,0.412994954,3369,209,1,2
58480,2014/03/31,2007/04/06,686,3,1.041317365,1336,686,3,0
58481,2014/03/31,2012/01/13,399,2,0.796792669,1746,399,2,0
58482,2014/03/31,2012/06/19,152,2,0.399948246,3478,152,0,2
58483,2014/03/31,2006/06/03,19,2,0.485,2868,19,0,2
58484,2014/03/31,2009/08/11,12,2,0.58,2398,12,0,2
58485,2014/03/31,2012/10/05,137,3,0.396068376,3510,137,1,2
58486,2014/03/31,2006/03/16,569,2,0.5,2780,569,2,0
58487,2014/03/31,2012/12/05,320,2,0.5,2780,320,1,1
58488,2014/03/31,2011/10/11,573,2,0.5,2780,573,2,0
58489,2014/03/31,2012/08/15,333,2,0.530534351,2620,333,1,1
58490,2014/03/31,2007/12/19,158,2,0.907193211,1532,158,0,2
58491,2014/03/31,2012/01/10,641,3,0.8,1737,641,3,0
58492,2014/03/31,2012/11/24,490,2,0.7,1985,490,2,0
58493,2014/03/31,2012/12/12,472,2,0.7,1985,472,2,0
58494,2014/03/31,2010/07/01,498,2,0.7,1985,498,2,0
58495,2014/03/31,2012/12/11,24,2,0.6933483029999999,2004,24,0,2
58496,2014/03/31,2011/01/21,30,2,0.915,1518,30,0,2
58497,2014/03/31,2013/02/21,399,2,0.912952005,1521,399,2,0
58498,2014/03/31,2013/03/01,356,2,0.4,3471,356,0,2
58499,2014/03/31,2010/05/12,560,2,0.888291747,1563,560,2,0
58500,2014/03/31,2011/03/28,7,3,0.42030881,3303,7,0,3
58501,2014/03/31,2009/03/28,362,3,0.4289799070000001,3235,362,1,2
58502,2014/03/31,2008/12/09,5,2,0.604372822,2296,5,0,2
58503,2014/03/31,2011/03/25,20,3,0.34,4081,20,0,3
58504,2014/03/31,2013/02/08,36,10,0.754,1840,36,2,8
58505,2014/03/31,2012/05/08,662,2,0.872876023,1589,662,2,0
58506,2014/03/31,2009/09/18,601,2,0.45,3082,601,2,0
58507,2014/03/31,2012/04/11,555,2,0.575,2412,555,2,0
58508,2014/03/31,2011/01/04,192,3,0.66326638,2091,192,0,3
58509,2014/03/31,2006/10/02,184,2,0.6,2310,184,0,2
58510,2014/03/31,2012/03/29,569,2,0.666346154,2080,569,2,0
58511,2014/03/31,2012/04/29,49,2,0.917781457,1510,49,1,1
58512,2014/03/31,2011/12/22,37,4,0.4327170520000001,3202,37,1,3
58513,2014/03/31,2011/05/07,242,2,0.908511475,1525,242,0,2
58514,2014/03/31,2012/01/06,468,2,1.0,1385,468,2,0
58515,2014/03/31,2008/11/01,58,3,0.548692552,2524,58,2,1
58516,2014/03/31,2006/08/14,15,3,0.6945358759999999,1993,15,0,3
58517,2014/03/31,2006/10/23,159,2,0.685,2020,159,0,2
58518,2014/03/31,2012/03/25,496,3,0.515251397,2685,496,3,0
58519,2014/03/31,2012/02/28,678,2,0.540390625,2560,678,2,0
58520,2014/03/31,2012/03/10,232,2,0.6225697570000001,2222,232,0,2
58521,2014/03/31,2008/11/18,370,3,0.6145268770000001,2251,370,3,0
58522,2014/03/31,2007/12/15,669,2,0.95,1456,669,2,0
58523,2014/03/31,2008/04/15,37,2,0.95,1456,37,0,2
58524,2014/03/31,2007/10/31,5,3,0.539457878,2564,5,0,3
58525,2014/03/31,2007/06/13,130,3,0.651743638,2122,130,0,3
58526,2014/03/31,2009/07/27,578,2,0.5479397779999999,2524,578,2,0
58527,2014/03/31,2008/02/10,239,2,0.538135461,2569,239,0,2
58528,2014/03/31,2006/04/10,274,2,0.608731836,2271,274,0,2
58529,2014/03/31,2009/03/01,562,2,0.42251605,3271,562,2,0
58530,2014/03/31,2012/03/26,26,3,0.371710597,3718,26,0,3
58531,2014/03/31,2006/11/26,120,4,0.723518325,1910,120,3,1
58532,2014/03/31,2011/05/14,138,3,0.408368794,3384,138,1,2
58533,2014/03/31,2004/12/20,674,3,0.385144928,3588,674,3,0
58534,2014/03/31,2007/06/09,81,2,0.713242127,1937,81,0,2
58535,2014/03/31,2011/03/24,88,3,0.34216002,4037,88,1,2
58536,2014/03/31,2012/03/03,339,2,0.575301958,2401,339,1,1
58537,2014/03/31,2008/01/24,137,2,0.450923931,3063,137,0,2
58538,2014/03/31,2006/06/17,78,5,0.504,2740,78,1,4
58539,2014/03/31,2009/03/18,168,4,0.63,2192,168,2,2
58540,2014/03/31,2009/03/13,127,3,0.522668433,2642,127,0,3
58541,2014/03/31,2008/04/18,280,3,0.841462523,1641,280,0,3
58542,2014/03/31,2011/01/04,131,2,0.473584906,2915,131,0,2
58543,2014/03/31,2011/09/14,215,2,0.519932203,2655,215,0,2
58544,2014/03/31,2011/02/28,632,2,1.0,1380,632,2,0
58545,2014/03/31,2007/06/19,444,2,1.0,1380,444,2,0
58546,2014/03/31,2011/06/02,637,2,1.0,1380,637,2,0
58547,2014/03/31,2012/08/14,401,2,1.0,1380,401,2,0
58548,2014/03/31,2012/07/15,568,2,1.0,1380,568,2,0
58549,2014/03/31,2013/01/10,348,2,1.0,1380,348,1,1
58550,2014/03/31,2005/12/24,607,2,1.0,1380,607,2,0
58551,2014/03/31,2006/10/25,655,2,1.0,1380,655,2,0
58552,2014/03/31,2012/10/23,522,2,1.0,1380,522,2,0
58553,2014/03/31,2010/12/13,721,2,1.0,1380,721,2,0
58554,2014/03/31,2011/12/03,658,2,1.0,1380,658,2,0
58555,2014/03/31,2012/10/10,486,2,1.0,1380,486,2,0
58556,2014/03/31,2006/05/18,581,2,1.0,1380,581,2,0
58557,2014/03/31,2010/08/28,393,2,1.0,1380,393,2,0
58558,2014/03/31,2005/12/01,377,2,1.0,1380,377,2,0
58559,2014/03/31,2012/07/27,576,2,1.0,1380,576,2,0
58560,2014/03/31,2007/02/17,515,2,1.0,1380,515,2,0
58561,2014/03/31,2010/12/26,469,2,1.0,1380,469,2,0
58562,2014/03/31,2011/09/28,359,2,1.0,1380,359,0,2
58563,2014/03/31,2012/05/15,684,2,1.0,1380,684,2,0
58564,2014/03/31,2011/01/15,686,2,1.0,1380,686,2,0
58565,2014/03/31,2010/03/22,430,3,0.833333333,1656,430,3,0
58566,2014/03/31,2012/10/26,381,2,1.0,1380,381,2,0
58567,2014/03/31,2012/06/17,621,2,0.876747141,1574,621,2,0
58568,2014/03/31,2011/06/09,594,2,1.0,1380,594,2,0
58569,2014/03/31,2009/04/02,560,2,1.0,1380,560,2,0
58570,2014/03/31,2009/09/13,702,2,1.0,1380,702,2,0
58571,2014/03/31,2010/11/30,60,6,0.445864297,3095,60,0,6
58572,2014/03/31,2011/07/25,12,2,0.7216108790000001,1912,12,0,2
58573,2014/03/31,2012/12/28,419,2,0.5156261679999999,2675,419,2,0
58574,2014/03/31,2011/11/03,282,2,0.659292543,2092,282,1,1
58575,2014/03/31,2011/09/30,480,2,0.85,1622,480,2,0
58576,2014/03/31,2012/03/19,729,2,0.85,1622,729,2,0
58577,2014/03/31,2007/05/02,23,2,0.541433621,2546,23,0,2
58578,2014/03/31,2008/07/22,131,2,0.5012295379999999,2749,131,1,1
58579,2014/03/31,2012/01/15,14,3,0.557773279,2470,14,0,3
58580,2014/03/31,2013/01/15,47,3,0.31265547,4406,47,1,2
58581,2014/03/31,2009/06/18,282,3,0.577994125,2383,282,1,2
58582,2014/03/31,2010/06/14,304,3,0.76,1812,304,2,1
58583,2014/03/31,2012/01/25,24,2,0.540871956,2546,24,0,2
58584,2014/03/31,2010/04/05,178,2,0.35,3934,178,1,1
58585,2014/03/31,2011/09/28,38,3,0.35,3933,38,0,3
58586,2014/03/31,2007/04/01,196,2,0.5,2752,196,0,2
58587,2014/03/31,2005/04/08,136,5,0.28894162100000004,4762,136,2,3
58588,2014/03/31,2006/04/03,268,2,0.457109635,3010,268,1,1
58589,2014/03/31,2010/03/31,2,3,0.706666667,1947,2,0,3
58590,2014/03/31,2012/02/19,147,2,0.29,4744,147,0,2
58591,2014/03/31,2012/08/11,279,2,0.491866285,2797,279,0,2
58592,2014/03/31,2011/12/17,631,3,0.6,2292,631,3,0
58593,2014/03/31,2012/12/27,298,2,0.8525604459999999,1613,298,0,2
58594,2014/03/31,2012/04/05,442,3,0.333333333,4125,442,3,0
58595,2014/03/31,2011/06/01,56,2,0.615443151,2234,56,1,1
58596,2014/03/31,2012/05/17,317,3,0.5166666670000001,2661,317,2,1
58597,2014/03/31,2012/12/27,390,2,0.775,1774,390,2,0
58598,2014/03/31,2012/01/16,646,2,0.775,1774,646,2,0
58599,2014/03/31,2012/09/11,1,2,0.405,3394,1,0,2
58600,2014/03/31,2012/03/27,538,2,0.575,2390,538,2,0
58601,2014/03/31,2010/09/09,714,2,0.575,2390,714,2,0
58602,2014/03/31,2011/10/22,367,2,0.575,2390,367,2,0
58603,2014/03/31,2012/03/21,548,4,0.3125,4396,548,4,0
58604,2014/03/31,2010/08/15,437,2,0.4,3434,437,2,0
58605,2014/03/31,2011/01/13,546,2,0.4,3434,546,2,0
58606,2014/03/31,2012/03/22,693,2,0.4,3434,693,2,0
58607,2014/03/31,2012/10/16,385,2,0.525,2616,385,2,0
58608,2014/03/31,2013/03/20,367,2,0.525,2616,367,2,0
58609,2014/03/31,2008/10/06,35,3,0.612771084,2241,35,0,3
58610,2014/03/31,2012/06/17,650,2,1.0,1373,650,2,0
58611,2014/03/31,2013/01/04,182,2,0.555860672,2469,182,0,2
58612,2014/03/31,2013/03/20,294,3,0.79,1737,294,0,3
58613,2014/03/31,2007/08/16,176,2,0.841852761,1630,176,1,1
58614,2014/03/31,2007/07/19,127,2,0.49,2800,127,0,2
58615,2014/03/31,2011/01/15,262,2,0.608509317,2254,262,0,2
58616,2014/03/31,2006/04/13,81,2,0.8,1714,81,0,2
58617,2014/03/31,2012/05/09,549,3,0.503027523,2725,549,3,0
58618,2014/03/31,2012/12/22,1,2,0.785,1746,1,1,1
58619,2014/03/31,2009/08/07,150,2,0.845,1622,150,0,2
58620,2014/03/31,2010/11/19,715,2,0.4,3426,715,2,0
58621,2014/03/31,2010/08/27,215,2,0.866238938,1582,215,0,2
58622,2014/03/31,2009/09/03,278,4,0.3175,4316,278,2,2
58623,2014/03/31,2005/07/12,312,2,0.596214099,2298,312,1,1
58624,2014/03/31,2009/02/06,358,3,0.4166666670000001,3288,358,1,2
58625,2014/03/31,2013/03/11,385,2,1.0,1370,385,2,0
58626,2014/03/31,2012/08/26,582,2,0.95,1442,582,2,0
58627,2014/03/31,2011/07/06,415,2,0.95,1442,415,2,0
58628,2014/03/31,2012/09/12,563,2,0.95,1442,563,2,0
58629,2014/03/31,2009/07/29,579,2,0.9,1522,579,2,0
58630,2014/03/31,2007/07/21,404,2,0.9,1522,404,2,0
58631,2014/03/31,2012/12/12,215,3,0.7492939240000001,1827,215,0,3
58632,2014/03/31,2010/03/24,32,10,0.7440000000000001,1840,32,5,5
58633,2014/03/31,2006/08/30,212,2,0.672357564,2036,212,1,1
58634,2014/03/31,2008/08/25,570,2,0.8623818529999999,1587,570,2,0
58635,2014/03/31,2009/03/05,91,3,0.440205854,3109,91,0,3
58636,2014/03/31,2012/11/02,515,2,0.4,3421,515,2,0
58637,2014/03/31,2007/09/17,144,2,0.482475317,2836,144,0,2
58638,2014/03/31,2012/09/02,204,3,0.6514285710000001,2100,204,0,3
58639,2014/03/31,2006/05/11,525,3,0.5980760820000001,2287,525,3,0
58640,2014/03/31,2006/03/24,246,2,0.51025,2680,246,0,2
58641,2014/03/31,2012/04/08,339,2,0.575,2378,339,0,2
58642,2014/03/31,2013/03/26,47,2,0.575,2378,47,0,2
58643,2014/03/31,2012/05/27,9,2,0.915,1494,9,0,2
58644,2014/03/31,2013/03/23,351,2,1.0,1367,351,1,1
58645,2014/03/31,2013/02/09,287,4,0.393775216,3470,287,2,2
58646,2014/03/31,2011/04/26,398,2,0.9,1518,398,2,0
58647,2014/03/31,2010/06/11,146,3,0.54281399,2516,146,2,1
58648,2014/03/31,2011/09/29,173,2,0.77108978,1771,173,1,1
58649,2014/03/31,2005/03/24,507,2,0.41976637,3253,507,2,0
58650,2014/03/31,2008/03/01,265,2,0.92,1484,265,0,2
58651,2014/03/31,2008/04/24,214,2,0.66,2068,214,0,2
58652,2014/03/31,2013/01/03,228,2,0.866177778,1575,228,0,2
58653,2014/03/31,2011/07/09,143,2,0.497417943,2742,143,0,2
58654,2014/03/31,2006/11/01,193,2,0.7077789309999999,1927,193,0,2
58655,2014/03/31,2006/08/28,486,2,0.7136577709999999,1911,486,2,0
58656,2014/03/31,2012/10/28,295,3,0.722330508,1888,295,0,3
58657,2014/03/31,2011/08/13,70,4,0.32868161,4149,70,1,3
58658,2014/03/31,2009/12/03,64,2,0.721507937,1890,64,0,2
58659,2014/03/31,2010/04/15,667,3,0.874278384,1559,667,3,0
58660,2014/03/31,2012/08/14,178,6,0.55,2478,178,2,4
58661,2014/03/31,2008/03/06,670,3,1.1,1239,670,3,0
58662,2014/03/31,2012/03/20,650,3,0.5369333860000001,2537,650,3,0
58663,2014/03/31,2011/10/09,357,2,0.790081206,1724,357,1,1
58664,2014/03/31,2012/02/05,293,4,0.333751531,4081,293,2,2
58665,2014/03/31,2010/01/05,611,3,1.0,1362,611,3,0
58666,2014/03/31,2012/11/02,159,2,0.570552995,2387,159,0,2
58667,2014/03/31,2007/02/23,184,2,0.4798308670000001,2838,184,0,2
58668,2014/03/31,2013/02/02,114,2,0.58,2347,114,0,2
58669,2014/03/31,2010/03/23,637,2,0.65,2094,637,2,0
58670,2014/03/31,2012/05/30,670,2,0.65,2094,670,2,0
58671,2014/03/31,2008/04/14,519,3,0.783333333,1737,519,3,0
58672,2014/03/31,2012/01/27,82,3,0.783333333,1737,82,0,3
58673,2014/03/31,2012/04/06,501,5,0.47,2895,501,5,0
58674,2014/03/31,2008/03/28,519,2,0.423203733,3215,519,2,0
58675,2014/03/31,2013/02/01,15,2,0.478031634,2845,15,1,1
58676,2014/03/31,2010/10/04,29,4,0.5032383420000001,2702,29,1,3
58677,2014/03/31,2013/01/17,15,2,0.430547815,3158,15,0,2
58678,2014/03/31,2010/10/24,163,2,0.63,2158,163,0,2
58679,2014/03/31,2007/06/15,4,2,0.495555961,2743,4,1,1
58680,2014/03/31,2012/04/25,474,2,0.440979883,3082,474,2,0
58681,2014/03/31,2013/03/03,228,2,0.56153719,2420,228,1,1
58682,2014/03/31,2011/07/25,135,3,0.52549323,2585,135,1,2
58683,2014/03/31,2011/09/05,624,2,0.901393497,1507,624,2,0
58684,2014/03/31,2012/09/06,399,2,0.85,1598,399,2,0
58685,2014/03/31,2012/07/30,579,2,0.575,2362,579,2,0
58686,2014/03/31,2012/08/18,372,3,0.8952208309999999,1517,372,3,0
58687,2014/03/31,2011/04/22,649,2,0.602484472,2254,649,2,0
58688,2014/03/31,2007/05/08,662,3,0.744871092,1823,662,3,0
58689,2014/03/31,2013/01/23,425,2,0.74110262,1832,425,2,0
58690,2014/03/31,2012/07/31,210,3,0.297475345,4563,210,1,2
58691,2014/03/31,2007/07/23,69,2,0.598703132,2267,69,0,2
58692,2014/03/31,2009/08/23,123,2,0.345,3934,123,0,2
58693,2014/03/31,2005/01/27,116,3,0.533990555,2541,116,1,2
58694,2014/03/31,2009/11/04,335,2,0.423563398,3202,335,1,1
58695,2014/03/31,2012/06/05,522,2,0.8053741090000001,1684,522,2,0
58696,2014/03/31,2012/01/30,630,2,0.4,3390,630,2,0
58697,2014/03/31,2012/04/25,398,2,0.738480392,1836,398,2,0
58698,2014/03/31,2011/04/11,534,3,0.429467681,3156,534,3,0
58699,2014/03/31,2013/02/03,402,2,0.9,1506,402,2,0
58700,2014/03/31,2009/08/22,256,3,0.7916471959999999,1712,256,2,1
58701,2014/03/31,2007/09/12,721,2,0.25,5420,721,2,0
58702,2014/03/31,2012/12/17,467,2,0.25,5420,467,2,0
58703,2014/03/31,2009/02/08,468,2,0.25,5420,468,2,0
58704,2014/03/31,2009/10/29,513,2,0.25,5420,513,2,0
58705,2014/03/31,2008/03/18,460,2,0.25,5420,460,2,0
58706,2014/03/31,2008/02/01,504,2,0.25,5420,504,2,0
58707,2014/03/31,2005/12/25,587,2,0.25,5420,587,2,0
58708,2014/03/31,2013/02/06,399,2,0.682619647,1985,399,2,0
58709,2014/03/31,2012/11/07,507,2,0.25,5420,507,2,0
58710,2014/03/31,2008/05/24,34,2,0.903266667,1500,34,0,2
58711,2014/03/31,2009/08/08,107,3,0.78,1737,107,2,1
58712,2014/03/31,2013/03/01,160,2,0.957088339,1415,160,1,1
58713,2014/03/31,2012/05/16,631,2,1.0,1354,631,2,0
58714,2014/03/31,2009/06/28,686,2,1.0,1354,686,2,0
58715,2014/03/31,2008/10/21,136,2,0.845,1602,136,0,2
58716,2014/03/31,2011/09/04,678,2,0.676148851,2002,678,2,0
58717,2014/03/31,2013/03/12,217,2,0.45,3008,217,0,2
58718,2014/03/31,2012/10/07,537,2,0.775,1746,537,2,0
58719,2014/03/31,2007/02/19,130,3,0.644342857,2100,130,0,3
58720,2014/03/31,2012/07/16,172,2,0.830092025,1630,172,1,1
58721,2014/03/31,2012/08/01,462,2,0.725,1866,462,2,0
58722,2014/03/31,2010/09/24,306,2,0.725,1866,306,0,2
58723,2014/03/31,2013/03/31,112,2,0.725,1866,112,0,2
58724,2014/03/31,2010/05/27,419,3,0.526176585,2571,419,3,0
58725,2014/03/31,2010/12/29,93,2,0.458941296,2947,93,1,1
58726,2014/03/31,2012/02/02,573,2,0.6,2254,573,2,0
58727,2014/03/31,2010/05/24,142,2,0.598000885,2261,142,1,1
58728,2014/03/31,2012/04/26,696,2,0.9,1502,696,2,0
58729,2014/03/31,2011/04/20,610,2,0.808916816,1671,610,2,0
58730,2014/03/31,2010/04/28,662,2,0.7,1931,662,2,0
58731,2014/03/31,2009/11/13,98,4,0.362908163,3724,98,0,4
58732,2014/03/31,2013/02/02,68,3,0.686666667,1968,68,1,2
58733,2014/03/31,2012/08/07,166,2,0.435,3106,166,0,2
58734,2014/03/31,2010/08/08,200,2,0.565,2390,200,1,1
58735,2014/03/31,2008/11/26,370,3,0.69992224,1929,370,3,0
58736,2014/03/31,2012/09/06,424,2,0.775,1742,424,2,0
58737,2014/03/31,2006/01/22,597,2,0.325,4154,597,2,0
58738,2014/03/31,2012/09/01,516,2,0.75,1800,516,2,0
58739,2014/03/31,2011/03/31,687,2,0.579497638,2329,687,2,0
58740,2014/03/31,2005/05/03,102,2,0.912170385,1479,102,0,2
58741,2014/03/31,2008/07/05,125,2,0.605475763,2228,125,1,1
58742,2014/03/31,2012/12/11,410,2,0.625,2158,410,2,0
58743,2014/03/31,2008/11/09,99,3,0.387072331,3484,99,0,3
58744,2014/03/31,2009/09/17,328,2,0.475493653,2836,328,1,1
58745,2014/03/31,2009/08/20,77,2,0.76,1774,77,0,2
58746,2014/03/31,2013/02/03,412,2,0.7,1926,412,2,0
58747,2014/03/31,2008/08/01,300,3,0.396718658,3398,300,2,1
58748,2014/03/31,2013/03/01,159,2,0.612102634,2202,159,0,2
58749,2014/03/31,2012/11/14,177,2,0.474559859,2840,177,0,2
58750,2014/03/31,2007/06/08,2,2,0.585895652,2300,2,0,2
58751,2014/03/31,2005/12/29,11,3,0.598866667,2250,11,0,3
58752,2014/03/31,2010/05/28,388,2,0.325,4146,388,2,0
58753,2014/03/31,2011/02/08,525,2,0.4,3367,525,2,0
58754,2014/03/31,2005/11/25,684,2,0.792058824,1700,684,2,0
58755,2014/03/31,2008/12/24,95,2,0.83,1622,95,0,2
58756,2014/03/31,2007/11/08,102,2,0.539054866,2497,102,0,2
58757,2014/03/31,2013/03/02,35,2,0.34,3958,35,0,2
58758,2014/03/31,2007/03/27,341,2,0.506400602,2656,341,0,2
58759,2014/03/31,2010/01/05,515,2,0.807022809,1666,515,2,0
58760,2014/03/31,2011/10/16,2,2,0.77,1746,2,0,2
58761,2014/03/31,2012/01/09,135,2,0.562045169,2391,135,0,2
58762,2014/03/31,2013/01/04,444,2,0.4,3359,444,2,0
58763,2014/03/31,2006/04/28,52,2,0.72,1866,52,0,2
58764,2014/03/31,2012/01/16,503,3,0.542167945,2477,503,3,0
58765,2014/03/31,2008/03/05,202,3,0.29333333300000003,4578,202,2,1
58766,2014/03/31,2008/01/24,137,2,0.4,3357,137,0,2
58767,2014/03/31,2010/01/31,77,2,0.5053368460000001,2657,77,1,1
58768,2014/03/31,2012/10/08,470,2,0.625,2148,470,2,0
58769,2014/03/31,2011/12/12,518,3,0.799940405,1678,518,3,0
58770,2014/03/31,2012/11/01,275,3,0.506715742,2649,275,2,1
58771,2014/03/31,2010/11/29,715,2,0.275,4880,715,2,0
58772,2014/03/31,2011/01/04,16,3,0.73087146,1836,16,0,3
58773,2014/03/31,2010/04/28,526,2,0.742090708,1808,526,2,0
58774,2014/03/31,2009/06/19,74,2,0.464596467,2887,74,0,2
58775,2014/03/31,2010/11/06,198,2,0.445,3014,198,0,2
58776,2014/03/31,2011/07/15,160,2,0.733940887,1827,160,0,2
58777,2014/03/31,2008/03/06,494,2,0.539380531,2486,494,2,0
58778,2014/03/31,2012/10/10,200,2,0.766171429,1750,200,1,1
58779,2014/03/31,2010/08/16,243,2,0.520093095,2578,243,0,2
58780,2014/03/31,2012/10/21,381,3,0.60247191,2225,381,3,0
58781,2014/03/31,2005/11/30,15,4,0.5775,2320,15,0,4
58782,2014/03/31,2007/07/13,99,2,0.468287312,2861,99,0,2
58783,2014/03/31,2011/01/04,393,2,0.45,2977,393,2,0
58784,2014/03/31,2012/10/28,368,3,0.534244116,2507,368,3,0
58785,2014/03/31,2012/07/29,278,2,0.34,3939,278,0,2
58786,2014/03/31,2011/06/20,485,2,0.6,2232,485,2,0
58787,2014/03/31,2012/10/10,147,5,0.424552949,3154,147,3,2
58788,2014/03/31,2012/06/15,656,2,1.0,1339,656,2,0
58789,2014/03/31,2008/09/24,349,2,1.0,1339,349,1,1
58790,2014/03/31,2012/04/10,721,2,1.0,1339,721,2,0
58791,2014/03/31,2011/04/20,240,2,0.793246445,1688,240,1,1
58792,2014/03/31,2012/05/02,280,2,0.592153914,2261,280,1,1
58793,2014/03/31,2011/11/29,4,3,0.563913227,2374,4,0,3
58794,2014/03/31,2013/02/25,41,2,0.5109312979999999,2620,41,0,2
58795,2014/03/31,2012/12/01,2,2,0.97,1380,2,1,1
58796,2014/03/31,2012/07/14,371,2,0.712726305,1878,371,2,0
58797,2014/03/31,2007/03/01,686,2,0.382728053,3497,686,2,0
58798,2014/03/31,2011/12/21,361,2,0.517220719,2587,361,1,1
58799,2014/03/31,2012/10/18,258,2,0.72,1858,258,0,2
58800,2014/03/31,2008/01/17,264,3,0.706666667,1893,264,2,1
58801,2014/03/31,2011/01/15,27,2,0.34,3934,27,0,2
58802,2014/03/31,2012/03/27,117,2,0.66744012,2004,117,0,2
58803,2014/03/31,2012/12/14,310,2,0.6,2229,310,0,2
58804,2014/03/31,2012/10/16,128,3,0.282552292,4733,128,0,3
58805,2014/03/31,2012/11/13,440,2,0.35,3820,440,2,0
58806,2014/03/31,2006/01/24,652,2,0.35,3820,652,2,0
58807,2014/03/31,2012/08/23,99,2,0.35,3820,99,1,1
58808,2014/03/31,2011/02/13,291,3,0.408548289,3272,291,2,1
58809,2014/03/31,2009/08/16,220,2,0.49,2728,220,0,2
58810,2014/03/31,2009/03/06,57,2,0.636073298,2101,57,0,2
58811,2014/03/31,2013/02/28,34,6,0.344391753,3880,34,0,6
58812,2014/03/31,2013/02/15,3,2,0.624336449,2140,3,0,2
58813,2014/03/31,2010/01/02,490,2,0.25,5344,490,2,0
58814,2014/03/31,2012/04/22,373,2,0.25,5344,373,2,0
58815,2014/03/31,2012/12/11,470,2,0.25,5344,470,2,0
58816,2014/03/31,2007/03/05,378,2,0.25,5344,378,2,0
58817,2014/03/31,2012/12/04,478,2,0.25,5344,478,2,0
58818,2014/03/31,2012/06/26,601,2,0.6854027709999999,1949,601,2,0
58819,2014/03/31,2012/10/10,400,2,0.25,5342,400,2,0
58820,2014/03/31,2010/12/24,646,2,0.778263403,1716,646,2,0
58821,2014/03/31,2007/10/24,503,2,0.375,3560,503,2,0
58822,2014/03/31,2012/12/01,485,2,0.375,3560,485,2,0
58823,2014/03/31,2012/08/09,590,2,0.825,1618,590,2,0
58824,2014/03/31,2011/05/15,604,2,0.49753915,2682,604,2,0
58825,2014/03/31,2012/03/15,375,3,0.308985642,4318,375,3,0
58826,2014/03/31,2013/01/30,360,2,0.631534091,2112,360,1,1
58827,2014/03/31,2012/05/01,531,3,0.294632207,4527,531,3,0
58828,2014/03/31,2012/10/14,233,2,0.565358203,2359,233,1,1
58829,2014/03/31,2007/06/12,7,2,0.419471199,3177,7,0,2
58830,2014/03/31,2006/06/18,195,2,0.967082729,1378,195,1,1
58831,2014/03/31,2008/07/02,402,2,1.0,1332,402,2,0
58832,2014/03/31,2010/09/21,350,3,0.8,1665,350,2,1
58833,2014/03/31,2012/10/06,433,2,0.795698925,1674,433,2,0
58834,2014/03/31,2010/06/11,655,2,1.0,1332,655,2,0
58835,2014/03/31,2012/01/16,675,2,1.0,1332,675,2,0
58836,2014/03/31,2011/05/18,5,4,0.4375,3044,5,1,3
58837,2014/03/31,2013/01/28,105,3,0.309365706,4304,105,1,2
58838,2014/03/31,2007/11/06,150,3,0.401102742,3319,150,0,3
58839,2014/03/31,2012/03/07,141,3,0.405595855,3281,141,1,2
58840,2014/03/31,2008/12/19,446,2,0.75,1774,446,2,0
58841,2014/03/31,2011/01/06,51,8,0.90375,1472,51,3,5
58842,2014/03/31,2008/03/04,525,3,0.583955224,2278,525,3,0
58843,2014/03/31,2009/06/24,41,2,0.87,1529,41,0,2
58844,2014/03/31,2008/04/25,370,2,1.0,1330,370,2,0
58845,2014/03/31,2011/12/22,402,2,0.497940846,2671,402,2,0
58846,2014/03/31,2006/04/07,32,4,0.875,1520,32,0,4
58847,2014/03/31,2011/08/11,306,3,0.330126614,4028,306,2,1
58848,2014/03/31,2010/07/03,278,2,0.6227728339999999,2135,278,1,1
58849,2014/03/31,2012/12/05,185,2,0.517419229,2569,185,1,1
58850,2014/03/31,2010/10/22,16,2,0.405,3280,16,0,2
58851,2014/03/31,2013/03/11,34,2,0.326772448,4065,34,0,2
58852,2014/03/31,2007/07/24,357,2,0.854633205,1554,357,1,1
58853,2014/03/31,2012/03/29,57,2,0.615,2158,57,0,2
58854,2014/03/31,2011/06/06,349,2,0.473795073,2801,349,1,1
58855,2014/03/31,2008/11/10,260,2,0.7772407729999999,1707,260,1,1
58856,2014/03/31,2007/07/14,296,3,0.823333333,1611,296,1,2
58857,2014/03/31,2009/03/05,337,2,0.5191855910000001,2554,337,1,1
58858,2014/03/31,2007/11/19,466,2,0.425,3120,466,2,0
58859,2014/03/31,2012/03/28,349,2,0.8763384009999999,1513,349,1,1
58860,2014/03/31,2008/09/01,58,2,0.535,2478,58,0,2
58861,2014/03/31,2013/03/22,207,2,0.799095841,1659,207,1,1
58862,2014/03/31,2006/12/31,321,3,0.556294587,2383,321,1,2
58863,2014/03/31,2010/03/24,577,4,0.478365211,2771,577,4,0
58864,2014/03/31,2011/04/01,370,3,0.346626569,3824,370,3,0
58865,2014/03/31,2010/05/24,416,2,0.488716814,2712,416,2,0
58866,2014/03/31,2011/03/27,275,2,0.5677249360000001,2334,275,1,1
58867,2014/03/31,2011/11/09,237,2,0.96,1380,237,1,1
58868,2014/03/31,2011/08/15,238,2,0.96,1380,238,0,2
58869,2014/03/31,2006/11/10,263,2,0.96,1380,263,1,1
58870,2014/03/31,2013/02/27,223,2,0.96,1380,223,1,1
58871,2014/03/31,2011/06/17,204,3,0.8112431109999999,1633,204,0,3
58872,2014/03/31,2009/07/08,114,4,0.411030096,3223,114,2,2
58873,2014/03/31,2010/12/06,75,3,0.521275089,2541,75,1,2
58874,2014/03/31,2012/11/09,189,2,0.6622,2000,189,1,1
58875,2014/03/31,2012/06/20,609,3,0.45496393,2911,609,3,0
58876,2014/03/31,2010/11/13,76,2,0.624398868,2121,76,0,2
58877,2014/03/31,2012/12/23,464,2,0.60254893,2197,464,2,0
58878,2014/03/31,2010/11/25,723,2,0.71104245,1861,723,2,0
58879,2014/03/31,2011/09/26,436,2,0.4,3308,436,2,0
58880,2014/03/31,2012/01/13,693,2,0.4,3308,693,2,0
58881,2014/03/31,2008/02/28,530,2,0.562303442,2353,530,2,0
58882,2014/03/31,2011/09/24,314,3,0.278878583,4744,314,1,2
58883,2014/03/31,2008/03/28,263,2,0.49,2700,263,0,2
58884,2014/03/31,2011/10/31,53,4,0.36095524,3664,53,0,4
58885,2014/03/31,2012/07/01,160,2,0.326767177,4046,160,1,1
58886,2014/03/31,2011/10/16,45,2,0.88,1502,45,0,2
58887,2014/03/31,2012/11/05,164,2,0.672278739,1966,164,1,1
58888,2014/03/31,2007/08/09,669,4,0.8,1652,669,4,0
58889,2014/03/31,2009/10/24,376,2,0.463196635,2853,376,2,0
58890,2014/03/31,2011/03/11,29,2,0.375302471,3521,29,0,2
58891,2014/03/31,2011/01/14,185,3,0.374584633,3527,185,2,1
58892,2014/03/31,2008/12/14,111,4,0.46,2872,111,3,1
58893,2014/03/31,2008/04/25,206,2,0.505,2616,206,0,2
58894,2014/03/31,2009/10/18,431,2,0.667357251,1979,431,2,0
58895,2014/03/31,2011/04/25,218,3,0.5282720000000001,2500,218,1,2
58896,2014/03/31,2007/03/08,491,2,0.475,2780,491,2,0
58897,2014/03/31,2011/07/27,424,2,0.876660027,1506,424,2,0
58898,2014/03/31,2011/09/01,586,2,0.4449780920000001,2967,586,2,0
58899,2014/03/31,2013/01/05,382,2,0.65,2030,382,2,0
58900,2014/03/31,2008/09/21,2,2,0.7281125829999999,1812,2,0,2
58901,2014/03/31,2007/03/12,139,2,0.767486911,1719,139,0,2
58902,2014/03/31,2008/02/24,314,2,0.780189237,1691,314,0,2
58903,2014/03/31,2011/01/20,381,3,0.663631791,1988,381,3,0
58904,2014/03/31,2012/05/20,226,2,0.71,1858,226,1,1
58905,2014/03/31,2008/05/17,228,3,0.585212955,2254,228,0,3
58906,2014/03/31,2007/06/22,635,4,0.55,2398,635,4,0
58907,2014/03/31,2011/05/23,294,3,0.66,1998,294,2,1
58908,2014/03/31,2011/01/04,665,2,0.45,2930,665,2,0
58909,2014/03/31,2011/03/20,527,2,0.68376556,1928,527,2,0
58910,2014/03/31,2012/10/25,176,4,0.3775,3492,176,0,4
58911,2014/03/31,2010/02/04,210,3,0.414515723,3180,210,2,1
58912,2014/03/31,2011/09/14,65,2,0.335,3934,65,0,2
58913,2014/03/31,2007/12/17,34,4,0.7975,1652,34,1,3
58914,2014/03/31,2011/11/01,9,3,0.491683464,2679,9,1,2
58915,2014/03/31,2011/04/25,450,2,0.545383023,2415,450,2,0
58916,2014/03/31,2011/02/28,122,2,0.553193277,2380,122,0,2
58917,2014/03/31,2008/06/30,606,3,0.539164277,2441,606,3,0
58918,2014/03/31,2010/04/19,34,2,0.450407255,2922,34,0,2
58919,2014/03/31,2012/12/26,217,2,0.38,3463,217,0,2
58920,2014/03/31,2012/08/18,521,2,0.667266734,1972,521,2,0
58921,2014/03/31,2010/07/30,170,2,0.626731777,2099,170,0,2
58922,2014/03/31,2007/12/10,42,2,0.728736842,1805,42,0,2
58923,2014/03/31,2009/05/03,181,2,0.425349288,3092,181,1,1
58924,2014/03/31,2007/02/05,151,2,0.495322034,2655,151,0,2
58925,2014/03/31,2013/01/07,241,2,0.391718797,3357,241,1,1
58926,2014/03/31,2012/12/22,271,2,0.5289219629999999,2486,271,0,2
58927,2014/03/31,2006/04/16,71,2,0.88,1494,71,0,2
58928,2014/03/31,2011/06/29,529,2,0.75,1752,529,2,0
58929,2014/03/31,2009/04/02,720,2,0.314116663,4183,720,2,0
58930,2014/03/31,2012/05/17,259,2,0.367715566,3572,259,1,1
58931,2014/03/31,2013/01/18,196,3,0.400448307,3279,196,1,2
58932,2014/03/31,2009/07/04,516,2,0.65,2020,516,2,0
58933,2014/03/31,2006/11/10,436,2,0.65,2020,436,2,0
58934,2014/03/31,2008/04/30,707,2,0.65,2020,707,2,0
58935,2014/03/31,2012/08/07,62,2,0.485573225,2704,62,1,1
58936,2014/03/31,2009/10/14,7,2,0.582484472,2254,7,0,2
58937,2014/03/31,2011/05/09,479,2,0.67236168,1952,479,2,0
58938,2014/03/31,2007/12/23,225,2,0.831692015,1578,225,0,2
58939,2014/03/31,2012/07/10,307,3,0.666666667,1968,307,2,1
58940,2014/03/31,2013/02/17,406,2,1.0,1312,406,2,0
58941,2014/03/31,2008/01/13,612,3,0.954109091,1375,612,3,0
58942,2014/03/31,2010/12/17,258,2,0.54231914,2419,258,0,2
58943,2014/03/31,2012/08/03,604,2,0.7,1873,604,2,0
58944,2014/03/31,2012/03/29,83,2,0.95,1380,83,1,1
58945,2014/03/31,2012/10/14,534,2,0.5,2622,534,2,0
58946,2014/03/31,2013/03/12,144,3,0.412888189,3175,144,2,1
58947,2014/03/31,2010/12/13,39,3,0.649271917,2019,39,0,3
58948,2014/03/31,2012/11/07,469,3,0.656006006,1998,469,3,0
58949,2014/03/31,2008/05/08,132,2,0.6805192109999999,1926,132,0,2
58950,2014/03/31,2012/07/12,447,2,0.9,1456,447,2,0
58951,2014/03/31,2010/12/20,612,4,0.252485549,5190,612,4,0
58952,2014/03/31,2011/01/13,620,2,0.9,1456,620,2,0
58953,2014/03/31,2009/05/22,608,2,0.9,1456,608,2,0
58954,2014/03/31,2013/02/07,416,2,0.9,1456,416,2,0
58955,2014/03/31,2011/04/17,383,2,0.5554472229999999,2359,383,2,0
58956,2014/03/31,2011/10/13,458,2,0.475,2758,458,2,0
58957,2014/03/31,2007/07/13,497,2,0.4,3275,497,2,0
58958,2014/03/31,2012/09/13,291,3,0.546906054,2395,291,2,1
58959,2014/03/31,2013/01/24,389,2,0.75,1746,389,2,0
58960,2014/03/31,2008/08/30,415,2,0.75,1746,415,2,0
58961,2014/03/31,2012/10/30,258,2,0.75,1746,258,0,2
58962,2014/03/31,2010/11/27,624,3,0.68286385,1917,624,3,0
58963,2014/03/31,2009/11/19,375,3,0.7333333329999999,1785,375,3,0
58964,2014/03/31,2007/07/01,287,2,0.72,1818,287,0,2
58965,2014/03/31,2007/08/17,377,2,0.66104093,1979,377,2,0
58966,2014/03/31,2012/01/01,677,2,0.5,2616,677,2,0
58967,2014/03/31,2012/02/05,668,2,0.5,2616,668,2,0
58968,2014/03/31,2005/11/01,270,2,0.683685311,1913,270,0,2
58969,2014/03/31,2011/09/24,197,3,0.35713817600000003,3662,197,2,1
58970,2014/03/31,2012/12/24,251,2,0.33,3963,251,0,2
58971,2014/03/31,2013/03/16,198,2,0.33,3963,198,0,2
58972,2014/03/31,2012/12/26,75,2,0.920133709,1421,75,1,1
58973,2014/03/31,2012/03/10,368,4,0.4,3268,368,4,0
58974,2014/03/31,2012/09/10,288,2,0.60420712,2163,288,1,1
58975,2014/03/31,2011/08/01,595,2,0.55,2376,595,2,0
58976,2014/03/31,2012/04/15,708,2,0.55,2376,708,2,0
58977,2014/03/31,2012/11/06,382,2,0.55,2376,382,2,0
58978,2014/03/31,2010/11/23,123,2,0.725938889,1800,123,1,1
58979,2014/03/31,2010/12/14,369,2,0.475018182,2750,369,2,0
58980,2014/03/31,2013/03/06,390,2,0.475018182,2750,390,2,0
58981,2014/03/31,2009/09/16,270,2,0.475,2750,270,1,1
58982,2014/03/31,2007/09/01,453,2,0.475,2750,453,2,0
58983,2014/03/31,2012/05/31,667,2,0.475,2750,667,2,0
58984,2014/03/31,2010/08/03,508,2,0.7,1866,508,2,0
58985,2014/03/31,2012/11/17,360,4,0.35,3732,360,2,2
58986,2014/03/31,2010/12/06,544,3,0.486256983,2685,544,3,0
58987,2014/03/31,2011/04/15,432,3,0.646138614,2020,432,3,0
58988,2014/03/31,2012/12/25,13,3,0.426383535,3061,13,0,3
58989,2014/03/31,2009/09/25,313,3,0.5,2610,313,2,1
58990,2014/03/31,2012/08/27,532,3,0.75,1740,532,3,0
58991,2014/03/31,2012/03/17,454,2,0.725,1800,454,2,0
58992,2014/03/31,2012/12/04,484,2,0.45,2900,484,2,0
58993,2014/03/31,2013/02/25,388,3,0.75,1740,388,3,0
58994,2014/03/31,2009/11/15,499,2,0.405800933,3215,499,2,0
58995,2014/03/31,2008/01/28,31,3,0.451936937,2886,31,2,1
58996,2014/03/31,2010/07/19,281,2,0.740181612,1762,281,0,2
58997,2014/03/31,2012/12/25,56,2,0.945,1380,56,1,1
58998,2014/03/31,2013/02/08,325,2,0.483660979,2696,325,1,1
58999,2014/03/31,2010/10/25,525,2,0.73252809,1780,525,2,0
59000,2014/03/31,2011/12/12,660,2,0.6953600000000001,1875,660,2,0
59001,2014/03/31,2008/02/01,294,3,0.336644278,3871,294,1,2
59002,2014/03/31,2005/12/01,703,2,0.604010199,2157,703,2,0
59003,2014/03/31,2009/01/11,23,2,0.819836375,1589,23,0,2
59004,2014/03/31,2010/08/27,19,2,0.599392545,2173,19,1,1
59005,2014/03/31,2012/12/30,325,3,0.524788392,2481,325,1,2
59006,2014/03/31,2011/10/26,383,2,0.598849517,2173,383,2,0
59007,2014/03/31,2012/07/12,558,2,0.76592113,1699,558,2,0
59008,2014/03/31,2009/03/13,439,3,0.439082011,2963,439,3,0
59009,2014/03/31,2007/11/06,17,2,0.6238177460000001,2085,17,0,2
59010,2014/03/31,2010/09/10,342,2,0.5596857510000001,2323,342,1,1
59011,2014/03/31,2010/05/03,353,2,0.45778169,2840,353,1,1
59012,2014/03/31,2006/06/12,23,3,0.857434037,1516,23,0,3
59013,2014/03/31,2012/01/11,259,2,0.5768752770000001,2253,259,1,1
59014,2014/03/31,2013/01/23,108,4,0.483970205,2685,108,1,3
59015,2014/03/31,2011/02/01,120,2,0.510987023,2543,120,0,2
59016,2014/03/31,2008/04/23,120,2,0.510987023,2543,120,0,2
59017,2014/03/31,2013/02/05,297,2,0.740781072,1754,297,1,1
59018,2014/03/31,2010/07/01,148,2,0.8503403140000001,1528,148,1,1
59019,2014/03/31,2010/09/15,58,2,0.505,2572,58,0,2
59020,2014/03/31,2013/03/31,146,2,0.387826217,3349,146,0,2
59021,2014/03/31,2011/01/13,450,3,0.3713611670000001,3497,450,3,0
59022,2014/03/31,2011/10/28,380,2,0.6,2164,380,2,0
59023,2014/03/31,2007/03/01,558,4,0.4,3246,558,4,0
59024,2014/03/31,2011/01/13,75,2,0.33,3934,75,0,2
59025,2014/03/31,2013/03/05,249,2,0.33,3934,249,0,2
59026,2014/03/31,2011/04/06,671,2,1.0,1298,671,2,0
59027,2014/03/31,2010/07/27,426,2,1.0,1298,426,2,0
59028,2014/03/31,2011/09/14,694,2,1.0,1298,694,2,0
59029,2014/03/31,2009/03/28,47,3,0.666666667,1947,47,0,3
59030,2014/03/31,2010/09/30,624,2,1.0,1298,624,2,0
59031,2014/03/31,2012/03/12,712,2,1.0,1298,712,2,0
59032,2014/03/31,2012/12/13,401,2,1.0,1298,401,2,0
59033,2014/03/31,2005/09/01,551,2,1.0,1298,551,2,0
59034,2014/03/31,2012/04/17,685,2,1.0,1298,685,2,0
59035,2014/03/31,2013/02/04,136,2,0.475250824,2731,136,0,2
59036,2014/03/31,2012/07/02,570,2,0.947372263,1370,570,2,0
59037,2014/03/31,2012/09/12,561,2,0.9,1442,561,2,0
59038,2014/03/31,2012/09/12,561,2,0.9,1442,561,2,0
59039,2014/03/31,2012/12/30,457,2,0.8,1622,457,2,0
59040,2014/03/31,2010/12/29,290,4,0.259967942,4991,290,3,1
59041,2014/03/31,2008/02/21,325,4,0.300486336,4318,325,3,1
59042,2014/03/31,2010/12/12,293,2,0.561410645,2311,293,1,1
59043,2014/03/31,2007/05/13,343,3,0.526716782,2461,343,0,3
59044,2014/03/31,2008/09/16,565,2,0.793145655,1634,565,2,0
59045,2014/03/31,2013/01/25,157,2,0.491578149,2636,157,0,2
59046,2014/03/31,2006/09/25,530,2,0.623435996,2078,530,2,0
59047,2014/03/31,2010/09/05,169,2,0.605762395,2138,169,0,2
59048,2014/03/31,2007/10/01,644,2,1.0,1295,644,2,0
59049,2014/03/31,2012/07/25,200,2,0.495,2616,200,0,2
59050,2014/03/31,2012/05/05,619,2,0.6,2158,619,2,0
59051,2014/03/31,2012/12/31,361,4,0.3,4316,361,3,1
59052,2014/03/31,2006/01/13,155,3,0.34149037200000004,3791,155,0,3
59053,2014/03/31,2007/09/25,561,2,0.574567244,2253,561,2,0
59054,2014/03/31,2008/10/14,221,2,0.942139738,1374,221,1,1
59055,2014/03/31,2008/08/09,11,7,0.788787325,1641,11,2,5
59056,2014/03/31,2007/11/06,349,2,0.738949172,1751,349,1,1
59057,2014/03/31,2011/12/25,182,2,0.3,4313,182,0,2
59058,2014/03/31,2009/07/09,698,2,0.85,1522,698,2,0
59059,2014/03/31,2011/07/24,560,2,0.85,1522,560,2,0
59060,2014/03/31,2011/07/09,515,2,0.85,1522,515,2,0
59061,2014/03/31,2012/09/03,409,2,0.85,1522,409,2,0
59062,2014/03/31,2011/07/04,339,4,0.425,3044,339,3,1
59063,2014/03/31,2010/09/13,281,2,0.518125,2496,281,1,1
59064,2014/03/31,2006/08/03,28,2,0.58,2229,28,0,2
59065,2014/03/31,2012/01/27,12,2,0.64,2020,12,1,1
59066,2014/03/31,2013/03/19,288,3,0.476666667,2712,288,0,3
59067,2014/03/31,2010/11/02,660,3,0.373713129,3458,660,3,0
59068,2014/03/31,2012/12/11,83,2,0.790826193,1634,83,1,1
59069,2014/03/31,2006/01/07,346,3,0.365977337,3530,346,1,2
59070,2014/03/31,2013/03/26,229,2,0.55925974,2310,229,0,2
59071,2014/03/31,2012/10/16,42,2,0.681360759,1896,42,1,1
59072,2014/03/31,2009/12/09,76,3,0.654270517,1974,76,2,1
59073,2014/03/31,2010/06/30,110,2,0.4,3228,110,0,2
59074,2014/03/31,2006/08/03,27,3,0.6838135590000001,1888,27,1,2
59075,2014/03/31,2008/01/02,620,2,0.6101134220000001,2116,620,2,0
59076,2014/03/31,2011/07/18,50,2,0.735,1756,50,0,2
59077,2014/03/31,2012/09/28,494,2,0.433344527,2978,494,2,0
59078,2014/03/31,2012/05/29,199,2,0.647161484,1994,199,0,2
59079,2014/03/31,2011/06/24,142,2,0.935,1380,142,0,2
59080,2014/03/31,2010/11/20,253,2,0.659131323,1957,253,0,2
59081,2014/03/31,2010/05/30,246,2,0.693132724,1861,246,1,1
59082,2014/03/31,2012/12/26,167,2,0.415,3106,167,0,2
59083,2014/03/31,2011/08/21,219,2,0.446267313,2888,219,1,1
59084,2014/03/31,2009/12/15,380,3,0.8,1611,380,3,0
59085,2014/03/31,2006/10/31,489,3,0.8,1611,489,3,0
59086,2014/03/31,2010/12/20,611,3,0.685790314,1879,611,3,0
59087,2014/03/31,2012/11/17,401,3,0.5,2577,401,3,0
59088,2014/03/31,2013/02/27,32,2,0.37974359,3393,32,0,2
59089,2014/03/31,2007/11/17,77,2,0.552237462,2333,77,0,2
59090,2014/03/31,2008/05/22,80,2,0.62,2078,80,0,2
59091,2014/03/31,2012/08/22,26,2,0.497597528,2589,26,0,2
59092,2014/03/31,2009/05/26,22,2,0.38,3390,22,0,2
59093,2014/03/31,2007/01/10,70,2,0.7208449920000001,1787,70,0,2
59094,2014/03/31,2012/08/19,591,2,0.4,3220,591,2,0
59095,2014/03/31,2007/05/31,386,9,0.7777777779999999,1656,386,9,0
59096,2014/03/31,2012/04/24,177,2,0.92,1400,177,0,2
59097,2014/03/31,2013/01/01,41,3,0.316666667,4065,41,1,2
59098,2014/03/31,2010/12/29,247,2,0.49,2627,247,0,2
59099,2014/03/31,2006/03/08,35,3,0.540277078,2382,35,0,3
59100,2014/03/31,2010/02/16,651,3,0.8961002790000001,1436,651,3,0
59101,2014/03/31,2013/02/14,340,2,0.576220331,2233,340,1,1
59102,2014/03/31,2011/01/13,81,4,0.741175115,1736,81,0,4
59103,2014/03/31,2013/01/02,138,2,0.7390005740000001,1741,138,1,1
59104,2014/03/31,2010/08/31,397,2,0.425181758,3026,397,2,0
59105,2014/03/31,2013/03/29,65,2,0.38,3385,65,0,2
59106,2014/03/31,2008/10/21,143,2,0.8083280959999999,1591,143,1,1
59107,2014/03/31,2012/11/08,510,2,0.4,3215,510,2,0
59108,2014/03/31,2012/04/24,708,2,0.4,3215,708,2,0
59109,2014/03/31,2012/05/29,628,2,0.4,3215,628,2,0
59110,2014/03/31,2011/12/14,587,2,0.4,3215,587,2,0
59111,2014/03/31,2012/08/14,596,2,0.4,3215,596,2,0
59112,2014/03/31,2009/07/25,479,2,0.823271447,1562,479,2,0
59113,2014/03/31,2007/06/22,196,3,0.425493051,3022,196,1,2
59114,2014/03/31,2010/04/22,720,2,0.8,1607,720,2,0
59115,2014/03/31,2012/08/31,417,2,0.467533649,2749,417,2,0
59116,2014/03/31,2012/07/27,542,2,0.5,2570,542,2,0
59117,2014/03/31,2012/06/06,150,3,0.5340399,2406,150,2,1
59118,2014/03/31,2013/01/04,225,2,0.5110425789999999,2513,225,1,1
59119,2014/03/31,2009/10/01,645,3,0.4,3210,645,3,0
59120,2014/03/31,2012/06/15,512,3,0.367463498,3493,512,3,0
59121,2014/03/31,2012/11/19,87,2,0.787220859,1630,87,1,1
59122,2014/03/31,2009/06/17,391,2,0.8519920320000001,1506,391,2,0
59123,2014/03/31,2010/11/25,159,2,0.673962165,1903,159,0,2
59124,2014/03/31,2006/03/27,216,2,0.2925,4384,216,0,2
59125,2014/03/31,2007/11/07,376,3,0.47383592,2706,376,3,0
59126,2014/03/31,2007/11/23,307,2,0.785119412,1633,307,1,1
59127,2014/03/31,2011/02/05,214,2,0.85,1508,214,0,2
59128,2014/03/31,2006/11/01,338,3,0.379973318,3373,338,2,1
59129,2014/03/31,2010/05/11,256,2,0.3,4268,256,0,2
59130,2014/03/31,2007/12/26,51,2,1.41,908,51,0,2
59131,2014/03/31,2011/04/11,203,2,0.781562882,1638,203,1,1
59132,2014/03/31,2013/01/18,281,2,0.67,1910,281,1,1
59133,2014/03/31,2008/05/10,578,4,0.7125,1796,578,4,0
59134,2014/03/31,2012/08/03,574,2,0.4,3199,574,2,0
59135,2014/03/31,2005/09/16,116,3,0.7067734809999999,1810,116,2,1
59136,2014/03/31,2012/05/19,502,2,0.684689507,1868,502,2,0
59137,2014/03/31,2007/12/08,58,2,0.63,2030,58,0,2
59138,2014/03/31,2009/07/16,1,2,0.465,2750,1,1,1
59139,2014/03/31,2005/08/29,573,2,0.325,3934,573,2,0
59140,2014/03/31,2012/06/21,361,2,0.325,3934,361,1,1
59141,2014/03/31,2012/04/24,506,2,0.325,3934,506,2,0
59142,2014/03/31,2010/01/27,688,2,0.325,3934,688,2,0
59143,2014/03/31,2007/03/02,578,2,0.325,3934,578,2,0
59144,2014/03/31,2011/09/30,236,2,0.72,1774,236,0,2
59145,2014/03/31,2008/08/18,434,2,0.507168388,2518,434,2,0
59146,2014/03/31,2012/08/26,582,2,0.738888889,1728,582,2,0
59147,2014/03/31,2008/04/13,412,3,0.709699833,1799,412,3,0
59148,2014/03/31,2006/03/09,212,4,0.822021893,1553,212,2,2
59149,2014/03/31,2011/05/24,629,2,0.925,1380,629,2,0
59150,2014/03/31,2012/10/01,443,2,0.420454545,3036,443,2,0
59151,2014/03/31,2009/07/14,107,2,0.49,2605,107,0,2
59152,2014/03/31,2009/09/18,196,2,0.588225806,2170,196,1,1
59153,2014/03/31,2012/07/05,351,2,0.7272079770000001,1755,351,1,1
59154,2014/03/31,2012/10/10,88,3,0.781261482,1633,88,0,3
59155,2014/03/31,2012/07/31,327,2,0.432897862,2947,327,1,1
59156,2014/03/31,2011/09/30,60,2,0.823453841,1549,60,0,2
59157,2014/03/31,2008/11/22,113,3,0.7088048920000001,1799,113,2,1
59158,2014/03/31,2009/11/07,14,2,0.58,2198,14,0,2
59159,2014/03/31,2012/01/20,239,2,0.346507203,3679,239,1,1
59160,2014/03/31,2012/04/25,545,3,0.4,3186,545,3,0
59161,2014/03/31,2012/05/12,686,3,0.4,3185,686,3,0
59162,2014/03/31,2012/12/30,448,2,0.7,1820,448,2,0
59163,2014/03/31,2010/10/22,648,2,1.1,1158,648,2,0
59164,2014/03/31,2010/01/29,145,4,0.389718482,3268,145,1,3
59165,2014/03/31,2012/10/15,70,2,0.41,3106,70,0,2
59166,2014/03/31,2006/12/08,148,2,0.785,1622,148,0,2
59167,2014/03/31,2006/08/06,19,2,0.665441715,1913,19,0,2
59168,2014/03/31,2013/01/19,56,2,0.547972449,2323,56,0,2
59169,2014/03/31,2011/04/20,471,2,0.530112453,2401,471,2,0
59170,2014/03/31,2012/11/04,399,2,0.7,1818,399,2,0
59171,2014/03/31,2009/07/01,221,3,0.744543326,1708,221,1,2
59172,2014/03/31,2011/08/24,197,2,0.571266846,2226,197,1,1
59173,2014/03/31,2012/11/24,214,2,0.58,2192,214,0,2
59174,2014/03/31,2011/03/16,666,2,0.375,3390,666,2,0
59175,2014/03/31,2011/08/13,80,2,0.7129052159999999,1783,80,1,1
59176,2014/03/31,2012/04/06,6,2,0.835,1522,6,1,1
59177,2014/03/31,2012/10/31,421,2,0.55,2310,421,2,0
59178,2014/03/31,2010/01/07,182,4,0.414401305,3065,182,3,1
59179,2014/03/31,2012/02/28,596,2,0.85,1494,596,2,0
59180,2014/03/31,2011/02/18,624,2,0.85,1494,624,2,0
59181,2014/03/31,2012/07/29,391,2,0.870919067,1458,391,2,0
59182,2014/03/31,2009/07/13,540,2,0.870919067,1458,540,2,0
59183,2014/03/31,2006/11/07,385,3,0.59274043,2142,385,3,0
59184,2014/03/31,2006/10/30,194,2,0.92,1380,194,0,2
59185,2014/03/31,2007/11/08,102,2,0.92,1380,102,0,2
59186,2014/03/31,2008/04/16,174,2,0.92,1380,174,0,2
59187,2014/03/31,2012/01/16,16,2,0.92,1380,16,0,2
59188,2014/03/31,2008/01/09,163,2,0.92,1380,163,0,2
59189,2014/03/31,2012/12/26,6,2,0.452094017,2808,6,0,2
59190,2014/03/31,2012/04/11,120,3,0.374076039,3393,120,0,3
59191,2014/03/31,2011/06/05,55,2,0.608695444,2085,55,1,1
59192,2014/03/31,2007/10/17,620,2,0.88997195,1426,620,2,0
59193,2014/03/31,2012/12/15,468,2,1.0,1269,468,2,0
59194,2014/03/31,2012/12/17,411,2,1.0,1269,411,2,0
59195,2014/03/31,2006/02/23,476,2,1.0,1269,476,2,0
59196,2014/03/31,2011/07/12,265,2,0.474532536,2674,265,1,1
59197,2014/03/31,2012/06/21,601,3,0.455892921,2783,601,3,0
59198,2014/03/31,2013/03/25,230,2,0.961849886,1319,230,1,1
59199,2014/03/31,2013/01/15,370,3,0.580366133,2185,370,3,0
59200,2014/03/31,2013/01/01,36,2,0.587253358,2159,36,0,2
59201,2014/03/31,2009/12/13,262,2,0.592853134,2138,262,1,1
59202,2014/03/31,2012/03/09,683,2,0.769114078,1648,683,2,0
59203,2014/03/31,2010/01/12,723,2,0.460509091,2750,723,2,0
59204,2014/03/31,2009/01/15,334,2,0.725,1746,334,0,2
59205,2014/03/31,2012/07/02,92,2,0.725,1746,92,0,2
59206,2014/03/31,2011/07/05,558,2,0.48566769,2606,558,2,0
59207,2014/03/31,2011/12/28,668,2,0.768894289,1646,668,2,0
59208,2014/03/31,2010/04/13,429,3,0.65,1947,429,3,0
59209,2014/03/31,2013/01/16,368,3,0.65,1947,368,3,0
59210,2014/03/31,2009/01/04,377,3,0.6333333329999999,1998,377,3,0
59211,2014/03/31,2008/03/22,117,2,0.78,1622,117,0,2
59212,2014/03/31,2011/10/11,421,2,0.4,3162,421,2,0
59213,2014/03/31,2012/02/25,463,2,0.475969138,2657,463,2,0
59214,2014/03/31,2010/11/01,414,3,0.483333333,2616,414,3,0
59215,2014/03/31,2010/05/15,382,3,0.7353026779999999,1718,382,3,0
59216,2014/03/31,2012/07/10,181,2,0.725,1742,181,1,1
59217,2014/03/31,2006/02/18,448,2,0.625,2020,448,2,0
59218,2014/03/31,2008/10/25,107,3,0.726666667,1737,107,0,3
59219,2014/03/31,2011/09/08,94,3,0.926666667,1362,94,1,2
59220,2014/03/31,2011/06/12,695,2,0.570995475,2210,695,2,0
59221,2014/03/31,2006/05/13,147,2,0.832236148,1516,147,0,2
59222,2014/03/31,2011/07/16,509,2,0.6079518070000001,2075,509,2,0
59223,2014/03/31,2008/12/25,14,2,0.534491525,2360,14,0,2
59224,2014/03/31,2007/02/28,59,2,0.82361855,1531,59,1,1
59225,2014/03/31,2009/03/07,521,3,0.55,2292,521,3,0
59226,2014/03/31,2010/12/13,3,2,0.610387409,2065,3,1,1
59227,2014/03/31,2008/06/09,424,3,0.7666666670000001,1644,424,3,0
59228,2014/03/31,2009/01/23,339,2,0.575,2192,339,1,1
59229,2014/03/31,2005/10/21,662,3,0.383333333,3288,662,3,0
59230,2014/03/31,2012/07/25,190,2,0.49,2572,190,0,2
59231,2014/03/31,2013/01/19,8,3,0.52097561,2419,8,2,1
59232,2014/03/31,2009/12/29,186,2,0.49,2571,186,0,2
59233,2014/03/31,2008/11/03,640,3,0.33258516,3787,640,3,0
59234,2014/03/31,2005/11/25,200,2,0.608738521,2069,200,1,1
59235,2014/03/31,2012/12/24,458,2,0.5569217160000001,2261,458,2,0
59236,2014/03/31,2009/03/24,30,2,0.97,1298,30,1,1
59237,2014/03/31,2004/12/23,9,2,0.606168675,2075,9,0,2
59238,2014/03/31,2008/04/23,530,2,0.775,1622,530,2,0
59239,2014/03/31,2012/11/16,497,2,0.4,3142,497,2,0
59240,2014/03/31,2012/06/26,49,3,0.614498778,2045,49,0,3
59241,2014/03/31,2010/09/28,41,2,0.27,4654,41,0,2
59242,2014/03/31,2013/02/14,393,2,0.6,2094,393,2,0
59243,2014/03/31,2011/08/22,138,2,0.528275862,2378,138,1,1
59244,2014/03/31,2008/03/30,212,2,0.91,1380,212,0,2
59245,2014/03/31,2005/08/31,248,2,0.91,1380,248,0,2
59246,2014/03/31,2012/06/13,220,2,0.72,1744,220,0,2
59247,2014/03/31,2011/04/25,237,2,0.48,2616,237,0,2
59248,2014/03/31,2012/12/05,379,2,0.6,2092,379,2,0
59249,2014/03/31,2012/03/29,310,2,0.596861626,2103,310,1,1
59250,2014/03/31,2011/01/05,400,2,0.525,2390,400,2,0
59251,2014/03/31,2006/12/06,329,3,0.35,3585,329,2,1
59252,2014/03/31,2012/04/15,348,2,0.25,5017,348,1,1
59253,2014/03/31,2010/12/29,679,2,0.7232122259999999,1734,679,2,0
59254,2014/03/31,2013/01/15,54,4,0.285335609,4395,54,1,3
59255,2014/03/31,2005/04/01,378,2,0.6460587329999999,1941,378,2,0
59256,2014/03/31,2006/04/26,24,2,0.593693182,2112,24,0,2
59257,2014/03/31,2010/01/10,697,2,0.732359813,1712,697,2,0
59258,2014/03/31,2010/12/11,218,2,0.590810556,2122,218,0,2
59259,2014/03/31,2013/01/22,78,2,0.760582524,1648,78,1,1
59260,2014/03/31,2012/02/02,593,3,0.837700535,1496,593,3,0
59261,2014/03/31,2005/09/01,445,3,0.408708415,3066,445,3,0
59262,2014/03/31,2011/01/04,72,4,0.54,2320,72,0,4
59263,2014/03/31,2012/09/24,19,2,0.715,1752,19,1,1
59264,2014/03/31,2013/01/04,39,2,0.466706408,2684,39,1,1
59265,2014/03/31,2012/12/16,230,2,0.490062598,2556,230,0,2
59266,2014/03/31,2008/06/20,18,2,0.965,1298,18,1,1
59267,2014/03/31,2010/11/25,138,2,0.477495234,2623,138,0,2
59268,2014/03/31,2008/03/11,211,4,0.31,4040,211,3,1
59269,2014/03/31,2008/11/08,143,2,0.62,2020,143,0,2
59270,2014/03/31,2007/02/13,439,2,0.600383509,2086,439,2,0
59271,2014/03/31,2010/10/24,11,2,0.644199691,1943,11,1,1
59272,2014/03/31,2012/09/27,368,3,0.480433948,2604,368,3,0
59273,2014/03/31,2008/10/14,75,2,0.9,1390,75,1,1
59274,2014/03/31,2012/04/30,170,2,0.494910962,2527,170,0,2
59275,2014/03/31,2007/12/13,152,3,0.45875642,2726,152,0,3
59276,2014/03/31,2009/07/03,438,2,0.784378921,1594,438,2,0
59277,2014/03/31,2010/04/08,287,3,0.413682991,3022,287,2,1
59278,2014/03/31,2010/10/22,96,2,0.527237453,2371,96,0,2
59279,2014/03/31,2011/06/24,571,2,0.7045685279999999,1773,571,2,0
59280,2014/03/31,2012/09/01,496,2,0.644478844,1938,496,2,0
59281,2014/03/31,2013/03/13,113,2,0.7008024690000001,1782,113,0,2
59282,2014/03/31,2009/12/11,121,2,0.727651515,1716,121,1,1
59283,2014/03/31,2012/11/06,403,2,0.8,1560,403,2,0
59284,2014/03/31,2012/10/22,284,2,0.8270377729999999,1509,284,1,1
59285,2014/03/31,2010/04/06,292,3,0.332129359,3757,292,0,3
59286,2014/03/31,2012/04/24,214,2,0.66443557,1878,214,0,2
59287,2014/03/31,2012/08/05,581,2,0.775,1610,581,2,0
59288,2014/03/31,2011/01/13,42,2,0.516851698,2414,42,0,2
59289,2014/03/31,2013/01/03,331,2,0.525,2376,331,0,2
59290,2014/03/31,2011/10/23,259,2,0.48644167,2563,259,1,1
59291,2014/03/31,2010/02/07,657,2,0.637269939,1956,657,2,0
59292,2014/03/31,2012/08/04,563,2,0.45,2770,563,2,0
59293,2014/03/31,2012/11/14,500,2,0.25,4986,500,2,0
59294,2014/03/31,2008/02/05,145,2,0.487096522,2559,145,0,2
59295,2014/03/31,2012/09/19,97,2,0.3,4154,97,0,2
59296,2014/03/31,2011/09/04,146,3,0.317010939,3931,146,0,3
59297,2014/03/31,2012/06/29,196,2,0.96,1298,196,1,1
59298,2014/03/31,2011/07/10,132,2,0.351291232,3547,132,1,1
59299,2014/03/31,2011/07/21,96,2,0.981749409,1269,96,1,1
59300,2014/03/31,2011/06/14,209,3,0.262431009,4747,209,2,1
59301,2014/03/31,2012/12/28,214,2,0.619145129,2012,214,0,2
59302,2014/03/31,2012/06/27,627,2,0.630045524,1977,627,2,0
59303,2014/03/31,2009/09/27,25,3,0.369134558,3374,25,0,3
59304,2014/03/31,2010/08/03,197,3,0.6899113570000001,1805,197,0,3
59305,2014/03/31,2007/12/11,158,2,0.67,1858,158,0,2
59306,2014/03/31,2011/03/17,420,2,0.6479698070000001,1921,420,2,0
59307,2014/03/31,2012/09/05,73,3,0.824512922,1509,73,1,2
59308,2014/03/31,2012/07/14,397,2,0.450271444,2763,397,2,0
59309,2014/03/31,2005/12/03,24,5,0.489103421,2543,24,2,3
59310,2014/03/31,2009/09/06,217,2,0.7605504590000001,1635,217,0,2
59311,2014/03/31,2011/08/05,21,2,0.491212959,2531,21,1,1
59312,2014/03/31,2010/11/17,550,2,0.551242236,2254,550,2,0
59313,2014/03/31,2012/01/26,703,2,0.551242236,2254,703,2,0
59314,2014/03/31,2010/12/20,680,2,0.4,3106,680,2,0
59315,2014/03/31,2010/06/17,653,2,0.592935561,2095,653,2,0
59316,2014/03/31,2008/05/01,623,2,0.9,1380,623,2,0
59317,2014/03/31,2012/01/25,722,2,0.9,1380,722,2,0
59318,2014/03/31,2010/04/08,717,2,0.9,1380,717,2,0
59319,2014/03/31,2007/11/02,388,2,0.9,1380,388,2,0
59320,2014/03/31,2006/10/15,336,2,0.9,1380,336,1,1
59321,2014/03/31,2012/12/29,427,2,0.9,1380,427,2,0
59322,2014/03/31,2011/07/13,468,2,0.9,1380,468,2,0
59323,2014/03/31,2011/03/07,564,2,0.9,1380,564,2,0
59324,2014/03/31,2011/04/06,593,2,0.7,1774,593,2,0
59325,2014/03/31,2012/05/12,685,2,0.92729649,1339,685,2,0
59326,2014/03/31,2012/01/26,139,2,0.707378917,1755,139,0,2
59327,2014/03/31,2010/04/21,15,3,0.5210831229999999,2382,15,0,3
59328,2014/03/31,2007/07/27,525,3,0.383333333,3237,525,3,0
59329,2014/03/31,2008/11/02,62,2,0.478334618,2594,62,0,2
59330,2014/03/31,2012/11/02,289,2,0.628328267,1974,289,1,1
59331,2014/03/31,2011/05/23,102,3,0.64892203,1911,102,1,2
59332,2014/03/31,2012/08/31,427,2,0.657824934,1885,427,2,0
59333,2014/03/31,2005/12/04,487,2,0.683949255,1813,487,2,0
59334,2014/03/31,2010/11/29,305,3,0.363716632,3409,305,1,2
59335,2014/03/31,2010/10/07,167,2,0.59919768,2069,167,1,1
59336,2014/03/31,2013/03/29,48,2,0.955,1298,48,1,1
59337,2014/03/31,2010/08/02,62,2,0.955,1298,62,1,1
59338,2014/03/31,2013/01/06,28,3,0.32,3873,28,1,2
59339,2014/03/31,2012/09/03,183,2,0.315,3934,183,1,1
59340,2014/03/31,2008/06/24,313,2,0.6419689120000001,1930,313,1,1
59341,2014/03/31,2013/01/24,388,3,1.0,1239,388,3,0
59342,2014/03/31,2013/01/01,176,2,0.38,3260,176,0,2
59343,2014/03/31,2012/04/15,38,2,0.677881773,1827,38,0,2
59344,2014/03/31,2013/02/22,41,3,0.462934579,2675,41,0,3
59345,2014/03/31,2012/10/26,509,2,0.426948276,2900,509,2,0
59346,2014/03/31,2010/10/11,8,2,0.384711001,3218,8,0,2
59347,2014/03/31,2011/08/01,660,3,0.453147877,2732,660,3,0
59348,2014/03/31,2012/02/04,31,2,0.609133858,2032,31,0,2
59349,2014/03/31,2011/12/26,629,2,0.45,2750,629,2,0
59350,2014/03/31,2007/12/06,330,2,0.739247312,1674,330,1,1
59351,2014/03/31,2011/01/04,106,2,0.45596168,2714,106,1,1
59352,2014/03/31,2007/07/02,311,2,0.68431969,1808,311,1,1
59353,2014/03/31,2006/11/01,149,2,0.72,1718,149,0,2
59354,2014/03/31,2012/07/01,458,2,0.548757764,2254,458,2,0
59355,2014/03/31,2012/10/02,167,2,0.758803681,1630,167,0,2
59356,2014/03/31,2011/02/21,235,2,0.758803681,1630,235,0,2
59357,2014/03/31,2011/07/26,700,2,0.428081717,2888,700,2,0
59358,2014/03/31,2011/02/01,97,5,0.436,2835,97,2,3
59359,2014/03/31,2012/10/07,173,2,0.55,2247,173,0,2
59360,2014/03/31,2011/02/15,197,2,0.535,2310,197,0,2
59361,2014/03/31,2006/06/16,93,2,0.436839873,2829,93,1,1
59362,2014/03/31,2010/07/05,229,3,0.73161042,1689,229,0,3
59363,2014/03/31,2008/06/12,40,2,0.895,1380,40,0,2
59364,2014/03/31,2007/09/21,6,2,0.702953899,1757,6,0,2
59365,2014/03/31,2012/04/21,711,2,0.4,3087,711,2,0
59366,2014/03/31,2013/03/26,186,2,0.48,2572,186,0,2
59367,2014/03/31,2013/01/01,206,2,0.6096049379999999,2025,206,0,2
59368,2014/03/31,2013/02/10,84,5,0.573091922,2154,84,0,5
59369,2014/03/31,2011/01/13,23,2,0.82889859,1489,23,0,2
59370,2014/03/31,2012/11/26,161,3,0.628746816,1963,161,2,1
59371,2014/03/31,2012/11/11,435,2,0.534705373,2308,435,2,0
59372,2014/03/31,2009/06/08,104,3,0.388919004,3173,104,1,2
59373,2014/03/31,2009/12/29,593,2,0.951349268,1297,593,2,0
59374,2014/03/31,2012/03/27,687,2,0.531080499,2323,687,2,0
59375,2014/03/31,2010/12/19,322,2,0.604656863,2040,322,0,2
59376,2014/03/31,2011/03/18,184,2,0.665590934,1853,184,0,2
59377,2014/03/31,2009/04/07,20,2,0.46295045,2664,20,1,1
59378,2014/03/31,2007/07/08,558,2,0.95,1298,558,2,0
59379,2014/03/31,2013/03/20,183,2,0.95,1298,183,0,2
59380,2014/03/31,2007/05/15,535,2,0.95,1298,535,2,0
59381,2014/03/31,2008/07/03,719,2,0.95,1298,719,2,0
59382,2014/03/31,2011/09/24,715,2,0.95,1298,715,2,0
59383,2014/03/31,2009/06/25,646,2,0.95,1298,646,2,0
59384,2014/03/31,2008/03/20,91,2,0.6322,1950,91,1,1
59385,2014/03/31,2006/02/14,33,2,0.347066441,3552,33,0,2
59386,2014/03/31,2007/05/11,236,2,0.484143755,2546,236,1,1
59387,2014/03/31,2006/07/28,85,2,0.295226347,4175,85,1,1
59388,2014/03/31,2010/07/26,654,2,0.7641041540000001,1613,654,2,0
59389,2014/03/31,2008/05/13,527,3,0.659390048,1869,527,3,0
59390,2014/03/31,2012/06/11,135,2,0.47,2622,135,1,1
59391,2014/03/31,2010/02/16,673,2,0.7315914490000001,1684,673,2,0
59392,2014/03/31,2010/01/13,483,2,0.6738785559999999,1828,483,2,0
59393,2014/03/31,2007/05/16,8,2,0.601695164,2047,8,0,2
59394,2014/03/31,2011/11/09,363,2,0.5,2463,363,1,1
59395,2014/03/31,2011/07/04,104,2,0.949483423,1297,104,1,1
59396,2014/03/31,2010/03/26,289,2,0.291980081,4217,289,1,1
59397,2014/03/31,2013/03/16,350,2,0.420440574,2928,350,0,2
59398,2014/03/31,2013/03/16,350,2,0.420440574,2928,350,0,2
59399,2014/03/31,2013/02/25,48,2,0.63,1954,48,0,2
59400,2014/03/31,2009/10/30,126,2,0.80141276,1536,126,1,1
59401,2014/03/31,2008/03/05,162,2,0.92,1337,162,0,2
59402,2014/03/31,2013/03/09,386,2,0.615,2000,386,2,0
59403,2014/03/31,2007/11/29,301,2,0.841108071,1462,301,1,1
59404,2014/03/31,2012/09/18,102,2,0.723305882,1700,102,1,1
59405,2014/03/31,2008/02/22,387,2,0.919670905,1337,387,2,0
59406,2014/03/31,2011/11/24,195,2,0.912032641,1348,195,0,2
59407,2014/03/31,2012/08/01,590,3,0.501346389,2451,590,3,0
59408,2014/03/31,2009/12/08,622,2,1.0,1228,622,2,0
59409,2014/03/31,2012/07/10,627,2,0.5,2456,627,2,0
59410,2014/03/31,2012/11/12,357,3,0.454553869,2701,357,2,1
59411,2014/03/31,2012/08/22,420,2,0.2,6138,420,2,0
59412,2014/03/31,2009/11/18,103,2,0.559881387,2192,103,0,2
59413,2014/03/31,2008/02/24,122,2,0.722342554,1699,122,0,2
59414,2014/03/31,2013/01/01,98,3,0.544724689,2252,98,0,3
59415,2014/03/31,2011/05/20,163,2,0.604275862,2030,163,1,1
59416,2014/03/31,2012/11/17,492,2,0.4,3066,492,2,0
59417,2014/03/31,2012/09/28,493,2,0.4,3066,493,2,0
59418,2014/03/31,2012/08/12,590,2,0.700742857,1750,590,2,0
59419,2014/03/31,2012/09/19,494,2,0.470710173,2605,494,2,0
59420,2014/03/31,2006/04/29,254,3,0.549614523,2231,254,2,1
59421,2014/03/31,2010/12/13,304,2,0.59,2078,304,1,1
59422,2014/03/31,2013/01/19,437,2,0.55,2229,437,2,0
59423,2014/03/31,2009/06/29,423,3,0.9,1362,423,3,0
59424,2014/03/31,2009/09/22,62,3,0.9,1362,62,0,3
59425,2014/03/31,2011/10/16,724,3,0.6040414000000001,2029,724,3,0
59426,2014/03/31,2007/03/31,172,2,0.92,1332,172,0,2
59427,2014/03/31,2008/05/19,219,2,0.92,1332,219,0,2
59428,2014/03/31,2007/11/23,287,2,0.52,2356,287,0,2
59429,2014/03/31,2006/09/15,96,2,0.418769231,2925,96,0,2
59430,2014/03/31,2012/05/09,583,3,0.972063492,1260,583,3,0
59431,2014/03/31,2006/10/01,7,2,0.755,1622,7,0,2
59432,2014/03/31,2010/01/01,635,2,0.448005854,2733,635,2,0
59433,2014/03/31,2007/03/07,208,2,0.50273922,2435,208,0,2
59434,2014/03/31,2012/07/07,548,2,0.689189189,1776,548,2,0
59435,2014/03/31,2007/03/06,157,2,0.92,1330,157,0,2
59436,2014/03/31,2007/03/26,590,2,0.7,1746,590,2,0
59437,2014/03/31,2011/06/03,533,2,0.7,1746,533,2,0
59438,2014/03/31,2013/02/25,342,2,0.6823841429999999,1791,342,1,1
59439,2014/03/31,2012/10/08,533,2,0.4860978520000001,2514,533,2,0
59440,2014/03/31,2011/11/08,119,2,0.651408,1875,119,0,2
59441,2014/03/31,2013/01/11,235,2,0.92,1327,235,0,2
59442,2014/03/31,2012/09/30,11,2,0.629515214,1939,11,1,1
59443,2014/03/31,2011/07/09,312,2,0.666967213,1830,312,1,1
59444,2014/03/31,2011/08/11,291,2,0.621757514,1963,291,0,2
59445,2014/03/31,2009/07/02,21,2,0.612076229,1994,21,1,1
59446,2014/03/31,2011/10/31,614,5,0.54,2260,614,5,0
59447,2014/03/31,2005/01/25,235,3,0.233824487,5219,235,2,1
59448,2014/03/31,2011/09/23,125,2,0.94,1298,125,0,2
59449,2014/03/31,2010/04/17,253,3,0.5927891160000001,2058,253,2,1
59450,2014/03/31,2012/12/15,375,2,0.5707533929999999,2137,375,2,0
59451,2014/03/31,2012/10/31,502,2,0.4,3049,502,2,0
59452,2014/03/31,2012/09/18,560,2,0.4,3049,560,2,0
59453,2014/03/31,2010/10/20,314,2,0.740437158,1647,314,1,1
59454,2014/03/31,2009/02/21,144,2,0.466309751,2615,144,0,2
59455,2014/03/31,2013/03/10,208,2,0.910306199,1339,208,1,1
59456,2014/03/31,2007/12/29,279,2,0.511149329,2384,279,1,1
59457,2014/03/31,2008/02/12,128,3,0.488596632,2494,128,2,1
59458,2014/03/31,2009/12/08,281,2,0.541846085,2248,281,0,2
59459,2014/03/31,2009/08/19,16,3,0.418426658,2911,16,0,3
59460,2014/03/31,2009/11/25,516,2,0.447629548,2721,516,2,0
59461,2014/03/31,2012/04/30,660,2,0.6,2030,660,2,0
59462,2014/03/31,2012/01/16,605,2,0.6,2030,605,2,0
59463,2014/03/31,2009/06/30,4,2,0.609,2000,4,0,2
59464,2014/03/31,2010/09/07,326,3,0.588878143,2068,326,2,1
59465,2014/03/31,2009/02/20,61,2,0.815,1494,61,0,2
59466,2014/03/31,2006/11/23,354,2,0.8,1522,354,1,1
59467,2014/03/31,2012/05/12,681,2,0.8,1522,681,2,0
59468,2014/03/31,2012/08/30,481,3,0.533333333,2283,481,3,0
59469,2014/03/31,2008/02/06,361,2,0.8,1522,361,1,1
59470,2014/03/31,2012/08/08,449,2,0.8,1522,449,2,0
59471,2014/03/31,2008/04/25,538,2,0.8,1522,538,2,0
59472,2014/03/31,2011/08/09,81,3,0.369184354,3298,81,2,1
59473,2014/03/31,2013/02/26,30,5,0.304,4005,30,1,4
59474,2014/03/31,2011/04/17,310,3,0.694238448,1753,310,2,1
59475,2014/03/31,2013/02/20,339,2,0.75,1622,339,1,1
59476,2014/03/31,2012/03/27,340,2,0.75,1622,340,1,1
59477,2014/03/31,2006/05/29,434,2,0.75,1622,434,2,0
59478,2014/03/31,2011/12/09,579,3,0.937895143,1297,579,3,0
59479,2014/03/31,2007/11/04,68,2,0.76,1600,68,0,2
59480,2014/03/31,2012/09/04,431,4,0.7106955,1711,431,4,0
59481,2014/03/31,2006/01/30,153,2,0.415,2930,153,1,1
59482,2014/03/31,2011/05/29,716,3,0.7,1737,716,3,0
59483,2014/03/31,2011/11/21,382,3,0.7,1737,382,3,0
59484,2014/03/31,2011/11/12,184,4,0.390176565,3115,184,1,3
59485,2014/03/31,2007/01/31,44,2,0.47070488,2582,44,0,2
59486,2014/03/31,2013/01/24,317,2,0.5,2430,317,1,1
59487,2014/03/31,2012/09/01,44,2,0.7270377020000001,1671,44,1,1
59488,2014/03/31,2011/02/28,644,2,0.5370026529999999,2262,644,2,0
59489,2014/03/31,2011/12/11,197,2,0.72518209,1675,197,1,1
59490,2014/03/31,2013/01/21,5,2,0.947371295,1282,5,1,1
59491,2014/03/31,2007/06/06,9,4,0.92,1320,9,3,1
59492,2014/03/31,2011/07/03,33,2,0.88,1380,33,0,2
59493,2014/03/31,2007/02/01,95,2,0.49,2478,95,0,2
59494,2014/03/31,2010/08/28,14,5,0.602113095,2016,14,0,5
59495,2014/03/31,2012/07/10,104,3,0.35019042100000003,3466,104,0,3
59496,2014/03/31,2012/06/04,436,3,0.6166666670000001,1968,436,3,0
59497,2014/03/31,2005/02/11,292,2,0.515,2356,292,1,1
59498,2014/03/31,2012/09/19,485,2,0.45,2696,485,2,0
59499,2014/03/31,2008/09/30,595,2,0.45,2696,595,2,0
59500,2014/03/31,2010/11/06,501,2,0.45,2696,501,2,0
59501,2014/03/31,2008/02/10,140,2,0.795,1526,140,0,2
59502,2014/03/31,2012/12/27,356,2,0.65,1866,356,1,1
59503,2014/03/31,2005/09/20,598,2,0.844050104,1437,598,2,0
59504,2014/03/31,2013/01/31,15,2,0.51,2378,15,0,2
59505,2014/03/31,2009/12/17,100,3,0.573861808,2113,100,0,3
59506,2014/03/31,2005/09/01,239,2,0.5657722820000001,2143,239,1,1
59507,2014/03/31,2011/09/21,183,2,0.501211244,2419,183,1,1
59508,2014/03/31,2012/10/14,535,2,0.4,3031,535,2,0
59509,2014/03/31,2008/06/21,162,2,0.535,2266,162,0,2
59510,2014/03/31,2011/01/04,554,3,0.410759065,2951,554,3,0
59511,2014/03/31,2010/01/30,258,2,0.605157264,2003,258,1,1
59512,2014/03/31,2005/03/26,43,2,0.695,1744,43,0,2
59513,2014/03/31,2012/09/22,557,2,0.963434022,1258,557,2,0
59514,2014/03/31,2008/03/09,708,2,0.6,2020,708,2,0
59515,2014/03/31,2009/03/30,108,2,0.58,2089,108,0,2
59516,2014/03/31,2012/06/13,628,2,0.806121091,1503,628,2,0
59517,2014/03/31,2009/01/03,293,2,0.605172414,2001,293,0,2
59518,2014/03/31,2010/01/02,721,2,0.7422440220000001,1631,721,2,0
59519,2014/03/31,2006/06/17,170,3,0.696666667,1737,170,2,1
59520,2014/03/31,2009/07/29,237,2,0.401729748,3012,237,1,1
59521,2014/03/31,2011/07/12,258,3,0.430092428,2813,258,1,2
59522,2014/03/31,2011/05/12,89,2,0.448191253,2698,89,0,2
59523,2014/03/31,2012/10/30,158,2,0.38,3182,158,0,2
59524,2014/03/31,2012/05/16,242,2,0.479631099,2521,242,1,1
59525,2014/03/31,2011/04/09,21,2,0.780555197,1549,21,0,2
59526,2014/03/31,2005/06/19,205,2,0.92,1314,205,0,2
59527,2014/03/31,2011/01/18,80,2,0.575,2102,80,0,2
59528,2014/03/31,2009/01/28,714,2,1.0,1208,714,2,0
59529,2014/03/31,2008/06/19,728,2,1.0,1208,728,2,0
59530,2014/03/31,2011/03/02,360,2,0.65,1858,360,1,1
59531,2014/03/31,2008/09/19,337,2,0.75,1610,337,0,2
59532,2014/03/31,2009/11/11,141,2,0.93,1298,141,0,2
59533,2014/03/31,2006/07/16,13,2,0.505,2390,13,0,2
59534,2014/03/31,2007/09/04,124,2,0.62619097,1927,124,1,1
59535,2014/03/31,2009/10/16,366,2,0.5,2412,366,1,1
59536,2014/03/31,2009/09/11,314,2,0.415827586,2900,314,1,1
59537,2014/03/31,2012/07/17,22,2,0.42142258,2861,22,0,2
59538,2014/03/31,2012/07/05,399,2,0.331222527,3640,399,2,0
59539,2014/03/31,2012/11/20,288,2,0.601596806,2004,288,1,1
59540,2014/03/31,2009/05/06,217,2,0.79,1526,217,1,1
59541,2014/03/31,2013/02/16,49,3,0.621701908,1939,49,1,2
59542,2014/03/31,2012/03/01,247,2,0.58,2078,247,0,2
59543,2014/03/31,2007/02/05,314,3,0.277364787,4345,314,1,2
59544,2014/03/31,2013/01/09,219,3,0.456424242,2640,219,1,2
59545,2014/03/31,2008/06/28,295,2,0.471550509,2554,295,0,2
59546,2014/03/31,2013/03/30,328,2,0.424295278,2838,328,0,2
59547,2014/03/31,2012/07/13,628,2,0.928064765,1297,628,2,0
59548,2014/03/31,2012/10/07,542,2,0.7997342190000001,1505,542,2,0
59549,2014/03/31,2011/07/20,240,2,0.46,2616,240,0,2
59550,2014/03/31,2012/08/28,66,2,0.63,1910,66,0,2
59551,2014/03/31,2013/01/18,370,2,0.7201917320000001,1669,370,2,0
59552,2014/03/31,2013/01/08,449,2,0.611139369,1966,449,2,0
59553,2014/03/31,2011/03/11,720,2,0.825,1456,720,2,0
59554,2014/03/31,2009/12/12,540,2,0.4,3003,540,2,0
59555,2014/03/31,2011/05/11,256,2,0.7274924290000001,1651,256,1,1
59556,2014/03/31,2012/12/07,389,2,0.896938013,1339,389,2,0
59557,2014/03/31,2013/03/28,273,2,0.925,1298,273,1,1
59558,2014/03/31,2011/12/01,534,2,0.925,1298,534,2,0
59559,2014/03/31,2012/03/29,389,2,0.925,1298,389,2,0
59560,2014/03/31,2010/06/16,431,2,0.925,1298,431,2,0
59561,2014/03/31,2007/08/16,672,2,0.925,1298,672,2,0
59562,2014/03/31,2011/09/29,461,3,0.312061347,3847,461,3,0
59563,2014/03/31,2012/02/13,302,2,0.447583893,2682,302,0,2
59564,2014/03/31,2010/02/16,28,5,0.307364917,3905,28,2,3
59565,2014/03/31,2008/04/13,590,2,1.0,1200,590,2,0
59566,2014/03/31,2013/02/07,262,2,0.413877199,2899,262,0,2
59567,2014/03/31,2012/11/09,199,4,0.408210276,2939,199,1,3
59568,2014/03/31,2012/06/25,214,2,0.33,3634,214,0,2
59569,2014/03/31,2009/08/01,181,2,0.578947368,2071,181,0,2
59570,2014/03/31,2010/03/22,123,3,0.310530951,3861,123,1,2
59571,2014/03/31,2008/11/11,317,2,0.643555317,1862,317,1,1
59572,2014/03/31,2008/06/14,89,2,0.501876833,2387,89,0,2
59573,2014/03/31,2012/07/24,382,2,0.7979999999999999,1500,382,2,0
59574,2014/03/31,2011/04/22,615,3,0.391655759,3056,615,3,0
59575,2014/03/31,2010/05/18,56,2,0.64,1870,56,1,1
59576,2014/03/31,2012/03/11,416,2,0.6430913979999999,1860,416,2,0
59577,2014/03/31,2012/09/24,131,2,0.685,1746,131,1,1
59578,2014/03/31,2008/12/22,23,2,0.572484442,2089,23,0,2
59579,2014/03/31,2008/08/29,601,2,0.8,1494,601,2,0
59580,2014/03/31,2009/09/17,513,2,0.8,1494,513,2,0
59581,2014/03/31,2008/12/27,171,4,0.259826087,4600,171,2,2
59582,2014/03/31,2011/01/06,51,2,0.537839784,2222,51,1,1
59583,2014/03/31,2005/06/29,452,3,0.333333333,3585,452,3,0
59584,2014/03/31,2009/04/14,505,2,0.5,2390,505,2,0
59585,2014/03/31,2011/07/21,550,3,0.438118812,2727,550,3,0
59586,2014/03/31,2012/05/30,669,2,0.666313441,1793,669,2,0
59587,2014/03/31,2012/08/09,1,2,0.466082716,2563,1,0,2
59588,2014/03/31,2012/04/25,704,3,0.719145093,1661,704,3,0
59589,2014/03/31,2008/07/01,62,2,0.64,1866,62,0,2
59590,2014/03/31,2011/07/13,205,2,0.92,1298,205,0,2
59591,2014/03/31,2010/12/06,210,2,0.92,1298,210,0,2
59592,2014/03/31,2007/07/27,188,2,0.92,1298,188,0,2
59593,2014/03/31,2010/03/13,227,2,0.92,1298,227,0,2
59594,2014/03/31,2006/07/17,200,2,0.92,1298,200,0,2
59595,2014/03/31,2011/10/08,175,2,0.92,1298,175,0,2
59596,2014/03/31,2012/03/16,277,2,0.92,1298,277,0,2
59597,2014/03/31,2012/07/28,603,2,0.4,2985,603,2,0
59598,2014/03/31,2011/02/18,652,2,0.625,1910,652,2,0
59599,2014/03/31,2010/03/08,45,4,0.785,1520,45,2,2
59600,2014/03/31,2012/11/02,17,3,0.303333333,3933,17,1,2
59601,2014/03/31,2007/12/13,560,2,0.445869159,2675,560,2,0
59602,2014/03/31,2007/08/03,141,3,0.482558704,2470,141,2,1
59603,2014/03/31,2008/07/20,632,2,0.707843137,1683,632,2,0
59604,2014/03/31,2006/11/23,377,3,0.25,4764,377,3,0
59605,2014/03/31,2009/07/22,395,2,0.4,2977,395,2,0
59606,2014/03/31,2006/04/26,678,2,0.4,2977,678,2,0
59607,2014/03/31,2012/12/24,462,2,0.4,2977,462,2,0
59608,2014/03/31,2011/05/25,259,2,1.146936416,1038,259,1,1
59609,2014/03/31,2011/02/01,28,2,0.92,1294,28,0,2
59610,2014/03/31,2012/05/01,322,2,0.513724644,2317,322,0,2
59611,2014/03/31,2007/08/15,445,2,1.0,1190,445,2,0
59612,2014/03/31,2008/07/26,140,2,0.34,3500,140,0,2
59613,2014/03/31,2008/09/11,659,2,1.0,1190,659,2,0
59614,2014/03/31,2013/01/28,404,2,1.0,1190,404,2,0
59615,2014/03/31,2008/09/29,188,2,0.391269319,3041,188,1,1
59616,2014/03/31,2013/03/12,297,2,0.888521285,1339,297,1,1
59617,2014/03/31,2012/07/11,598,2,0.587988136,2023,598,2,0
59618,2014/03/31,2007/06/18,649,2,0.4,2972,649,2,0
59619,2014/03/31,2009/12/11,307,2,0.8,1486,307,0,2
59620,2014/03/31,2013/01/09,437,2,0.4,2972,437,2,0
59621,2014/03/31,2011/05/10,336,2,0.97124183,1224,336,0,2
59622,2014/03/31,2005/11/22,521,4,1.023944875,1161,521,4,0
59623,2014/03/31,2013/03/28,167,2,0.963241491,1234,167,0,2
59624,2014/03/31,2012/01/05,289,2,0.729190184,1630,289,1,1
59625,2014/03/31,2008/02/08,532,2,0.5,2376,532,2,0
59626,2014/03/31,2012/05/17,427,2,0.75752551,1568,427,2,0
59627,2014/03/31,2010/11/19,145,3,0.3917381270000001,3032,145,1,2
59628,2014/03/31,2012/10/16,45,4,0.275201669,4314,45,0,4
59629,2014/03/31,2013/01/30,246,2,0.33,3597,246,0,2
59630,2014/03/31,2013/03/20,90,2,0.40690566,2915,90,1,1
59631,2014/03/31,2005/11/15,321,3,0.6278454210000001,1889,321,1,2
59632,2014/03/31,2008/08/02,373,3,0.717675545,1652,373,3,0
59633,2014/03/31,2010/09/09,37,2,0.468924051,2528,37,0,2
59634,2014/03/31,2007/02/05,132,3,0.368136646,3220,132,0,3
59635,2014/03/31,2011/08/08,183,2,0.522061674,2270,183,0,2
59636,2014/03/31,2010/12/29,136,2,0.453623133,2611,136,1,1
59637,2014/03/31,2005/07/17,29,2,0.683712471,1732,29,1,1
59638,2014/03/31,2012/10/19,368,2,0.7,1691,368,2,0
59639,2014/03/31,2007/06/30,369,2,0.523463069,2261,369,2,0
59640,2014/03/31,2012/11/13,415,2,0.65,1820,415,2,0
59641,2014/03/31,2013/03/23,3,2,0.69,1714,3,1,1
59642,2014/03/31,2012/09/26,187,2,0.479955357,2464,187,0,2
59643,2014/03/31,2013/03/07,252,2,0.28,4223,252,0,2
59644,2014/03/31,2012/12/11,210,2,0.281485714,4200,210,0,2
59645,2014/03/31,2010/12/23,539,2,0.449790636,2627,539,2,0
59646,2014/03/31,2006/08/10,389,2,0.572154964,2065,389,2,0
59647,2014/03/31,2009/09/20,82,2,0.497050905,2377,82,1,1
59648,2014/03/31,2007/06/15,189,2,0.91,1298,189,0,2
59649,2014/03/31,2013/03/01,211,2,0.91,1298,211,0,2
59650,2014/03/31,2008/07/05,170,2,0.91,1298,170,1,1
59651,2014/03/31,2009/04/29,203,2,0.91,1298,203,0,2
59652,2014/03/31,2012/02/26,111,2,0.91,1298,111,0,2
59653,2014/03/31,2011/08/22,113,2,0.91,1298,113,0,2
59654,2014/03/31,2012/08/26,300,3,0.555,2128,300,1,2
59655,2014/03/31,2011/02/08,534,2,0.92992126,1270,534,2,0
59656,2014/03/31,2011/12/18,698,2,0.9,1312,698,2,0
59657,2014/03/31,2013/03/17,381,2,0.4,2951,381,2,0
59658,2014/03/31,2010/12/13,308,2,0.3,3934,308,1,1
59659,2014/03/31,2011/01/14,504,2,1.0,1180,504,2,0
59660,2014/03/31,2009/06/29,24,2,0.855,1380,24,0,2
59661,2014/03/31,2013/03/03,134,2,0.855,1380,134,0,2
59662,2014/03/31,2006/10/30,166,2,0.81,1456,166,1,1
59663,2014/03/31,2006/04/03,602,2,0.523136646,2254,602,2,0
59664,2014/03/31,2009/01/06,507,3,0.25,4716,507,3,0
59665,2014/03/31,2011/01/13,600,2,0.820961003,1436,600,2,0
59666,2014/03/31,2005/11/07,50,2,0.885,1332,50,0,2
59667,2014/03/31,2010/11/29,533,3,0.354511278,3325,533,3,0
59668,2014/03/31,2010/09/18,127,2,0.675,1746,127,0,2
59669,2014/03/31,2012/11/27,488,2,0.675,1746,488,2,0
59670,2014/03/31,2013/03/09,388,2,0.675,1746,388,2,0
59671,2014/03/31,2012/06/05,332,3,0.716666667,1644,332,2,1
59672,2014/03/31,2008/01/13,510,2,0.586460926,2009,510,2,0
59673,2014/03/31,2008/03/02,309,2,0.281303725,4188,309,1,1
59674,2014/03/31,2010/07/13,503,2,0.7235872240000001,1628,503,2,0
59675,2014/03/31,2013/01/10,138,2,0.5250824789999999,2243,138,0,2
59676,2014/03/31,2008/12/10,217,2,0.58,2030,217,0,2
59677,2014/03/31,2007/05/29,682,2,0.45,2616,682,2,0
59678,2014/03/31,2009/06/18,592,2,0.524431565,2243,592,2,0
59679,2014/03/31,2012/11/24,101,3,0.363333333,3237,101,2,1
59680,2014/03/31,2013/03/15,360,4,0.6278964229999999,1873,360,2,2
59681,2014/03/31,2006/07/13,646,3,0.885908063,1327,646,3,0
59682,2014/03/31,2010/05/13,536,2,0.369227144,3183,536,2,0
59683,2014/03/31,2011/11/13,220,3,0.32946173300000003,3567,220,2,1
59684,2014/03/31,2008/02/03,73,2,0.413786545,2839,73,0,2
59685,2014/03/31,2006/01/15,37,2,0.905,1298,37,0,2
59686,2014/03/31,2010/06/07,140,2,0.411113056,2857,140,0,2
59687,2014/03/31,2007/10/16,115,2,0.5042292829999999,2329,115,0,2
59688,2014/03/31,2012/11/30,463,2,0.630665951,1862,463,2,0
59689,2014/03/31,2009/12/03,56,3,0.652266667,1800,56,0,3
59690,2014/03/31,2011/11/08,220,4,0.362647513,3237,220,1,3
59691,2014/03/31,2011/12/22,198,2,0.614275249,1911,198,0,2
59692,2014/03/31,2006/05/18,118,2,0.465208086,2523,118,1,1
59693,2014/03/31,2010/05/20,207,2,0.85,1380,207,1,1
59694,2014/03/31,2013/01/10,418,2,0.85,1380,418,2,0
59695,2014/03/31,2013/01/07,448,2,0.25,4692,448,2,0
59696,2014/03/31,2012/12/19,173,2,0.409385475,2864,173,0,2
59697,2014/03/31,2005/04/01,641,2,0.7232572490000001,1621,641,2,0
59698,2014/03/31,2006/11/20,662,2,0.680046404,1724,662,2,0
59699,2014/03/31,2008/05/03,114,2,0.88,1332,114,0,2
59700,2014/03/31,2011/01/30,426,2,0.4,2930,426,2,0
59701,2014/03/31,2007/06/10,146,2,0.4,2930,146,0,2
59702,2014/03/31,2007/11/26,52,2,0.58,2020,52,0,2
59703,2014/03/31,2008/10/26,23,2,0.58,2020,23,0,2
59704,2014/03/31,2011/03/15,124,2,0.841149425,1392,124,0,2
59705,2014/03/31,2008/01/05,257,3,0.363333333,3222,257,2,1
59706,2014/03/31,2013/01/04,262,2,0.544465116,2150,262,1,1
59707,2014/03/31,2011/05/18,25,2,0.63,1858,25,0,2
59708,2014/03/31,2012/01/24,413,3,0.4,2925,413,3,0
59709,2014/03/31,2009/11/11,3,3,0.294764424,3969,3,0,3
59710,2014/03/31,2006/01/26,23,3,0.673333333,1737,23,0,3
59711,2014/03/31,2010/11/01,85,2,0.546987839,2138,85,0,2
59712,2014/03/31,2009/12/11,201,2,0.797150648,1467,201,0,2
59713,2014/03/31,2013/03/23,272,2,0.646274185,1809,272,0,2
59714,2014/03/31,2008/08/08,7,2,0.8515003640000001,1373,7,0,2
59715,2014/03/31,2009/08/27,399,2,0.952730236,1227,399,2,0
59716,2014/03/31,2009/06/16,638,2,0.425,2750,638,2,0
59717,2014/03/31,2005/08/19,665,2,0.425,2750,665,2,0
59718,2014/03/31,2012/01/31,377,2,0.625,1870,377,2,0
59719,2014/03/31,2011/06/30,229,2,0.957967213,1220,229,1,1
59720,2014/03/31,2009/03/19,345,2,0.424872727,2750,345,1,1
59721,2014/03/31,2011/06/16,216,4,0.34,3436,216,2,2
59722,2014/03/31,2012/04/11,720,2,0.9,1298,720,2,0
59723,2014/03/31,2009/02/08,448,2,0.9,1298,448,2,0
59724,2014/03/31,2008/12/03,724,2,0.9,1298,724,2,0
59725,2014/03/31,2012/12/26,398,2,0.9,1298,398,2,0
59726,2014/03/31,2012/02/08,81,2,0.9,1298,81,0,2
59727,2014/03/31,2012/05/10,691,2,0.9,1298,691,2,0
59728,2014/03/31,2007/06/07,621,2,0.9,1298,621,2,0
59729,2014/03/31,2008/05/20,162,2,0.9,1298,162,0,2
59730,2014/03/31,2011/02/15,62,2,0.9,1298,62,0,2
59731,2014/03/31,2012/02/26,684,2,0.9,1298,684,2,0
59732,2014/03/31,2006/06/18,5,2,0.9,1298,5,0,2
59733,2014/03/31,2011/08/02,62,2,0.9,1298,62,0,2
59734,2014/03/31,2012/10/16,191,3,0.593333333,1968,191,2,1
59735,2014/03/31,2008/09/21,18,2,0.69,1692,18,1,1
59736,2014/03/31,2008/07/30,23,2,0.499264328,2338,23,0,2
59737,2014/03/31,2012/01/18,421,2,0.775,1506,421,2,0
59738,2014/03/31,2010/11/01,92,2,0.6009474770000001,1942,92,0,2
59739,2014/03/31,2010/03/21,193,2,0.445,2622,193,0,2
59740,2014/03/31,2013/01/02,140,2,0.445,2622,140,0,2
59741,2014/03/31,2012/04/12,618,2,0.625,1866,618,2,0
59742,2014/03/31,2012/08/09,389,2,0.625,1866,389,2,0
59743,2014/03/31,2012/10/08,508,2,0.625,1866,508,2,0
59744,2014/03/31,2011/05/07,48,2,0.43,2712,48,0,2
59745,2014/03/31,2006/03/22,160,2,0.845,1380,160,0,2
59746,2014/03/31,2012/09/22,13,2,0.851131387,1370,13,0,2
59747,2014/03/31,2008/03/21,82,2,0.464257268,2511,82,1,1
59748,2014/03/31,2011/11/25,553,2,0.875,1332,553,2,0
59749,2014/03/31,2011/04/13,142,2,0.466411694,2497,142,0,2
59750,2014/03/31,2011/06/15,325,2,0.9,1294,325,1,1
59751,2014/03/31,2012/02/06,452,2,0.9,1294,452,2,0
59752,2014/03/31,2006/06/16,474,2,0.9,1294,474,2,0
59753,2014/03/31,2012/10/16,177,2,0.445,2616,177,0,2
59754,2014/03/31,2012/04/17,524,3,1.0,1164,524,3,0
59755,2014/03/31,2010/11/12,87,2,0.7717970820000001,1508,87,0,2
59756,2014/03/31,2010/10/29,143,3,0.276097272,4215,143,1,2
59757,2014/03/31,2011/01/31,502,3,0.270828485,4297,502,3,0
59758,2014/03/31,2013/01/24,310,3,0.5867624810000001,1983,310,0,3
59759,2014/03/31,2010/05/18,201,2,0.548317625,2122,201,0,2
59760,2014/03/31,2013/03/03,274,2,0.28,4154,274,0,2
59761,2014/03/31,2011/08/11,268,2,0.465706848,2497,268,0,2
59762,2014/03/31,2013/01/30,400,2,0.575,2020,400,2,0
59763,2014/03/31,2010/12/30,393,2,0.575,2020,393,2,0
59764,2014/03/31,2006/04/20,255,2,0.6880094790000001,1688,255,0,2
59765,2014/03/31,2013/03/08,140,2,0.6489938510000001,1789,140,0,2
59766,2014/03/31,2005/03/12,146,2,0.702822532,1651,146,0,2
59767,2014/03/31,2012/06/18,651,2,1.0,1160,651,2,0
59768,2014/03/31,2012/08/21,587,2,1.0,1160,587,2,0
59769,2014/03/31,2009/12/02,725,2,1.0,1160,725,2,0
59770,2014/03/31,2012/07/02,635,2,1.0,1160,635,2,0
59771,2014/03/31,2011/11/08,600,2,1.0,1160,600,2,0
59772,2014/03/31,2012/05/23,638,2,1.0,1160,638,2,0
59773,2014/03/31,2010/11/12,659,2,1.0,1160,659,2,0
59774,2014/03/31,2012/07/12,625,2,1.0,1160,625,2,0
59775,2014/03/31,2008/11/01,218,2,0.38,3052,218,0,2
59776,2014/03/31,2012/04/08,723,2,0.4,2899,723,2,0
59777,2014/03/31,2012/08/14,595,2,0.4,2899,595,2,0
59778,2014/03/31,2012/08/15,594,2,0.4,2899,594,2,0
59779,2014/03/31,2013/02/27,398,2,0.4,2899,398,2,0
59780,2014/03/31,2009/09/08,269,2,0.622944653,1861,269,1,1
59781,2014/03/31,2012/11/09,99,2,0.683380531,1695,99,0,2
59782,2014/03/31,2011/01/13,328,2,0.496698113,2332,328,1,1
59783,2014/03/31,2008/05/11,491,2,0.596037056,1943,491,2,0
59784,2014/03/31,2011/10/16,339,2,1.0,1158,339,1,1
59785,2014/03/31,2005/10/18,514,2,1.0,1158,514,2,0
59786,2014/03/31,2013/03/24,372,2,1.0,1158,372,2,0
59787,2014/03/31,2011/09/19,605,2,1.0,1158,605,2,0
59788,2014/03/31,2012/10/30,487,2,1.0,1158,487,2,0
59789,2014/03/31,2012/08/22,585,2,1.0,1158,585,2,0
59790,2014/03/31,2012/10/25,522,2,1.0,1158,522,2,0
59791,2014/03/31,2013/03/24,372,2,1.0,1158,372,2,0
59792,2014/03/31,2012/01/17,531,2,1.0,1158,531,2,0
59793,2014/03/31,2012/03/13,597,2,1.0,1158,597,2,0
59794,2014/03/31,2007/05/26,601,2,1.0,1158,601,2,0
59795,2014/03/31,2009/02/26,609,2,1.0,1158,609,2,0
59796,2014/03/31,2011/06/20,338,2,1.0,1158,338,0,2
59797,2014/03/31,2012/06/01,606,2,1.0,1158,606,2,0
59798,2014/03/31,2010/07/27,717,2,1.0,1158,717,2,0
59799,2014/03/31,2012/04/29,702,2,1.0,1158,702,2,0
59800,2014/03/31,2011/05/27,668,2,1.0,1158,668,2,0
59801,2014/03/31,2012/04/20,599,2,1.0,1158,599,2,0
59802,2014/03/31,2011/02/05,513,2,0.35,3308,513,2,0
59803,2014/03/31,2007/12/16,561,2,0.56365628,2054,561,2,0
59804,2014/03/31,2011/08/11,420,2,0.45,2572,420,2,0
59805,2014/03/31,2011/09/02,517,2,0.45,2572,517,2,0
59806,2014/03/31,2008/10/11,227,2,0.558860454,2071,227,1,1
59807,2014/03/31,2009/03/21,78,3,0.678815249,1705,78,2,1
59808,2014/03/31,2009/08/21,339,2,0.4,2893,339,0,2
59809,2014/03/31,2012/06/05,655,2,0.4,2892,655,2,0
59810,2014/03/31,2013/02/20,397,2,0.4,2892,397,2,0
59811,2014/03/31,2007/06/26,140,3,0.198515531,5827,140,2,1
59812,2014/03/31,2011/10/31,199,3,0.45,2570,199,1,2
59813,2014/03/31,2012/04/21,711,2,0.712569316,1623,711,2,0
59814,2014/03/31,2011/02/05,53,2,0.815800988,1417,53,0,2
59815,2014/03/31,2007/11/08,93,3,0.3512283370000001,3289,93,0,3
59816,2014/03/31,2012/01/21,390,2,0.453020792,2549,390,2,0
59817,2014/03/31,2012/09/11,300,2,0.33,3499,300,0,2
59818,2014/03/31,2011/08/18,503,3,0.716666667,1611,503,3,0
59819,2014/03/31,2012/06/20,473,2,0.677230047,1704,473,2,0
59820,2014/03/31,2012/09/06,172,2,0.415,2780,172,1,1
59821,2014/03/31,2013/01/24,222,2,0.58,1989,222,0,2
59822,2014/03/31,2012/04/20,708,2,0.8,1442,708,2,0
59823,2014/03/31,2011/03/18,576,2,0.733778626,1572,576,2,0
59824,2014/03/31,2011/04/20,164,2,0.480992494,2398,164,1,1
59825,2014/03/31,2010/12/13,16,3,0.268966884,4288,16,0,3
59826,2014/03/31,2012/11/25,450,2,0.65,1774,450,2,0
59827,2014/03/31,2013/01/10,348,2,0.65,1774,348,1,1
59828,2014/03/31,2012/09/16,561,2,0.65,1774,561,2,0
59829,2014/03/31,2011/08/23,661,2,0.574414549,2007,661,2,0
59830,2014/03/31,2012/05/28,104,2,0.938705212,1228,104,1,1
59831,2014/03/31,2011/07/12,14,2,0.34,3390,14,0,2
59832,2014/03/31,2010/11/14,2,2,0.34,3390,2,1,1
59833,2014/03/31,2010/09/08,170,2,0.34,3390,170,0,2
59834,2014/03/31,2012/02/19,47,4,0.4975,2316,47,1,3
59835,2014/03/31,2005/07/20,580,4,0.7064071120000001,1631,580,4,0
59836,2014/03/31,2006/11/22,433,3,0.696072508,1655,433,3,0
59837,2014/03/31,2011/06/08,669,2,1.0,1152,669,2,0
59838,2014/03/31,2010/12/16,394,2,1.0,1152,394,2,0
59839,2014/03/31,2011/01/27,404,3,0.521367134,2209,404,3,0
59840,2014/03/31,2010/08/28,279,2,0.354482759,3248,279,1,1
59841,2014/03/31,2010/12/22,277,2,0.478234317,2407,277,1,1
59842,2014/03/31,2007/11/15,297,2,0.44,2616,297,0,2
59843,2014/03/31,2013/02/04,314,2,0.6768235290000001,1700,314,1,1
59844,2014/03/31,2011/06/08,401,2,0.581866464,1977,401,2,0
59845,2014/03/31,2012/11/10,290,2,0.6209503239999999,1852,290,1,1
59846,2014/03/31,2011/12/27,306,2,0.329701835,3488,306,1,1
59847,2014/03/31,2013/01/10,238,3,0.39359589,2920,238,1,2
59848,2014/03/31,2011/03/27,588,2,0.955361596,1203,588,2,0
59849,2014/03/31,2011/09/02,36,2,0.429540187,2675,36,1,1
59850,2014/03/31,2010/04/28,78,2,0.885,1298,78,0,2
59851,2014/03/31,2011/10/28,28,2,0.885,1298,28,0,2
59852,2014/03/31,2012/07/25,227,2,0.885,1298,227,0,2
59853,2014/03/31,2012/03/20,218,2,0.885,1298,218,0,2
59854,2014/03/31,2012/08/14,185,2,0.885,1298,185,1,1
59855,2014/03/31,2012/05/13,485,2,0.6,1914,485,2,0
59856,2014/03/31,2009/12/04,617,3,0.4,2871,617,3,0
59857,2014/03/31,2011/12/26,219,3,0.33959775200000003,3381,219,0,3
59858,2014/03/31,2009/07/03,51,2,0.875,1312,51,0,2
59859,2014/03/31,2012/12/20,247,2,0.514917003,2229,247,1,1
59860,2014/03/31,2012/12/26,47,3,0.6333333329999999,1812,47,1,2
59861,2014/03/31,2009/06/19,468,2,0.322589261,3557,468,2,0
59862,2014/03/31,2008/09/21,36,2,0.456031809,2515,36,0,2
59863,2014/03/31,2008/04/13,104,2,0.3621092520000001,3167,104,1,1
59864,2014/03/31,2011/09/13,255,3,0.6862298029999999,1671,255,1,2
59865,2014/03/31,2011/10/14,687,2,0.349588289,3279,687,2,0
59866,2014/03/31,2009/10/12,531,2,0.6,1910,531,2,0
59867,2014/03/31,2008/09/16,98,2,0.3,3820,98,0,2
59868,2014/03/31,2011/08/05,311,2,0.6854066990000001,1672,311,0,2
59869,2014/03/31,2011/10/29,374,3,0.25,4578,374,3,0
59870,2014/03/31,2009/11/25,669,2,0.8064834390000001,1419,669,2,0
59871,2014/03/31,2012/10/23,12,2,0.776863544,1473,12,0,2
59872,2014/03/31,2006/08/10,94,2,0.77,1486,94,0,2
59873,2014/03/31,2006/03/30,600,2,0.392957746,2911,600,2,0
59874,2014/03/31,2007/11/18,371,2,0.397565217,2875,371,2,0
59875,2014/03/31,2012/04/27,698,2,0.25,4570,698,2,0
59876,2014/03/31,2006/11/18,441,2,0.371875,3072,441,2,0
59877,2014/03/31,2012/12/26,99,2,0.740239793,1543,99,1,1
59878,2014/03/31,2007/06/30,225,2,0.415,2752,225,0,2
59879,2014/03/31,2009/01/13,99,2,0.415,2752,99,0,2
59880,2014/03/31,2006/01/15,125,2,0.543139867,2102,125,1,1
59881,2014/03/31,2013/01/08,424,2,0.425615213,2682,424,2,0
59882,2014/03/31,2010/10/23,503,2,0.75,1522,503,2,0
59883,2014/03/31,2013/01/21,436,2,0.75,1522,436,2,0
59884,2014/03/31,2012/09/19,107,2,0.415054545,2750,107,0,2
59885,2014/03/31,2013/01/04,36,3,0.276666667,4125,36,0,3
59886,2014/03/31,2012/12/12,86,4,0.2725,4188,86,1,3
59887,2014/03/31,2007/04/27,304,2,0.72,1584,304,0,2
59888,2014/03/31,2008/10/06,192,2,0.8806486490000001,1295,192,0,2
59889,2014/03/31,2011/01/24,43,2,0.461773998,2469,43,0,2
59890,2014/03/31,2005/10/19,241,2,0.647001704,1761,241,0,2
59891,2014/03/31,2006/08/27,548,2,0.904126984,1260,548,2,0
59892,2014/03/31,2011/02/20,189,2,0.623448276,1827,189,1,1
59893,2014/03/31,2006/06/12,504,2,1.0,1139,504,2,0
59894,2014/03/31,2007/07/03,51,2,0.44540086,2557,51,0,2
59895,2014/03/31,2006/06/16,419,2,0.7524818,1511,419,2,0
59896,2014/03/31,2010/05/09,622,2,0.7,1624,622,2,0
59897,2014/03/31,2008/02/10,455,2,0.467674897,2430,455,2,0
59898,2014/03/31,2008/09/24,682,2,0.6216356670000001,1828,682,2,0
59899,2014/03/31,2012/11/13,128,2,0.34,3342,128,0,2
59900,2014/03/31,2012/06/25,605,2,0.647435897,1755,605,2,0
59901,2014/03/31,2010/02/09,470,2,0.475,2392,470,2,0
59902,2014/03/31,2011/11/21,201,2,0.705652174,1610,201,0,2
59903,2014/03/31,2012/04/06,724,3,0.937293729,1212,724,3,0
59904,2014/03/31,2013/03/11,144,3,0.77,1475,144,0,3
59905,2014/03/31,2011/08/06,68,2,0.875,1298,68,0,2
59906,2014/03/31,2005/09/09,419,2,0.875,1298,419,2,0
59907,2014/03/31,2012/02/09,335,3,0.31384743,3618,335,2,1
59908,2014/03/31,2012/02/23,728,2,0.7,1622,728,2,0
59909,2014/03/31,2012/07/21,619,2,0.7,1622,619,2,0
59910,2014/03/31,2012/11/30,164,2,0.92,1234,164,0,2
59911,2014/03/31,2012/01/17,454,3,0.316666667,3585,454,3,0
59912,2014/03/31,2010/03/29,524,3,0.316666667,3585,524,3,0
59913,2014/03/31,2008/12/16,125,2,0.34,3338,125,0,2
59914,2014/03/31,2010/09/09,607,2,0.65,1746,607,2,0
59915,2014/03/31,2011/01/04,661,2,0.65,1746,661,2,0
59916,2014/03/31,2008/05/17,120,3,0.63328683,1792,120,0,3
59917,2014/03/31,2008/02/27,9,3,0.570770005,1987,9,0,3
59918,2014/03/31,2013/01/23,404,2,1.0,1134,404,2,0
59919,2014/03/31,2006/04/05,328,2,1.0,1134,328,1,1
59920,2014/03/31,2007/06/18,558,2,1.0,1134,558,2,0
59921,2014/03/31,2008/02/04,709,2,1.0,1134,709,2,0
59922,2014/03/31,2011/04/15,168,2,0.90499601,1253,168,1,1
59923,2014/03/31,2010/05/26,174,3,0.496666667,2283,174,1,2
59924,2014/03/31,2012/03/15,285,2,0.608888292,1862,285,1,1
59925,2014/03/31,2011/12/30,46,2,0.53098829,2135,46,0,2
59926,2014/03/31,2008/12/22,126,4,0.507452999,2234,126,2,2
59927,2014/03/31,2006/07/18,569,2,0.65,1744,569,2,0
59928,2014/03/31,2011/04/12,124,2,0.5267828920000001,2151,124,0,2
59929,2014/03/31,2008/11/13,52,2,0.304335214,3723,52,0,2
59930,2014/03/31,2010/05/31,455,2,0.25,4532,455,2,0
59931,2014/03/31,2010/04/05,400,2,0.525,2158,400,2,0
59932,2014/03/31,2013/03/01,170,2,0.500600972,2263,170,1,1
59933,2014/03/31,2010/04/15,78,2,0.500600972,2263,78,0,2
59934,2014/03/31,2012/08/10,595,2,0.7,1618,595,2,0
59935,2014/03/31,2011/09/21,183,2,0.54573494,2075,183,1,1
59936,2014/03/31,2012/11/30,206,2,0.28,4044,206,0,2
59937,2014/03/31,2011/10/13,651,2,0.85,1332,651,2,0
59938,2014/03/31,2007/10/18,386,2,0.85,1332,386,2,0
59939,2014/03/31,2010/04/20,631,2,0.85,1332,631,2,0
59940,2014/03/31,2011/01/27,92,2,0.392827897,2882,92,0,2
59941,2014/03/31,2012/02/20,4,4,0.319187817,3546,4,2,2
59942,2014/03/31,2011/10/18,36,2,0.82,1380,36,0,2
59943,2014/03/31,2010/07/06,48,2,0.594944766,1901,48,0,2
59944,2014/03/31,2012/10/30,513,2,0.740635232,1527,513,2,0
59945,2014/03/31,2013/03/03,264,2,0.425875706,2655,264,0,2
59946,2014/03/31,2012/05/16,286,3,0.484716981,2332,286,2,1
59947,2014/03/31,2008/07/25,26,2,0.550043796,2055,26,0,2
59948,2014/03/31,2009/08/07,396,2,0.881435257,1282,396,2,0
59949,2014/03/31,2009/01/17,411,2,0.625,1808,411,2,0
59950,2014/03/31,2012/09/19,385,3,0.316666667,3567,385,3,0
59951,2014/03/31,2012/05/21,655,2,0.75,1506,655,2,0
59952,2014/03/31,2010/06/10,268,2,0.49,2305,268,0,2
59953,2014/03/31,2011/12/14,523,2,0.383350305,2946,523,2,0
59954,2014/03/31,2007/09/04,29,3,0.738574232,1529,29,0,3
59955,2014/03/31,2012/07/11,2,2,0.773479452,1460,2,0,2
59956,2014/03/31,2012/06/26,128,2,0.87,1298,128,1,1
59957,2014/03/31,2013/03/13,60,2,0.87,1298,60,1,1
59958,2014/03/31,2011/02/22,714,2,0.25,4516,714,2,0
59959,2014/03/31,2009/01/12,71,2,0.57,1980,71,1,1
59960,2014/03/31,2012/05/15,317,2,0.4206935120000001,2682,317,1,1
59961,2014/03/31,2012/11/13,441,2,0.700745342,1610,441,2,0
59962,2014/03/31,2012/02/26,152,2,0.6198076920000001,1820,152,0,2
59963,2014/03/31,2007/12/18,386,2,0.536584206,2102,386,2,0
59964,2014/03/31,2011/05/14,196,2,0.747931034,1508,196,1,1
59965,2014/03/31,2011/08/08,337,2,0.635984208,1773,337,1,1
59966,2014/03/31,2013/03/17,380,2,0.4,2819,380,2,0
59967,2014/03/31,2013/02/16,336,2,0.567758186,1985,336,1,1
59968,2014/03/31,2013/02/02,422,2,0.5,2254,422,2,0
59969,2014/03/31,2011/02/23,155,3,0.373289169,3019,155,1,2
59970,2014/03/31,2007/11/17,110,4,0.295,3820,110,0,4
59971,2014/03/31,2013/01/06,364,2,0.505745063,2228,364,1,1
59972,2014/03/31,2013/03/04,249,2,0.568309788,1982,249,0,2
59973,2014/03/31,2012/03/08,454,2,0.878549142,1282,454,2,0
59974,2014/03/31,2012/04/21,207,3,0.493333333,2283,207,2,1
59975,2014/03/31,2009/11/27,544,3,0.354629921,3175,544,3,0
59976,2014/03/31,2011/08/11,328,2,0.360044786,3126,328,1,1
59977,2014/03/31,2012/04/20,117,3,0.588332462,1913,117,1,2
59978,2014/03/31,2011/01/15,443,2,0.4,2813,443,2,0
59979,2014/03/31,2011/10/16,183,2,0.640341491,1757,183,0,2
59980,2014/03/31,2008/04/30,552,2,0.691031941,1628,552,2,0
59981,2014/03/31,2013/02/04,363,2,0.25,4500,363,0,2
59982,2014/03/31,2013/02/01,408,2,0.625,1800,408,2,0
59983,2014/03/31,2007/02/01,19,2,0.43,2616,19,0,2
59984,2014/03/31,2013/01/11,215,2,0.34,3308,215,1,1
59985,2014/03/31,2012/03/16,554,2,0.532591189,2111,554,2,0
59986,2014/03/31,2012/09/19,156,2,0.498757764,2254,156,0,2
59987,2014/03/31,2007/04/06,364,2,0.498757764,2254,364,1,1
59988,2014/03/31,2007/08/17,707,2,0.523428039,2147,707,2,0
59989,2014/03/31,2013/03/15,94,2,0.289852979,3877,94,0,2
59990,2014/03/31,2012/04/07,714,2,0.4,2809,714,2,0
59991,2014/03/31,2013/01/18,77,2,0.33,3404,77,0,2
59992,2014/03/31,2012/12/23,226,2,0.39,2880,226,1,1
59993,2014/03/31,2012/05/24,31,2,0.375,2994,31,0,2
59994,2014/03/31,2012/04/29,30,2,0.879741379,1276,30,0,2
59995,2014/03/31,2012/06/30,29,2,0.502448523,2234,29,0,2
59996,2014/03/31,2010/05/20,695,2,0.6,1870,695,2,0
59997,2014/03/31,2006/06/13,253,4,0.7619904890000001,1472,253,3,1
59998,2014/03/31,2011/07/06,51,2,0.285,3934,51,0,2
59999,2014/03/31,2008/11/25,292,2,0.77,1456,292,0,2
60000,2014/03/31,2012/09/28,150,3,0.282574382,3966,150,0,3
60001,2014/03/31,2006/01/07,111,2,0.75,1494,111,0,2
60002,2014/03/31,2011/07/03,627,2,0.75,1494,627,2,0
60003,2014/03/31,2009/08/11,647,3,0.458616455,2443,647,3,0
60004,2014/03/31,2013/01/08,285,2,0.33,3393,285,0,2
60005,2014/03/31,2012/07/18,211,3,0.443553883,2524,211,0,3
60006,2014/03/31,2008/07/08,7,2,0.848468537,1319,7,0,2
60007,2014/03/31,2013/02/14,14,2,0.8995659159999999,1244,14,0,2
60008,2014/03/31,2011/03/15,576,2,0.438440439,2552,576,2,0
60009,2014/03/31,2007/06/14,159,2,0.435,2572,159,0,2
60010,2014/03/31,2012/09/02,191,2,0.735,1522,191,1,1
60011,2014/03/31,2011/05/11,35,2,0.525382809,2129,35,0,2
60012,2014/03/31,2009/02/26,222,2,0.910570033,1228,222,0,2
60013,2014/03/31,2013/03/24,51,2,0.403979039,2767,51,0,2
60014,2014/03/31,2012/09/26,284,2,0.909429967,1228,284,1,1
60015,2014/03/31,2012/07/13,257,2,0.47,2376,257,1,1
60016,2014/03/31,2012/07/04,78,2,0.65,1718,78,1,1
60017,2014/03/31,2013/03/04,245,2,0.65,1718,245,0,2
60018,2014/03/31,2012/07/24,136,3,0.635569476,1756,136,1,2
60019,2014/03/31,2012/06/28,643,2,0.85,1312,643,2,0
60020,2014/03/31,2007/11/01,696,2,0.85,1312,696,2,0
60021,2014/03/31,2012/04/04,336,2,0.85,1312,336,1,1
60022,2014/03/31,2012/01/24,11,2,0.509913123,2187,11,1,1
60023,2014/03/31,2009/01/11,365,2,0.531110052,2099,365,1,1
60024,2014/03/31,2007/07/28,51,2,0.365,3052,51,0,2
60025,2014/03/31,2008/10/31,189,2,0.631963678,1762,189,0,2
60026,2014/03/31,2012/09/19,266,2,0.295,3774,266,1,1
60027,2014/03/31,2010/09/01,286,3,0.327189888,3402,286,0,3
60028,2014/03/31,2011/04/18,84,3,0.276978596,4018,84,0,3
60029,2014/03/31,2008/11/27,476,2,0.4,2780,476,2,0
60030,2014/03/31,2011/11/30,457,2,0.4,2780,457,2,0
60031,2014/03/31,2012/06/04,561,2,0.4,2780,561,2,0
60032,2014/03/31,2011/07/08,615,2,0.4,2780,615,2,0
60033,2014/03/31,2012/07/08,598,2,0.4,2780,598,2,0
60034,2014/03/31,2011/09/24,367,2,0.4,2780,367,2,0
60035,2014/03/31,2013/03/09,171,2,0.417364865,2664,171,0,2
60036,2014/03/31,2008/01/01,337,2,0.425,2616,337,1,1
60037,2014/03/31,2011/04/27,197,2,0.515,2158,197,0,2
60038,2014/03/31,2012/06/07,376,2,0.8105109490000001,1370,376,2,0
60039,2014/03/31,2007/07/11,215,2,0.631701764,1757,215,0,2
60040,2014/03/31,2006/10/28,712,2,0.8,1387,712,2,0
60041,2014/03/31,2013/01/03,295,2,0.7009860940000001,1582,295,1,1
60042,2014/03/31,2011/01/04,480,2,0.625,1774,480,2,0
60043,2014/03/31,2007/11/24,230,2,0.625,1774,230,0,2
60044,2014/03/31,2006/08/17,152,2,0.635,1746,152,1,1
60045,2014/03/31,2010/03/11,647,2,0.937109045,1183,647,2,0
60046,2014/03/31,2012/09/05,6,6,0.293743372,3772,6,3,3
60047,2014/03/31,2006/11/26,546,2,0.725,1528,546,2,0
60048,2014/03/31,2011/02/09,334,3,0.855289575,1295,334,2,1
60049,2014/03/31,2013/03/11,174,3,0.4435926220000001,2494,174,1,2
60050,2014/03/31,2011/08/21,114,3,0.412761194,2680,114,2,1
60051,2014/03/31,2010/08/22,556,3,0.303430296,3644,556,3,0
60052,2014/03/31,2008/09/27,151,2,0.408242245,2708,151,1,1
60053,2014/03/31,2012/08/22,110,2,0.9,1228,110,1,1
60054,2014/03/31,2011/12/12,179,2,0.447557716,2469,179,0,2
60055,2014/03/31,2009/03/02,493,2,0.505675057,2185,493,2,0
60056,2014/03/31,2012/06/04,13,2,0.525392297,2103,13,1,1
60057,2014/03/31,2006/09/09,167,3,0.31,3564,167,2,1
60058,2014/03/31,2012/11/09,505,2,0.7,1578,505,2,0
60059,2014/03/31,2011/11/16,112,2,0.782473423,1411,112,0,2
60060,2014/03/31,2012/03/22,559,2,0.672760512,1641,559,2,0
60061,2014/03/31,2008/02/25,440,2,0.8,1380,440,2,0
60062,2014/03/31,2011/12/12,694,2,0.4,2760,694,2,0
60063,2014/03/31,2009/12/02,173,2,0.396714594,2782,173,0,2
60064,2014/03/31,2008/03/12,573,2,0.665159735,1659,573,2,0
60065,2014/03/31,2012/02/17,202,3,0.731750663,1508,202,0,3
60066,2014/03/31,2011/01/13,240,2,0.466751269,2364,240,1,1
60067,2014/03/31,2013/03/19,273,2,0.85,1298,273,1,1
60068,2014/03/31,2012/08/31,576,2,0.85,1298,576,2,0
60069,2014/03/31,2013/01/01,27,2,0.85,1298,27,0,2
60070,2014/03/31,2010/12/29,677,3,0.566666667,1947,677,3,0
60071,2014/03/31,2011/02/21,598,2,0.85,1298,598,2,0
60072,2014/03/31,2012/07/27,613,2,0.85,1298,613,2,0
60073,2014/03/31,2013/03/01,273,2,0.85,1298,273,1,1
60074,2014/03/31,2012/12/27,391,2,0.85,1298,391,2,0
60075,2014/03/31,2013/03/01,258,2,0.85,1298,258,0,2
60076,2014/03/31,2012/09/03,103,2,0.69408433,1589,103,0,2
60077,2014/03/31,2006/10/30,140,2,0.669987849,1646,140,1,1
60078,2014/03/31,2012/01/08,179,2,0.69,1598,179,1,1
60079,2014/03/31,2007/09/08,175,2,0.33210241,3320,175,0,2
60080,2014/03/31,2013/01/06,10,3,0.28,3936,10,0,3
60081,2014/03/31,2011/08/02,272,2,0.6857934040000001,1607,272,0,2
60082,2014/03/31,2011/08/05,519,3,0.5148598129999999,2140,519,3,0
60083,2014/03/31,2012/04/19,195,2,0.6802655959999999,1619,195,1,1
60084,2014/03/31,2013/02/05,219,3,0.652257109,1688,219,1,2
60085,2014/03/31,2012/07/02,635,2,0.949956859,1159,635,2,0
60086,2014/03/31,2013/01/24,41,2,0.797695652,1380,41,0,2
60087,2014/03/31,2010/02/01,168,3,0.34,3237,168,1,2
60088,2014/03/31,2012/04/24,538,2,0.725,1518,538,2,0
60089,2014/03/31,2005/05/12,186,2,0.825,1334,186,1,1
60090,2014/03/31,2012/02/14,704,2,0.95,1158,704,2,0
60091,2014/03/31,2012/07/10,584,2,0.95,1158,584,2,0
60092,2014/03/31,2012/07/22,611,2,0.95,1158,611,2,0
60093,2014/03/31,2011/05/18,540,2,0.4,2750,540,2,0
60094,2014/03/31,2011/04/28,449,2,0.580359029,1894,449,2,0
60095,2014/03/31,2010/02/12,74,2,0.485888594,2262,74,0,2
60096,2014/03/31,2012/09/04,569,2,0.4,2747,569,2,0
60097,2014/03/31,2012/07/24,616,2,0.4,2747,616,2,0
60098,2014/03/31,2011/04/18,541,2,0.49171889,2234,541,2,0
60099,2014/03/31,2013/01/31,216,2,0.452591677,2427,216,0,2
60100,2014/03/31,2010/07/20,706,2,0.444714459,2469,706,2,0
60101,2014/03/31,2012/07/20,500,2,0.7593015209999999,1446,500,2,0
60102,2014/03/31,2008/02/28,323,2,0.367509207,2987,323,1,1
60103,2014/03/31,2009/09/22,387,3,0.491733871,2232,387,3,0
60104,2014/03/31,2007/04/28,335,2,0.342066708,3208,335,1,1
60105,2014/03/31,2012/12/03,100,2,0.845,1298,100,0,2
60106,2014/03/31,2009/11/03,560,2,0.6,1828,560,2,0
60107,2014/03/31,2010/11/17,5,3,0.44755102,2450,5,0,3
60108,2014/03/31,2005/01/12,659,4,0.5,2192,659,4,0
60109,2014/03/31,2005/09/26,112,2,0.418929254,2615,112,0,2
60110,2014/03/31,2008/03/31,21,2,0.572594142,1912,21,0,2
60111,2014/03/31,2013/02/12,207,4,0.6625,1652,207,1,3
60112,2014/03/31,2012/01/12,56,3,0.96,1140,56,2,1
60113,2014/03/31,2010/08/08,347,2,0.663934426,1647,347,1,1
60114,2014/03/31,2011/07/24,694,2,0.424825175,2574,694,2,0
60115,2014/03/31,2013/01/14,360,2,0.55,1987,360,1,1
60116,2014/03/31,2010/06/13,7,2,0.620931818,1760,7,0,2
60117,2014/03/31,2010/11/10,293,2,0.49,2229,293,0,2
60118,2014/03/31,2012/07/10,174,2,0.573851813,1903,174,1,1
60119,2014/03/31,2011/09/01,432,3,0.4,2730,432,3,0
60120,2014/03/31,2006/03/18,611,2,0.6,1820,611,2,0
60121,2014/03/31,2007/10/01,371,2,0.83279939,1311,371,2,0
60122,2014/03/31,2012/12/20,465,2,0.55,1985,465,2,0
60123,2014/03/31,2012/11/27,475,2,0.55,1985,475,2,0
60124,2014/03/31,2013/02/03,422,2,0.55,1985,422,2,0
60125,2014/03/31,2007/05/17,22,2,0.585,1866,22,0,2
60126,2014/03/31,2011/01/19,282,2,0.585,1866,282,1,1
60127,2014/03/31,2009/06/30,410,2,0.625,1746,410,2,0
60128,2014/03/31,2008/07/02,419,2,0.625,1746,419,2,0
60129,2014/03/31,2008/09/17,142,2,0.625,1746,142,0,2
60130,2014/03/31,2012/04/24,664,2,0.625,1746,664,2,0
60131,2014/03/31,2013/03/19,168,2,0.669447853,1630,168,1,1
60132,2014/03/31,2010/03/07,124,2,0.641764706,1700,124,0,2
60133,2014/03/31,2005/05/12,315,3,0.342493719,3184,315,0,3
60134,2014/03/31,2013/03/27,200,2,0.414228723,2632,200,1,1
60135,2014/03/31,2008/12/31,83,2,0.436413131,2498,83,0,2
60136,2014/03/31,2010/09/26,485,2,0.6925031770000001,1574,485,2,0
60137,2014/03/31,2004/11/09,590,2,0.625,1744,590,2,0
60138,2014/03/31,2010/11/20,117,3,0.319671458,3409,117,0,3
60139,2014/03/31,2009/11/16,379,2,0.473901696,2299,379,2,0
60140,2014/03/31,2010/08/01,723,2,0.503071594,2165,723,2,0
60141,2014/03/31,2010/01/14,662,2,0.443986955,2453,662,2,0
60142,2014/03/31,2006/09/26,171,2,0.7557113120000001,1441,171,0,2
60143,2014/03/31,2009/11/04,652,2,0.857322835,1270,652,2,0
60144,2014/03/31,2013/03/21,161,2,0.96,1134,161,1,1
60145,2014/03/31,2012/01/04,138,3,0.8404787640000001,1295,138,0,3
60146,2014/03/31,2011/06/30,213,2,0.415,2622,213,0,2
60147,2014/03/31,2013/03/15,44,2,0.52790393,2061,44,0,2
60148,2014/03/31,2008/03/28,470,3,0.546184739,1992,470,3,0
60149,2014/03/31,2012/04/12,68,2,0.619203187,1757,68,1,1
60150,2014/03/31,2012/08/02,103,3,0.61977208,1755,103,2,1
60151,2014/03/31,2013/01/07,424,2,0.9,1208,424,2,0
60152,2014/03/31,2009/06/29,616,2,0.9,1208,616,2,0
60153,2014/03/31,2008/07/17,200,2,0.954416155,1139,200,1,1
60154,2014/03/31,2006/12/08,198,2,0.954416155,1139,198,1,1
60155,2014/03/31,2011/03/30,586,2,0.5,2173,586,2,0
60156,2014/03/31,2012/06/16,472,2,0.492763158,2204,472,2,0
60157,2014/03/31,2011/10/25,266,2,0.525,2068,266,0,2
60158,2014/03/31,2008/02/04,224,2,0.6234750139999999,1741,224,0,2
60159,2014/03/31,2007/03/04,103,2,0.69050923,1571,103,0,2
60160,2014/03/31,2008/02/26,198,2,0.58,1870,198,0,2
60161,2014/03/31,2007/12/09,19,3,0.472794246,2294,19,0,3
60162,2014/03/31,2006/03/17,340,2,0.375,2892,340,1,1
60163,2014/03/31,2012/11/17,379,2,0.375,2892,379,2,0
60164,2014/03/31,2009/07/25,172,3,0.487605761,2222,172,0,3
60165,2014/03/31,2010/11/29,116,2,0.68686747,1577,116,0,2
60166,2014/03/31,2012/04/17,715,2,0.4,2707,715,2,0
60167,2014/03/31,2009/02/04,292,2,0.8184126979999999,1323,292,1,1
60168,2014/03/31,2013/01/10,350,4,0.4125,2624,350,3,1
60169,2014/03/31,2011/09/08,129,2,0.532233153,2033,129,1,1
60170,2014/03/31,2006/07/05,210,2,0.946596675,1143,210,1,1
60171,2014/03/31,2006/06/17,69,2,0.48,2254,69,0,2
60172,2014/03/31,2005/03/30,351,2,0.75,1442,351,1,1
60173,2014/03/31,2009/10/01,578,3,0.8341312740000001,1295,578,3,0
60174,2014/03/31,2012/04/14,159,2,0.580386889,1861,159,1,1
60175,2014/03/31,2011/09/01,142,2,0.675,1600,142,0,2
60176,2014/03/31,2008/12/11,46,3,0.683105629,1581,46,1,2
60177,2014/03/31,2012/10/05,541,2,0.466637857,2314,541,2,0
60178,2014/03/31,2011/01/15,510,2,0.47715422,2263,510,2,0
60179,2014/03/31,2011/03/20,684,2,0.585412148,1844,684,2,0
60180,2014/03/31,2012/01/10,587,2,0.434151247,2486,587,2,0
60181,2014/03/31,2012/07/01,24,3,0.400467532,2695,24,2,1
60182,2014/03/31,2008/01/18,67,4,0.4075,2648,67,2,2
60183,2014/03/31,2007/04/19,492,2,0.5,2158,492,2,0
60184,2014/03/31,2011/09/05,664,2,0.455466442,2369,664,2,0
60185,2014/03/31,2010/04/26,405,2,0.5,2158,405,2,0
60186,2014/03/31,2008/01/23,229,2,0.5,2158,229,0,2
60187,2014/03/31,2011/01/20,60,3,0.62,1740,60,1,2
60188,2014/03/31,2011/11/10,227,3,0.596972883,1807,227,2,1
60189,2014/03/31,2012/10/01,543,2,0.55,1961,543,2,0
60190,2014/03/31,2007/04/29,253,2,0.566589595,1903,253,1,1
60191,2014/03/31,2006/11/01,356,3,0.75,1437,356,2,1
60192,2014/03/31,2011/11/22,325,2,0.47810559,2254,325,1,1
60193,2014/03/31,2012/12/27,44,6,0.316666667,3402,44,0,6
60194,2014/03/31,2013/02/27,50,2,0.70442119,1529,50,0,2
60195,2014/03/31,2013/01/27,61,2,0.523323615,2058,61,1,1
60196,2014/03/31,2009/01/17,27,2,0.93,1158,27,0,2
60197,2014/03/31,2005/01/01,18,2,0.93,1158,18,0,2
60198,2014/03/31,2008/11/16,388,2,0.503601497,2138,388,2,0
60199,2014/03/31,2011/01/23,185,2,0.5273052429999999,2041,185,0,2
60200,2014/03/31,2011/08/24,33,3,0.511869648,2102,33,1,2
60201,2014/03/31,2006/10/08,205,3,0.546666667,1968,205,1,2
60202,2014/03/31,2011/09/29,114,3,0.435366248,2471,114,0,3
60203,2014/03/31,2013/01/09,103,2,0.793874539,1355,103,0,2
60204,2014/03/31,2007/02/28,230,2,0.72,1494,230,0,2
60205,2014/03/31,2008/10/18,688,2,0.45,2390,688,2,0
60206,2014/03/31,2010/07/14,206,2,0.364488136,2950,206,1,1
60207,2014/03/31,2012/07/14,627,2,0.4,2688,627,2,0
60208,2014/03/31,2012/05/10,691,2,0.4,2688,691,2,0
60209,2014/03/31,2012/08/14,593,2,0.4,2688,593,2,0
60210,2014/03/31,2011/09/20,110,2,0.89,1208,110,0,2
60211,2014/03/31,2007/09/07,417,2,0.747566064,1438,417,2,0
60212,2014/03/31,2006/04/01,256,2,0.7981575040000001,1346,256,0,2
60213,2014/03/31,2008/10/09,63,2,0.465,2310,63,1,1
60214,2014/03/31,2013/02/22,108,2,0.83,1294,108,0,2
60215,2014/03/31,2006/03/20,48,2,0.583297121,1841,48,0,2
60216,2014/03/31,2011/11/24,308,2,0.435870889,2463,308,0,2
60217,2014/03/31,2010/05/26,176,2,0.67,1602,176,0,2
60218,2014/03/31,2009/10/07,697,2,0.925,1160,697,2,0
60219,2014/03/31,2010/09/02,712,2,0.515593465,2081,712,2,0
60220,2014/03/31,2013/02/15,380,2,0.575,1866,380,2,0
60221,2014/03/31,2012/10/05,541,2,0.85,1262,541,2,0
60222,2014/03/31,2005/07/13,253,2,0.60296796,1779,253,1,1
60223,2014/03/31,2006/12/06,34,2,0.41,2616,34,0,2
60224,2014/03/31,2012/06/21,635,2,0.291146116,3682,635,2,0
60225,2014/03/31,2013/01/02,4,2,0.527336288,2031,4,0,2
60226,2014/03/31,2011/01/24,401,2,0.9,1190,401,2,0
60227,2014/03/31,2011/08/30,534,3,0.55,1947,534,3,0
60228,2014/03/31,2007/01/18,108,3,0.55,1947,108,0,3
60229,2014/03/31,2013/03/01,375,2,0.825,1298,375,2,0
60230,2014/03/31,2012/05/29,45,2,0.415,2580,45,0,2
60231,2014/03/31,2010/01/13,26,2,0.53,2020,26,0,2
60232,2014/03/31,2008/04/20,6,2,0.385,2780,6,0,2
60233,2014/03/31,2012/08/04,604,2,0.7,1529,604,2,0
60234,2014/03/31,2012/08/20,105,2,0.939420544,1139,105,1,1
60235,2014/03/31,2010/09/30,23,3,0.429510237,2491,23,0,3
60236,2014/03/31,2007/02/18,302,2,0.56,1910,302,0,2
60237,2014/03/31,2012/08/16,327,2,0.4743788820000001,2254,327,0,2
60238,2014/03/31,2012/12/11,48,2,0.885,1208,48,0,2
60239,2014/03/31,2008/01/30,86,4,0.4425,2416,86,1,3
60240,2014/03/31,2013/03/21,78,2,0.78896679,1355,78,1,1
60241,2014/03/31,2008/07/17,33,2,0.6443037970000001,1659,33,0,2
60242,2014/03/31,2011/05/28,691,2,0.30972182,3451,691,2,0
60243,2014/03/31,2012/12/19,468,2,0.25,4273,468,2,0
60244,2014/03/31,2010/03/26,577,2,0.465584133,2294,577,2,0
60245,2014/03/31,2012/06/19,114,5,0.380491803,2806,114,2,3
60246,2014/03/31,2011/01/28,650,2,0.473701731,2253,650,2,0
60247,2014/03/31,2010/10/12,587,2,0.317624293,3359,587,2,0
60248,2014/03/31,2010/09/09,239,2,0.49,2177,239,0,2
60249,2014/03/31,2011/07/25,16,2,0.413731575,2578,16,1,1
60250,2014/03/31,2011/06/28,692,2,0.525,2030,692,2,0
60251,2014/03/31,2012/03/15,325,3,0.533333333,1998,325,1,2
60252,2014/03/31,2011/09/03,459,2,0.7,1522,459,2,0
60253,2014/03/31,2012/05/01,698,2,0.7,1522,698,2,0
60254,2014/03/31,2010/12/29,532,2,0.7,1522,532,2,0
60255,2014/03/31,2012/01/14,640,2,0.7,1522,640,2,0
60256,2014/03/31,2011/12/22,45,2,0.637964072,1670,45,0,2
60257,2014/03/31,2011/07/31,218,2,0.92,1158,218,0,2
60258,2014/03/31,2012/01/17,213,2,0.92,1158,213,0,2
60259,2014/03/31,2007/12/13,244,2,0.92,1158,244,0,2
60260,2014/03/31,2012/02/15,234,2,0.92,1158,234,0,2
60261,2014/03/31,2008/08/23,190,2,0.92,1158,190,0,2
60262,2014/03/31,2012/03/22,201,2,0.92,1158,201,0,2
60263,2014/03/31,2011/07/16,31,2,0.92,1158,31,0,2
60264,2014/03/31,2011/05/14,216,2,0.92,1158,216,0,2
60265,2014/03/31,2005/10/15,201,2,0.92,1158,201,0,2
60266,2014/03/31,2011/07/12,174,3,0.37270119,2858,174,1,2
60267,2014/03/31,2010/05/07,139,2,0.867149837,1228,139,0,2
60268,2014/03/31,2013/01/03,197,2,0.3,3548,197,0,2
60269,2014/03/31,2012/04/01,723,2,0.6,1774,723,2,0
60270,2014/03/31,2008/07/22,19,2,0.82,1298,19,0,2
60271,2014/03/31,2010/11/18,347,3,0.933333333,1140,347,1,2
60272,2014/03/31,2009/08/22,578,3,0.933333333,1140,578,3,0
60273,2014/03/31,2010/09/20,360,2,0.475,2240,360,1,1
60274,2014/03/31,2012/02/15,21,3,0.6466666670000001,1644,21,0,3
60275,2014/03/31,2012/09/04,249,3,0.523333333,2031,249,2,1
60276,2014/03/31,2006/04/13,197,2,0.648411729,1637,197,1,1
60277,2014/03/31,2011/12/28,228,2,0.961086957,1104,228,1,1
60278,2014/03/31,2007/07/25,260,2,0.434189189,2442,260,0,2
60279,2014/03/31,2007/09/07,715,2,0.25,4241,715,2,0
60280,2014/03/31,2012/01/25,315,2,0.7,1514,315,1,1
60281,2014/03/31,2010/06/25,90,2,0.44754223,2368,90,1,1
60282,2014/03/31,2011/02/08,67,2,0.915,1158,67,0,2
60283,2014/03/31,2013/03/28,17,2,0.915,1158,17,0,2
60284,2014/03/31,2010/01/05,49,2,0.915,1158,49,0,2
60285,2014/03/31,2006/09/23,630,2,0.41781768,2534,630,2,0
60286,2014/03/31,2007/04/01,23,2,0.531068741,1993,23,0,2
60287,2014/03/31,2011/11/20,17,2,0.606875,1744,17,0,2
60288,2014/03/31,2013/01/05,449,2,0.5180372,2043,449,2,0
60289,2014/03/31,2012/05/24,262,2,0.479700816,2206,262,0,2
60290,2014/03/31,2008/12/18,459,7,0.8214285709999999,1288,459,7,0
60291,2014/03/31,2012/01/07,43,2,0.41,2580,43,0,2
60292,2014/03/31,2010/11/26,693,2,0.6494775660000001,1627,693,2,0
60293,2014/03/31,2013/03/11,261,2,0.565,1870,261,0,2
60294,2014/03/31,2011/03/07,518,2,0.544352759,1939,518,2,0
60295,2014/03/31,2005/03/31,447,3,0.567419355,1860,447,3,0
60296,2014/03/31,2010/02/23,178,2,0.466268789,2262,178,1,1
60297,2014/03/31,2010/12/20,60,2,0.91,1158,60,0,2
60298,2014/03/31,2006/10/18,245,2,0.551087866,1912,245,1,1
60299,2014/03/31,2013/03/08,130,2,0.564951717,1864,130,1,1
60300,2014/03/31,2012/07/01,150,2,0.6441126070000001,1634,150,1,1
60301,2014/03/31,2007/04/04,245,2,0.466770186,2254,245,1,1
60302,2014/03/31,2012/08/14,468,2,0.465075155,2262,468,2,0
60303,2014/03/31,2011/03/18,289,2,0.748157895,1406,289,1,1
60304,2014/03/31,2007/12/02,7,2,0.618564706,1700,7,0,2
60305,2014/03/31,2011/11/30,259,2,0.81,1298,259,0,2
60306,2014/03/31,2009/02/14,254,2,0.81,1298,254,1,1
60307,2014/03/31,2012/11/06,146,2,0.4,2627,146,0,2
60308,2014/03/31,2010/05/07,400,2,0.4,2627,400,2,0
60309,2014/03/31,2011/02/04,23,2,0.607743056,1728,23,1,1
60310,2014/03/31,2009/05/30,99,2,0.76706355,1369,99,0,2
60311,2014/03/31,2012/10/10,530,2,0.649814356,1616,530,2,0
60312,2014/03/31,2009/10/05,403,2,1.0,1050,403,2,0
60313,2014/03/31,2011/11/14,582,2,0.4,2624,582,2,0
60314,2014/03/31,2012/04/26,341,2,0.8,1312,341,1,1
60315,2014/03/31,2012/11/17,424,2,0.744113475,1410,424,2,0
60316,2014/03/31,2006/03/28,7,2,0.563469388,1862,7,1,1
60317,2014/03/31,2012/11/10,3,2,0.60902439,1722,3,0,2
60318,2014/03/31,2011/04/15,208,2,0.642742331,1630,208,0,2
60319,2014/03/31,2008/03/19,428,2,0.6,1746,428,2,0
60320,2014/03/31,2010/11/17,78,2,0.6,1746,78,0,2
60321,2014/03/31,2012/09/11,469,3,0.4,2619,469,3,0
60322,2014/03/31,2010/11/12,711,2,0.948641304,1104,711,2,0
60323,2014/03/31,2013/02/08,68,2,0.8528501629999999,1228,68,1,1
60324,2014/03/31,2012/10/02,403,2,0.344150509,3043,403,2,0
60325,2014/03/31,2012/09/17,365,2,0.301338515,3474,365,1,1
60326,2014/03/31,2012/05/15,35,2,0.446016191,2347,35,1,1
60327,2014/03/31,2008/11/22,8,4,0.365270506,2865,8,2,2
60328,2014/03/31,2005/09/30,509,2,0.4,2616,509,2,0
60329,2014/03/31,2011/07/15,471,2,0.4,2616,471,2,0
60330,2014/03/31,2012/03/13,616,2,0.4,2616,616,2,0
60331,2014/03/31,2005/06/03,582,2,0.4,2616,582,2,0
60332,2014/03/31,2007/11/11,653,2,0.4,2616,653,2,0
60333,2014/03/31,2012/08/24,565,2,0.4,2616,565,2,0
60334,2014/03/31,2012/07/18,582,2,0.4,2616,582,2,0
60335,2014/03/31,2010/07/23,482,2,0.4,2616,482,2,0
60336,2014/03/31,2012/02/27,671,2,0.4,2616,671,2,0
60337,2014/03/31,2010/12/26,553,3,0.4,2616,553,3,0
60338,2014/03/31,2011/02/08,464,2,0.4,2616,464,2,0
60339,2014/03/31,2011/12/26,505,2,0.4,2616,505,2,0
60340,2014/03/31,2009/02/25,636,2,0.4,2616,636,2,0
60341,2014/03/31,2010/02/16,387,2,0.4,2616,387,2,0
60342,2014/03/31,2012/03/15,499,2,0.4,2616,499,2,0
60343,2014/03/31,2008/10/15,667,2,0.4,2616,667,2,0
60344,2014/03/31,2012/06/15,654,2,0.4,2616,654,2,0
60345,2014/03/31,2012/08/13,551,2,0.4,2616,551,2,0
60346,2014/03/31,2013/03/02,396,2,0.4,2616,396,2,0
60347,2014/03/31,2012/03/30,729,2,0.4,2616,729,2,0
60348,2014/03/31,2011/06/19,354,2,0.425824176,2457,354,1,1
60349,2014/03/31,2012/09/11,204,2,0.645,1622,204,1,1
60350,2014/03/31,2012/02/23,564,2,0.659457755,1586,564,2,0
60351,2014/03/31,2012/07/27,608,2,0.7,1494,608,2,0
60352,2014/03/31,2008/07/31,91,2,0.7,1494,91,0,2
60353,2014/03/31,2011/09/14,609,2,0.7,1494,609,2,0
60354,2014/03/31,2009/07/03,198,2,0.38,2752,198,0,2
60355,2014/03/31,2012/09/30,169,2,0.38,2752,169,0,2
60356,2014/03/31,2010/02/28,32,2,0.441063291,2370,32,0,2
60357,2014/03/31,2008/02/06,233,2,0.38,2750,233,0,2
60358,2014/03/31,2010/12/26,234,2,0.38,2750,234,0,2
60359,2014/03/31,2006/08/22,35,2,0.56,1866,35,0,2
60360,2014/03/31,2007/11/13,209,2,0.557248,1875,209,1,1
60361,2014/03/31,2013/03/22,1,2,0.49254717,2120,1,1,1
60362,2014/03/31,2011/09/15,658,2,0.9,1160,658,2,0
60363,2014/03/31,2012/02/15,586,2,0.9,1160,586,2,0
60364,2014/03/31,2012/04/13,717,2,0.9,1160,717,2,0
60365,2014/03/31,2011/07/15,715,2,0.9,1160,715,2,0
60366,2014/03/31,2011/01/05,660,2,0.9,1160,660,2,0
60367,2014/03/31,2011/12/05,680,2,0.9,1160,680,2,0
60368,2014/03/31,2009/10/05,721,2,0.9,1160,721,2,0
60369,2014/03/31,2010/03/06,710,2,0.9,1160,710,2,0
60370,2014/03/31,2012/08/03,604,2,0.9,1160,604,2,0
60371,2014/03/31,2005/10/13,154,2,0.462981366,2254,154,0,2
60372,2014/03/31,2006/10/07,566,2,0.398853211,2616,566,2,0
60373,2014/03/31,2012/11/13,275,2,0.92,1134,275,0,2
60374,2014/03/31,2009/11/08,132,2,0.92,1134,132,0,2
60375,2014/03/31,2012/07/24,214,2,0.92,1134,214,0,2
60376,2014/03/31,2013/02/26,114,3,0.5575360770000001,1871,114,0,3
60377,2014/03/31,2007/12/14,122,2,0.423447016,2463,122,1,1
60378,2014/03/31,2008/12/26,222,2,0.8492752440000001,1228,222,0,2
60379,2014/03/31,2011/12/10,160,2,0.8492752440000001,1228,160,0,2
60380,2014/03/31,2010/12/20,576,2,0.375,2780,576,2,0
60381,2014/03/31,2008/08/25,333,2,0.375,2780,333,0,2
60382,2014/03/31,2012/10/12,454,2,0.375,2780,454,2,0
60383,2014/03/31,2006/03/01,681,2,0.375,2780,681,2,0
60384,2014/03/31,2009/08/08,429,2,0.666070288,1565,429,2,0
60385,2014/03/31,2012/08/14,594,2,0.9,1158,594,2,0
60386,2014/03/31,2010/01/05,522,2,0.9,1158,522,2,0
60387,2014/03/31,2012/08/10,597,2,0.9,1158,597,2,0
60388,2014/03/31,2009/10/14,44,2,0.875,1190,44,0,2
60389,2014/03/31,2006/01/05,36,2,0.875,1190,36,0,2
60390,2014/03/31,2012/11/18,498,3,0.298053249,3493,498,3,0
60391,2014/03/31,2012/09/03,466,2,0.306837607,3393,466,2,0
60392,2014/03/31,2013/02/25,189,2,0.28,3718,189,0,2
60393,2014/03/31,2011/12/14,312,2,0.428924598,2427,312,1,1
60394,2014/03/31,2007/12/04,213,3,0.428177705,2431,213,1,2
60395,2014/03/31,2012/03/03,398,2,0.7,1486,398,2,0
60396,2014/03/31,2008/03/28,160,2,0.75,1386,160,0,2
60397,2014/03/31,2010/05/26,142,2,0.579030641,1795,142,1,1
60398,2014/03/31,2013/01/30,389,3,0.5908470720000001,1759,389,3,0
60399,2014/03/31,2010/12/29,23,3,0.533333333,1947,23,0,3
60400,2014/03/31,2012/08/24,583,2,0.8,1298,583,2,0
60401,2014/03/31,2011/11/21,620,2,0.8,1298,620,2,0
60402,2014/03/31,2013/02/27,226,3,0.354641148,2926,226,0,3
60403,2014/03/31,2007/04/19,19,2,0.403492804,2571,19,0,2
60404,2014/03/31,2012/02/10,60,2,0.895004314,1159,60,1,1
60405,2014/03/31,2009/08/31,181,2,0.33,3142,181,0,2
60406,2014/03/31,2012/12/22,197,2,0.532542373,1947,197,1,1
60407,2014/03/31,2013/02/27,59,2,0.895,1158,59,0,2
60408,2014/03/31,2012/03/14,714,2,0.4,2590,714,2,0
60409,2014/03/31,2013/02/25,399,2,0.4,2590,399,2,0
60410,2014/03/31,2010/03/23,28,3,0.339151098,3051,28,2,1
60411,2014/03/31,2007/04/28,221,2,0.780271493,1326,221,1,1
60412,2014/03/31,2012/11/18,493,2,0.25,4137,493,2,0
60413,2014/03/31,2010/04/11,197,2,0.472830361,2187,197,0,2
60414,2014/03/31,2012/10/22,522,2,0.55,1880,522,2,0
60415,2014/03/31,2006/11/01,436,3,0.319006479,3241,436,3,0
60416,2014/03/31,2013/03/06,388,2,0.775,1334,388,2,0
60417,2014/03/31,2012/10/28,513,2,0.4,2582,513,2,0
60418,2014/03/31,2009/06/18,555,3,0.7666666670000001,1347,555,3,0
60419,2014/03/31,2007/12/20,462,3,0.833333333,1239,462,3,0
60420,2014/03/31,2012/12/04,393,2,0.4,2580,393,2,0
60421,2014/03/31,2007/05/05,28,3,0.53,1947,28,0,3
60422,2014/03/31,2012/02/27,228,2,0.795,1298,228,0,2
60423,2014/03/31,2012/09/03,486,2,0.325781497,3167,486,2,0
60424,2014/03/31,2007/05/21,523,3,0.45,2292,523,3,0
60425,2014/03/31,2012/09/26,491,2,0.38768797,2660,491,2,0
60426,2014/03/31,2011/09/12,554,2,0.375,2750,554,2,0
60427,2014/03/31,2008/06/10,694,2,0.7820940820000001,1318,694,2,0
60428,2014/03/31,2012/12/31,443,4,0.3,3436,443,4,0
60429,2014/03/31,2012/12/25,53,3,0.6266666670000001,1644,53,0,3
60430,2014/03/31,2008/12/05,476,3,0.449280419,2293,476,3,0
60431,2014/03/31,2007/07/15,152,2,0.59,1746,152,1,1
60432,2014/03/31,2008/05/13,16,2,0.517918552,1989,16,1,1
60433,2014/03/31,2012/07/08,451,2,0.25,4119,451,2,0
60434,2014/03/31,2009/01/21,521,2,0.4,2572,521,2,0
60435,2014/03/31,2010/10/29,114,2,0.4,2572,114,0,2
60436,2014/03/31,2010/04/25,102,2,0.37,2780,102,1,1
60437,2014/03/31,2012/08/29,173,2,0.659333333,1560,173,0,2
60438,2014/03/31,2011/08/19,727,2,0.6,1714,727,2,0
60439,2014/03/31,2010/01/31,74,2,0.6808151090000001,1509,74,1,1
60440,2014/03/31,2012/05/01,699,2,0.675,1522,699,2,0
60441,2014/03/31,2012/10/31,508,2,0.593013857,1732,508,2,0
60442,2014/03/31,2011/09/01,125,3,0.40017537,2566,125,2,1
60443,2014/03/31,2011/11/08,467,2,0.85,1208,467,2,0
60444,2014/03/31,2013/02/07,168,3,0.510442566,2011,168,2,1
60445,2014/03/31,2010/09/06,424,2,0.6712884240000001,1529,424,2,0
60446,2014/03/31,2012/01/13,415,2,0.55,1866,415,2,0
60447,2014/03/31,2011/01/20,257,2,0.33,3108,257,0,2
60448,2014/03/31,2012/11/10,505,2,0.8,1282,505,2,0
60449,2014/03/31,2012/12/30,457,2,0.8151033390000001,1258,457,2,0
60450,2014/03/31,2010/10/12,381,2,0.6798408490000001,1508,381,2,0
60451,2014/03/31,2012/09/01,497,2,0.475,2158,497,2,0
60452,2014/03/31,2005/07/11,658,2,0.25,4100,658,2,0
60453,2014/03/31,2012/07/25,341,2,0.25,4100,341,0,2
60454,2014/03/31,2012/12/31,381,2,0.957049486,1071,381,2,0
60455,2014/03/31,2006/09/27,693,2,0.25,4100,693,2,0
60456,2014/03/31,2012/11/30,484,2,0.25,4100,484,2,0
60457,2014/03/31,2011/11/01,664,2,0.25,4100,664,2,0
60458,2014/03/31,2007/01/11,57,2,0.93,1102,57,0,2
60459,2014/03/31,2007/03/13,66,2,0.885,1158,66,0,2
60460,2014/03/31,2009/04/24,51,2,0.8637774029999999,1186,51,0,2
60461,2014/03/31,2012/11/29,43,2,0.398808411,2568,43,1,1
60462,2014/03/31,2009/08/28,148,2,0.644493392,1589,148,1,1
60463,2014/03/31,2011/06/14,26,2,0.889,1150,26,1,1
60464,2014/03/31,2012/12/11,316,3,0.25,4089,316,2,1
60465,2014/03/31,2007/06/21,40,3,0.8966666670000001,1140,40,0,3
60466,2014/03/31,2007/12/08,139,2,0.601282353,1700,139,0,2
60467,2014/03/31,2011/12/22,173,2,0.39382659,2595,173,1,1
60468,2014/03/31,2012/12/09,52,2,0.719148487,1421,52,1,1
60469,2014/03/31,2012/03/06,108,3,0.35666666700000005,2865,108,0,3
60470,2014/03/31,2012/06/04,98,2,0.542026525,1885,98,1,1
60471,2014/03/31,2009/03/03,602,2,0.509780439,2004,602,2,0
60472,2014/03/31,2005/12/20,454,3,0.75,1362,454,3,0
60473,2014/03/31,2013/03/19,293,2,0.665840939,1534,293,1,1
60474,2014/03/31,2011/02/27,165,4,0.360296401,2834,165,2,2
60475,2014/03/31,2008/11/15,141,2,0.615232068,1659,141,0,2
60476,2014/03/31,2008/04/17,725,2,0.9,1134,725,2,0
60477,2014/03/31,2008/10/07,347,2,0.9,1134,347,0,2
60478,2014/03/31,2010/01/26,690,2,0.9,1134,690,2,0
60479,2014/03/31,2012/08/23,314,2,0.95,1074,314,1,1
60480,2014/03/31,2006/08/18,240,2,0.585,1744,240,1,1
60481,2014/03/31,2005/10/18,86,2,0.710320334,1436,86,0,2
60482,2014/03/31,2012/04/01,113,2,0.503451852,2025,113,1,1
60483,2014/03/31,2010/05/03,80,2,0.452142857,2254,80,0,2
60484,2014/03/31,2009/02/23,673,2,0.587039171,1736,673,2,0
60485,2014/03/31,2012/01/10,103,2,0.785,1298,103,0,2
60486,2014/03/31,2012/11/12,353,2,0.25,4074,353,0,2
60487,2014/03/31,2012/01/09,286,3,0.352774506,2887,286,1,2
60488,2014/03/31,2007/11/05,556,2,0.8404624279999999,1211,556,2,0
60489,2014/03/31,2010/11/19,11,2,0.376960712,2698,11,0,2
60490,2014/03/31,2008/04/13,489,2,0.539962825,1883,489,2,0
60491,2014/03/31,2006/01/10,677,2,0.965527066,1053,677,2,0
60492,2014/03/31,2010/11/14,599,2,0.425,2390,599,2,0
60493,2014/03/31,2011/09/11,436,2,0.425,2390,436,2,0
60494,2014/03/31,2012/02/26,591,2,0.425,2390,591,2,0
60495,2014/03/31,2006/03/31,247,2,0.92,1104,247,0,2
60496,2014/03/31,2012/02/27,589,2,0.875,1160,589,2,0
60497,2014/03/31,2011/12/22,694,2,0.875,1160,694,2,0
60498,2014/03/31,2011/04/12,426,2,0.875,1160,426,2,0
60499,2014/03/31,2013/02/27,96,3,0.436660929,2324,96,0,3
60500,2014/03/31,2012/09/25,554,2,0.4,2536,554,2,0
60501,2014/03/31,2012/12/13,89,2,0.425768262,2382,89,0,2
60502,2014/03/31,2005/12/28,324,2,0.625,1622,324,0,2
60503,2014/03/31,2011/11/30,328,2,0.625,1622,328,0,2
60504,2014/03/31,2007/09/01,81,2,0.917309783,1104,81,1,1
60505,2014/03/31,2012/06/28,449,2,0.527265625,1920,449,2,0
60506,2014/03/31,2008/01/09,266,2,0.76,1332,266,0,2
60507,2014/03/31,2009/10/10,218,2,0.76,1332,218,0,2
60508,2014/03/31,2010/09/25,39,2,0.353715484,2861,39,0,2
60509,2014/03/31,2013/01/17,35,2,0.770098935,1314,35,1,1
60510,2014/03/31,2008/07/27,89,2,0.484573755,2088,89,0,2
60511,2014/03/31,2011/06/27,46,3,0.28396968,3562,46,2,1
60512,2014/03/31,2012/11/14,443,2,0.656688312,1540,443,2,0
60513,2014/03/31,2006/05/13,96,2,0.462373114,2187,96,0,2
60514,2014/03/31,2009/04/27,4,2,0.528932496,1911,4,0,2
60515,2014/03/31,2010/12/29,26,2,0.63,1604,26,0,2
60516,2014/03/31,2008/11/11,345,2,0.425073622,2377,345,1,1
60517,2014/03/31,2008/03/13,1,2,0.58,1742,1,0,2
60518,2014/03/31,2012/10/08,537,2,0.5,2020,537,2,0
60519,2014/03/31,2012/04/12,716,2,0.7,1442,716,2,0
60520,2014/03/31,2011/07/14,377,2,0.8860403859999999,1139,377,2,0
60521,2014/03/31,2012/06/28,66,2,0.824905969,1223,66,1,1
60522,2014/03/31,2011/08/01,292,2,0.468981869,2151,292,0,2
60523,2014/03/31,2012/06/19,173,3,0.301200358,3349,173,2,1
60524,2014/03/31,2011/09/14,68,3,0.6133333329999999,1644,68,2,1
60525,2014/03/31,2007/01/19,166,3,0.6133333329999999,1644,166,0,3
60526,2014/03/31,2011/04/18,132,3,0.5175154000000001,1948,132,0,3
60527,2014/03/31,2008/05/26,207,3,0.269521262,3739,207,2,1
60528,2014/03/31,2008/07/01,146,3,0.58,1737,146,0,3
60529,2014/03/31,2011/05/11,339,2,0.903590664,1114,339,1,1
60530,2014/03/31,2009/02/13,123,2,0.67,1502,123,0,2
60531,2014/03/31,2008/06/12,143,2,0.625,1610,143,0,2
60532,2014/03/31,2010/06/17,279,2,0.775,1298,279,1,1
60533,2014/03/31,2010/02/23,482,3,0.5166666670000001,1947,482,3,0
60534,2014/03/31,2013/01/31,424,2,0.775,1298,424,2,0
60535,2014/03/31,2011/06/22,37,2,0.65887287,1526,37,1,1
60536,2014/03/31,2012/08/02,570,2,0.8526717559999999,1179,570,2,0
60537,2014/03/31,2012/12/07,388,2,0.518653251,1938,388,2,0
60538,2014/03/31,2013/03/23,309,2,0.25,4020,309,0,2
60539,2014/03/31,2006/11/28,7,2,0.664662698,1512,7,1,1
60540,2014/03/31,2010/05/29,17,2,0.487554585,2061,17,0,2
60541,2014/03/31,2012/02/27,122,2,0.495,2030,122,1,1
60542,2014/03/31,2009/10/27,251,2,0.365,2752,251,0,2
60543,2014/03/31,2008/10/15,336,2,0.547899618,1833,336,1,1
60544,2014/03/31,2010/01/04,436,2,0.486246973,2065,436,2,0
60545,2014/03/31,2010/04/26,118,2,0.560603015,1791,118,0,2
60546,2014/03/31,2012/10/26,368,2,0.575,1746,368,2,0
60547,2014/03/31,2011/01/13,174,2,0.8257119340000001,1215,174,1,1
60548,2014/03/31,2004/12/15,169,2,0.401561249,2498,169,0,2
60549,2014/03/31,2011/09/18,542,2,0.45,2229,542,2,0
60550,2014/03/31,2012/10/02,542,2,0.45,2229,542,2,0
60551,2014/03/31,2011/02/04,207,2,0.45,2229,207,0,2
60552,2014/03/31,2008/02/14,552,2,1.0,1003,552,2,0
60553,2014/03/31,2011/03/22,355,2,0.575,1744,355,1,1
60554,2014/03/31,2006/09/28,67,2,0.588749266,1703,67,0,2
60555,2014/03/31,2010/12/29,291,2,0.569613636,1760,291,0,2
60556,2014/03/31,2012/06/17,646,4,0.4,2506,646,4,0
60557,2014/03/31,2012/06/06,1,2,0.493540128,2031,1,1,1
60558,2014/03/31,2006/12/25,641,2,0.689202201,1454,641,2,0
60559,2014/03/31,2006/12/22,103,2,0.865,1158,103,0,2
60560,2014/03/31,2011/05/01,200,2,0.342775496,2922,200,0,2
60561,2014/03/31,2008/10/14,579,2,0.371558442,2695,579,2,0
60562,2014/03/31,2010/11/01,484,2,0.425,2356,484,2,0
60563,2014/03/31,2005/03/29,141,2,0.67,1494,141,0,2
60564,2014/03/31,2013/03/26,31,2,0.576526498,1736,31,0,2
60565,2014/03/31,2011/06/30,144,2,0.49,2042,144,0,2
60566,2014/03/31,2009/04/08,32,2,0.308510638,3243,32,1,1
60567,2014/03/31,2011/10/31,183,2,0.295,3390,183,1,1
60568,2014/03/31,2012/03/03,132,2,0.771814672,1295,132,0,2
60569,2014/03/31,2012/05/21,123,2,0.77,1298,123,1,1
60570,2014/03/31,2005/11/25,70,2,0.5746175960000001,1739,70,0,2
60571,2014/03/31,2009/02/09,608,2,0.75,1332,608,2,0
60572,2014/03/31,2011/06/06,442,2,0.75,1332,442,2,0
60573,2014/03/31,2012/11/24,389,2,0.347546973,2874,389,2,0
60574,2014/03/31,2012/09/16,75,2,0.465,2148,75,0,2
60575,2014/03/31,2012/06/07,622,2,0.726036364,1375,622,2,0
60576,2014/03/31,2011/05/10,363,2,0.35,2852,363,1,1
60577,2014/03/31,2012/07/31,348,2,0.35,2852,348,0,2
60578,2014/03/31,2007/06/19,675,2,0.5897163120000001,1692,675,2,0
60579,2014/03/31,2013/03/13,115,2,0.67,1489,115,0,2
60580,2014/03/31,2007/05/17,404,2,0.371923937,2682,404,2,0
60581,2014/03/31,2012/10/09,533,3,0.4,2493,533,3,0
60582,2014/03/31,2011/09/05,158,2,0.442391304,2254,158,0,2
60583,2014/03/31,2005/08/22,470,3,0.381407804,2614,470,3,0
60584,2014/03/31,2012/02/22,525,2,0.403643725,2470,525,2,0
60585,2014/03/31,2012/08/10,61,2,0.421701227,2363,61,1,1
60586,2014/03/31,2012/10/14,276,3,0.540531742,1843,276,1,2
60587,2014/03/31,2011/11/21,288,2,0.415,2400,288,0,2
60588,2014/03/31,2011/07/10,308,2,0.743208955,1340,308,1,1
60589,2014/03/31,2005/07/15,35,2,0.737061436,1351,35,0,2
60590,2014/03/31,2012/08/20,4,2,0.34,2928,4,0,2
60591,2014/03/31,2009/10/29,320,2,0.5632427839999999,1767,320,1,1
60592,2014/03/31,2011/05/31,318,2,0.456516751,2179,318,1,1
60593,2014/03/31,2011/07/11,362,2,0.475,2094,362,1,1
60594,2014/03/31,2007/05/16,465,2,0.25,3978,465,2,0
60595,2014/03/31,2010/07/26,221,2,0.55,1808,221,0,2
60596,2014/03/31,2011/03/30,301,2,0.495648056,2006,301,1,1
60597,2014/03/31,2011/12/26,228,2,0.38,2616,228,0,2
60598,2014/03/31,2012/10/11,31,3,0.495775561,2005,31,1,2
60599,2014/03/31,2013/03/08,386,2,0.6,1656,386,2,0
60600,2014/03/31,2010/08/11,392,2,0.925,1074,392,2,0
60601,2014/03/31,2005/12/15,18,2,0.610535055,1626,18,0,2
60602,2014/03/31,2012/02/10,151,2,0.7503401359999999,1323,151,1,1
60603,2014/03/31,2010/04/19,628,3,0.569931074,1741,628,3,0
60604,2014/03/31,2013/01/06,217,2,0.415,2390,217,0,2
60605,2014/03/31,2012/11/08,121,3,0.4597913770000001,2157,121,2,1
60606,2014/03/31,2007/11/09,45,2,0.774539063,1280,45,1,1
60607,2014/03/31,2007/05/10,398,2,0.310460382,3193,398,2,0
60608,2014/03/31,2009/02/07,108,2,0.505,1962,108,0,2
60609,2014/03/31,2012/09/11,384,3,0.4,2477,384,3,0
60610,2014/03/31,2013/03/12,86,3,0.28746589300000003,3445,86,0,3
60611,2014/03/31,2007/04/04,134,2,0.855,1158,134,0,2
60612,2014/03/31,2007/09/08,658,2,1.0,990,658,2,0
60613,2014/03/31,2012/04/25,706,2,0.55,1800,706,2,0
60614,2014/03/31,2013/01/22,48,2,0.65,1522,48,0,2
60615,2014/03/31,2010/07/31,66,2,0.509340886,1942,66,0,2
60616,2014/03/31,2009/05/06,58,2,0.561909091,1760,58,0,2
60617,2014/03/31,2010/11/06,710,2,0.660093583,1496,710,2,0
60618,2014/03/31,2013/01/14,429,2,0.475,2078,429,2,0
60619,2014/03/31,2012/07/07,62,2,0.342688433,2879,62,1,1
60620,2014/03/31,2009/07/18,681,2,0.374099355,2637,681,2,0
60621,2014/03/31,2013/01/23,239,2,0.565,1746,239,1,1
60622,2014/03/31,2007/12/16,201,2,0.76,1298,201,1,1
60623,2014/03/31,2011/12/31,701,2,0.85,1160,701,2,0
60624,2014/03/31,2011/12/31,701,2,0.85,1160,701,2,0
60625,2014/03/31,2010/05/09,698,2,0.85,1160,698,2,0
60626,2014/03/31,2011/07/28,621,2,0.85,1160,621,2,0
60627,2014/03/31,2012/06/16,626,2,0.85,1160,626,2,0
60628,2014/03/31,2012/05/31,631,2,0.85,1160,631,2,0
60629,2014/03/31,2012/02/21,663,2,0.85,1160,663,2,0
60630,2014/03/31,2009/10/19,587,2,0.85,1160,587,2,0
60631,2014/03/31,2011/10/29,489,2,0.534065041,1845,489,2,0
60632,2014/03/31,2012/07/14,57,3,0.513,1920,57,2,1
60633,2014/03/31,2009/01/10,408,2,0.901648352,1092,408,2,0
60634,2014/03/31,2008/07/08,205,2,0.555,1774,205,0,2
60635,2014/03/31,2007/09/15,295,2,0.8605244759999999,1144,295,1,1
60636,2014/03/31,2012/01/09,514,2,0.85,1158,514,2,0
60637,2014/03/31,2012/09/13,564,2,0.85,1158,564,2,0
60638,2014/03/31,2010/09/24,435,2,0.85,1158,435,2,0
60639,2014/03/31,2006/04/30,640,2,0.85,1158,640,2,0
60640,2014/03/31,2012/12/17,313,2,0.85,1158,313,1,1
60641,2014/03/31,2011/05/24,25,2,0.675490734,1457,25,0,2
60642,2014/03/31,2012/07/23,604,2,0.75,1312,604,2,0
60643,2014/03/31,2008/04/18,449,2,0.25,3934,449,2,0
60644,2014/03/31,2011/09/30,465,2,0.25,3934,465,2,0
60645,2014/03/31,2011/12/22,522,2,0.25,3934,522,2,0
60646,2014/03/31,2012/12/27,358,2,0.25,3934,358,0,2
60647,2014/03/31,2007/08/12,136,2,0.441184388,2229,136,0,2
60648,2014/03/31,2009/10/10,383,2,0.375,2622,383,2,0
60649,2014/03/31,2009/03/19,77,2,0.501986721,1958,77,0,2
60650,2014/03/31,2011/04/05,603,2,0.700427655,1403,603,2,0
60651,2014/03/31,2012/10/13,366,2,0.271450276,3620,366,1,1
60652,2014/03/31,2013/03/19,273,2,0.37491034,2621,273,1,1
60653,2014/03/31,2008/10/14,227,3,0.628974359,1560,227,1,2
60654,2014/03/31,2010/11/19,193,2,0.564818653,1737,193,0,2
60655,2014/03/31,2006/12/08,721,2,0.375,2616,721,2,0
60656,2014/03/31,2011/10/23,506,2,0.8,1226,506,2,0
60657,2014/03/31,2013/03/12,303,2,0.38,2580,303,0,2
60658,2014/03/31,2013/02/11,413,2,1.0,980,413,2,0
60659,2014/03/31,2007/09/15,328,2,1.0,980,328,1,1
60660,2014/03/31,2012/12/22,417,2,1.0,980,417,2,0
60661,2014/03/31,2011/09/24,22,2,0.755,1298,22,0,2
60662,2014/03/31,2012/12/06,451,2,0.525,1866,451,2,0
60663,2014/03/31,2006/04/11,326,2,0.771867612,1269,326,1,1
60664,2014/03/31,2006/08/10,90,2,0.26421365,3707,90,0,2
60665,2014/03/31,2010/11/25,148,3,0.388295004,2522,148,0,3
60666,2014/03/31,2011/12/15,125,2,0.512401884,1911,125,1,1
60667,2014/03/31,2011/03/30,214,2,0.845,1158,214,0,2
60668,2014/03/31,2006/01/06,239,2,0.845,1158,239,0,2
60669,2014/03/31,2006/05/31,273,2,0.845,1158,273,0,2
60670,2014/03/31,2006/06/19,180,2,0.845,1158,180,0,2
60671,2014/03/31,2010/06/07,148,2,0.56,1746,148,0,2
60672,2014/03/31,2012/08/17,593,2,0.661814489,1477,593,2,0
60673,2014/03/31,2013/03/25,2,2,0.464736091,2103,2,0,2
60674,2014/03/31,2009/02/19,387,2,1.0,977,387,2,0
60675,2014/03/31,2011/11/02,157,2,0.502626159,1942,157,0,2
60676,2014/03/31,2013/02/01,224,2,0.7796006390000001,1252,224,1,1
60677,2014/03/31,2011/04/11,495,2,0.55,1774,495,2,0
60678,2014/03/31,2012/10/02,192,2,0.67,1456,192,0,2
60679,2014/03/31,2012/11/16,192,2,0.445,2192,192,0,2
60680,2014/03/31,2011/04/25,147,2,0.618908629,1576,147,1,1
60681,2014/03/31,2012/09/04,552,2,0.43561858,2239,552,2,0
60682,2014/03/31,2012/02/06,105,3,0.623854033,1562,105,1,2
60683,2014/03/31,2007/12/26,626,2,0.734212509,1327,626,2,0
60684,2014/03/31,2013/03/21,11,4,0.356921949,2729,11,0,4
60685,2014/03/31,2008/06/01,197,3,0.5191577829999999,1876,197,1,2
60686,2014/03/31,2012/04/06,724,2,0.75,1298,724,2,0
60687,2014/03/31,2012/07/26,611,2,0.75,1298,611,2,0
60688,2014/03/31,2012/09/11,563,2,0.75,1298,563,2,0
60689,2014/03/31,2009/02/16,532,2,0.75,1298,532,2,0
60690,2014/03/31,2012/05/28,673,2,0.75,1298,673,2,0
60691,2014/03/31,2012/10/12,414,2,0.75,1298,414,2,0
60692,2014/03/31,2012/08/10,600,2,0.75,1298,600,2,0
60693,2014/03/31,2012/07/15,619,2,0.75,1298,619,2,0
60694,2014/03/31,2011/02/14,234,2,0.75,1298,234,0,2
60695,2014/03/31,2012/07/05,634,2,0.75,1298,634,2,0
60696,2014/03/31,2012/08/31,575,2,0.75,1298,575,2,0
60697,2014/03/31,2012/11/25,487,2,0.75,1298,487,2,0
60698,2014/03/31,2012/10/18,291,2,0.75,1298,291,0,2
60699,2014/03/31,2012/04/20,709,2,0.75,1298,709,2,0
60700,2014/03/31,2012/07/13,625,2,0.75,1298,625,2,0
60701,2014/03/31,2010/07/04,526,3,0.4,2433,526,3,0
60702,2014/03/31,2013/02/28,324,2,0.35,2780,324,0,2
60703,2014/03/31,2012/03/22,670,2,0.35,2780,670,2,0
60704,2014/03/31,2010/01/07,245,2,0.685098592,1420,245,0,2
60705,2014/03/31,2012/03/29,179,2,0.365264739,2663,179,0,2
60706,2014/03/31,2012/09/25,290,2,0.5708925429999999,1703,290,1,1
60707,2014/03/31,2012/04/27,499,2,0.25,3888,499,2,0
60708,2014/03/31,2013/01/11,32,3,0.276666667,3513,32,0,3
60709,2014/03/31,2013/02/25,6,2,0.398814116,2437,6,1,1
60710,2014/03/31,2008/08/20,448,2,0.34221831,2840,448,2,0
60711,2014/03/31,2010/02/27,161,2,0.52220849,1861,161,0,2
60712,2014/03/31,2012/12/13,127,2,0.271472478,3579,127,1,1
60713,2014/03/31,2012/11/11,477,2,0.525,1850,477,2,0
60714,2014/03/31,2012/04/17,558,2,0.45,2158,558,2,0
60715,2014/03/31,2010/11/19,226,2,0.65,1494,226,0,2
60716,2014/03/31,2010/11/02,614,2,0.65,1494,614,2,0
60717,2014/03/31,2013/02/10,327,2,0.45,2158,327,1,1
60718,2014/03/31,2012/06/05,651,2,0.306718305,3163,651,2,0
60719,2014/03/31,2012/04/03,236,2,0.5365688989999999,1807,236,0,2
60720,2014/03/31,2008/04/18,601,2,0.25,3877,601,2,0
60721,2014/03/31,2012/05/21,680,2,0.4,2423,680,2,0
60722,2014/03/31,2012/08/31,154,2,0.369725296,2621,154,1,1
60723,2014/03/31,2010/11/17,59,4,0.2775,3492,59,0,4
60724,2014/03/31,2010/07/26,271,2,0.555,1746,271,0,2
60725,2014/03/31,2008/03/03,484,2,0.897222222,1080,484,2,0
60726,2014/03/31,2012/05/21,471,2,0.897222222,1080,471,2,0
60727,2014/03/31,2012/06/01,115,2,0.835,1158,115,1,1
60728,2014/03/31,2011/12/11,67,2,0.835,1158,67,1,1
60729,2014/03/31,2011/05/09,255,2,0.835,1158,255,1,1
60730,2014/03/31,2010/11/25,109,2,0.835,1158,109,0,2
60731,2014/03/31,2007/06/28,180,2,0.835,1158,180,0,2
60732,2014/03/31,2012/01/19,583,2,0.580312125,1666,583,2,0
60733,2014/03/31,2011/11/30,622,2,0.9,1074,622,2,0
60734,2014/03/31,2005/05/28,393,2,0.9,1074,393,2,0
60735,2014/03/31,2006/03/09,558,2,0.9,1074,558,2,0
60736,2014/03/31,2007/02/21,725,2,0.9,1074,725,2,0
60737,2014/03/31,2012/12/19,26,2,0.428757764,2254,26,0,2
60738,2014/03/31,2005/03/13,383,2,0.8,1208,383,2,0
60739,2014/03/31,2007/10/01,178,3,0.301516854,3204,178,1,2
60740,2014/03/31,2006/07/10,477,2,0.355147059,2720,477,2,0
60741,2014/03/31,2012/11/02,174,2,0.43768359,2206,174,0,2
60742,2014/03/31,2012/08/07,305,2,0.34007044700000005,2839,305,1,1
60743,2014/03/31,2010/07/21,148,2,0.586452005,1646,148,0,2
60744,2014/03/31,2009/06/21,233,4,0.635,1520,233,0,4
60745,2014/03/31,2008/03/01,353,2,0.5960469429999999,1619,353,0,2
60746,2014/03/31,2011/06/17,44,2,0.44,2192,44,0,2
60747,2014/03/31,2010/10/31,434,2,0.475,2030,434,2,0
60748,2014/03/31,2012/10/02,179,2,0.341488306,2822,179,1,1
60749,2014/03/31,2010/11/17,551,3,0.336687631,2862,551,3,0
60750,2014/03/31,2013/03/19,199,2,0.546122449,1764,199,0,2
60751,2014/03/31,2011/03/17,478,2,0.4,2407,478,2,0
60752,2014/03/31,2007/10/25,342,2,0.35,2750,342,0,2
60753,2014/03/31,2012/12/06,478,2,0.35,2750,478,2,0
60754,2014/03/31,2005/09/06,13,2,0.5879108120000001,1637,13,1,1
60755,2014/03/31,2012/02/05,21,2,0.68,1415,21,0,2
60756,2014/03/31,2012/10/23,363,3,0.328069577,2932,363,1,2
60757,2014/03/31,2006/07/01,379,2,0.598444306,1607,379,2,0
60758,2014/03/31,2012/10/23,317,2,0.516353383,1862,317,1,1
60759,2014/03/31,2008/10/27,21,2,0.8440737490000001,1139,21,0,2
60760,2014/03/31,2012/10/19,60,2,0.786091578,1223,60,1,1
60761,2014/03/31,2013/03/09,387,2,0.6,1602,387,2,0
60762,2014/03/31,2012/12/27,295,2,0.862154399,1114,295,0,2
60763,2014/03/31,2008/09/06,160,2,0.287044571,3343,160,1,1
60764,2014/03/31,2010/08/26,346,2,0.475,2020,346,0,2
60765,2014/03/31,2010/10/13,698,2,0.55,1744,698,2,0
60766,2014/03/31,2013/02/12,48,2,0.875,1096,48,0,2
60767,2014/03/31,2009/09/18,203,3,0.583333333,1644,203,2,1
60768,2014/03/31,2010/01/23,50,2,0.418902972,2288,50,0,2
60769,2014/03/31,2010/07/23,284,2,0.845,1134,284,0,2
60770,2014/03/31,2010/07/23,284,2,0.845,1134,284,0,2
60771,2014/03/31,2012/08/09,600,3,1.165693431,822,600,3,0
60772,2014/03/31,2008/08/23,327,2,0.494040248,1938,327,1,1
60773,2014/03/31,2005/03/26,651,2,0.612348049,1563,651,2,0
60774,2014/03/31,2011/09/08,586,2,0.825,1160,586,2,0
60775,2014/03/31,2010/02/26,159,3,0.55,1740,159,0,3
60776,2014/03/31,2012/09/09,501,2,0.825,1160,501,2,0
60777,2014/03/31,2013/02/12,154,2,0.49,1952,154,0,2
60778,2014/03/31,2012/10/15,427,2,0.6062777429999999,1577,427,2,0
60779,2014/03/31,2011/01/25,507,2,0.4,2390,507,2,0
60780,2014/03/31,2009/07/02,612,2,0.355714818,2686,612,2,0
60781,2014/03/31,2007/01/10,140,2,0.814961571,1171,140,0,2
60782,2014/03/31,2010/01/11,53,2,0.79,1208,53,1,1
60783,2014/03/31,2005/10/05,410,2,0.51681128,1844,410,2,0
60784,2014/03/31,2011/11/28,510,2,0.725,1314,510,2,0
60785,2014/03/31,2008/04/25,590,2,0.725,1314,590,2,0
60786,2014/03/31,2010/06/26,81,2,0.715,1332,81,0,2
60787,2014/03/31,2012/11/20,27,2,0.51,1866,27,0,2
60788,2014/03/31,2007/07/27,551,2,0.725,1312,551,2,0
60789,2014/03/31,2011/03/07,288,2,0.46040678,2065,288,1,1
60790,2014/03/31,2005/09/15,42,3,0.363333333,2616,42,0,3
60791,2014/03/31,2010/08/07,147,2,0.4,2376,147,1,1
60792,2014/03/31,2011/05/17,24,2,0.444389331,2137,24,0,2
60793,2014/03/31,2011/04/24,524,3,0.971954964,977,524,3,0
60794,2014/03/31,2007/10/12,254,2,0.585,1622,254,0,2
60795,2014/03/31,2009/10/08,480,2,0.569046191,1667,480,2,0
60796,2014/03/31,2012/04/23,554,2,0.420652174,2254,554,2,0
60797,2014/03/31,2008/11/14,553,2,1.0,947,553,2,0
60798,2014/03/31,2011/11/16,64,2,0.622544379,1521,64,0,2
60799,2014/03/31,2013/02/03,124,2,0.619071288,1529,124,1,1
60800,2014/03/31,2009/08/09,423,2,0.654564315,1446,423,2,0
60801,2014/03/31,2007/09/02,209,2,0.52,1820,209,0,2
60802,2014/03/31,2012/05/24,435,2,0.34612289700000004,2734,435,2,0
60803,2014/03/31,2012/06/15,246,2,0.71,1332,246,0,2
60804,2014/03/31,2010/03/23,481,2,0.613376623,1540,481,2,0
60805,2014/03/31,2010/12/17,41,2,0.404189131,2337,41,0,2
60806,2014/03/31,2008/04/21,25,2,0.754121406,1252,25,0,2
60807,2014/03/31,2008/03/12,4,2,0.509330815,1853,4,0,2
60808,2014/03/31,2010/07/28,74,3,0.543333333,1737,74,0,3
60809,2014/03/31,2013/02/12,359,2,0.75,1258,359,0,2
60810,2014/03/31,2011/03/08,40,2,0.484483821,1947,40,0,2
60811,2014/03/31,2011/01/31,307,2,0.3,3142,307,0,2
60812,2014/03/31,2012/04/20,559,2,1.0,942,559,2,0
60813,2014/03/31,2011/01/12,395,2,0.8715277779999999,1080,395,2,0
60814,2014/03/31,2013/01/01,177,2,0.63,1494,177,0,2
60815,2014/03/31,2007/12/17,636,2,0.732373541,1285,636,2,0
60816,2014/03/31,2012/03/01,280,2,0.96,980,280,0,2
60817,2014/03/31,2006/07/15,195,2,0.607314396,1549,195,0,2
60818,2014/03/31,2010/12/16,275,2,0.400417199,2349,275,0,2
60819,2014/03/31,2013/02/16,281,2,0.46973027,2002,281,0,2
60820,2014/03/31,2012/07/26,512,3,0.5017342579999999,1874,512,3,0
60821,2014/03/31,2011/07/19,133,2,0.591699182,1589,133,1,1
60822,2014/03/31,2010/01/11,404,2,0.76097166,1235,404,2,0
60823,2014/03/31,2011/03/08,163,2,0.875,1074,163,0,2
60824,2014/03/31,2009/01/16,647,2,0.875,1074,647,2,0
60825,2014/03/31,2012/01/02,36,2,0.375033959,2503,36,0,2
60826,2014/03/31,2009/06/27,19,2,0.552483814,1699,19,0,2
60827,2014/03/31,2012/08/03,262,3,0.823333333,1140,262,1,2
60828,2014/03/31,2008/04/21,399,2,0.7642508140000001,1228,399,2,0
60829,2014/03/31,2012/07/10,151,2,0.606451196,1547,151,1,1
60830,2014/03/31,2008/09/10,141,2,0.868611111,1080,141,0,2
60831,2014/03/31,2012/09/24,66,2,0.323519669,2898,66,1,1
60832,2014/03/31,2010/04/21,266,3,0.7566666670000001,1239,266,2,1
60833,2014/03/31,2005/11/01,264,2,0.738173228,1270,264,1,1
60834,2014/03/31,2005/11/04,351,2,0.593322785,1580,351,1,1
60835,2014/03/31,2009/08/01,517,2,0.634190928,1477,517,2,0
60836,2014/03/31,2012/09/13,414,2,0.775,1208,414,2,0
60837,2014/03/31,2009/07/01,640,2,0.419046553,2234,640,2,0
60838,2014/03/31,2005/05/30,317,4,0.367386185,2548,317,3,1
60839,2014/03/31,2012/10/01,544,2,0.25,3744,544,2,0
60840,2014/03/31,2012/10/01,544,2,0.25,3744,544,2,0
60841,2014/03/31,2010/07/01,253,2,0.38,2463,253,0,2
60842,2014/03/31,2007/08/17,382,2,0.743879173,1258,382,2,0
60843,2014/03/31,2006/04/03,287,2,0.34,2750,287,0,2
60844,2014/03/31,2011/01/14,14,2,0.89,1050,14,0,2
60845,2014/03/31,2010/11/15,550,2,0.44205298,2114,550,2,0
60846,2014/03/31,2010/12/06,9,3,0.524719101,1780,9,0,3
60847,2014/03/31,2009/11/19,493,2,0.25,3734,493,2,0
60848,2014/03/31,2006/06/18,252,2,0.525915493,1775,252,0,2
60849,2014/03/31,2011/05/24,670,2,0.5,1866,670,2,0
60850,2014/03/31,2012/04/12,490,2,0.537039171,1736,490,2,0
60851,2014/03/31,2007/11/30,500,2,0.537039171,1736,500,2,0
60852,2014/03/31,2012/02/12,187,2,0.596046065,1563,187,0,2
60853,2014/03/31,2012/11/22,220,2,0.71,1312,220,1,1
60854,2014/03/31,2005/12/13,468,2,0.789322034,1180,468,2,0
60855,2014/03/31,2009/11/17,561,2,0.571042945,1630,561,2,0
60856,2014/03/31,2012/01/06,310,2,0.91846002,1013,310,1,1
60857,2014/03/31,2008/10/28,359,2,0.25,3721,359,0,2
60858,2014/03/31,2010/05/18,172,2,0.6843046359999999,1359,172,0,2
60859,2014/03/31,2012/10/12,154,2,0.54746172,1698,154,1,1
60860,2014/03/31,2008/11/27,515,2,0.625,1486,515,2,0
60861,2014/03/31,2009/10/06,248,2,0.451712062,2056,248,0,2
60862,2014/03/31,2009/11/04,174,2,0.92,1009,174,0,2
60863,2014/03/31,2009/08/31,68,2,0.454143836,2044,68,1,1
60864,2014/03/31,2007/05/01,125,2,0.715,1298,125,0,2
60865,2014/03/31,2012/05/13,687,2,0.8,1160,687,2,0
60866,2014/03/31,2012/05/26,674,2,0.8,1160,674,2,0
60867,2014/03/31,2008/03/09,273,2,0.735,1262,273,1,1
60868,2014/03/31,2012/01/09,613,2,0.45,2061,613,2,0
60869,2014/03/31,2008/04/09,86,2,0.39,2378,86,1,1
60870,2014/03/31,2012/11/14,422,2,0.426367816,2175,422,2,0
60871,2014/03/31,2008/06/06,158,2,0.92,1007,158,0,2
60872,2014/03/31,2010/08/26,459,2,0.8,1158,459,2,0
60873,2014/03/31,2011/05/08,458,2,0.8,1158,458,2,0
60874,2014/03/31,2011/08/02,73,2,0.8,1158,73,1,1
60875,2014/03/31,2011/11/22,665,2,0.8,1158,665,2,0
60876,2014/03/31,2013/03/07,362,2,0.8,1158,362,1,1
60877,2014/03/31,2012/05/16,683,2,0.8,1158,683,2,0
60878,2014/03/31,2010/06/09,41,2,0.62,1494,41,0,2
60879,2014/03/31,2012/06/08,73,2,0.62,1494,73,0,2
60880,2014/03/31,2008/07/16,321,2,0.373014913,2481,321,1,1
60881,2014/03/31,2013/01/09,94,3,0.331558581,2791,94,0,3
60882,2014/03/31,2013/01/15,18,2,0.53,1746,18,0,2
60883,2014/03/31,2013/01/01,451,2,0.351177364,2633,451,2,0
60884,2014/03/31,2011/07/07,383,2,0.752850163,1228,383,2,0
60885,2014/03/31,2012/06/17,43,2,0.605,1528,43,0,2
60886,2014/03/31,2012/07/31,62,2,0.815,1134,62,0,2
60887,2014/03/31,2011/09/12,597,2,0.5,1847,597,2,0
60888,2014/03/31,2011/09/16,533,2,0.6,1539,533,2,0
60889,2014/03/31,2009/07/23,370,2,0.531548647,1737,370,2,0
60890,2014/03/31,2012/06/20,625,2,0.7757983190000001,1190,625,2,0
60891,2014/03/31,2012/04/03,582,2,0.4,2308,582,2,0
60892,2014/03/31,2012/06/01,4,2,0.569333333,1620,4,0,2
60893,2014/03/31,2010/03/01,266,3,0.386666667,2385,266,1,2
60894,2014/03/31,2007/11/11,128,2,0.751965742,1226,128,1,1
60895,2014/03/31,2011/05/29,236,2,0.71,1298,236,1,1
60896,2014/03/31,2008/09/24,90,2,0.733089172,1256,90,0,2
60897,2014/03/31,2011/12/01,292,6,0.833333333,1104,292,4,2
60898,2014/03/31,2012/01/16,520,2,0.7,1314,520,2,0
60899,2014/03/31,2010/03/08,372,2,0.409461264,2246,372,2,0
60900,2014/03/31,2006/07/25,555,2,0.54437537,1689,555,2,0
60901,2014/03/31,2005/02/01,362,2,0.337835355,2721,362,1,1
60902,2014/03/31,2010/07/03,155,2,0.695563967,1321,155,0,2
60903,2014/03/31,2012/12/25,453,2,0.7,1312,453,2,0
60904,2014/03/31,2012/04/26,637,2,0.7,1312,637,2,0
60905,2014/03/31,2012/10/20,199,2,0.28,3280,199,0,2
60906,2014/03/31,2011/05/31,191,2,0.92,998,191,0,2
60907,2014/03/31,2012/07/06,559,2,0.328226671,2797,559,2,0
60908,2014/03/31,2013/03/07,157,2,0.7475570029999999,1228,157,1,1
60909,2014/03/31,2008/09/01,340,2,0.377777778,2430,340,1,1
60910,2014/03/31,2007/05/28,317,2,0.795320624,1154,317,0,2
60911,2014/03/31,2012/07/06,272,2,0.35,2622,272,1,1
60912,2014/03/31,2009/11/24,544,2,0.35,2622,544,2,0
60913,2014/03/31,2010/10/26,391,2,0.35,2622,391,2,0
60914,2014/03/31,2013/01/10,336,2,0.35,2622,336,1,1
60915,2014/03/31,2012/09/08,522,2,0.6,1529,522,2,0
60916,2014/03/31,2010/01/29,331,2,0.425,2158,331,1,1
60917,2014/03/31,2008/04/23,554,2,0.425,2158,554,2,0
60918,2014/03/31,2012/09/11,469,2,0.356967692,2569,469,2,0
60919,2014/03/31,2012/08/31,178,2,0.6,1528,178,0,2
60920,2014/03/31,2009/02/20,262,2,0.366786715,2499,262,1,1
60921,2014/03/31,2009/07/18,320,2,0.6622109829999999,1384,320,1,1
60922,2014/03/31,2012/08/08,156,2,0.576765261,1589,156,0,2
60923,2014/03/31,2013/02/08,212,2,0.49,1870,212,0,2
60924,2014/03/31,2012/04/07,79,2,0.34147651,2682,79,1,1
60925,2014/03/31,2007/10/01,310,2,0.35,2616,310,0,2
60926,2014/03/31,2012/02/05,680,2,0.525,1744,680,2,0
60927,2014/03/31,2006/03/24,714,2,0.525847214,1741,714,2,0
60928,2014/03/31,2008/01/10,44,2,0.27,3390,44,0,2
60929,2014/03/31,2007/01/28,227,2,0.706571429,1295,227,1,1
60930,2014/03/31,2009/12/10,193,3,0.52095672,1756,193,0,3
60931,2014/03/31,2011/02/04,51,2,0.40007874,2286,51,0,2
60932,2014/03/31,2010/11/18,222,2,0.571018114,1601,222,0,2
60933,2014/03/31,2007/03/12,115,2,0.446793744,2046,115,0,2
60934,2014/03/31,2011/10/19,547,2,0.362267142,2523,547,2,0
60935,2014/03/31,2008/05/22,247,2,0.49,1865,247,0,2
60936,2014/03/31,2012/04/02,657,2,0.8596425209999999,1063,657,2,0
60937,2014/03/31,2011/01/13,264,3,0.385855513,2367,264,2,1
60938,2014/03/31,2012/05/24,544,2,0.6,1522,544,2,0
60939,2014/03/31,2010/11/01,400,3,0.4,2283,400,3,0
60940,2014/03/31,2011/09/17,462,2,0.6,1522,462,2,0
60941,2014/03/31,2006/12/03,64,2,0.85,1074,64,0,2
60942,2014/03/31,2010/07/17,729,2,0.85,1074,729,2,0
60943,2014/03/31,2010/01/12,169,2,0.38,2400,169,0,2
60944,2014/03/31,2009/12/29,52,2,0.695,1312,52,0,2
60945,2014/03/31,2012/08/20,23,2,0.796005245,1144,23,0,2
60946,2014/03/31,2008/09/27,8,2,0.390291595,2332,8,0,2
60947,2014/03/31,2011/10/26,533,2,0.5,1820,533,2,0
60948,2014/03/31,2012/09/19,431,2,0.403726708,2254,431,2,0
60949,2014/03/31,2010/10/23,566,2,0.25,3635,566,2,0
60950,2014/03/31,2010/09/09,363,2,0.7,1298,363,0,2
60951,2014/03/31,2012/12/18,470,2,0.7,1298,470,2,0
60952,2014/03/31,2011/03/26,515,2,0.7,1298,515,2,0
60953,2014/03/31,2007/12/06,256,2,0.38,2390,256,0,2
60954,2014/03/31,2011/01/17,527,2,1.0,908,527,2,0
60955,2014/03/31,2007/10/16,44,2,0.335,2710,44,1,1
60956,2014/03/31,2012/06/05,651,2,0.740252855,1226,651,2,0
60957,2014/03/31,2006/02/01,146,2,0.845,1074,146,0,2
60958,2014/03/31,2012/12/26,411,2,0.475,1910,411,2,0
60959,2014/03/31,2012/11/13,480,2,0.8,1134,480,2,0
60960,2014/03/31,2007/09/22,231,2,0.38,2387,231,0,2
60961,2014/03/31,2011/04/20,425,2,0.571626734,1586,425,2,0
60962,2014/03/31,2013/02/08,275,2,0.42,2158,275,0,2
60963,2014/03/31,2011/10/11,577,2,0.4,2265,577,2,0
60964,2014/03/31,2010/12/13,675,2,0.75,1208,675,2,0
60965,2014/03/31,2012/12/12,475,2,0.75,1208,475,2,0
60966,2014/03/31,2013/01/14,33,3,0.73,1239,33,1,2
60967,2014/03/31,2012/11/13,58,2,0.825,1096,58,0,2
60968,2014/03/31,2012/04/30,543,2,1.0,904,543,2,0
60969,2014/03/31,2008/11/18,404,2,1.0,904,404,2,0
60970,2014/03/31,2009/01/23,521,2,0.35,2582,521,2,0
60971,2014/03/31,2012/12/30,38,2,0.325,2780,38,0,2
60972,2014/03/31,2012/07/25,128,2,0.445,2030,128,0,2
60973,2014/03/31,2012/05/05,44,2,0.313955509,2877,44,1,1
60974,2014/03/31,2008/09/29,57,2,0.78,1158,57,0,2
60975,2014/03/31,2007/11/17,34,2,0.78,1158,34,0,2
60976,2014/03/31,2007/11/17,189,2,0.666568266,1355,189,1,1
60977,2014/03/31,2013/02/23,77,3,0.7487728029999999,1206,77,0,3
60978,2014/03/31,2012/01/01,447,2,0.35,2580,447,2,0
60979,2014/03/31,2012/09/04,471,2,0.35,2580,471,2,0
60980,2014/03/31,2005/11/15,50,3,0.186185567,4850,50,0,3
60981,2014/03/31,2012/09/16,525,3,0.458871378,1967,525,3,0
60982,2014/03/31,2011/08/01,176,2,0.369561655,2441,176,1,1
60983,2014/03/31,2012/01/22,105,3,0.479877594,1879,105,0,3
60984,2014/03/31,2012/07/06,124,2,0.952101373,947,124,1,1
60985,2014/03/31,2013/01/18,396,2,0.4,2254,396,2,0
60986,2014/03/31,2012/11/06,471,2,0.4,2254,471,2,0
60987,2014/03/31,2007/10/01,466,2,0.543399638,1659,466,2,0
60988,2014/03/31,2007/07/10,491,2,0.397880795,2265,491,2,0
60989,2014/03/31,2011/01/13,545,2,0.546177184,1648,545,2,0
60990,2014/03/31,2007/09/03,146,2,0.426136364,2112,146,1,1
60991,2014/03/31,2009/10/09,577,3,0.581395349,1548,577,3,0
60992,2014/03/31,2011/06/14,25,3,0.469457203,1916,25,0,3
60993,2014/03/31,2012/10/24,263,2,0.546348724,1646,263,0,2
60994,2014/03/31,2012/08/14,590,2,0.675,1332,590,2,0
60995,2014/03/31,2011/09/10,527,2,0.775,1160,527,2,0
60996,2014/03/31,2010/06/11,362,2,0.775,1160,362,1,1
60997,2014/03/31,2012/01/06,532,2,0.775,1160,532,2,0
60998,2014/03/31,2007/07/30,586,2,0.940376569,956,586,2,0
60999,2014/03/31,2013/01/02,17,2,0.322346609,2787,17,0,2
61000,2014/03/31,2012/10/22,102,4,0.31564147600000003,2845,102,2,2
61001,2014/03/31,2011/09/29,381,2,0.7,1282,381,2,0
61002,2014/03/31,2010/10/10,672,2,0.653605244,1373,672,2,0
61003,2014/03/31,2012/09/18,327,2,0.284188847,3156,327,1,1
61004,2014/03/31,2010/06/11,164,2,0.835,1074,164,0,2
61005,2014/03/31,2012/10/16,133,3,0.514933946,1741,133,1,2
61006,2014/03/31,2005/03/26,620,2,0.6,1494,620,2,0
61007,2014/03/31,2012/09/25,540,2,0.325,2758,540,2,0
61008,2014/03/31,2006/03/23,14,2,0.69,1298,14,0,2
61009,2014/03/31,2009/07/26,32,2,0.69,1298,32,0,2
61010,2014/03/31,2011/01/13,206,2,0.415,2158,206,0,2
61011,2014/03/31,2011/01/13,151,2,0.8891062559999999,1007,151,0,2
61012,2014/03/31,2011/03/31,198,2,0.681232877,1314,198,1,1
61013,2014/03/31,2012/05/16,661,2,0.612251882,1461,661,2,0
61014,2014/03/31,2007/12/17,9,2,0.695,1286,9,0,2
61015,2014/03/31,2005/08/02,34,2,0.796336898,1122,34,0,2
61016,2014/03/31,2012/09/01,12,2,0.811963636,1100,12,1,1
61017,2014/03/31,2012/10/02,91,2,0.67,1332,91,1,1
61018,2014/03/31,2006/02/18,157,2,0.67,1332,157,0,2
61019,2014/03/31,2013/03/25,373,2,0.4,2230,373,2,0
61020,2014/03/31,2008/08/09,648,2,0.375,2378,648,2,0
61021,2014/03/31,2013/03/10,337,2,0.375,2378,337,0,2
61022,2014/03/31,2006/10/15,3,2,0.77,1158,3,0,2
61023,2014/03/31,2010/08/07,7,2,0.34,2622,7,0,2
61024,2014/03/31,2008/02/28,443,2,0.375,2376,443,2,0
61025,2014/03/31,2012/12/22,450,2,0.375,2376,450,2,0
61026,2014/03/31,2012/11/27,277,4,0.3921101320000001,2270,277,2,2
61027,2014/03/31,2011/03/26,573,2,0.382030915,2329,573,2,0
61028,2014/03/31,2012/11/27,81,2,0.34,2616,81,0,2
61029,2014/03/31,2009/09/11,3,2,0.561794062,1583,3,1,1
61030,2014/03/31,2005/05/01,245,2,0.7176674740000001,1239,245,0,2
61031,2014/03/31,2007/03/01,232,6,0.803333333,1104,232,4,2
61032,2014/03/31,2012/08/05,392,2,0.475,1866,392,2,0
61033,2014/03/31,2007/11/19,51,2,0.428274529,2069,51,0,2
61034,2014/03/31,2012/10/29,516,2,0.825,1074,516,2,0
61035,2014/03/31,2012/07/13,375,2,0.32442328800000003,2731,375,2,0
61036,2014/03/31,2011/07/28,4,3,0.51,1737,4,2,1
61037,2014/03/31,2013/02/03,254,2,0.665,1332,254,0,2
61038,2014/03/31,2011/01/24,436,2,0.8201388890000001,1080,436,2,0
61039,2014/03/31,2011/05/31,193,2,0.877185332,1009,193,1,1
61040,2014/03/31,2005/12/20,29,2,0.433290891,2042,29,0,2
61041,2014/03/31,2005/10/02,29,2,0.625,1414,29,0,2
61042,2014/03/31,2010/02/01,392,2,0.375,2356,392,2,0
61043,2014/03/31,2011/04/11,32,2,0.34,2595,32,0,2
61044,2014/03/31,2009/03/03,374,2,0.875,1008,374,2,0
61045,2014/03/31,2010/11/20,231,2,0.587581612,1501,231,1,1
61046,2014/03/31,2008/05/31,40,2,0.34,2594,40,0,2
61047,2014/03/31,2012/12/23,400,2,0.616433566,1430,400,2,0
61048,2014/03/31,2012/12/10,344,2,0.342976654,2570,344,1,1
61049,2014/03/31,2007/12/04,436,2,0.556727732,1583,436,2,0
61050,2014/03/31,2012/07/10,631,2,0.4,2202,631,2,0
61051,2014/03/31,2012/07/10,631,2,0.4,2202,631,2,0
61052,2014/03/31,2013/01/22,43,2,0.325,2710,43,0,2
61053,2014/03/31,2013/02/02,381,2,0.25,3521,381,2,0
61054,2014/03/31,2012/11/23,220,2,0.76,1158,220,0,2
61055,2014/03/31,2011/01/13,223,2,0.76,1158,223,0,2
61056,2014/03/31,2013/03/31,231,3,0.526666667,1671,231,0,3
61057,2014/03/31,2008/02/26,85,2,0.345540275,2545,85,0,2
61058,2014/03/31,2011/10/06,298,2,0.66,1332,298,0,2
61059,2014/03/31,2010/09/20,115,2,0.67,1312,115,0,2
61060,2014/03/31,2012/04/04,705,2,0.4,2196,705,2,0
61061,2014/03/31,2011/05/10,148,2,0.678285714,1295,148,0,2
61062,2014/03/31,2013/01/24,35,2,0.38,2310,35,0,2
61063,2014/03/31,2009/11/11,61,2,0.575,1526,61,0,2
61064,2014/03/31,2013/02/13,94,4,0.485,1808,94,1,3
61065,2014/03/31,2012/08/23,393,2,0.4,2192,393,2,0
61066,2014/03/31,2007/08/22,359,2,0.8,1096,359,0,2
61067,2014/03/31,2008/07/19,629,2,0.4,2192,629,2,0
61068,2014/03/31,2009/04/19,598,2,0.4,2192,598,2,0
61069,2014/03/31,2010/04/01,332,2,0.429382958,2042,332,1,1
61070,2014/03/31,2011/01/13,558,2,0.498861696,1757,558,2,0
61071,2014/03/31,2011/11/30,110,2,0.675,1298,110,0,2
61072,2014/03/31,2010/12/13,430,2,0.725,1208,430,2,0
61073,2014/03/31,2010/08/06,364,2,0.444918699,1968,364,1,1
61074,2014/03/31,2009/05/08,24,3,0.358990976,2438,24,0,3
61075,2014/03/31,2007/03/30,631,2,0.575,1522,631,2,0
61076,2014/03/31,2012/07/31,424,2,0.37318686,2344,424,2,0
61077,2014/03/31,2005/05/20,27,2,0.755,1158,27,0,2
61078,2014/03/31,2013/01/31,363,3,0.894319345,977,363,0,3
61079,2014/03/31,2013/01/26,313,3,0.466115261,1874,313,2,1
61080,2014/03/31,2007/07/24,677,2,0.6565789470000001,1330,677,2,0
61081,2014/03/31,2011/01/14,176,2,0.77,1134,176,0,2
61082,2014/03/31,2013/01/31,128,2,0.77,1134,128,0,2
61083,2014/03/31,2013/03/19,1,2,0.386440903,2259,1,0,2
61084,2014/03/31,2008/02/07,94,2,0.807777778,1080,94,0,2
61085,2014/03/31,2009/10/06,556,2,0.5,1744,556,2,0
61086,2014/03/31,2012/04/04,724,2,0.5,1744,724,2,0
61087,2014/03/31,2012/07/14,346,2,0.5,1744,346,1,1
61088,2014/03/31,2009/06/17,258,2,0.37,2356,258,1,1
61089,2014/03/31,2009/11/13,204,2,0.96,908,204,1,1
61090,2014/03/31,2012/11/27,488,2,0.75,1160,488,2,0
61091,2014/03/31,2012/11/11,505,2,0.75,1160,505,2,0
61092,2014/03/31,2012/12/19,429,2,0.75,1160,429,2,0
61093,2014/03/31,2012/12/30,451,2,0.75,1160,451,2,0
61094,2014/03/31,2011/12/26,123,2,0.72,1208,123,1,1
61095,2014/03/31,2007/05/28,3,2,0.28,3106,3,0,2
61096,2014/03/31,2013/03/21,128,2,0.49,1774,128,0,2
61097,2014/03/31,2008/02/04,67,3,0.570328299,1523,67,0,3
61098,2014/03/31,2011/05/21,308,2,0.75,1158,308,0,2
61099,2014/03/31,2007/11/23,106,2,0.32,2714,106,0,2
61100,2014/03/31,2012/10/16,81,2,0.765,1134,81,0,2
61101,2014/03/31,2011/08/08,670,2,0.32625047,2659,670,2,0
61102,2014/03/31,2011/12/17,23,3,0.437276853,1983,23,0,3
61103,2014/03/31,2005/03/01,361,2,0.497160069,1743,361,1,1
61104,2014/03/31,2012/08/23,342,2,0.375,2310,342,1,1
61105,2014/03/31,2008/03/28,98,2,0.375,2310,98,0,2
61106,2014/03/31,2012/01/09,7,2,0.7845923909999999,1104,7,1,1
61107,2014/03/31,2011/08/29,477,2,0.25,3464,477,2,0
61108,2014/03/31,2012/10/25,323,2,0.65,1332,323,0,2
61109,2014/03/31,2011/07/12,589,2,0.75,1154,589,2,0
61110,2014/03/31,2009/01/05,277,2,0.282260274,3066,277,1,1
61111,2014/03/31,2013/03/11,18,2,0.33,2622,18,0,2
61112,2014/03/31,2006/09/27,670,2,0.677899687,1276,670,2,0
61113,2014/03/31,2013/02/23,145,3,0.507535211,1704,145,0,3
61114,2014/03/31,2007/09/07,30,2,0.922358591,937,30,0,2
61115,2014/03/31,2012/07/21,399,2,0.4,2158,399,2,0
61116,2014/03/31,2013/02/06,288,2,0.665,1298,288,1,1
61117,2014/03/31,2010/08/18,135,3,0.3,2875,135,0,3
61118,2014/03/31,2013/03/11,51,3,0.476666667,1809,51,0,3
61119,2014/03/31,2012/06/20,589,2,0.6,1436,589,2,0
61120,2014/03/31,2012/02/11,383,2,0.25,3444,383,2,0
61121,2014/03/31,2013/02/16,349,2,0.4,2151,349,0,2
61122,2014/03/31,2012/11/26,491,2,0.772307002,1114,491,2,0
61123,2014/03/31,2011/05/22,479,2,0.25,3440,479,2,0
61124,2014/03/31,2007/06/01,473,2,0.8,1074,473,2,0
61125,2014/03/31,2011/07/17,418,2,0.8,1074,418,2,0
61126,2014/03/31,2012/02/20,706,2,0.8,1074,706,2,0
61127,2014/03/31,2011/04/08,669,2,0.8,1074,669,2,0
61128,2014/03/31,2012/03/15,635,2,0.8,1074,635,2,0
61129,2014/03/31,2011/07/28,495,2,0.8,1074,495,2,0
61130,2014/03/31,2012/03/10,636,2,0.8,1074,636,2,0
61131,2014/03/31,2012/11/19,475,2,0.4,2148,475,2,0
61132,2014/03/31,2012/05/03,337,2,0.575,1494,337,0,2
61133,2014/03/31,2011/11/06,324,2,0.470454545,1826,324,1,1
61134,2014/03/31,2013/03/22,72,2,0.6759685040000001,1270,72,1,1
61135,2014/03/31,2006/10/09,56,2,0.46,1866,56,0,2
61136,2014/03/31,2011/12/22,108,2,0.4640400220000001,1849,108,1,1
61137,2014/03/31,2007/09/14,125,2,0.413854317,2073,125,1,1
61138,2014/03/31,2012/06/06,662,2,0.7950880440000001,1079,662,2,0
61139,2014/03/31,2007/07/19,287,3,0.466626768,1838,287,2,1
61140,2014/03/31,2009/04/30,56,2,0.532104283,1611,56,0,2
61141,2014/03/31,2005/09/10,109,2,0.53565,1600,109,0,2
61142,2014/03/31,2006/11/30,82,2,0.74,1158,82,0,2
61143,2014/03/31,2013/02/02,314,2,0.85,1008,314,1,1
61144,2014/03/31,2013/01/04,145,2,0.36,2378,145,0,2
61145,2014/03/31,2013/02/22,168,2,0.49,1746,168,1,1
61146,2014/03/31,2013/03/14,107,2,0.172379032,4960,107,0,2
61147,2014/03/31,2011/07/30,114,2,0.49,1744,114,0,2
61148,2014/03/31,2009/07/08,304,2,0.345564549,2471,304,0,2
61149,2014/03/31,2010/12/13,700,2,0.709725686,1203,700,2,0
61150,2014/03/31,2008/09/08,34,2,0.933194748,914,34,0,2
61151,2014/03/31,2009/11/18,160,2,0.65,1312,160,0,2
61152,2014/03/31,2012/10/23,63,2,0.89,958,63,0,2
61153,2014/03/31,2007/12/15,304,2,0.64,1332,304,0,2
61154,2014/03/31,2011/07/29,671,2,0.37810559,2254,671,2,0
61155,2014/03/31,2010/11/29,459,2,0.37810559,2254,459,2,0
61156,2014/03/31,2012/10/22,473,2,0.651490826,1308,473,2,0
61157,2014/03/31,2009/02/19,158,2,0.8694285709999999,980,158,1,1
61158,2014/03/31,2013/02/28,398,2,0.4,2130,398,2,0
61159,2014/03/31,2010/01/03,553,2,0.675,1262,553,2,0
61160,2014/03/31,2012/10/16,95,2,0.64,1330,95,0,2
61161,2014/03/31,2008/05/07,52,2,0.64,1330,52,0,2
61162,2014/03/31,2012/11/29,411,2,0.738368056,1152,411,2,0
61163,2014/03/31,2005/06/05,551,2,0.65955711,1287,551,2,0
61164,2014/03/31,2007/09/18,37,2,0.380820996,2229,37,1,1
61165,2014/03/31,2012/08/29,166,2,0.7076980820000001,1199,166,0,2
61166,2014/03/31,2010/02/10,355,2,0.25,3394,355,0,2
61167,2014/03/31,2008/02/26,475,2,0.7,1212,475,2,0
61168,2014/03/31,2008/06/03,420,2,0.25,3390,420,2,0
61169,2014/03/31,2005/07/12,323,2,0.25,3390,323,1,1
61170,2014/03/31,2008/03/22,3,2,0.555,1526,3,0,2
61171,2014/03/31,2012/04/08,687,2,0.343788063,2463,687,2,0
61172,2014/03/31,2010/12/29,546,2,0.7505767520000001,1127,546,2,0
61173,2014/03/31,2013/01/10,77,3,0.32,2643,77,1,2
61174,2014/03/31,2011/12/17,79,2,0.28,3020,79,0,2
61175,2014/03/31,2011/12/22,546,2,0.7,1208,546,2,0
61176,2014/03/31,2012/06/21,636,2,0.7,1208,636,2,0
61177,2014/03/31,2012/04/27,90,2,0.555,1522,90,0,2
61178,2014/03/31,2012/12/26,309,2,0.325665253,2593,309,1,1
61179,2014/03/31,2011/03/07,580,2,0.4,2111,580,2,0
61180,2014/03/31,2012/11/29,484,2,0.6518918920000001,1295,484,2,0
61181,2014/03/31,2011/05/27,223,2,0.7,1206,223,1,1
61182,2014/03/31,2012/03/13,206,3,0.513333333,1644,206,1,2
61183,2014/03/31,2006/03/27,443,2,0.65,1298,443,2,0
61184,2014/03/31,2011/12/21,112,2,0.65,1298,112,1,1
61185,2014/03/31,2012/06/03,662,2,0.65,1298,662,2,0
61186,2014/03/31,2008/02/20,611,2,0.475,1774,611,2,0
61187,2014/03/31,2011/03/23,171,3,0.483333333,1740,171,1,2
61188,2014/03/31,2013/01/17,136,2,0.480789022,1749,136,1,1
61189,2014/03/31,2012/05/14,685,3,0.4,2102,685,3,0
61190,2014/03/31,2011/02/01,462,2,0.4,2102,462,2,0
61191,2014/03/31,2007/10/16,318,2,0.414571006,2028,318,0,2
61192,2014/03/31,2011/05/22,346,2,0.4,2101,346,0,2
61193,2014/03/31,2009/02/25,59,2,0.3,2800,59,1,1
61194,2014/03/31,2011/09/16,330,2,0.3,2800,330,0,2
61195,2014/03/31,2012/09/19,197,2,0.393008891,2137,197,1,1
61196,2014/03/31,2012/09/29,433,2,0.45,1866,433,2,0
61197,2014/03/31,2005/10/27,612,2,0.45,1866,612,2,0
61198,2014/03/31,2012/01/29,201,2,0.509763206,1647,201,0,2
61199,2014/03/31,2009/03/27,11,3,0.483333333,1737,11,0,3
61200,2014/03/31,2011/01/24,7,2,0.725,1158,7,0,2
61201,2014/03/31,2009/09/01,130,3,0.3666666670000001,2289,130,0,3
61202,2014/03/31,2012/08/13,509,2,0.8076997109999999,1039,509,2,0
61203,2014/03/31,2012/11/16,9,4,0.315,2664,9,1,3
61204,2014/03/31,2006/04/15,16,2,0.3735886020000001,2246,16,0,2
61205,2014/03/31,2010/03/08,120,2,0.48,1746,120,0,2
61206,2014/03/31,2013/03/03,124,2,0.4,2094,124,0,2
61207,2014/03/31,2006/12/10,179,2,0.734473684,1140,179,1,1
61208,2014/03/31,2012/04/01,652,2,0.6571428570000001,1274,652,2,0
61209,2014/03/31,2012/11/06,495,2,0.55,1522,495,2,0
61210,2014/03/31,2012/11/06,495,2,0.55,1522,495,2,0
61211,2014/03/31,2010/06/25,452,2,0.55,1522,452,2,0
61212,2014/03/31,2008/01/28,158,2,0.831122145,1007,158,0,2
61213,2014/03/31,2008/01/28,158,2,0.831122145,1007,158,0,2
61214,2014/03/31,2007/12/07,376,2,0.4,2092,376,2,0
61215,2014/03/31,2012/07/22,564,2,0.36893739,2268,564,2,0
61216,2014/03/31,2011/01/15,280,2,0.504279687,1659,280,1,1
61217,2014/03/31,2011/07/14,360,3,0.530500951,1577,360,1,2
61218,2014/03/31,2010/04/01,468,2,0.35,2390,468,2,0
61219,2014/03/31,2010/02/23,101,2,0.32,2614,101,0,2
61220,2014/03/31,2012/07/13,443,2,0.478608247,1746,443,2,0
61221,2014/03/31,2009/09/08,578,2,0.8356,1000,578,2,0
61222,2014/03/31,2011/03/14,455,2,0.592831796,1409,455,2,0
61223,2014/03/31,2011/12/05,612,2,0.625,1334,612,2,0
61224,2014/03/31,2011/08/22,612,2,0.625,1334,612,2,0
61225,2014/03/31,2005/03/17,86,2,0.417744361,1995,86,0,2
61226,2014/03/31,2008/05/06,84,2,0.376015343,2216,84,1,1
61227,2014/03/31,2006/04/26,489,2,0.394039735,2114,489,2,0
61228,2014/03/31,2010/08/19,620,2,0.703761623,1183,620,2,0
61229,2014/03/31,2010/12/10,147,2,0.925,900,147,0,2
61230,2014/03/31,2008/03/01,443,2,0.625,1332,443,2,0
61231,2014/03/31,2010/09/18,452,2,0.775,1074,452,2,0
61232,2014/03/31,2008/08/29,450,2,0.775,1074,450,2,0
61233,2014/03/31,2012/07/25,358,2,0.35,2378,358,0,2
61234,2014/03/31,2007/08/17,285,2,0.92,904,285,0,2
61235,2014/03/31,2009/12/18,223,2,0.92,904,223,0,2
61236,2014/03/31,2013/03/13,133,2,0.35,2376,133,0,2
61237,2014/03/31,2008/10/29,673,2,0.35,2376,673,2,0
61238,2014/03/31,2011/06/05,327,2,0.35,2376,327,0,2
61239,2014/03/31,2008/02/10,400,2,0.523285085,1589,400,2,0
61240,2014/03/31,2008/09/03,299,2,0.51215783,1622,299,1,1
61241,2014/03/31,2013/03/24,372,2,0.25,3321,372,2,0
61242,2014/03/31,2006/09/15,89,2,0.321558744,2579,89,0,2
61243,2014/03/31,2013/03/26,109,2,0.555,1494,109,0,2
61244,2014/03/31,2011/10/12,724,3,0.5,1658,724,3,0
61245,2014/03/31,2011/10/08,468,2,0.47495702,1745,468,2,0
61246,2014/03/31,2006/04/16,90,2,0.41724572,1986,90,0,2
61247,2014/03/31,2013/03/29,358,2,0.475,1744,358,0,2
61248,2014/03/31,2008/12/08,684,2,0.475,1744,684,2,0
61249,2014/03/31,2013/02/03,417,2,0.75,1104,417,2,0
61250,2014/03/31,2011/03/10,445,6,0.75,1104,445,6,0
61251,2014/03/31,2008/03/04,393,2,0.75,1104,393,2,0
61252,2014/03/31,2008/11/16,70,3,0.456666667,1812,70,0,3
61253,2014/03/31,2011/10/07,167,2,0.367018634,2254,167,1,1
61254,2014/03/31,2011/10/17,468,2,0.426611655,1939,468,2,0
61255,2014/03/31,2012/11/12,411,2,0.5061505510000001,1634,411,2,0
61256,2014/03/31,2010/11/25,17,2,0.77,1074,17,0,2
61257,2014/03/31,2011/11/12,184,3,0.32300781300000003,2560,184,0,3
61258,2014/03/31,2005/11/22,666,2,0.335722989,2462,666,2,0
61259,2014/03/31,2012/07/25,616,2,0.4,2066,616,2,0
61260,2014/03/31,2010/02/18,508,2,1.0,826,508,2,0
61261,2014/03/31,2007/10/30,489,2,1.0,826,489,2,0
61262,2014/03/31,2010/11/12,593,2,0.575,1436,593,2,0
61263,2014/03/31,2010/03/31,71,2,0.704944492,1171,71,0,2
61264,2014/03/31,2013/02/25,328,2,0.29996363600000003,2750,328,0,2
61265,2014/03/31,2005/09/25,4,2,0.334409257,2463,4,1,1
61266,2014/03/31,2012/04/07,519,2,0.319123351,2578,519,2,0
61267,2014/03/31,2009/11/21,283,3,0.335595918,2450,283,2,1
61268,2014/03/31,2012/07/31,597,2,0.725,1134,597,2,0
61269,2014/03/31,2011/02/08,181,2,0.34,2418,181,0,2
61270,2014/03/31,2008/04/29,525,3,0.5,1644,525,3,0
61271,2014/03/31,2013/02/28,386,3,1.0,822,386,3,0
61272,2014/03/31,2009/07/28,97,2,0.420849974,1953,97,0,2
61273,2014/03/31,2011/05/14,287,2,0.615,1336,287,0,2
61274,2014/03/31,2005/06/12,356,3,0.326141326,2519,356,2,1
61275,2014/03/31,2010/03/23,343,2,0.625,1314,343,1,1
61276,2014/03/31,2012/05/12,682,2,0.4,2053,682,2,0
61277,2014/03/31,2012/06/22,649,2,0.4,2053,649,2,0
61278,2014/03/31,2012/06/30,138,2,0.633130301,1297,138,1,1
61279,2014/03/31,2011/06/29,50,3,0.7333333329999999,1119,50,1,2
61280,2014/03/31,2008/12/19,189,3,0.33,2486,189,0,3
61281,2014/03/31,2008/08/02,601,2,0.65,1262,601,2,0
61282,2014/03/31,2013/01/28,3,2,0.520755556,1575,3,0,2
61283,2014/03/31,2009/03/24,154,2,0.295,2780,154,0,2
61284,2014/03/31,2009/10/23,662,2,0.625,1312,662,2,0
61285,2014/03/31,2011/08/11,189,2,0.733682796,1116,189,1,1
61286,2014/03/31,2012/12/31,423,2,0.348297872,2350,423,2,0
61287,2014/03/31,2011/08/05,463,2,0.311690784,2626,463,2,0
61288,2014/03/31,2007/03/01,301,2,1.089747004,751,301,0,2
61289,2014/03/31,2006/03/07,69,2,0.34,2407,69,0,2
61290,2014/03/31,2011/11/14,227,2,0.7575,1080,227,0,2
61291,2014/03/31,2011/06/23,725,2,0.9,908,725,2,0
61292,2014/03/31,2012/08/01,396,2,0.9,908,396,2,0
61293,2014/03/31,2010/05/27,507,2,0.643307087,1270,507,2,0
61294,2014/03/31,2012/09/24,19,2,0.485157457,1683,19,1,1
61295,2014/03/31,2008/09/14,93,2,0.705,1158,93,0,2
61296,2014/03/31,2012/10/27,318,2,0.25,3261,318,1,1
61297,2014/03/31,2009/01/05,727,2,0.5258564960000001,1547,727,2,0
61298,2014/03/31,2012/06/04,73,2,0.895,908,73,0,2
61299,2014/03/31,2012/03/15,122,2,0.34,2390,122,0,2
61300,2014/03/31,2012/07/05,633,2,0.7,1160,633,2,0
61301,2014/03/31,2008/05/03,674,2,0.5,1623,674,2,0
61302,2014/03/31,2012/10/18,529,2,0.625,1298,529,2,0
61303,2014/03/31,2011/01/04,313,5,0.25,3245,313,0,5
61304,2014/03/31,2012/03/12,389,2,0.625,1298,389,2,0
61305,2014/03/31,2013/01/27,178,2,0.625,1298,178,1,1
61306,2014/03/31,2009/10/17,297,2,0.625,1298,297,0,2
61307,2014/03/31,2011/08/12,389,2,0.625,1298,389,2,0
61308,2014/03/31,2013/03/02,373,2,0.5,1622,373,2,0
61309,2014/03/31,2011/04/20,510,2,0.7,1158,510,2,0
61310,2014/03/31,2012/04/23,704,2,0.7,1158,704,2,0
61311,2014/03/31,2011/11/15,672,2,0.35110533200000005,2307,672,2,0
61312,2014/03/31,2009/02/08,561,2,0.51429479,1574,561,2,0
61313,2014/03/31,2007/07/02,482,2,0.375,2158,482,2,0
61314,2014/03/31,2012/01/06,561,2,0.375,2158,561,2,0
61315,2014/03/31,2013/01/24,384,2,0.375,2158,384,2,0
61316,2014/03/31,2010/12/13,648,2,0.625,1294,648,2,0
61317,2014/03/31,2012/08/11,387,2,0.406611362,1989,387,2,0
61318,2014/03/31,2010/04/12,306,2,0.310799385,2602,306,1,1
61319,2014/03/31,2013/03/13,7,2,0.277040082,2919,7,0,2
61320,2014/03/31,2011/01/13,209,2,0.528613473,1529,209,0,2
61321,2014/03/31,2007/08/03,236,3,0.335292653,2409,236,1,2
61322,2014/03/31,2009/01/02,471,2,0.375244073,2151,471,2,0
61323,2014/03/31,2010/05/21,146,2,0.28659801100000004,2816,146,0,2
61324,2014/03/31,2011/02/04,191,2,0.615,1312,191,0,2
61325,2014/03/31,2007/11/09,113,2,0.825516888,977,113,0,2
61326,2014/03/31,2012/09/20,299,2,0.620253846,1300,299,1,1
61327,2014/03/31,2008/11/28,620,2,0.754162769,1069,620,2,0
61328,2014/03/31,2010/09/16,109,2,0.402210579,2004,109,0,2
61329,2014/03/31,2012/01/19,169,2,0.735,1096,169,0,2
61330,2014/03/31,2011/10/07,504,2,0.75,1074,504,2,0
61331,2014/03/31,2012/11/11,153,2,0.71,1134,153,1,1
61332,2014/03/31,2011/09/06,456,2,0.85,947,456,2,0
61333,2014/03/31,2012/10/01,158,2,0.745277778,1080,158,0,2
61334,2014/03/31,2013/03/18,57,2,0.695,1158,57,1,1
61335,2014/03/31,2008/01/08,17,2,0.605,1330,17,0,2
61336,2014/03/31,2009/07/01,47,3,0.4866666670000001,1653,47,0,3
61337,2014/03/31,2011/03/11,42,2,0.355,2266,42,0,2
61338,2014/03/31,2013/01/05,88,2,0.43,1870,88,0,2
61339,2014/03/31,2007/11/05,67,2,0.46,1746,67,0,2
61340,2014/03/31,2008/03/07,157,2,0.46,1746,157,0,2
61341,2014/03/31,2012/10/05,539,2,0.743055556,1080,539,2,0
61342,2014/03/31,2011/11/16,167,2,0.480312125,1666,167,1,1
61343,2014/03/31,2011/08/29,164,2,0.34,2352,164,0,2
61344,2014/03/31,2008/06/18,156,2,0.616491904,1297,156,0,2
61345,2014/03/31,2012/05/26,611,2,0.437629995,1827,611,2,0
61346,2014/03/31,2008/04/28,718,2,0.525,1522,718,2,0
61347,2014/03/31,2007/03/05,669,2,0.25,3196,669,2,0
61348,2014/03/31,2013/03/04,81,2,0.28,2852,81,0,2
61349,2014/03/31,2009/05/31,541,2,0.762559694,1047,541,2,0
61350,2014/03/31,2010/04/20,191,2,0.746679139,1069,191,1,1
61351,2014/03/31,2011/07/27,621,2,0.722961957,1104,621,2,0
61352,2014/03/31,2011/02/07,229,2,0.657749382,1213,229,1,1
61353,2014/03/31,2010/10/07,135,3,0.489441375,1629,135,2,1
61354,2014/03/31,2011/09/10,570,2,0.7216032609999999,1104,570,2,0
61355,2014/03/31,2011/06/13,67,2,0.63755004,1249,67,1,1
61356,2014/03/31,2012/12/25,43,2,0.305,2610,43,0,2
61357,2014/03/31,2012/12/21,356,2,0.32942029,2415,356,1,1
61358,2014/03/31,2007/08/05,47,2,0.72,1104,47,0,2
61359,2014/03/31,2011/05/13,193,3,0.74,1074,193,2,1
61360,2014/03/31,2009/02/18,717,2,0.425,1870,717,2,0
61361,2014/03/31,2006/06/05,625,2,0.725,1096,625,2,0
61362,2014/03/31,2010/11/29,28,2,0.455,1746,28,0,2
61363,2014/03/31,2005/03/09,218,2,0.455,1746,218,0,2
61364,2014/03/31,2012/03/15,119,2,0.408461143,1943,119,0,2
61365,2014/03/31,2009/04/09,86,2,0.364,2180,86,0,2
61366,2014/03/31,2009/01/01,523,2,0.647226754,1226,523,2,0
61367,2014/03/31,2006/07/21,462,2,0.294816054,2691,462,2,0
61368,2014/03/31,2010/08/22,360,2,0.355650224,2230,360,1,1
61369,2014/03/31,2008/02/10,239,2,0.496562108,1594,239,1,1
61370,2014/03/31,2007/02/22,29,2,0.468317536,1688,29,0,2
61371,2014/03/31,2011/09/28,324,2,0.581604121,1359,324,0,2
61372,2014/03/31,2008/07/04,211,2,0.459302326,1720,211,0,2
61373,2014/03/31,2011/01/15,131,2,0.445,1774,131,0,2
61374,2014/03/31,2008/10/15,247,2,0.72,1096,247,0,2
61375,2014/03/31,2011/10/13,698,2,0.320341048,2463,698,2,0
61376,2014/03/31,2005/07/12,193,2,0.729861111,1080,193,0,2
61377,2014/03/31,2011/01/13,345,2,0.4,1970,345,0,2
61378,2014/03/31,2008/12/08,85,2,0.365,2158,85,0,2
61379,2014/03/31,2013/03/14,295,2,0.831721225,947,295,1,1
61380,2014/03/31,2010/10/20,416,2,0.6,1312,416,2,0
61381,2014/03/31,2011/04/06,685,2,0.4,1967,685,2,0
61382,2014/03/31,2005/10/19,674,2,0.4,1967,674,2,0
61383,2014/03/31,2010/01/16,248,2,0.57,1380,248,0,2
61384,2014/03/31,2009/08/03,17,2,0.38,2068,17,0,2
61385,2014/03/31,2008/07/26,526,2,0.45,1746,526,2,0
61386,2014/03/31,2012/05/22,563,2,0.45,1746,563,2,0
61387,2014/03/31,2013/03/14,128,2,0.3,2616,128,0,2
61388,2014/03/31,2011/07/19,452,2,0.3,2616,452,2,0
61389,2014/03/31,2009/12/23,272,2,0.622329094,1258,272,1,1
61390,2014/03/31,2012/07/05,626,2,0.345149912,2268,626,2,0
61391,2014/03/31,2011/12/14,641,2,0.6751509920000001,1159,641,2,0
61392,2014/03/31,2011/04/27,158,2,0.69,1134,158,1,1
61393,2014/03/31,2010/05/30,55,2,0.44340922,1757,55,1,1
61394,2014/03/31,2010/05/28,479,2,0.6,1298,479,2,0
61395,2014/03/31,2011/04/04,138,3,0.4,1947,138,2,1
61396,2014/03/31,2012/07/09,317,2,0.390350877,1995,317,1,1
61397,2014/03/31,2009/11/23,619,2,0.725,1074,619,2,0
61398,2014/03/31,2013/02/26,195,3,0.748173077,1040,195,0,3
61399,2014/03/31,2011/04/11,557,2,0.44165247,1761,557,2,0
61400,2014/03/31,2012/12/01,380,3,0.35291439,2196,380,3,0
61401,2014/03/31,2007/05/23,507,3,0.499483871,1550,507,3,0
61402,2014/03/31,2012/05/01,213,3,0.393333333,1968,213,2,1
61403,2014/03/31,2013/01/09,80,2,0.309779736,2497,80,0,2
61404,2014/03/31,2012/10/16,335,2,0.6,1289,335,1,1
61405,2014/03/31,2005/07/28,226,2,0.6713541670000001,1152,226,0,2
61406,2014/03/31,2012/08/24,586,2,0.4,1933,586,2,0
61407,2014/03/31,2012/09/13,36,3,0.329620469,2345,36,0,3
61408,2014/03/31,2013/02/26,28,2,0.307609562,2510,28,0,2
61409,2014/03/31,2012/11/04,514,2,0.5250340139999999,1470,514,2,0
61410,2014/03/31,2011/10/20,429,2,0.362206573,2130,429,2,0
61411,2014/03/31,2012/09/15,87,2,0.665,1160,87,1,1
61412,2014/03/31,2012/11/19,199,2,0.42210728,1827,199,1,1
61413,2014/03/31,2007/02/01,97,2,0.3,2570,97,0,2
61414,2014/03/31,2012/11/20,274,2,0.28,2750,274,0,2
61415,2014/03/31,2005/12/04,64,2,0.460526631,1671,64,0,2
61416,2014/03/31,2012/05/08,554,2,0.85,904,554,2,0
61417,2014/03/31,2012/07/20,542,2,0.85,904,542,2,0
61418,2014/03/31,2013/01/05,135,3,0.29333333300000003,2619,135,0,3
61419,2014/03/31,2012/04/30,656,2,0.4,1920,656,2,0
61420,2014/03/31,2011/01/04,1,2,0.38,2020,1,0,2
61421,2014/03/31,2010/12/06,198,2,0.38,2020,198,0,2
61422,2014/03/31,2012/02/12,109,2,0.52594928,1459,109,0,2
61423,2014/03/31,2013/01/05,247,2,0.845,908,247,0,2
61424,2014/03/31,2012/02/21,714,2,0.7,1096,714,2,0
61425,2014/03/31,2006/09/30,545,2,0.7,1096,545,2,0
61426,2014/03/31,2011/08/10,397,2,0.7,1096,397,2,0
61427,2014/03/31,2008/12/18,43,2,0.442228637,1732,43,1,1
61428,2014/03/31,2012/11/20,346,2,0.587260169,1303,346,0,2
61429,2014/03/31,2005/09/29,23,2,0.361109014,2119,23,1,1
61430,2014/03/31,2007/11/23,681,2,0.525,1456,681,2,0
61431,2014/03/31,2008/09/15,442,2,0.25,3052,442,2,0
61432,2014/03/31,2012/11/12,282,2,0.470388649,1621,282,1,1
61433,2014/03/31,2012/09/19,560,2,0.4,1902,560,2,0
61434,2014/03/31,2012/09/19,560,2,0.4,1902,560,2,0
61435,2014/03/31,2011/09/05,480,2,1.0,760,480,2,0
61436,2014/03/31,2007/06/16,661,2,1.0,760,661,2,0
61437,2014/03/31,2009/08/29,501,2,1.0,760,501,2,0
61438,2014/03/31,2013/02/15,411,2,1.0,760,411,2,0
61439,2014/03/31,2005/04/09,727,2,1.0,760,727,2,0
61440,2014/03/31,2010/10/03,517,2,1.0,760,517,2,0
61441,2014/03/31,2012/06/04,122,2,0.632777314,1199,122,0,2
61442,2014/03/31,2011/04/27,450,2,0.409481361,1851,450,2,0
61443,2014/03/31,2008/03/06,104,2,0.435,1742,104,0,2
61444,2014/03/31,2012/06/02,213,2,0.7175,1056,213,1,1
61445,2014/03/31,2009/05/23,309,2,0.25,3029,309,0,2
61446,2014/03/31,2008/06/07,540,2,0.6,1262,540,2,0
61447,2014/03/31,2011/03/06,24,2,0.36,2102,24,0,2
61448,2014/03/31,2012/10/27,482,2,0.6676963810000001,1133,482,2,0
61449,2014/03/31,2013/01/24,322,2,0.75,1008,322,1,1
61450,2014/03/31,2008/11/23,247,2,0.33,2290,247,0,2
61451,2014/03/31,2012/05/07,654,2,0.25,3022,654,2,0
61452,2014/03/31,2009/08/28,342,2,0.35,2158,342,1,1
61453,2014/03/31,2012/09/18,557,2,0.35,2158,557,2,0
61454,2014/03/31,2010/05/26,649,2,0.575,1312,649,2,0
61455,2014/03/31,2011/10/27,649,2,0.575,1312,649,2,0
61456,2014/03/31,2012/12/03,388,2,0.575,1312,388,2,0
61457,2014/03/31,2007/07/09,36,2,0.4426835,1703,36,0,2
61458,2014/03/31,2008/03/16,115,2,0.83,908,115,0,2
61459,2014/03/31,2007/09/27,316,2,0.365283843,2061,316,1,1
61460,2014/03/31,2010/12/18,584,2,0.65,1158,584,2,0
61461,2014/03/31,2011/07/09,192,2,0.65,1158,192,0,2
61462,2014/03/31,2011/12/22,609,2,0.65,1158,609,2,0
61463,2014/03/31,2011/03/31,182,2,0.65,1158,182,0,2
61464,2014/03/31,2011/06/09,253,2,0.785,958,253,0,2
61465,2014/03/31,2012/07/07,394,2,0.4,1880,394,2,0
61466,2014/03/31,2005/02/09,515,2,0.7,1074,515,2,0
61467,2014/03/31,2012/05/23,390,2,0.387364621,1939,390,2,0
61468,2014/03/31,2011/10/18,105,2,0.37,2030,105,0,2
61469,2014/03/31,2009/10/24,634,2,1.0,751,634,2,0
61470,2014/03/31,2007/08/21,22,2,0.43,1744,22,0,2
61471,2014/03/31,2006/09/01,29,2,0.34,2204,29,0,2
61472,2014/03/31,2009/05/01,678,2,0.825,908,678,2,0
61473,2014/03/31,2012/01/16,84,2,0.671533632,1115,84,0,2
61474,2014/03/31,2012/03/03,91,2,0.34,2200,91,1,1
61475,2014/03/31,2012/05/25,671,2,0.5,1494,671,2,0
61476,2014/03/31,2013/03/15,228,2,0.8952038370000001,834,228,0,2
61477,2014/03/31,2008/02/16,492,2,0.575,1298,492,2,0
61478,2014/03/31,2012/11/04,324,2,0.575,1298,324,1,1
61479,2014/03/31,2013/02/17,67,3,0.326666667,2283,67,0,3
61480,2014/03/31,2013/03/30,55,2,0.285,2616,55,0,2
61481,2014/03/31,2013/01/31,301,2,0.39,1910,301,0,2
61482,2014/03/31,2013/01/31,217,2,0.39,1910,217,1,1
61483,2014/03/31,2011/06/13,3,2,0.315,2362,3,0,2
61484,2014/03/31,2013/01/01,346,2,0.425,1746,346,1,1
61485,2014/03/31,2011/04/08,602,2,0.425,1746,602,2,0
61486,2014/03/31,2008/12/25,459,2,0.425,1744,459,2,0
61487,2014/03/31,2006/01/24,31,2,0.405454545,1826,31,0,2
61488,2014/03/31,2008/06/09,106,2,0.7900960509999999,937,106,0,2
61489,2014/03/31,2005/01/30,622,2,0.346533958,2135,622,2,0
61490,2014/03/31,2012/08/09,46,2,0.341236162,2168,46,1,1
61491,2014/03/31,2011/01/13,136,2,0.467174463,1582,136,0,2
61492,2014/03/31,2011/11/15,303,2,0.365,2020,303,0,2
61493,2014/03/31,2012/11/11,507,2,0.4,1843,507,2,0
61494,2014/03/31,2004/12/31,107,2,0.65,1134,107,0,2
61495,2014/03/31,2008/11/02,296,2,0.308764139,2387,296,0,2
61496,2014/03/31,2011/05/09,271,2,0.265,2780,271,1,1
61497,2014/03/31,2012/11/13,200,2,0.415,1774,200,1,1
61498,2014/03/31,2012/04/24,340,4,1.0,736,340,2,2
61499,2014/03/31,2010/04/13,211,2,0.7208521059999999,1021,211,1,1
61500,2014/03/31,2012/01/25,121,2,0.33000448600000004,2229,121,0,2
61501,2014/03/31,2011/11/24,166,2,0.33,2229,166,0,2
61502,2014/03/31,2011/06/16,197,2,0.33,2229,197,0,2
61503,2014/03/31,2008/10/06,87,2,0.541081678,1359,87,1,1
61504,2014/03/31,2008/05/22,6,2,0.635,1158,6,0,2
61505,2014/03/31,2005/12/11,33,2,0.326118012,2254,33,0,2
61506,2014/03/31,2012/11/01,127,3,0.373333333,1968,127,0,3
61507,2014/03/31,2007/02/21,185,3,0.470358974,1560,185,1,2
61508,2014/03/31,2013/03/06,236,2,0.42,1746,236,0,2
61509,2014/03/31,2009/03/10,486,2,0.55,1332,486,2,0
61510,2014/03/31,2012/11/24,485,2,0.25,2930,485,2,0
61511,2014/03/31,2012/05/29,599,2,0.25,2930,599,2,0
61512,2014/03/31,2012/10/24,72,2,0.28,2616,72,0,2
61513,2014/03/31,2006/02/21,287,4,0.330822413,2213,287,2,2
61514,2014/03/31,2011/02/25,441,2,0.921878941,793,441,2,0
61515,2014/03/31,2008/10/15,55,3,0.298675388,2446,55,1,2
61516,2014/03/31,2009/06/18,310,2,0.6732258059999999,1085,310,1,1
61517,2014/03/31,2011/10/20,489,2,0.45,1622,489,2,0
61518,2014/03/31,2012/03/06,276,2,0.63,1158,276,0,2
61519,2014/03/31,2009/04/11,304,2,0.265,2752,304,0,2
61520,2014/03/31,2010/11/19,448,2,0.420525404,1732,448,2,0
61521,2014/03/31,2012/08/01,589,2,0.4,1820,589,2,0
61522,2014/03/31,2009/09/28,79,2,0.414265376,1756,79,0,2
61523,2014/03/31,2008/06/07,260,2,0.38,1914,260,0,2
61524,2014/03/31,2008/11/15,122,2,0.36,2020,122,0,2
61525,2014/03/31,2007/02/12,71,2,0.48,1514,71,0,2
61526,2014/03/31,2012/04/04,720,2,0.8,908,720,2,0
61527,2014/03/31,2012/04/05,727,2,0.4,1815,727,2,0
61528,2014/03/31,2011/11/28,35,2,0.37,1962,35,0,2
61529,2014/03/31,2009/03/18,716,2,0.575,1262,716,2,0
61530,2014/03/31,2013/01/24,357,2,0.625,1160,357,1,1
61531,2014/03/31,2012/12/05,480,2,0.675,1074,480,2,0
61532,2014/03/31,2007/06/28,146,2,0.385,1880,146,0,2
61533,2014/03/31,2012/09/09,569,2,0.625,1158,569,2,0
61534,2014/03/31,2011/02/03,306,2,0.670138889,1080,306,0,2
61535,2014/03/31,2010/10/28,38,2,0.625,1158,38,0,2
61536,2014/03/31,2012/04/01,427,2,0.4,1808,427,2,0
61537,2014/03/31,2013/03/04,177,2,0.28,2582,177,0,2
61538,2014/03/31,2009/08/14,335,2,0.475,1522,335,1,1
61539,2014/03/31,2009/10/26,678,2,0.475,1522,678,2,0
61540,2014/03/31,2013/03/03,103,2,0.320496894,2254,103,0,2
61541,2014/03/31,2007/07/20,342,2,0.95,760,342,1,1
61542,2014/03/31,2011/08/15,549,2,0.95,760,549,2,0
61543,2014/03/31,2012/01/18,410,2,0.55,1312,410,2,0
61544,2014/03/31,2013/03/20,367,2,0.55,1312,367,2,0
61545,2014/03/31,2011/07/21,457,2,0.55,1312,457,2,0
61546,2014/03/31,2011/02/28,663,2,0.55,1312,663,2,0
61547,2014/03/31,2011/03/07,488,2,1.0,721,488,2,0
61548,2014/03/31,2011/09/06,94,2,0.31950310600000004,2254,94,0,2
61549,2014/03/31,2006/05/21,281,3,0.36,1998,281,2,1
61550,2014/03/31,2010/11/01,318,2,0.452896725,1588,318,1,1
61551,2014/03/31,2013/01/26,135,2,0.595,1208,135,0,2
61552,2014/03/31,2012/12/05,123,2,0.555011583,1295,123,0,2
61553,2014/03/31,2012/05/01,545,2,0.8,898,545,2,0
61554,2014/03/31,2011/05/27,126,2,0.28958837800000004,2478,126,0,2
61555,2014/03/31,2008/07/01,193,2,0.487126359,1472,193,1,1
61556,2014/03/31,2007/12/22,363,3,0.2,3585,363,2,1
61557,2014/03/31,2008/05/18,15,2,0.524111192,1367,15,0,2
61558,2014/03/31,2007/12/17,9,3,0.433333333,1653,9,0,3
61559,2014/03/31,2012/08/14,38,2,0.41,1746,38,0,2
61560,2014/03/31,2013/01/02,20,2,0.41,1746,20,0,2
61561,2014/03/31,2008/02/12,523,2,0.55,1298,523,2,0
61562,2014/03/31,2006/05/11,359,2,0.55,1298,359,0,2
61563,2014/03/31,2012/05/16,681,2,0.55,1298,681,2,0
61564,2014/03/31,2013/01/16,441,2,0.55,1298,441,2,0
61565,2014/03/31,2013/03/30,366,2,0.55,1298,366,1,1
61566,2014/03/31,2007/05/21,153,2,0.3,2378,153,0,2
61567,2014/03/31,2007/04/25,352,2,0.4268562870000001,1670,352,1,1
61568,2014/03/31,2011/01/17,16,2,0.499698457,1426,16,1,1
61569,2014/03/31,2007/05/14,616,2,0.65,1096,616,2,0
61570,2014/03/31,2011/01/07,707,2,0.65,1096,707,2,0
61571,2014/03/31,2005/04/26,282,2,0.26538003,2684,282,1,1
61572,2014/03/31,2008/05/24,294,2,0.617777778,1152,294,0,2
61573,2014/03/31,2011/09/17,23,2,0.38,1870,23,0,2
61574,2014/03/31,2006/12/01,690,2,0.8958385879999999,793,690,2,0
61575,2014/03/31,2011/03/28,710,2,0.45,1578,710,2,0
61576,2014/03/31,2011/10/12,643,2,0.45,1578,643,2,0
61577,2014/03/31,2012/06/08,660,2,0.475,1494,660,2,0
61578,2014/03/31,2007/08/08,505,2,0.4,1774,505,2,0
61579,2014/03/31,2011/01/04,80,2,0.39,1818,80,0,2
61580,2014/03/31,2013/01/02,276,3,0.36,1968,276,2,1
61581,2014/03/31,2011/02/07,137,2,0.604944492,1171,137,0,2
61582,2014/03/31,2005/09/29,678,2,0.4,1769,678,2,0
61583,2014/03/31,2012/06/04,52,3,0.17150824399999998,4124,52,2,1
61584,2014/03/31,2011/04/18,60,2,0.62911032,1124,60,0,2
61585,2014/03/31,2007/04/02,373,2,0.418838863,1688,373,2,0
61586,2014/03/31,2011/10/01,77,2,0.408123557,1732,77,0,2
61587,2014/03/31,2013/01/10,75,2,0.334375,2112,75,1,1
61588,2014/03/31,2009/08/18,61,2,0.78,904,61,0,2
61589,2014/03/31,2012/08/07,108,2,0.476829268,1476,108,0,2
61590,2014/03/31,2011/05/20,431,2,0.542316602,1295,431,2,0
61591,2014/03/31,2012/07/07,277,2,0.47,1494,277,0,2
61592,2014/03/31,2011/01/13,262,2,0.47,1494,262,0,2
61593,2014/03/31,2007/04/29,390,2,0.404844291,1734,390,2,0
61594,2014/03/31,2012/07/18,27,2,0.64,1096,27,1,1
61595,2014/03/31,2007/08/20,152,2,0.276359338,2538,152,1,1
61596,2014/03/31,2010/08/16,652,2,0.4,1752,652,2,0
61597,2014/03/31,2013/01/24,89,2,0.290868301,2407,89,0,2
61598,2014/03/31,2006/12/01,90,2,0.633532609,1104,90,1,1
61599,2014/03/31,2005/12/28,309,2,0.525,1332,309,0,2
61600,2014/03/31,2010/02/28,162,2,0.92,760,162,0,2
61601,2014/03/31,2010/12/06,214,2,0.67785645,1031,214,0,2
61602,2014/03/31,2012/02/27,92,2,0.34,2055,92,0,2
61603,2014/03/31,2012/10/28,521,2,0.615594714,1135,521,2,0
61604,2014/03/31,2010/12/20,436,2,0.4,1746,436,2,0
61605,2014/03/31,2011/01/24,393,2,0.4,1746,393,2,0
61606,2014/03/31,2012/12/29,425,2,0.4,1746,425,2,0
61607,2014/03/31,2011/10/03,504,2,0.65,1074,504,2,0
61608,2014/03/31,2005/02/10,452,2,0.673359073,1036,452,2,0
61609,2014/03/31,2010/06/20,641,2,0.4,1744,641,2,0
61610,2014/03/31,2012/10/09,499,2,0.4,1744,499,2,0
61611,2014/03/31,2011/11/12,624,2,0.4,1743,624,2,0
61612,2014/03/31,2005/10/22,44,2,0.396736902,1756,44,0,2
61613,2014/03/31,2012/03/14,7,2,0.915,760,7,0,2
61614,2014/03/31,2010/11/29,448,2,0.25,2780,448,2,0
61615,2014/03/31,2007/05/09,497,2,0.25,2780,497,2,0
61616,2014/03/31,2011/04/05,528,2,0.6,1158,528,2,0
61617,2014/03/31,2012/07/14,622,2,0.6,1158,622,2,0
61618,2014/03/31,2011/09/24,611,2,0.6,1158,611,2,0
61619,2014/03/31,2011/10/24,544,2,0.4,1737,544,2,0
61620,2014/03/31,2013/02/18,404,2,0.6,1158,404,2,0
61621,2014/03/31,2009/09/06,486,3,0.3666666670000001,1893,486,3,0
61622,2014/03/31,2012/11/27,294,2,0.265,2616,294,1,1
61623,2014/03/31,2010/02/28,28,2,0.29,2390,28,0,2
61624,2014/03/31,2012/02/06,312,2,0.738207044,937,312,1,1
61625,2014/03/31,2009/11/10,206,2,0.294234043,2350,206,1,1
61626,2014/03/31,2012/04/25,218,2,0.35321410299999995,1957,218,1,1
61627,2014/03/31,2010/11/29,132,2,0.32,2158,132,0,2
61628,2014/03/31,2011/04/21,229,5,0.75,920,229,4,1
61629,2014/03/31,2012/12/03,480,2,0.25,2758,480,2,0
61630,2014/03/31,2012/12/03,479,2,0.25,2758,479,2,0
61631,2014/03/31,2010/07/24,432,2,0.25,2750,432,2,0
61632,2014/03/31,2006/06/28,327,2,0.25,2750,327,0,2
61633,2014/03/31,2012/05/29,24,2,0.26617533,2578,24,1,1
61634,2014/03/31,2008/03/19,398,2,0.3826268820000001,1793,398,2,0
61635,2014/03/31,2010/04/05,569,2,0.730916844,938,569,2,0
61636,2014/03/31,2012/08/11,532,2,0.625,1096,532,2,0
61637,2014/03/31,2012/04/05,717,2,0.625,1096,717,2,0
61638,2014/03/31,2008/05/28,411,2,0.625,1096,411,2,0
61639,2014/03/31,2012/12/06,366,2,0.436949585,1567,366,1,1
61640,2014/03/31,2012/03/10,558,2,0.45,1521,558,2,0
61641,2014/03/31,2007/07/15,17,2,0.346876268,1972,17,1,1
61642,2014/03/31,2010/09/21,553,2,0.9,760,553,2,0
61643,2014/03/31,2012/10/16,285,2,0.52,1312,285,0,2
61644,2014/03/31,2008/10/10,40,2,0.592337098,1151,40,0,2
61645,2014/03/31,2012/09/10,497,2,0.825,826,497,2,0
61646,2014/03/31,2013/01/15,78,2,0.269635932,2527,78,0,2
61647,2014/03/31,2012/06/03,384,2,0.417771639,1629,384,2,0
61648,2014/03/31,2012/04/13,719,2,0.4,1700,719,2,0
61649,2014/03/31,2012/11/03,512,2,0.425,1600,512,2,0
61650,2014/03/31,2013/01/02,349,2,0.75,904,349,0,2
61651,2014/03/31,2011/11/10,285,2,0.585,1158,285,1,1
61652,2014/03/31,2006/09/25,118,2,0.89,760,118,0,2
61653,2014/03/31,2011/11/11,6,2,0.89,760,6,0,2
61654,2014/03/31,2005/05/30,221,2,0.3,2254,221,0,2
61655,2014/03/31,2010/03/03,200,2,0.38,1774,200,0,2
61656,2014/03/31,2010/01/01,324,2,0.406616314,1655,324,1,1
61657,2014/03/31,2011/07/31,49,2,0.385,1746,49,0,2
61658,2014/03/31,2013/01/06,224,2,0.385,1746,224,0,2
61659,2014/03/31,2008/02/23,205,2,0.58,1158,205,0,2
61660,2014/03/31,2013/01/23,95,3,0.29333333300000003,2289,95,0,3
61661,2014/03/31,2008/07/26,51,4,0.3725,1800,51,0,4
61662,2014/03/31,2013/01/04,259,2,0.82192638,815,259,1,1
61663,2014/03/31,2011/09/08,82,2,0.558173478,1199,82,0,2
61664,2014/03/31,2012/12/16,73,3,0.393333333,1701,73,2,1
61665,2014/03/31,2007/02/08,31,2,0.34,1962,31,0,2
61666,2014/03/31,2012/09/01,219,2,0.575,1160,219,1,1
61667,2014/03/31,2012/10/10,443,2,0.6772357720000001,984,443,2,0
61668,2014/03/31,2006/02/02,648,2,0.575,1158,648,2,0
61669,2014/03/31,2011/01/20,628,2,0.875,760,628,2,0
61670,2014/03/31,2006/04/10,144,2,0.377771461,1759,144,0,2
61671,2014/03/31,2013/03/12,281,3,0.3666666670000001,1812,281,0,3
61672,2014/03/31,2007/09/16,323,2,0.473378475,1403,323,0,2
61673,2014/03/31,2011/03/28,97,3,0.322438077,2059,97,0,3
61674,2014/03/31,2012/07/31,305,2,0.293881988,2254,305,0,2
61675,2014/03/31,2007/02/04,261,2,0.33,2007,261,0,2
61676,2014/03/31,2012/11/29,308,2,0.34818612,1902,308,1,1
61677,2014/03/31,2010/06/18,129,2,0.277032691,2386,129,1,1
61678,2014/03/31,2012/05/01,700,2,0.8,826,700,2,0
61679,2014/03/31,2007/06/12,525,2,0.8,826,525,2,0
61680,2014/03/31,2012/04/18,406,2,1.0,660,406,2,0
61681,2014/03/31,2010/03/16,260,2,0.878348868,751,260,0,2
61682,2014/03/31,2011/07/22,477,2,0.449114441,1468,477,2,0
61683,2014/03/31,2011/05/05,35,2,0.34,1938,35,0,2
61684,2014/03/31,2008/08/13,47,2,0.305,2158,47,0,2
61685,2014/03/31,2010/03/12,509,2,0.6,1096,509,2,0
61686,2014/03/31,2010/11/15,624,2,0.6,1096,624,2,0
61687,2014/03/31,2011/01/13,29,2,0.275479682,2387,29,0,2
61688,2014/03/31,2012/11/29,484,2,0.507683398,1295,484,2,0
61689,2014/03/31,2012/07/21,542,2,0.25,2622,542,2,0
61690,2014/03/31,2011/11/20,38,2,0.505,1298,38,0,2
61691,2014/03/31,2012/12/26,273,2,0.45,1456,273,0,2
61692,2014/03/31,2010/03/01,547,2,0.35,1870,547,2,0
61693,2014/03/31,2007/03/11,405,2,0.375,1744,405,2,0
61694,2014/03/31,2012/04/30,324,2,0.25,2616,324,0,2
61695,2014/03/31,2013/03/24,45,2,0.275,2378,45,0,2
61696,2014/03/31,2010/08/07,552,3,0.30971564,2110,552,3,0
61697,2014/03/31,2012/07/06,634,2,0.823959647,793,634,2,0
61698,2014/03/31,2013/01/06,168,2,0.565662338,1155,168,0,2
61699,2014/03/31,2012/12/26,459,2,0.55,1186,459,2,0
61700,2014/03/31,2012/02/27,342,2,0.25,2605,342,0,2
61701,2014/03/31,2006/01/17,339,2,0.465329513,1396,339,1,1
61702,2014/03/31,2012/07/24,612,2,0.4,1622,612,2,0
61703,2014/03/31,2012/10/06,540,2,0.4,1620,540,2,0
61704,2014/03/31,2013/03/28,341,2,0.4,1620,341,0,2
61705,2014/03/31,2013/02/04,422,2,0.4,1620,422,2,0
61706,2014/03/31,2009/03/11,63,2,0.89,728,63,0,2
61707,2014/03/31,2010/10/29,6,2,0.34,1905,6,0,2
61708,2014/03/31,2010/05/07,329,2,0.3,2158,329,0,2
61709,2014/03/31,2011/10/25,448,2,0.425,1522,448,2,0
61710,2014/03/31,2008/04/23,494,2,0.633398629,1021,494,2,0
61711,2014/03/31,2012/10/01,547,2,0.85,760,547,2,0
61712,2014/03/31,2007/03/13,552,2,0.85,760,552,2,0
61713,2014/03/31,2007/03/31,566,2,0.5383653039999999,1199,566,2,0
61714,2014/03/31,2011/10/19,681,2,0.4,1613,681,2,0
61715,2014/03/31,2010/05/02,696,2,0.9,716,696,2,0
61716,2014/03/31,2006/10/22,378,2,0.9,716,378,2,0
61717,2014/03/31,2010/03/30,563,4,0.875,736,563,4,0
61718,2014/03/31,2009/11/28,19,5,0.7,920,19,1,4
61719,2014/03/31,2012/05/08,310,2,0.25,2572,310,0,2
61720,2014/03/31,2008/04/01,467,2,0.25,2563,467,2,0
61721,2014/03/31,2013/01/01,37,2,0.49,1306,37,0,2
61722,2014/03/31,2008/03/15,66,2,0.6055681820000001,1056,66,0,2
61723,2014/03/31,2013/02/09,373,2,0.4,1598,373,2,0
61724,2014/03/31,2013/01/11,74,2,0.34,1880,74,1,1
61725,2014/03/31,2011/04/07,7,2,0.84,760,7,0,2
61726,2014/03/31,2010/12/13,40,3,0.34,1877,40,0,3
61727,2014/03/31,2005/06/15,33,2,0.409332478,1558,33,0,2
61728,2014/03/31,2009/10/24,697,2,0.55,1158,697,2,0
61729,2014/03/31,2013/03/24,276,2,0.295,2158,276,0,2
61730,2014/03/31,2013/03/01,218,2,0.6711919829999999,948,218,0,2
61731,2014/03/31,2012/08/14,5,2,0.44757917,1421,5,0,2
61732,2014/03/31,2012/09/12,247,2,0.463088128,1373,247,1,1
61733,2014/03/31,2005/08/27,675,2,0.25,2542,675,2,0
61734,2014/03/31,2013/02/20,124,2,0.280725022,2262,124,1,1
61735,2014/03/31,2012/03/08,446,3,0.48335872,1313,446,3,0
61736,2014/03/31,2012/08/23,372,2,0.525,1208,372,2,0
61737,2014/03/31,2008/03/22,114,3,0.316666667,1998,114,0,3
61738,2014/03/31,2012/08/28,84,2,0.475,1332,84,0,2
61739,2014/03/31,2004/11/25,44,2,0.420798403,1503,44,1,1
61740,2014/03/31,2009/05/29,338,2,0.319479535,1979,338,0,2
61741,2014/03/31,2011/06/22,273,2,0.28,2253,273,0,2
61742,2014/03/31,2004/12/11,107,2,0.555,1134,107,0,2
61743,2014/03/31,2010/05/03,581,2,0.825,760,581,2,0
61744,2014/03/31,2011/08/10,79,2,0.29,2158,79,0,2
61745,2014/03/31,2011/06/06,546,4,0.85,736,546,4,0
61746,2014/03/31,2012/04/14,458,4,0.85,736,458,4,0
61747,2014/03/31,2008/06/21,300,2,0.494099526,1266,300,1,1
61748,2014/03/31,2013/03/30,325,2,0.25,2502,325,0,2
61749,2014/03/31,2013/01/25,78,2,0.28,2232,78,0,2
61750,2014/03/31,2011/05/12,117,2,0.5368588639999999,1162,117,0,2
61751,2014/03/31,2012/11/13,357,2,0.475,1312,357,0,2
61752,2014/03/31,2012/05/14,663,2,0.475,1312,663,2,0
61753,2014/03/31,2009/12/28,144,2,0.590445498,1055,144,1,1
61754,2014/03/31,2010/12/20,346,2,0.25,2486,346,0,2
61755,2014/03/31,2011/09/26,139,2,0.24749004,2510,139,1,1
61756,2014/03/31,2005/11/05,136,2,0.535,1158,136,0,2
61757,2014/03/31,2011/03/07,619,2,0.75,826,619,2,0
61758,2014/03/31,2011/12/11,580,2,0.311161388,1989,580,2,0
61759,2014/03/31,2008/08/28,71,2,0.328548644,1881,71,0,2
61760,2014/03/31,2011/07/09,481,2,0.36262478,1703,481,2,0
61761,2014/03/31,2013/01/06,416,2,0.59728419,1031,416,2,0
61762,2014/03/31,2010/11/19,687,2,0.25,2463,687,2,0
61763,2014/03/31,2009/08/24,374,2,0.25,2463,374,2,0
61764,2014/03/31,2010/11/19,168,2,0.738105516,834,168,0,2
61765,2014/03/31,2008/01/23,420,2,0.419461486,1467,420,2,0
61766,2014/03/31,2013/03/29,289,2,0.46,1332,289,0,2
61767,2014/03/31,2012/01/12,506,2,0.4,1526,506,2,0
61768,2014/03/31,2013/01/16,439,2,0.35,1744,439,2,0
61769,2014/03/31,2009/07/28,293,2,0.47,1298,293,1,1
61770,2014/03/31,2007/12/02,569,2,0.4,1522,569,2,0
61771,2014/03/31,2009/05/22,453,2,0.4,1522,453,2,0
61772,2014/03/31,2012/03/29,695,2,0.4,1522,695,2,0
61773,2014/03/31,2012/04/03,692,2,0.4,1522,692,2,0
61774,2014/03/31,2009/11/04,680,2,0.4,1522,680,2,0
61775,2014/03/31,2009/11/21,669,2,0.551358696,1104,669,2,0
61776,2014/03/31,2006/06/09,238,2,0.525,1158,238,0,2
61777,2014/03/31,2007/05/24,265,2,0.313909657,1926,265,0,2
61778,2014/03/31,2010/03/29,122,2,0.795,760,122,0,2
61779,2014/03/31,2013/02/06,366,2,0.5,1208,366,1,1
61780,2014/03/31,2012/11/22,496,2,0.4,1510,496,2,0
61781,2014/03/31,2012/11/05,208,2,0.494545455,1221,208,1,1
61782,2014/03/31,2007/06/09,366,2,0.55,1096,366,1,1
61783,2014/03/31,2012/12/01,478,2,0.55,1096,478,2,0
61784,2014/03/31,2012/06/05,400,3,0.3666666670000001,1644,400,3,0
61785,2014/03/31,2013/03/21,344,2,0.4,1506,344,1,1
61786,2014/03/31,2013/03/07,49,2,0.26,2310,49,1,1
61787,2014/03/31,2013/03/15,364,2,0.25,2401,364,0,2
61788,2014/03/31,2011/07/26,17,2,0.422019704,1421,17,1,1
61789,2014/03/31,2005/11/21,81,2,0.295,2030,81,1,1
61790,2014/03/31,2011/10/02,487,4,0.8125,736,487,4,0
61791,2014/03/31,2012/12/27,437,2,0.4,1494,437,2,0
61792,2014/03/31,2011/04/02,82,2,0.265393159,2251,82,0,2
61793,2014/03/31,2007/05/04,137,2,0.32,1866,137,0,2
61794,2014/03/31,2011/09/09,99,2,0.46,1298,99,1,1
61795,2014/03/31,2009/02/08,57,2,0.34,1756,57,0,2
61796,2014/03/31,2006/08/03,397,2,0.25,2378,397,2,0
61797,2014/03/31,2010/12/20,126,2,0.34,1744,126,0,2
61798,2014/03/31,2011/02/21,3,2,0.34,1744,3,0,2
61799,2014/03/31,2013/03/28,321,2,0.25,2370,321,0,2
61800,2014/03/31,2013/02/09,405,2,0.477258065,1240,405,2,0
61801,2014/03/31,2011/09/24,44,2,0.67,882,44,0,2
61802,2014/03/31,2009/10/09,630,2,0.825,716,630,2,0
61803,2014/03/31,2012/06/26,392,2,0.825,716,392,2,0
61804,2014/03/31,2012/08/05,24,3,0.34,1737,24,0,3
61805,2014/03/31,2012/04/12,210,2,0.395,1494,210,0,2
61806,2014/03/31,2005/04/12,475,2,0.25,2356,475,2,0
61807,2014/03/31,2009/05/19,493,2,0.25,2356,493,2,0
61808,2014/03/31,2006/08/25,17,2,0.497271959,1184,17,0,2
61809,2014/03/31,2007/10/31,32,2,0.489524604,1199,32,0,2
61810,2014/03/31,2013/02/25,22,2,0.28,2092,22,0,2
61811,2014/03/31,2010/11/25,166,2,0.77,760,166,0,2
61812,2014/03/31,2013/02/27,78,2,0.422310469,1385,78,0,2
61813,2014/03/31,2013/02/10,21,3,0.406666667,1437,21,0,3
61814,2014/03/31,2012/07/16,49,2,0.45,1298,49,1,1
61815,2014/03/31,2009/03/21,150,2,0.445,1312,150,0,2
61816,2014/03/31,2011/08/27,405,2,0.4,1458,405,2,0
61817,2014/03/31,2013/02/13,47,2,0.27,2158,47,0,2
61818,2014/03/31,2012/12/21,393,2,0.4,1456,393,2,0
61819,2014/03/31,2011/05/05,355,2,0.5,1160,355,0,2
61820,2014/03/31,2010/11/24,232,2,0.7007738809999999,827,232,1,1
61821,2014/03/31,2011/01/15,443,2,0.5,1158,443,2,0
61822,2014/03/31,2012/05/19,331,2,0.5,1158,331,0,2
61823,2014/03/31,2012/05/19,331,2,0.5,1158,331,0,2
61824,2014/03/31,2008/08/28,341,2,0.7,826,341,0,2
61825,2014/03/31,2009/10/28,104,2,0.436467474,1322,104,0,2
61826,2014/03/31,2012/06/12,632,2,0.4,1442,632,2,0
61827,2014/03/31,2012/04/24,648,2,0.533966636,1079,648,2,0
61828,2014/03/31,2009/03/17,397,3,0.328107184,1754,397,3,0
61829,2014/03/31,2010/12/29,46,2,0.385,1494,46,0,2
61830,2014/03/31,2011/06/20,545,2,0.543519395,1057,545,2,0
61831,2014/03/31,2009/12/12,375,2,0.8,716,375,2,0
61832,2014/03/31,2013/02/11,119,2,0.415,1380,119,0,2
61833,2014/03/31,2011/12/12,519,2,0.25,2288,519,2,0
61834,2014/03/31,2010/04/01,501,2,0.75,760,501,2,0
61835,2014/03/31,2011/11/15,309,2,0.75,760,309,0,2
61836,2014/03/31,2010/12/20,90,2,0.29,1962,90,0,2
61837,2014/03/31,2011/05/04,296,2,0.49,1160,296,0,2
61838,2014/03/31,2007/08/16,341,2,0.498463565,1139,341,1,1
61839,2014/03/31,2010/11/19,266,2,0.38,1494,266,0,2
61840,2014/03/31,2010/11/19,170,2,0.49,1158,170,0,2
61841,2014/03/31,2010/02/22,78,2,0.49,1158,78,1,1
61842,2014/03/31,2007/06/03,16,2,0.49,1158,16,0,2
61843,2014/03/31,2012/08/29,386,2,0.425,1332,386,2,0
61844,2014/03/31,2008/02/09,76,2,0.278965007,2029,76,1,1
61845,2014/03/31,2010/08/24,130,2,0.515,1096,130,0,2
61846,2014/03/31,2010/03/01,430,2,0.25,2254,430,2,0
61847,2014/03/31,2011/01/24,432,2,0.25,2254,432,2,0
61848,2014/03/31,2012/07/01,92,2,0.381192412,1476,92,1,1
61849,2014/03/31,2011/01/09,386,2,0.4,1406,386,2,0
61850,2014/03/31,2012/09/01,511,2,0.375,1494,511,2,0
61851,2014/03/31,2006/03/07,114,2,0.735,760,114,0,2
61852,2014/03/31,2012/08/14,327,2,0.25,2234,327,1,1
61853,2014/03/31,2012/02/20,170,4,0.39,1432,170,2,2
61854,2014/03/31,2012/01/01,432,2,0.425,1312,432,2,0
61855,2014/03/31,2006/03/13,570,2,0.25,2230,570,2,0
61856,2014/03/31,2013/01/06,448,2,0.5,1114,448,2,0
61857,2014/03/31,2008/02/21,16,2,0.275,2020,16,0,2
61858,2014/03/31,2006/05/25,59,2,0.73,760,59,0,2
61859,2014/03/31,2013/02/01,243,2,0.405750916,1365,243,0,2
61860,2014/03/31,2013/02/01,364,3,1.0,552,364,2,1
61861,2014/03/31,2008/05/04,579,3,1.0,552,579,3,0
61862,2014/03/31,2008/05/22,319,2,0.5,1104,319,0,2
61863,2014/03/31,2010/03/07,245,2,0.34,1622,245,1,1
61864,2014/03/31,2011/10/31,658,2,0.475,1158,658,2,0
61865,2014/03/31,2006/07/23,147,2,0.92,597,147,0,2
61866,2014/03/31,2013/03/18,131,2,0.32,1714,131,0,2
61867,2014/03/31,2008/09/17,566,2,0.5,1096,566,2,0
61868,2014/03/31,2012/09/07,499,2,0.5,1096,499,2,0
61869,2014/03/31,2013/02/18,305,2,0.365,1494,305,0,2
61870,2014/03/31,2011/04/13,149,3,0.58010661,938,149,0,3
61871,2014/03/31,2012/07/06,224,2,0.323093824,1684,224,1,1
61872,2014/03/31,2013/02/09,404,2,0.293506494,1848,404,2,0
61873,2014/03/31,2011/01/11,333,2,0.313499421,1726,333,1,1
61874,2014/03/31,2012/11/09,492,2,0.475,1134,492,2,0
61875,2014/03/31,2012/09/26,88,2,0.28,1914,88,0,2
61876,2014/03/31,2012/08/02,605,2,0.4,1339,605,2,0
61877,2014/03/31,2011/02/01,727,2,0.4,1339,727,2,0
61878,2014/03/31,2012/12/04,35,2,0.46,1158,35,1,1
61879,2014/03/31,2007/06/14,42,2,0.249624765,2132,42,1,1
61880,2014/03/31,2008/09/30,205,2,0.49,1080,205,0,2
61881,2014/03/31,2006/04/26,477,2,0.525,1008,477,2,0
61882,2014/03/31,2012/12/18,406,2,0.286930586,1844,406,2,0
61883,2014/03/31,2013/03/01,190,2,0.33,1602,190,0,2
61884,2014/03/31,2010/12/29,91,2,0.695,760,91,0,2
61885,2014/03/31,2007/11/10,578,2,0.350132626,1508,578,2,0
61886,2014/03/31,2013/02/05,398,2,0.4,1312,398,2,0
61887,2014/03/31,2011/01/14,126,2,0.4,1306,126,0,2
61888,2014/03/31,2012/11/20,359,2,0.475,1096,359,1,1
61889,2014/03/31,2011/09/09,419,2,0.137586116,3774,419,2,0
61890,2014/03/31,2011/02/07,660,2,0.4,1298,660,2,0
61891,2014/03/31,2012/04/05,722,2,0.4,1298,722,2,0
61892,2014/03/31,2012/03/21,584,2,0.4,1298,584,2,0
61893,2014/03/31,2012/02/11,593,2,0.4,1298,593,2,0
61894,2014/03/31,2013/02/06,91,3,0.36,1437,91,0,3
61895,2014/03/31,2012/11/08,499,2,0.400584567,1283,499,2,0
61896,2014/03/31,2011/06/02,682,2,0.394208494,1295,682,2,0
61897,2014/03/31,2012/07/01,543,2,0.45,1134,543,2,0
61898,2014/03/31,2013/01/31,275,2,0.465,1096,275,1,1
61899,2014/03/31,2008/05/05,279,2,0.28,1820,279,0,2
61900,2014/03/31,2010/11/17,283,2,0.34,1494,283,0,2
61901,2014/03/31,2012/09/11,87,2,0.391915058,1295,87,0,2
61902,2014/03/31,2007/03/19,155,2,0.38,1332,155,0,2
61903,2014/03/31,2012/05/16,195,2,0.415,1208,195,0,2
61904,2014/03/31,2008/04/30,56,2,0.274389041,1825,56,0,2
61905,2014/03/31,2012/05/16,270,2,0.415,1206,270,0,2
61906,2014/03/31,2011/09/07,91,2,0.33,1506,91,0,2
61907,2014/03/31,2010/06/01,23,2,0.34,1456,23,0,2
61908,2014/03/31,2011/12/12,281,2,0.75,660,281,0,2
61909,2014/03/31,2012/12/26,175,2,0.28,1746,175,0,2
61910,2014/03/31,2012/07/16,72,2,0.28,1746,72,0,2
61911,2014/03/31,2008/05/20,31,2,0.28,1746,31,0,2
61912,2014/03/31,2008/04/14,185,2,0.28,1746,185,0,2
61913,2014/03/31,2010/03/12,564,2,0.36176906,1351,564,2,0
61914,2014/03/31,2010/07/07,180,2,0.28,1744,180,0,2
61915,2014/03/31,2010/06/03,306,2,0.375,1298,306,1,1
61916,2014/03/31,2011/06/19,159,2,0.42,1158,159,0,2
61917,2014/03/31,2013/03/15,379,2,0.325,1494,379,2,0
61918,2014/03/31,2011/03/28,709,2,0.4,1208,709,2,0
61919,2014/03/31,2012/06/29,612,2,0.4,1208,612,2,0
61920,2014/03/31,2013/02/01,243,2,0.635,760,243,1,1
61921,2014/03/31,2011/08/30,56,2,0.44,1096,56,1,1
61922,2014/03/31,2012/05/08,678,2,0.35058309,1372,678,2,0
61923,2014/03/31,2012/12/20,180,2,0.415,1158,180,0,2
61924,2014/03/31,2010/11/17,7,2,0.33,1456,7,0,2
61925,2014/03/31,2012/07/05,275,2,0.487202442,983,275,1,1
61926,2014/03/31,2009/03/04,35,2,0.255966792,1867,35,0,2
61927,2014/03/31,2013/01/27,392,2,0.4,1190,392,2,0
61928,2014/03/31,2007/07/19,12,2,0.41,1158,12,0,2
61929,2014/03/31,2013/03/01,338,2,0.35,1332,338,0,2
61930,2014/03/31,2011/08/22,318,2,0.425,1096,318,0,2
61931,2014/03/31,2005/03/15,337,3,0.283333333,1644,337,2,1
61932,2014/03/31,2012/11/18,492,2,0.351442673,1317,492,2,0
61933,2014/03/31,2012/11/02,208,2,0.265,1746,208,0,2
61934,2014/03/31,2008/02/23,356,2,0.25,1850,356,0,2
61935,2014/03/31,2010/03/13,644,2,0.25,1832,644,2,0
61936,2014/03/31,2012/06/01,162,2,0.55,826,162,1,1
61937,2014/03/31,2013/02/11,18,2,0.28,1622,18,0,2
61938,2014/03/31,2011/06/02,461,2,0.4,1134,461,2,0
61939,2014/03/31,2006/10/18,398,2,0.4,1134,398,2,0
61940,2014/03/31,2011/12/01,499,2,0.25,1807,499,2,0
61941,2014/03/31,2011/02/04,247,2,0.38,1186,247,0,2
61942,2014/03/31,2012/08/13,222,2,0.287701149,1566,222,1,1
61943,2014/03/31,2010/09/10,183,2,0.4484800000000001,1000,183,0,2
61944,2014/03/31,2008/04/15,322,2,0.75,597,322,1,1
61945,2014/03/31,2012/06/08,37,2,0.37,1210,37,0,2
61946,2014/03/31,2012/05/27,78,2,0.6,746,78,0,2
61947,2014/03/31,2013/02/03,296,2,0.625,716,296,0,2
61948,2014/03/31,2009/01/23,3,2,0.28,1598,3,0,2
61949,2014/03/31,2008/07/01,96,2,0.34,1312,96,0,2
61950,2014/03/31,2013/01/27,231,2,0.34,1312,231,1,1
61951,2014/03/31,2011/02/18,194,2,0.295,1494,194,1,1
61952,2014/03/31,2008/11/14,176,2,0.38,1158,176,0,2
61953,2014/03/31,2012/06/24,199,2,0.38,1158,199,0,2
61954,2014/03/31,2012/02/05,179,2,0.38,1158,179,0,2
61955,2014/03/31,2008/04/07,488,2,0.25,1757,488,2,0
61956,2014/03/31,2013/01/24,396,2,0.4,1096,396,2,0
61957,2014/03/31,2012/03/28,553,2,0.25,1744,553,2,0
61958,2014/03/31,2012/03/15,691,2,0.375,1158,691,2,0
61959,2014/03/31,2011/11/03,511,2,0.334633205,1295,511,2,0
61960,2014/03/31,2013/01/09,245,2,0.28,1546,245,0,2
61961,2014/03/31,2010/04/07,385,2,0.4,1080,385,2,0
61962,2014/03/31,2011/09/07,232,2,0.462931034,928,232,1,1
61963,2014/03/31,2012/05/23,627,2,0.4,1074,627,2,0
61964,2014/03/31,2010/02/05,112,2,0.4,1074,112,0,2
61965,2014/03/31,2007/08/11,621,2,0.4,1074,621,2,0
61966,2014/03/31,2011/01/28,47,2,0.595,716,47,0,2
61967,2014/03/31,2007/12/03,121,2,0.35,1206,121,0,2
61968,2014/03/31,2008/06/01,3,2,0.385,1096,3,0,2
61969,2014/03/31,2013/02/14,66,2,0.28,1506,66,0,2
61970,2014/03/31,2010/03/01,9,2,0.465,900,9,1,1
61971,2014/03/31,2011/06/28,7,2,0.28,1494,7,0,2
61972,2014/03/31,2009/09/01,442,2,0.33313253,1245,442,2,0
61973,2014/03/31,2008/03/21,483,3,0.75,552,483,3,0
61974,2014/03/31,2011/04/22,653,2,0.45,904,653,2,0
61975,2014/03/31,2008/04/24,591,2,0.45,904,591,2,0
61976,2014/03/31,2009/08/18,646,2,0.45,904,646,2,0
61977,2014/03/31,2011/01/13,193,2,0.45,904,193,0,2
61978,2014/03/31,2013/02/14,2,2,0.28,1442,2,0,2
61979,2014/03/31,2009/12/20,499,2,0.25,1600,499,2,0
61980,2014/03/31,2006/03/28,95,2,0.535,746,95,0,2
61981,2014/03/31,2011/02/21,34,2,0.53,746,34,0,2
61982,2014/03/31,2013/03/19,114,2,0.3,1312,114,0,2
61983,2014/03/31,2012/06/12,643,2,0.3,1312,643,2,0
61984,2014/03/31,2008/02/17,228,2,0.690921986,564,228,0,2
61985,2014/03/31,2013/02/28,52,2,0.27,1434,52,0,2
61986,2014/03/31,2006/01/25,67,2,1.05,368,67,0,2
61987,2014/03/31,2006/04/23,655,2,0.35,1096,655,2,0
61988,2014/03/31,2012/06/07,322,2,0.325,1158,322,1,1
61989,2014/03/31,2008/12/03,209,2,0.415,904,209,0,2
61990,2014/03/31,2011/01/13,416,2,0.25,1494,416,2,0
61991,2014/03/31,2008/09/23,664,2,0.25,1494,664,2,0
61992,2014/03/31,2011/12/14,28,2,0.34,1096,28,0,2
61993,2014/03/31,2011/04/24,338,2,1.0,368,338,0,2
61994,2014/03/31,2008/06/09,466,2,1.0,368,466,2,0
61995,2014/03/31,2011/11/29,655,2,1.0,368,655,2,0
61996,2014/03/31,2010/02/07,32,2,0.275,1312,32,0,2
61997,2014/03/31,2012/11/19,286,2,0.328611111,1080,286,0,2
61998,2014/03/31,2011/12/01,156,2,0.3,1160,156,0,2
61999,2014/03/31,2013/01/14,117,2,0.945,368,117,1,1
62000,2014/03/31,2011/02/03,304,2,0.265,1298,304,0,2
62001,2014/03/31,2012/12/18,103,3,0.3,1140,103,0,3
62002,2014/03/31,2012/09/11,106,2,0.3,1134,106,0,2
62003,2014/03/31,2012/05/11,633,2,0.25,1357,633,2,0
62004,2014/03/31,2011/07/21,275,2,0.92,368,275,0,2
62005,2014/03/31,2010/05/25,473,2,0.4,834,473,2,0
62006,2014/03/31,2011/01/13,18,2,0.245891932,1351,18,0,2
62007,2014/03/31,2009/01/03,424,2,0.25,1298,424,2,0
62008,2014/03/31,2012/09/30,52,2,0.275,1158,52,0,2
62009,2014/03/31,2012/09/19,23,2,0.28,1134,23,0,2
62010,2014/03/31,2005/03/14,53,2,0.34,928,53,0,2
62011,2014/03/31,2011/02/09,421,2,0.85,368,421,2,0
62012,2014/03/31,2011/03/06,472,2,0.85,368,472,2,0
62013,2014/03/31,2006/06/09,450,2,0.85,368,450,2,0
62014,2014/03/31,2013/03/11,384,2,0.85,368,384,2,0
62015,2014/03/31,2012/03/29,158,2,0.34,904,158,0,2
62016,2014/03/31,2011/03/09,199,2,0.835,368,199,0,2
62017,2014/03/31,2013/02/05,9,2,0.30712,1000,9,0,2
62018,2014/03/31,2012/10/18,498,2,0.4,760,498,2,0
62019,2014/03/31,2008/08/08,306,2,0.25,1208,306,0,2
62020,2014/03/31,2007/12/09,624,2,0.8,368,624,2,0
62021,2014/03/31,2005/05/18,73,2,0.32,904,73,0,2
62022,2014/03/31,2012/06/26,198,2,0.77,368,198,0,2
62023,2014/03/31,2013/02/22,50,2,0.76,368,50,1,1
62024,2014/03/31,2013/03/03,131,2,0.29,958,131,0,2
62025,2014/03/31,2008/02/13,57,2,0.19,1456,57,0,2
62026,2014/03/31,2009/12/12,471,2,0.75,368,471,2,0
62027,2014/03/31,2011/07/17,492,2,0.75,368,492,2,0
62028,2014/03/31,2004/12/16,252,2,0.75,368,252,0,2
62029,2014/03/31,2013/01/31,416,2,0.75,368,416,2,0
62030,2014/03/31,2008/12/05,418,2,0.75,368,418,2,0
62031,2014/03/31,2012/07/12,412,2,0.75,368,412,2,0
62032,2014/03/31,2012/04/12,671,2,0.25,1096,671,2,0
62033,2014/03/31,2010/07/07,464,2,0.25,1096,464,2,0
62034,2014/03/31,2012/10/23,519,2,0.25,1096,519,2,0
62035,2014/03/31,2005/03/11,538,2,0.25,1096,538,2,0
62036,2014/03/31,2013/02/12,360,2,0.25,1096,360,0,2
62037,2014/03/31,2011/01/14,180,2,0.14,1914,180,0,2
62038,2014/03/31,2013/03/29,357,2,0.35,760,357,0,2
62039,2014/03/31,2005/05/08,89,2,0.71,368,89,0,2
62040,2014/03/31,2008/11/16,121,2,0.67,368,121,0,2
62041,2014/03/31,2010/07/08,39,2,0.225,1062,39,1,1
62042,2014/03/31,2012/12/20,464,2,0.25,904,464,2,0
62043,2014/03/31,2011/04/14,282,2,0.28,760,282,0,2
